PokerStars Zoom Hand #229229354995:  Hold'em No Limit ($0.01/$0.02) - 2021/08/21 20:56:43 CET [2021/08/21 14:56:43 ET]
Table 'Halley' 6-max Seat #1 is the button
Seat 1: CréééW!!! ($1.01 in chips) 
Seat 2: Giljane ($2.95 in chips) 
Seat 3: Scaaalll ($2 in chips) 
Seat 4: Dominykas ($2.60 in chips) 
Seat 5: Sinad1302 ($3.31 in chips) 
Seat 6: musirov ($2.81 in chips) 
Giljane: posts small blind $0.01
Scaaalll: posts big blind $0.02
*** HOLE CARDS ***
Dealt to Scaaalll [Kh 6d]
Dominykas: folds 
Sinad1302: folds 
Sinad1302 is disconnected 
musirov: calls $0.02
CréééW!!!: folds 
Giljane: calls $0.01
Scaaalll: checks 
*** FLOP *** [Js 3h Ah]
Giljane: checks 
Scaaalll: checks 
musirov: checks 
*** TURN *** [Js 3h Ah] [Kd]
Giljane: checks 
Scaaalll: checks 
musirov: checks 
*** RIVER *** [Js 3h Ah Kd] [5d]
Giljane: bets $0.02
Scaaalll: calls $0.02
musirov: folds 
*** SHOW DOWN ***
Giljane: shows [9d 5c] (a pair of Fives)
Scaaalll: shows [Kh 6d] (a pair of Kings)
Scaaalll collected $0.10 from pot
*** SUMMARY ***
Total pot $0.10 | Rake $0 
Board [Js 3h Ah Kd 5d]
Seat 1: CréééW!!! (button) folded before Flop (didn't bet)
Seat 2: Giljane (small blind) showed [9d 5c] and lost with a pair of Fives
Seat 3: Scaaalll (big blind) showed [Kh 6d] and won ($0.10) with a pair of Kings
Seat 4: Dominykas folded before Flop (didn't bet)
Seat 5: Sinad1302 folded before Flop (didn't bet)
Seat 6: musirov folded on the River



PokerStars Zoom Hand #229229372606:  Hold'em No Limit ($0.01/$0.02) - 2021/08/21 20:57:43 CET [2021/08/21 14:57:43 ET]
Table 'Halley' 6-max Seat #1 is the button
Seat 1: Pogled ($1.36 in chips) 
Seat 2: bt710 ($2.08 in chips) 
Seat 3: SpartanRace1 ($9.62 in chips) 
Seat 4: sanko1980 ($0.64 in chips) 
Seat 5: Quantum771 ($2.38 in chips) 
Seat 6: Scaaalll ($2.05 in chips) 
bt710: posts small blind $0.01
SpartanRace1: posts big blind $0.02
*** HOLE CARDS ***
Dealt to Scaaalll [Jd 3s]
sanko1980: raises $0.02 to $0.04
Quantum771: folds 
Scaaalll: folds 
Pogled: folds 
bt710: folds 
SpartanRace1: folds 
Uncalled bet ($0.02) returned to sanko1980
sanko1980 collected $0.05 from pot
sanko1980: doesn't show hand 
*** SUMMARY ***
Total pot $0.05 | Rake $0 
Seat 1: Pogled (button) folded before Flop (didn't bet)
Seat 2: bt710 (small blind) folded before Flop
Seat 3: SpartanRace1 (big blind) folded before Flop
Seat 4: sanko1980 collected ($0.05)
Seat 5: Quantum771 folded before Flop (didn't bet)
Seat 6: Scaaalll folded before Flop (didn't bet)



PokerStars Zoom Hand #229229374052:  Hold'em No Limit ($0.01/$0.02) - 2021/08/21 20:57:48 CET [2021/08/21 14:57:48 ET]
Table 'Halley' 6-max Seat #1 is the button
Seat 1: klausC3 ($2.99 in chips) 
Seat 2: majo_74 ($2 in chips) 
Seat 3: Zazill ($2.38 in chips) 
Seat 4: Hallyson_23 ($2 in chips) 
Seat 5: Scaaalll ($2.05 in chips) 
Seat 6: 6i3oH77 ($1.34 in chips) 
majo_74: posts small blind $0.01
Zazill: posts big blind $0.02
*** HOLE CARDS ***
Dealt to Scaaalll [Js Jh]
Hallyson_23: folds 
Scaaalll: raises $0.04 to $0.06
6i3oH77: calls $0.06
klausC3: folds 
majo_74: folds 
Zazill: folds 
*** FLOP *** [9c 3d Ks]
Scaaalll: bets $0.08
6i3oH77: calls $0.08
*** TURN *** [9c 3d Ks] [Jc]
Scaaalll: bets $0.22
6i3oH77: folds 
Uncalled bet ($0.22) returned to Scaaalll
Scaaalll collected $0.30 from pot
Scaaalll: doesn't show hand 
6i3oH77 is disconnected 
*** SUMMARY ***
Total pot $0.31 | Rake $0.01 
Board [9c 3d Ks Jc]
Seat 1: klausC3 (button) folded before Flop (didn't bet)
Seat 2: majo_74 (small blind) folded before Flop
Seat 3: Zazill (big blind) folded before Flop
Seat 4: Hallyson_23 folded before Flop (didn't bet)
Seat 5: Scaaalll collected ($0.30)
Seat 6: 6i3oH77 folded on the Turn



PokerStars Zoom Hand #229229370813:  Hold'em No Limit ($0.01/$0.02) - 2021/08/21 20:57:38 CET [2021/08/21 14:57:38 ET]
Table 'Halley' 6-max Seat #1 is the button
Seat 1: Scaaalll ($2.05 in chips) 
Seat 2: Fastidium ($1 in chips) 
Seat 3: xxRoseIloveu ($6.16 in chips) 
Seat 4: lexus00174 ($2.08 in chips) 
Seat 5: beber_1613 ($2.05 in chips) 
Seat 6: mgort1988 ($3.47 in chips) 
Fastidium: posts small blind $0.01
xxRoseIloveu: posts big blind $0.02
*** HOLE CARDS ***
Dealt to Scaaalll [Ts 5h]
lexus00174: folds 
beber_1613: folds 
mgort1988: folds 
Scaaalll: folds 
Fastidium: raises $0.04 to $0.06
xxRoseIloveu: calls $0.04
*** FLOP *** [Ks Qs As]
Fastidium: checks 
xxRoseIloveu: checks 
*** TURN *** [Ks Qs As] [3c]
Fastidium: checks 
xxRoseIloveu: checks 
*** RIVER *** [Ks Qs As 3c] [Kc]
Fastidium: checks 
xxRoseIloveu: checks 
*** SHOW DOWN ***
Fastidium: shows [4c 6d] (a pair of Kings)
xxRoseIloveu: shows [7h 8s] (a pair of Kings - Ace+Queen+Eight kicker)
xxRoseIloveu collected $0.12 from pot
*** SUMMARY ***
Total pot $0.12 | Rake $0 
Board [Ks Qs As 3c Kc]
Seat 1: Scaaalll (button) folded before Flop (didn't bet)
Seat 2: Fastidium (small blind) showed [4c 6d] and lost with a pair of Kings
Seat 3: xxRoseIloveu (big blind) showed [7h 8s] and won ($0.12) with a pair of Kings
Seat 4: lexus00174 folded before Flop (didn't bet)
Seat 5: beber_1613 folded before Flop (didn't bet)
Seat 6: mgort1988 folded before Flop (didn't bet)



PokerStars Zoom Hand #229229366953:  Hold'em No Limit ($0.01/$0.02) - 2021/08/21 20:57:24 CET [2021/08/21 14:57:24 ET]
Table 'Halley' 6-max Seat #1 is the button
Seat 1: AlexRexer ($1.53 in chips) 
Seat 2: Scaaalll ($2.06 in chips) 
Seat 3: fabor1303 ($7.70 in chips) 
Seat 4: ckooistra36 ($0.79 in chips) 
Seat 5: no way yo ($3.58 in chips) 
Seat 6: Draat505 ($2.02 in chips) 
Scaaalll: posts small blind $0.01
fabor1303: posts big blind $0.02
*** HOLE CARDS ***
Dealt to Scaaalll [Ac 9s]
ckooistra36: raises $0.02 to $0.04
no way yo: calls $0.04
Draat505: folds 
AlexRexer: raises $0.11 to $0.15
Scaaalll: folds 
fabor1303: folds 
ckooistra36: calls $0.11
no way yo: calls $0.11
*** FLOP *** [7s 6h 5h]
ckooistra36: bets $0.08
no way yo: calls $0.08
AlexRexer: raises $0.50 to $0.58
ckooistra36: raises $0.06 to $0.64 and is all-in
no way yo: folds 
AlexRexer: calls $0.06
*** TURN *** [7s 6h 5h] [6d]
*** RIVER *** [7s 6h 5h 6d] [Kh]
*** SHOW DOWN ***
ckooistra36: shows [Ah 4c] (a pair of Sixes)
AlexRexer: shows [Th Td] (two pair, Tens and Sixes)
AlexRexer is disconnected 
AlexRexer cashed out the hand for $1.01 | Cash Out Fee $0.01
*** SUMMARY ***
Total pot $1.84 | Rake $0.06 
Board [7s 6h 5h 6d Kh]
Seat 1: AlexRexer (button) showed [Th Td] and won ($1.78) with two pair, Tens and Sixes (pot not awarded as player cashed out)
Seat 2: Scaaalll (small blind) folded before Flop
Seat 3: fabor1303 (big blind) folded before Flop
Seat 4: ckooistra36 showed [Ah 4c] and lost with a pair of Sixes
Seat 5: no way yo folded on the Flop
Seat 6: Draat505 folded before Flop (didn't bet)



PokerStars Zoom Hand #229229382376:  Hold'em No Limit ($0.01/$0.02) - 2021/08/21 20:58:16 CET [2021/08/21 14:58:16 ET]
Table 'Halley' 6-max Seat #1 is the button
Seat 1: vindoffree ($2.85 in chips) 
Seat 2: Scaaalll ($2.21 in chips) 
Seat 3: greenthum33 ($3.78 in chips) 
Seat 4: SpartanRace1 ($4.29 in chips) 
Seat 5: pphit ($2.82 in chips) 
Seat 6: estelionat171 ($0.91 in chips) 
Scaaalll: posts small blind $0.01
greenthum33: posts big blind $0.02
*** HOLE CARDS ***
Dealt to Scaaalll [Jd Kc]
SpartanRace1: folds 
pphit: folds 
estelionat171: folds 
vindoffree: folds 
Scaaalll: raises $0.04 to $0.06
greenthum33: folds 
Uncalled bet ($0.04) returned to Scaaalll
Scaaalll collected $0.04 from pot
Scaaalll: doesn't show hand 
*** SUMMARY ***
Total pot $0.04 | Rake $0 
Seat 1: vindoffree (button) folded before Flop (didn't bet)
Seat 2: Scaaalll (small blind) collected ($0.04)
Seat 3: greenthum33 (big blind) folded before Flop
Seat 4: SpartanRace1 folded before Flop (didn't bet)
Seat 5: pphit folded before Flop (didn't bet)
Seat 6: estelionat171 folded before Flop (didn't bet)



PokerStars Zoom Hand #229229387124:  Hold'em No Limit ($0.01/$0.02) - 2021/08/21 20:58:32 CET [2021/08/21 14:58:32 ET]
Table 'Halley' 6-max Seat #1 is the button
Seat 1: PaddyPoland ($2 in chips) 
Seat 2: Thoker ($2 in chips) 
Seat 3: HellNative ($2.34 in chips) 
Seat 4: Scaaalll ($2.23 in chips) 
Seat 5: yositoas ($3.50 in chips) 
Seat 6: CordiPS ($2.65 in chips) 
Thoker: posts small blind $0.01
HellNative: posts big blind $0.02
*** HOLE CARDS ***
Dealt to Scaaalll [2s 3h]
Scaaalll: folds 
yositoas: folds 
CordiPS: folds 
PaddyPoland: raises $0.02 to $0.04
Thoker: folds 
HellNative: folds 
Uncalled bet ($0.02) returned to PaddyPoland
PaddyPoland collected $0.05 from pot
PaddyPoland: doesn't show hand 
*** SUMMARY ***
Total pot $0.05 | Rake $0 
Seat 1: PaddyPoland (button) collected ($0.05)
Seat 2: Thoker (small blind) folded before Flop
Seat 3: HellNative (big blind) folded before Flop
Seat 4: Scaaalll folded before Flop (didn't bet)
Seat 5: yositoas folded before Flop (didn't bet)
Seat 6: CordiPS folded before Flop (didn't bet)



PokerStars Zoom Hand #229229388351:  Hold'em No Limit ($0.01/$0.02) - 2021/08/21 20:58:36 CET [2021/08/21 14:58:36 ET]
Table 'Halley' 6-max Seat #1 is the button
Seat 1: diegohgmelo ($1.52 in chips) 
Seat 2: PaddyPoland ($2.15 in chips) 
Seat 3: Scaaalll ($2.23 in chips) 
Seat 4: RonilsonCosta ($2.75 in chips) 
Seat 5: ATLienZzz ($2.59 in chips) 
Seat 6: kamburova ($0.77 in chips) 
PaddyPoland: posts small blind $0.01
Scaaalll: posts big blind $0.02
*** HOLE CARDS ***
Dealt to Scaaalll [7d 5c]
kamburova is disconnected 
RonilsonCosta: folds 
diegohgmelo is disconnected 
ATLienZzz: raises $0.04 to $0.06
kamburova: folds 
diegohgmelo: folds 
PaddyPoland: folds 
Scaaalll: folds 
Uncalled bet ($0.04) returned to ATLienZzz
ATLienZzz collected $0.05 from pot
ATLienZzz: doesn't show hand 
*** SUMMARY ***
Total pot $0.05 | Rake $0 
Seat 1: diegohgmelo (button) folded before Flop (didn't bet)
Seat 2: PaddyPoland (small blind) folded before Flop
Seat 3: Scaaalll (big blind) folded before Flop
Seat 4: RonilsonCosta folded before Flop (didn't bet)
Seat 5: ATLienZzz collected ($0.05)
Seat 6: kamburova folded before Flop (didn't bet)



PokerStars Zoom Hand #229229391910:  Hold'em No Limit ($0.01/$0.02) - 2021/08/21 20:58:48 CET [2021/08/21 14:58:48 ET]
Table 'Halley' 6-max Seat #1 is the button
Seat 1: Scaaalll ($2.21 in chips) 
Seat 2: cabe839 ($2.25 in chips) 
Seat 3: Natali172737 ($4.91 in chips) 
Seat 4: Kb013497 ($3.09 in chips) 
Seat 5: HellNative ($2.32 in chips) 
Seat 6: cvrcak5 ($3.63 in chips) 
cabe839: posts small blind $0.01
Natali172737: posts big blind $0.02
*** HOLE CARDS ***
Dealt to Scaaalll [Tc 8c]
Kb013497: folds 
HellNative: folds 
cvrcak5: folds 
Scaaalll: raises $0.02 to $0.04
cabe839: raises $0.09 to $0.13
Natali172737: folds 
Scaaalll: calls $0.09
*** FLOP *** [7s 5d 2h]
cabe839: bets $0.19
Scaaalll: folds 
Uncalled bet ($0.19) returned to cabe839
cabe839 collected $0.27 from pot
cabe839: doesn't show hand 
*** SUMMARY ***
Total pot $0.28 | Rake $0.01 
Board [7s 5d 2h]
Seat 1: Scaaalll (button) folded on the Flop
Seat 2: cabe839 (small blind) collected ($0.27)
Seat 3: Natali172737 (big blind) folded before Flop
Seat 4: Kb013497 folded before Flop (didn't bet)
Seat 5: HellNative folded before Flop (didn't bet)
Seat 6: cvrcak5 folded before Flop (didn't bet)



PokerStars Zoom Hand #229229408689:  Hold'em No Limit ($0.01/$0.02) - 2021/08/21 20:59:44 CET [2021/08/21 14:59:44 ET]
Table 'Halley' 6-max Seat #1 is the button
Seat 1: Scaaalll ($2.08 in chips) 
Seat 2: 1000xp ($2 in chips) 
Seat 3: Laonikos ($3.58 in chips) 
Seat 4: Ne0net ($2.91 in chips) 
Seat 5: estelionat171 ($0.92 in chips) 
Seat 6: KRITAYA ($1.80 in chips) 
1000xp: posts small blind $0.01
Laonikos: posts big blind $0.02
*** HOLE CARDS ***
Dealt to Scaaalll [3c Td]
Ne0net: folds 
estelionat171: folds 
KRITAYA: folds 
Scaaalll: folds 
1000xp: folds 
Uncalled bet ($0.01) returned to Laonikos
Laonikos collected $0.02 from pot
Laonikos: doesn't show hand 
*** SUMMARY ***
Total pot $0.02 | Rake $0 
Seat 1: Scaaalll (button) folded before Flop (didn't bet)
Seat 2: 1000xp (small blind) folded before Flop
Seat 3: Laonikos (big blind) collected ($0.02)
Seat 4: Ne0net folded before Flop (didn't bet)
Seat 5: estelionat171 folded before Flop (didn't bet)
Seat 6: KRITAYA folded before Flop (didn't bet)



PokerStars Zoom Hand #229229406271:  Hold'em No Limit ($0.01/$0.02) - 2021/08/21 20:59:36 CET [2021/08/21 14:59:36 ET]
Table 'Halley' 6-max Seat #1 is the button
Seat 1: AndreaBsAs ($2 in chips) 
Seat 2: Kb013497 ($3.07 in chips) 
Seat 3: rpycmbEM ($6.18 in chips) 
Seat 4: Halbschatten ($2.37 in chips) 
Seat 5: Scaaalll ($2.08 in chips) 
Seat 6: Miff0309 ($2 in chips) 
Kb013497: posts small blind $0.01
rpycmbEM: posts big blind $0.02
*** HOLE CARDS ***
Dealt to Scaaalll [Kh 4d]
Halbschatten: folds 
Scaaalll: folds 
Miff0309: raises $0.04 to $0.06
AndreaBsAs: raises $0.14 to $0.20
Kb013497: folds 
rpycmbEM: folds 
Miff0309: folds 
Uncalled bet ($0.14) returned to AndreaBsAs
AndreaBsAs collected $0.15 from pot
AndreaBsAs: doesn't show hand 
*** SUMMARY ***
Total pot $0.15 | Rake $0 
Seat 1: AndreaBsAs (button) collected ($0.15)
Seat 2: Kb013497 (small blind) folded before Flop
Seat 3: rpycmbEM (big blind) folded before Flop
Seat 4: Halbschatten folded before Flop (didn't bet)
Seat 5: Scaaalll folded before Flop (didn't bet)
Seat 6: Miff0309 folded before Flop



PokerStars Zoom Hand #229229409949:  Hold'em No Limit ($0.01/$0.02) - 2021/08/21 20:59:48 CET [2021/08/21 14:59:48 ET]
Table 'Halley' 6-max Seat #1 is the button
Seat 1: BossTH4 ($2.79 in chips) 
Seat 2: Kb013497 ($4.23 in chips) 
Seat 3: gasmar_29 ($2.10 in chips) 
Seat 4: pphit ($2.03 in chips) 
Seat 5: Zhyla95 ($2.28 in chips) 
Seat 6: Scaaalll ($2.08 in chips) 
Kb013497: posts small blind $0.01
gasmar_29: posts big blind $0.02
*** HOLE CARDS ***
Dealt to Scaaalll [Td Jh]
pphit: folds 
Zhyla95: folds 
Scaaalll: raises $0.04 to $0.06
BossTH4: folds 
Kb013497: folds 
gasmar_29: folds 
Uncalled bet ($0.04) returned to Scaaalll
Scaaalll collected $0.05 from pot
Scaaalll: doesn't show hand 
*** SUMMARY ***
Total pot $0.05 | Rake $0 
Seat 1: BossTH4 (button) folded before Flop (didn't bet)
Seat 2: Kb013497 (small blind) folded before Flop
Seat 3: gasmar_29 (big blind) folded before Flop
Seat 4: pphit folded before Flop (didn't bet)
Seat 5: Zhyla95 folded before Flop (didn't bet)
Seat 6: Scaaalll collected ($0.05)



PokerStars Zoom Hand #229229403628:  Hold'em No Limit ($0.01/$0.02) - 2021/08/21 20:59:27 CET [2021/08/21 14:59:27 ET]
Table 'Halley' 6-max Seat #1 is the button
Seat 1: NIK1973 23 ($2 in chips) 
Seat 2: NikosGr1991 ($1.09 in chips) 
Seat 3: QuieroPollo84 ($2.78 in chips) 
Seat 4: RoughRafff ($2.06 in chips) 
Seat 5: derry,me ($3.25 in chips) 
Seat 6: Scaaalll ($2.08 in chips) 
NikosGr1991: posts small blind $0.01
QuieroPollo84: posts big blind $0.02
*** HOLE CARDS ***
Dealt to Scaaalll [9d 7s]
derry,me is disconnected 
RoughRafff: folds 
derry,me has timed out while disconnected
derry,me: folds 
Scaaalll: folds 
NIK1973 23: raises $0.04 to $0.06
NikosGr1991: calls $0.05
QuieroPollo84: calls $0.04
*** FLOP *** [6c Kh 5c]
NikosGr1991: checks 
QuieroPollo84: checks 
NIK1973 23: checks 
*** TURN *** [6c Kh 5c] [Jc]
NikosGr1991: bets $0.08
QuieroPollo84: folds 
NIK1973 23: folds 
Uncalled bet ($0.08) returned to NikosGr1991
NikosGr1991 collected $0.17 from pot
NikosGr1991: doesn't show hand 
*** SUMMARY ***
Total pot $0.18 | Rake $0.01 
Board [6c Kh 5c Jc]
Seat 1: NIK1973 23 (button) folded on the Turn
Seat 2: NikosGr1991 (small blind) collected ($0.17)
Seat 3: QuieroPollo84 (big blind) folded on the Turn
Seat 4: RoughRafff folded before Flop (didn't bet)
Seat 5: derry,me folded before Flop (didn't bet)
Seat 6: Scaaalll folded before Flop (didn't bet)



PokerStars Zoom Hand #229229415601:  Hold'em No Limit ($0.01/$0.02) - 2021/08/21 21:00:06 CET [2021/08/21 15:00:06 ET]
Table 'Halley' 6-max Seat #1 is the button
Seat 1: Flankeris ($9.61 in chips) 
Seat 2: Taallt ($3.08 in chips) 
Seat 3: Scaaalll ($2.11 in chips) 
Seat 4: PaddyPoland ($2.15 in chips) 
Seat 5: thiagohbueno ($1.64 in chips) 
Seat 6: sigrivas ($3.94 in chips) 
Taallt: posts small blind $0.01
Scaaalll: posts big blind $0.02
*** HOLE CARDS ***
Dealt to Scaaalll [Jc Ks]
PaddyPoland: folds 
thiagohbueno: folds 
sigrivas: folds 
Flankeris: folds 
Taallt: raises $0.04 to $0.06
Scaaalll: calls $0.04
*** FLOP *** [6h 7c 5h]
Taallt: checks 
Scaaalll: bets $0.08
Taallt: calls $0.08
*** TURN *** [6h 7c 5h] [7h]
Taallt: checks 
Scaaalll: checks 
*** RIVER *** [6h 7c 5h 7h] [Qh]
Taallt: bets $0.24
Scaaalll: folds 
Uncalled bet ($0.24) returned to Taallt
Taallt collected $0.27 from pot
Taallt: doesn't show hand 
*** SUMMARY ***
Total pot $0.28 | Rake $0.01 
Board [6h 7c 5h 7h Qh]
Seat 1: Flankeris (button) folded before Flop (didn't bet)
Seat 2: Taallt (small blind) collected ($0.27)
Seat 3: Scaaalll (big blind) folded on the River
Seat 4: PaddyPoland folded before Flop (didn't bet)
Seat 5: thiagohbueno folded before Flop (didn't bet)
Seat 6: sigrivas folded before Flop (didn't bet)



PokerStars Zoom Hand #229229464917:  Hold'em No Limit ($0.01/$0.02) - 2021/08/21 21:02:11 CET [2021/08/21 15:02:11 ET]
Table 'Halley' 6-max Seat #1 is the button
Seat 1: KKARMELO ($2.43 in chips) 
Seat 2: sigrivas ($4.03 in chips) 
Seat 3: MirkoV224 ($2.54 in chips) 
Seat 4: PaddyPoland ($2.21 in chips) 
Seat 5: Scaaalll ($2 in chips) 
Seat 6: bigthereal ($2.04 in chips) 
sigrivas: posts small blind $0.01
MirkoV224: posts big blind $0.02
*** HOLE CARDS ***
Dealt to Scaaalll [3s 6c]
PaddyPoland: folds 
Scaaalll: folds 
bigthereal: raises $0.12 to $0.14
KKARMELO: folds 
sigrivas: folds 
MirkoV224: folds 
Uncalled bet ($0.12) returned to bigthereal
bigthereal collected $0.05 from pot
bigthereal: doesn't show hand 
*** SUMMARY ***
Total pot $0.05 | Rake $0 
Seat 1: KKARMELO (button) folded before Flop (didn't bet)
Seat 2: sigrivas (small blind) folded before Flop
Seat 3: MirkoV224 (big blind) folded before Flop
Seat 4: PaddyPoland folded before Flop (didn't bet)
Seat 5: Scaaalll folded before Flop (didn't bet)
Seat 6: bigthereal collected ($0.05)



PokerStars Zoom Hand #229229466764:  Hold'em No Limit ($0.01/$0.02) - 2021/08/21 21:02:15 CET [2021/08/21 15:02:15 ET]
Table 'Halley' 6-max Seat #1 is the button
Seat 1: Finkey99 ($2.16 in chips) 
Seat 2: Scaaalll ($2 in chips) 
Seat 3: veruda02 ($2 in chips) 
Seat 4: cvrcak5 ($4.30 in chips) 
Seat 5: iPitbull1 ($2 in chips) 
Seat 6: 365p2eva ($2.01 in chips) 
Scaaalll: posts small blind $0.01
veruda02: posts big blind $0.02
*** HOLE CARDS ***
Dealt to Scaaalll [As Qc]
cvrcak5: folds 
iPitbull1: folds 
365p2eva: folds 
Finkey99: folds 
Scaaalll: raises $0.04 to $0.06
veruda02: folds 
Uncalled bet ($0.04) returned to Scaaalll
Scaaalll collected $0.04 from pot
Scaaalll: doesn't show hand 
*** SUMMARY ***
Total pot $0.04 | Rake $0 
Seat 1: Finkey99 (button) folded before Flop (didn't bet)
Seat 2: Scaaalll (small blind) collected ($0.04)
Seat 3: veruda02 (big blind) folded before Flop
Seat 4: cvrcak5 folded before Flop (didn't bet)
Seat 5: iPitbull1 folded before Flop (didn't bet)
Seat 6: 365p2eva folded before Flop (didn't bet)



PokerStars Zoom Hand #229229461492:  Hold'em No Limit ($0.01/$0.02) - 2021/08/21 21:02:03 CET [2021/08/21 15:02:03 ET]
Table 'Halley' 6-max Seat #1 is the button
Seat 1: JuninhoXapa ($2.77 in chips) 
Seat 2: Scaaalll ($2 in chips) 
Seat 3: 365p2eva ($2.04 in chips) 
Seat 4: nwlondonrock ($3.37 in chips) 
Seat 5: Pechorin.G ($2.19 in chips) 
Seat 6: Armando.Bordi ($2.91 in chips) 
Scaaalll: posts small blind $0.01
365p2eva: posts big blind $0.02
*** HOLE CARDS ***
Dealt to Scaaalll [5h 7d]
nwlondonrock: raises $0.04 to $0.06
Pechorin.G: folds 
Armando.Bordi: folds 
JuninhoXapa: raises $0.13 to $0.19
Scaaalll: folds 
365p2eva: folds 
nwlondonrock: raises $3.18 to $3.37 and is all-in
JuninhoXapa: folds 
Uncalled bet ($3.18) returned to nwlondonrock
nwlondonrock collected $0.41 from pot
nwlondonrock: doesn't show hand 
*** SUMMARY ***
Total pot $0.41 | Rake $0 
Seat 1: JuninhoXapa (button) folded before Flop
Seat 2: Scaaalll (small blind) folded before Flop
Seat 3: 365p2eva (big blind) folded before Flop
Seat 4: nwlondonrock collected ($0.41)
Seat 5: Pechorin.G folded before Flop (didn't bet)
Seat 6: Armando.Bordi folded before Flop (didn't bet)



PokerStars Zoom Hand #229229473357:  Hold'em No Limit ($0.01/$0.02) - 2021/08/21 21:02:30 CET [2021/08/21 15:02:30 ET]
Table 'Halley' 6-max Seat #1 is the button
Seat 1: cabe839 ($2.24 in chips) 
Seat 2: Koldun 2636 ($2.29 in chips) 
Seat 3: Scaaalll ($2.02 in chips) 
Seat 4: Xlavariable ($4.13 in chips) 
Seat 5: ignat-of 777 ($0.72 in chips) 
Seat 6: zergmiky ($2.03 in chips) 
Koldun 2636: posts small blind $0.01
Scaaalll: posts big blind $0.02
*** HOLE CARDS ***
Dealt to Scaaalll [3h 4h]
Xlavariable: folds 
ignat-of 777: folds 
zergmiky: folds 
cabe839: raises $0.03 to $0.05
Koldun 2636: folds 
Scaaalll: folds 
Uncalled bet ($0.03) returned to cabe839
cabe839 collected $0.05 from pot
cabe839: doesn't show hand 
*** SUMMARY ***
Total pot $0.05 | Rake $0 
Seat 1: cabe839 (button) collected ($0.05)
Seat 2: Koldun 2636 (small blind) folded before Flop
Seat 3: Scaaalll (big blind) folded before Flop
Seat 4: Xlavariable folded before Flop (didn't bet)
Seat 5: ignat-of 777 folded before Flop (didn't bet)
Seat 6: zergmiky folded before Flop (didn't bet)



PokerStars Zoom Hand #229229495787:  Hold'em No Limit ($0.01/$0.02) - 2021/08/21 21:03:07 CET [2021/08/21 15:03:07 ET]
Table 'Halley' 6-max Seat #1 is the button
Seat 1: feybys ($2.21 in chips) 
Seat 2: Shadi8 ($2 in chips) 
Seat 3: Flankeris ($5.44 in chips) 
Seat 4: Scaaalll ($2 in chips) 
Seat 5: CréééW!!! ($1 in chips) 
Seat 6: curyurzeda ($4.32 in chips) 
Shadi8: posts small blind $0.01
Flankeris: posts big blind $0.02
*** HOLE CARDS ***
Dealt to Scaaalll [Ks Ah]
Scaaalll: raises $0.04 to $0.06
CréééW!!!: folds 
curyurzeda: raises $0.04 to $0.10
feybys: calls $0.10
Shadi8: folds 
Flankeris: folds 
Scaaalll: raises $0.24 to $0.34
curyurzeda: folds 
feybys: folds 
Uncalled bet ($0.24) returned to Scaaalll
curyurzeda is disconnected 
Scaaalll collected $0.33 from pot
Scaaalll: doesn't show hand 
*** SUMMARY ***
Total pot $0.33 | Rake $0 
Seat 1: feybys (button) folded before Flop
Seat 2: Shadi8 (small blind) folded before Flop
Seat 3: Flankeris (big blind) folded before Flop
Seat 4: Scaaalll collected ($0.33)
Seat 5: CréééW!!! folded before Flop (didn't bet)
Seat 6: curyurzeda folded before Flop



PokerStars Zoom Hand #229229489687:  Hold'em No Limit ($0.01/$0.02) - 2021/08/21 21:02:53 CET [2021/08/21 15:02:53 ET]
Table 'Halley' 6-max Seat #1 is the button
Seat 1: Scaaalll ($2 in chips) 
Seat 2: yositoas ($2.24 in chips) 
Seat 3: markzoom6894 ($1.94 in chips) 
Seat 4: Djalmethedj ($1.95 in chips) 
Seat 5: Sinad1302 ($2.67 in chips) 
Seat 6: Pupsi49 ($2.79 in chips) 
yositoas: posts small blind $0.01
markzoom6894: posts big blind $0.02
*** HOLE CARDS ***
Dealt to Scaaalll [9d 6s]
Djalmethedj: folds 
Sinad1302: raises $0.04 to $0.06
Pupsi49 has timed out while disconnected
Pupsi49: folds 
Scaaalll: folds 
yositoas: calls $0.05
markzoom6894: calls $0.04
*** FLOP *** [9c Th Ac]
yositoas: checks 
markzoom6894: checks 
Sinad1302: checks 
*** TURN *** [9c Th Ac] [9h]
yositoas: checks 
markzoom6894: bets $0.07
Sinad1302: folds 
yositoas: folds 
Uncalled bet ($0.07) returned to markzoom6894
Sinad1302 is disconnected 
markzoom6894 collected $0.17 from pot
markzoom6894: doesn't show hand 
*** SUMMARY ***
Total pot $0.18 | Rake $0.01 
Board [9c Th Ac 9h]
Seat 1: Scaaalll (button) folded before Flop (didn't bet)
Seat 2: yositoas (small blind) folded on the Turn
Seat 3: markzoom6894 (big blind) collected ($0.17)
Seat 4: Djalmethedj folded before Flop (didn't bet)
Seat 5: Sinad1302 folded on the Turn
Seat 6: Pupsi49 folded before Flop (didn't bet)



PokerStars Zoom Hand #229229491387:  Hold'em No Limit ($0.01/$0.02) - 2021/08/21 21:02:57 CET [2021/08/21 15:02:57 ET]
Table 'Halley' 6-max Seat #1 is the button
Seat 1: Munavili ($5.20 in chips) 
Seat 2: CréééW!!! ($2.23 in chips) 
Seat 3: py100ta ($2.61 in chips) 
Seat 4: martuska88 ($2.04 in chips) 
Seat 5: medbxl1971 ($1.23 in chips) 
Seat 6: Scaaalll ($2 in chips) 
CréééW!!!: posts small blind $0.01
py100ta: posts big blind $0.02
*** HOLE CARDS ***
Dealt to Scaaalll [6h Qs]
martuska88: folds 
medbxl1971: raises $0.02 to $0.04
Scaaalll: folds 
Munavili: raises $0.10 to $0.14
CréééW!!!: folds 
py100ta: folds 
medbxl1971: calls $0.10
*** FLOP *** [Kh Jh 3s]
medbxl1971: checks 
Munavili: bets $0.09
medbxl1971: calls $0.09
*** TURN *** [Kh Jh 3s] [4s]
medbxl1971: checks 
Munavili: checks 
*** RIVER *** [Kh Jh 3s 4s] [7d]
medbxl1971: checks 
Munavili: bets $0.15
medbxl1971: folds 
Uncalled bet ($0.15) returned to Munavili
Munavili collected $0.47 from pot
Munavili: doesn't show hand 
*** SUMMARY ***
Total pot $0.49 | Rake $0.02 
Board [Kh Jh 3s 4s 7d]
Seat 1: Munavili (button) collected ($0.47)
Seat 2: CréééW!!! (small blind) folded before Flop
Seat 3: py100ta (big blind) folded before Flop
Seat 4: martuska88 folded before Flop (didn't bet)
Seat 5: medbxl1971 folded on the River
Seat 6: Scaaalll folded before Flop (didn't bet)



PokerStars Zoom Hand #229229493589:  Hold'em No Limit ($0.01/$0.02) - 2021/08/21 21:03:02 CET [2021/08/21 15:03:02 ET]
Table 'Halley' 6-max Seat #1 is the button
Seat 1: Alex Koshva1 ($1.95 in chips) 
Seat 2: S.B.O190 ($2.53 in chips) 
Seat 3: trakiar ($7.23 in chips) 
Seat 4: Scaaalll ($2 in chips) 
Seat 5: TESTGOSHI ($1.98 in chips) 
Seat 6: Natali172737 ($2.94 in chips) 
S.B.O190: posts small blind $0.01
trakiar: posts big blind $0.02
*** HOLE CARDS ***
Dealt to Scaaalll [8c 4s]
Scaaalll: folds 
TESTGOSHI: calls $0.02
Natali172737: folds 
Alex Koshva1: raises $0.06 to $0.08
S.B.O190: folds 
trakiar: folds 
trakiar is disconnected 
TESTGOSHI: calls $0.06
*** FLOP *** [Td Kh 7h]
TESTGOSHI: bets $0.09
Alex Koshva1: calls $0.09
*** TURN *** [Td Kh 7h] [9h]
TESTGOSHI: bets $0.18
Alex Koshva1: folds 
Uncalled bet ($0.18) returned to TESTGOSHI
TESTGOSHI collected $0.36 from pot
TESTGOSHI: doesn't show hand 
*** SUMMARY ***
Total pot $0.37 | Rake $0.01 
Board [Td Kh 7h 9h]
Seat 1: Alex Koshva1 (button) folded on the Turn
Seat 2: S.B.O190 (small blind) folded before Flop
Seat 3: trakiar (big blind) folded before Flop
Seat 4: Scaaalll folded before Flop (didn't bet)
Seat 5: TESTGOSHI collected ($0.36)
Seat 6: Natali172737 folded before Flop (didn't bet)



PokerStars Zoom Hand #229229509958:  Hold'em No Limit ($0.01/$0.02) - 2021/08/21 21:03:39 CET [2021/08/21 15:03:39 ET]
Table 'Halley' 6-max Seat #1 is the button
Seat 1: yositoas ($2.18 in chips) 
Seat 2: YPAXAPA555 ($2.08 in chips) 
Seat 3: Sergio14b ($2.08 in chips) 
Seat 4: Scaaalll ($2.23 in chips) 
Seat 5: zergmiky ($2 in chips) 
Seat 6: SideshowPen ($2.21 in chips) 
YPAXAPA555: posts small blind $0.01
Sergio14b: posts big blind $0.02
*** HOLE CARDS ***
Dealt to Scaaalll [5c Ks]
Scaaalll: folds 
zergmiky: folds 
SideshowPen: folds 
yositoas: raises $0.03 to $0.05
YPAXAPA555: folds 
Sergio14b: folds 
Uncalled bet ($0.03) returned to yositoas
yositoas collected $0.05 from pot
yositoas: doesn't show hand 
*** SUMMARY ***
Total pot $0.05 | Rake $0 
Seat 1: yositoas (button) collected ($0.05)
Seat 2: YPAXAPA555 (small blind) folded before Flop
Seat 3: Sergio14b (big blind) folded before Flop
Seat 4: Scaaalll folded before Flop (didn't bet)
Seat 5: zergmiky folded before Flop (didn't bet)
Seat 6: SideshowPen folded before Flop (didn't bet)



PokerStars Zoom Hand #229229512621:  Hold'em No Limit ($0.01/$0.02) - 2021/08/21 21:03:45 CET [2021/08/21 15:03:45 ET]
Table 'Halley' 6-max Seat #1 is the button
Seat 1: luckybadoo ($1.37 in chips) 
Seat 2: Scaaalll ($2.23 in chips) 
Seat 3: lucksuckdonk ($3.18 in chips) 
Seat 4: arsad725 ($5.82 in chips) 
Seat 5: KoAlRy ($2 in chips) 
Seat 6: xxRoseIloveu ($1.85 in chips) 
Scaaalll: posts small blind $0.01
lucksuckdonk: posts big blind $0.02
*** HOLE CARDS ***
Dealt to Scaaalll [Kd Ks]
arsad725: folds 
KoAlRy: folds 
xxRoseIloveu: raises $0.04 to $0.06
luckybadoo: folds 
Scaaalll: raises $0.14 to $0.20
lucksuckdonk: folds 
xxRoseIloveu: folds 
Uncalled bet ($0.14) returned to Scaaalll
Scaaalll collected $0.14 from pot
Scaaalll: doesn't show hand 
*** SUMMARY ***
Total pot $0.14 | Rake $0 
Seat 1: luckybadoo (button) folded before Flop (didn't bet)
Seat 2: Scaaalll (small blind) collected ($0.14)
Seat 3: lucksuckdonk (big blind) folded before Flop
Seat 4: arsad725 folded before Flop (didn't bet)
Seat 5: KoAlRy folded before Flop (didn't bet)
Seat 6: xxRoseIloveu folded before Flop



PokerStars Zoom Hand #229229523195:  Hold'em No Limit ($0.01/$0.02) - 2021/08/21 21:04:09 CET [2021/08/21 15:04:09 ET]
Table 'Halley' 6-max Seat #1 is the button
Seat 1: D_S_S2804 ($0.69 in chips) 
Seat 2: iPitbull1 ($2.95 in chips) 
Seat 3: ser313131 ($2 in chips) 
Seat 4: trakiar ($7.23 in chips) 
Seat 5: Scaaalll ($2.31 in chips) 
Seat 6: Kb013497 ($3.61 in chips) 
iPitbull1: posts small blind $0.01
ser313131: posts big blind $0.02
*** HOLE CARDS ***
Dealt to Scaaalll [Tc Jc]
trakiar: folds 
trakiar is disconnected 
Scaaalll: raises $0.04 to $0.06
Kb013497: folds 
D_S_S2804: calls $0.06
iPitbull1: folds 
ser313131: folds 
*** FLOP *** [2h Kc 8s]
Scaaalll: bets $0.08
D_S_S2804: raises $0.08 to $0.16
Scaaalll: folds 
Uncalled bet ($0.08) returned to D_S_S2804
D_S_S2804 collected $0.30 from pot
D_S_S2804: doesn't show hand 
*** SUMMARY ***
Total pot $0.31 | Rake $0.01 
Board [2h Kc 8s]
Seat 1: D_S_S2804 (button) collected ($0.30)
Seat 2: iPitbull1 (small blind) folded before Flop
Seat 3: ser313131 (big blind) folded before Flop
Seat 4: trakiar folded before Flop (didn't bet)
Seat 5: Scaaalll folded on the Flop
Seat 6: Kb013497 folded before Flop (didn't bet)



PokerStars Zoom Hand #229229535250:  Hold'em No Limit ($0.01/$0.02) - 2021/08/21 21:04:36 CET [2021/08/21 15:04:36 ET]
Table 'Halley' 6-max Seat #1 is the button
Seat 1: KRITAYA ($1.13 in chips) 
Seat 2: Goose Of Poker ($1.98 in chips) 
Seat 3: Scaaalll ($2.17 in chips) 
Seat 4: Sergio14b ($2.06 in chips) 
Seat 5: lucksuckdonk ($3.18 in chips) 
Seat 6: iPitbull1 ($2.03 in chips) 
Goose Of Poker: posts small blind $0.01
Scaaalll: posts big blind $0.02
*** HOLE CARDS ***
Dealt to Scaaalll [8h Kd]
Sergio14b: folds 
lucksuckdonk: folds 
iPitbull1: folds 
KRITAYA: folds 
Goose Of Poker: folds 
Uncalled bet ($0.01) returned to Scaaalll
Scaaalll collected $0.02 from pot
Scaaalll: doesn't show hand 
*** SUMMARY ***
Total pot $0.02 | Rake $0 
Seat 1: KRITAYA (button) folded before Flop (didn't bet)
Seat 2: Goose Of Poker (small blind) folded before Flop
Seat 3: Scaaalll (big blind) collected ($0.02)
Seat 4: Sergio14b folded before Flop (didn't bet)
Seat 5: lucksuckdonk folded before Flop (didn't bet)
Seat 6: iPitbull1 folded before Flop (didn't bet)



PokerStars Zoom Hand #229229543651:  Hold'em No Limit ($0.01/$0.02) - 2021/08/21 21:04:55 CET [2021/08/21 15:04:55 ET]
Table 'Halley' 6-max Seat #1 is the button
Seat 1: Natali172737 ($2 in chips) 
Seat 2: Sul07 ($0.59 in chips) 
Seat 3: bananAAbandit ($2.14 in chips) 
Seat 4: gugamoraes ($2.03 in chips) 
Seat 5: no way yo ($1.09 in chips) 
Seat 6: Scaaalll ($2.18 in chips) 
Sul07: posts small blind $0.01
bananAAbandit: posts big blind $0.02
*** HOLE CARDS ***
Dealt to Scaaalll [2s Th]
gugamoraes: raises $0.04 to $0.06
no way yo: folds 
Scaaalll: folds 
Natali172737: folds 
Sul07: folds 
bananAAbandit: folds 
Uncalled bet ($0.04) returned to gugamoraes
gugamoraes collected $0.05 from pot
gugamoraes: doesn't show hand 
*** SUMMARY ***
Total pot $0.05 | Rake $0 
Seat 1: Natali172737 (button) folded before Flop (didn't bet)
Seat 2: Sul07 (small blind) folded before Flop
Seat 3: bananAAbandit (big blind) folded before Flop
Seat 4: gugamoraes collected ($0.05)
Seat 5: no way yo folded before Flop (didn't bet)
Seat 6: Scaaalll folded before Flop (didn't bet)



PokerStars Zoom Hand #229229539171:  Hold'em No Limit ($0.01/$0.02) - 2021/08/21 21:04:45 CET [2021/08/21 15:04:45 ET]
Table 'Halley' 6-max Seat #1 is the button
Seat 1: Scaaalll ($2.18 in chips) 
Seat 2: Hautkunst ($1.68 in chips) 
Seat 3: vindoffree ($2.98 in chips) 
Seat 4: D_S_S2804 ($0.85 in chips) 
Seat 5: Victor151886 ($2.03 in chips) 
Seat 6: kahzura ($2.08 in chips) 
Hautkunst: posts small blind $0.01
vindoffree: posts big blind $0.02
*** HOLE CARDS ***
Dealt to Scaaalll [2c Ad]
D_S_S2804: raises $0.04 to $0.06
Victor151886: folds 
Hautkunst is disconnected 
kahzura: folds 
Scaaalll: folds 
Hautkunst: folds 
vindoffree: calls $0.04
*** FLOP *** [Tc 7d Qd]
vindoffree: checks 
D_S_S2804: checks 
*** TURN *** [Tc 7d Qd] [7s]
vindoffree: checks 
D_S_S2804: bets $0.06
vindoffree: folds 
Uncalled bet ($0.06) returned to D_S_S2804
D_S_S2804 collected $0.13 from pot
D_S_S2804: doesn't show hand 
*** SUMMARY ***
Total pot $0.13 | Rake $0 
Board [Tc 7d Qd 7s]
Seat 1: Scaaalll (button) folded before Flop (didn't bet)
Seat 2: Hautkunst (small blind) folded before Flop
Seat 3: vindoffree (big blind) folded on the Turn
Seat 4: D_S_S2804 collected ($0.13)
Seat 5: Victor151886 folded before Flop (didn't bet)
Seat 6: kahzura folded before Flop (didn't bet)



PokerStars Zoom Hand #229229555341:  Hold'em No Limit ($0.01/$0.02) - 2021/08/21 21:05:21 CET [2021/08/21 15:05:21 ET]
Table 'Halley' 6-max Seat #1 is the button
Seat 1: vindoffree ($2.92 in chips) 
Seat 2: Scaaalll ($2.18 in chips) 
Seat 3: zergmiky ($2.47 in chips) 
Seat 4: le_vlimeux ($6.53 in chips) 
Seat 5: SaRCh_Ale ($2 in chips) 
Seat 6: Sparrovv ($2.22 in chips) 
Scaaalll: posts small blind $0.01
zergmiky: posts big blind $0.02
*** HOLE CARDS ***
Dealt to Scaaalll [Ah 7d]
le_vlimeux: folds 
SaRCh_Ale: folds 
Sparrovv: folds 
vindoffree: raises $0.04 to $0.06
Scaaalll: folds 
zergmiky: folds 
Uncalled bet ($0.04) returned to vindoffree
vindoffree collected $0.05 from pot
vindoffree: doesn't show hand 
*** SUMMARY ***
Total pot $0.05 | Rake $0 
Seat 1: vindoffree (button) collected ($0.05)
Seat 2: Scaaalll (small blind) folded before Flop
Seat 3: zergmiky (big blind) folded before Flop
Seat 4: le_vlimeux folded before Flop (didn't bet)
Seat 5: SaRCh_Ale folded before Flop (didn't bet)
Seat 6: Sparrovv folded before Flop (didn't bet)



PokerStars Zoom Hand #229229550849:  Hold'em No Limit ($0.01/$0.02) - 2021/08/21 21:05:11 CET [2021/08/21 15:05:11 ET]
Table 'Halley' 6-max Seat #1 is the button
Seat 1: Mikalai M. ($0.39 in chips) 
Seat 2: badds ($1.92 in chips) 
Seat 3: fishh_play ($2 in chips) 
Seat 4: Scaaalll ($2.18 in chips) 
Seat 5: diegohgmelo ($2.20 in chips) 
Seat 6: zizu1014 ($2.83 in chips) 
badds: posts small blind $0.01
fishh_play: posts big blind $0.02
*** HOLE CARDS ***
Dealt to Scaaalll [Th Qc]
Scaaalll: folds 
diegohgmelo: folds 
zizu1014: folds 
diegohgmelo is disconnected 
Mikalai M.: calls $0.02
badds: folds 
fishh_play: checks 
*** FLOP *** [Jh Td 5d]
fishh_play: checks 
Mikalai M.: checks 
*** TURN *** [Jh Td 5d] [8c]
fishh_play: checks 
Mikalai M.: checks 
*** RIVER *** [Jh Td 5d 8c] [5c]
fishh_play: checks 
Mikalai M.: checks 
*** SHOW DOWN ***
fishh_play: shows [2s As] (a pair of Fives)
Mikalai M.: shows [4h Js] (two pair, Jacks and Fives)
Mikalai M. collected $0.05 from pot
*** SUMMARY ***
Total pot $0.05 | Rake $0 
Board [Jh Td 5d 8c 5c]
Seat 1: Mikalai M. (button) showed [4h Js] and won ($0.05) with two pair, Jacks and Fives
Seat 2: badds (small blind) folded before Flop
Seat 3: fishh_play (big blind) showed [2s As] and lost with a pair of Fives
Seat 4: Scaaalll folded before Flop (didn't bet)
Seat 5: diegohgmelo folded before Flop (didn't bet)
Seat 6: zizu1014 folded before Flop (didn't bet)



PokerStars Zoom Hand #229229553046:  Hold'em No Limit ($0.01/$0.02) - 2021/08/21 21:05:16 CET [2021/08/21 15:05:16 ET]
Table 'Halley' 6-max Seat #1 is the button
Seat 1: yositoas ($4.09 in chips) 
Seat 2: sorinysu ($1.03 in chips) 
Seat 3: py100ta ($6.04 in chips) 
Seat 4: ARTMVSLV ($2.06 in chips) 
Seat 5: Scaaalll ($2.18 in chips) 
Seat 6: turbolya60 ($2.28 in chips) 
sorinysu: posts small blind $0.01
py100ta: posts big blind $0.02
*** HOLE CARDS ***
Dealt to Scaaalll [Ac 3d]
ARTMVSLV: folds 
Scaaalll: folds 
turbolya60: calls $0.02
yositoas: folds 
sorinysu: calls $0.01
py100ta: raises $0.08 to $0.10
turbolya60: folds 
sorinysu: folds 
Uncalled bet ($0.08) returned to py100ta
py100ta collected $0.06 from pot
py100ta: doesn't show hand 
sorinysu is disconnected 
*** SUMMARY ***
Total pot $0.06 | Rake $0 
Seat 1: yositoas (button) folded before Flop (didn't bet)
Seat 2: sorinysu (small blind) folded before Flop
Seat 3: py100ta (big blind) collected ($0.06)
Seat 4: ARTMVSLV folded before Flop (didn't bet)
Seat 5: Scaaalll folded before Flop (didn't bet)
Seat 6: turbolya60 folded before Flop



PokerStars Zoom Hand #229229568927:  Hold'em No Limit ($0.01/$0.02) - 2021/08/21 21:05:51 CET [2021/08/21 15:05:51 ET]
Table 'Halley' 6-max Seat #1 is the button
Seat 1: Syd Wright ($1.99 in chips) 
Seat 2: Vit13150 ($2.05 in chips) 
Seat 3: Berti281 ($2.06 in chips) 
Seat 4: RoughRafff ($2 in chips) 
Seat 5: andreydgk ($4.69 in chips) 
Seat 6: Scaaalll ($2.15 in chips) 
Vit13150: posts small blind $0.01
Berti281: posts big blind $0.02
*** HOLE CARDS ***
Dealt to Scaaalll [6d Qs]
RoughRafff: folds 
andreydgk: folds 
Scaaalll: folds 
Syd Wright: folds 
Vit13150: folds 
Uncalled bet ($0.01) returned to Berti281
Berti281 collected $0.02 from pot
Berti281: doesn't show hand 
*** SUMMARY ***
Total pot $0.02 | Rake $0 
Seat 1: Syd Wright (button) folded before Flop (didn't bet)
Seat 2: Vit13150 (small blind) folded before Flop
Seat 3: Berti281 (big blind) collected ($0.02)
Seat 4: RoughRafff folded before Flop (didn't bet)
Seat 5: andreydgk folded before Flop (didn't bet)
Seat 6: Scaaalll folded before Flop (didn't bet)



PokerStars Zoom Hand #229229549132:  Hold'em No Limit ($0.01/$0.02) - 2021/08/21 21:05:07 CET [2021/08/21 15:05:07 ET]
Table 'Halley' 6-max Seat #1 is the button
Seat 1: Henry Chinasky ($4.61 in chips) 
Seat 2: beber_1613 ($2.28 in chips) 
Seat 3: CordiPS ($2 in chips) 
Seat 4: Scaaalll ($2.18 in chips) 
Seat 5: TICTAC06017 ($1.24 in chips) 
Seat 6: johnjohnson11 ($1.15 in chips) 
beber_1613: posts small blind $0.01
CordiPS: posts big blind $0.02
*** HOLE CARDS ***
Dealt to Scaaalll [5s 9h]
Scaaalll: folds 
TICTAC06017: raises $0.02 to $0.04
johnjohnson11: folds 
johnjohnson11 is disconnected 
Henry Chinasky: raises $0.11 to $0.15
beber_1613: folds 
CordiPS: raises $0.35 to $0.50
TICTAC06017: folds 
Henry Chinasky: raises $4.11 to $4.61 and is all-in
CordiPS: calls $1.50 and is all-in
Uncalled bet ($2.61) returned to Henry Chinasky
*** FLOP *** [8d 9c 2c]
*** TURN *** [8d 9c 2c] [4s]
*** RIVER *** [8d 9c 2c 4s] [Qc]
*** SHOW DOWN ***
CordiPS: shows [Js Jh] (a pair of Jacks)
Henry Chinasky: shows [Kd Ks] (a pair of Kings)
Henry Chinasky collected $3.91 from pot
*** SUMMARY ***
Total pot $4.05 | Rake $0.14 
Board [8d 9c 2c 4s Qc]
Seat 1: Henry Chinasky (button) showed [Kd Ks] and won ($3.91) with a pair of Kings
Seat 2: beber_1613 (small blind) folded before Flop
Seat 3: CordiPS (big blind) showed [Js Jh] and lost with a pair of Jacks
Seat 4: Scaaalll folded before Flop (didn't bet)
Seat 5: TICTAC06017 folded before Flop
Seat 6: johnjohnson11 folded before Flop (didn't bet)



PokerStars Zoom Hand #229229567106:  Hold'em No Limit ($0.01/$0.02) - 2021/08/21 21:05:47 CET [2021/08/21 15:05:47 ET]
Table 'Halley' 6-max Seat #1 is the button
Seat 1: Scaaalll ($2.15 in chips) 
Seat 2: Snegul ($1.01 in chips) 
Seat 3: kwant33 ($4.04 in chips) 
Seat 4: Berti281 ($2.06 in chips) 
Seat 5: maliniak75 ($0.96 in chips) 
Seat 6: rpycmbEM ($5.82 in chips) 
Snegul: posts small blind $0.01
kwant33: posts big blind $0.02
*** HOLE CARDS ***
Dealt to Scaaalll [6d Js]
Berti281: folds 
maliniak75: calls $0.02
rpycmbEM: folds 
Scaaalll: folds 
Snegul: calls $0.01
kwant33: checks 
*** FLOP *** [3s 4h Ks]
Snegul: checks 
kwant33: checks 
maliniak75: bets $0.10
Snegul: folds 
kwant33: folds 
Uncalled bet ($0.10) returned to maliniak75
maliniak75 collected $0.06 from pot
maliniak75: doesn't show hand 
*** SUMMARY ***
Total pot $0.06 | Rake $0 
Board [3s 4h Ks]
Seat 1: Scaaalll (button) folded before Flop (didn't bet)
Seat 2: Snegul (small blind) folded on the Flop
Seat 3: kwant33 (big blind) folded on the Flop
Seat 4: Berti281 folded before Flop (didn't bet)
Seat 5: maliniak75 collected ($0.06)
Seat 6: rpycmbEM folded before Flop (didn't bet)



PokerStars Zoom Hand #229229560189:  Hold'em No Limit ($0.01/$0.02) - 2021/08/21 21:05:32 CET [2021/08/21 15:05:32 ET]
Table 'Halley' 6-max Seat #1 is the button
Seat 1: andreydgk ($2 in chips) 
Seat 2: Pokerkass ($3.42 in chips) 
Seat 3: Scaaalll ($2.17 in chips) 
Seat 4: johniXL ($1.04 in chips) 
Seat 5: pavlo8855 ($2.16 in chips) 
Seat 6: Pulp Hands ($0.21 in chips) 
Pokerkass: posts small blind $0.01
Scaaalll: posts big blind $0.02
*** HOLE CARDS ***
Dealt to Scaaalll [6s Tc]
johniXL: folds 
pavlo8855: raises $0.04 to $0.06
Pulp Hands: raises $0.04 to $0.10
andreydgk: folds 
Pokerkass: calls $0.09
Scaaalll: folds 
pavlo8855: calls $0.04
*** FLOP *** [2s 4d 7d]
Pokerkass: checks 
pavlo8855: checks 
Pulp Hands: checks 
*** TURN *** [2s 4d 7d] [Jd]
Pokerkass: checks 
pavlo8855: checks 
Pulp Hands: bets $0.11 and is all-in
Pokerkass: calls $0.11
pavlo8855: folds 
*** RIVER *** [2s 4d 7d Jd] [3h]
*** SHOW DOWN ***
Pokerkass: shows [Kc Qd] (high card King)
Pulp Hands: shows [Js Qh] (a pair of Jacks)
Pulp Hands cashed out the hand for $0.39
*** SUMMARY ***
Total pot $0.54 | Rake $0.02 
Board [2s 4d 7d Jd 3h]
Seat 1: andreydgk (button) folded before Flop (didn't bet)
Seat 2: Pokerkass (small blind) showed [Kc Qd] and lost with high card King
Seat 3: Scaaalll (big blind) folded before Flop
Seat 4: johniXL folded before Flop (didn't bet)
Seat 5: pavlo8855 folded on the Turn
Seat 6: Pulp Hands showed [Js Qh] and won ($0.52) with a pair of Jacks (pot not awarded as player cashed out)



PokerStars Zoom Hand #229229576068:  Hold'em No Limit ($0.01/$0.02) - 2021/08/21 21:06:07 CET [2021/08/21 15:06:07 ET]
Table 'Halley' 6-max Seat #1 is the button
Seat 1: Scaaalll ($2.15 in chips) 
Seat 2: KoAlRy ($2.26 in chips) 
Seat 3: CordiPS ($2.33 in chips) 
Seat 4: igara tigara ($1.91 in chips) 
Seat 5: Natali172737 ($3.01 in chips) 
Seat 6: pavlo8855 ($2.25 in chips) 
KoAlRy: posts small blind $0.01
CordiPS: posts big blind $0.02
*** HOLE CARDS ***
Dealt to Scaaalll [Ks 8h]
igara tigara: raises $0.04 to $0.06
Natali172737: folds 
pavlo8855: folds 
Scaaalll: folds 
KoAlRy: folds 
CordiPS: folds 
Uncalled bet ($0.04) returned to igara tigara
igara tigara collected $0.05 from pot
igara tigara: doesn't show hand 
*** SUMMARY ***
Total pot $0.05 | Rake $0 
Seat 1: Scaaalll (button) folded before Flop (didn't bet)
Seat 2: KoAlRy (small blind) folded before Flop
Seat 3: CordiPS (big blind) folded before Flop
Seat 4: igara tigara collected ($0.05)
Seat 5: Natali172737 folded before Flop (didn't bet)
Seat 6: pavlo8855 folded before Flop (didn't bet)



PokerStars Zoom Hand #229229574275:  Hold'em No Limit ($0.01/$0.02) - 2021/08/21 21:06:03 CET [2021/08/21 15:06:03 ET]
Table 'Halley' 6-max Seat #1 is the button
Seat 1: rpycmbEM ($5.81 in chips) 
Seat 2: Esskeetit420/69 ($2.05 in chips) 
Seat 3: MyWinCash ($2 in chips) 
Seat 4: Natali172737 ($2.13 in chips) 
Seat 5: Scaaalll ($2.15 in chips) 
Seat 6: yositoas ($5.10 in chips) 
Esskeetit420/69: posts small blind $0.01
MyWinCash: posts big blind $0.02
*** HOLE CARDS ***
Dealt to Scaaalll [5s Jc]
Natali172737: folds 
Scaaalll: folds 
yositoas: folds 
rpycmbEM: folds 
Esskeetit420/69: raises $0.04 to $0.06
MyWinCash: folds 
Uncalled bet ($0.04) returned to Esskeetit420/69
Esskeetit420/69 collected $0.04 from pot
Esskeetit420/69: doesn't show hand 
*** SUMMARY ***
Total pot $0.04 | Rake $0 
Seat 1: rpycmbEM (button) folded before Flop (didn't bet)
Seat 2: Esskeetit420/69 (small blind) collected ($0.04)
Seat 3: MyWinCash (big blind) folded before Flop
Seat 4: Natali172737 folded before Flop (didn't bet)
Seat 5: Scaaalll folded before Flop (didn't bet)
Seat 6: yositoas folded before Flop (didn't bet)



PokerStars Zoom Hand #229229580558:  Hold'em No Limit ($0.01/$0.02) - 2021/08/21 21:06:17 CET [2021/08/21 15:06:17 ET]
Table 'Halley' 6-max Seat #1 is the button
Seat 1: Esskeetit420/69 ($2.43 in chips) 
Seat 2: Scaaalll ($2.15 in chips) 
Seat 3: Player XVII ($2.54 in chips) 
Seat 4: SIGREX ($2 in chips) 
Seat 5: no way yo ($4.64 in chips) 
Seat 6: xxRoseIloveu ($1.89 in chips) 
Scaaalll: posts small blind $0.01
Player XVII: posts big blind $0.02
*** HOLE CARDS ***
Dealt to Scaaalll [5d Qs]
SIGREX: folds 
no way yo: folds 
xxRoseIloveu: folds 
Esskeetit420/69: folds 
Scaaalll: folds 
Uncalled bet ($0.01) returned to Player XVII
Player XVII collected $0.02 from pot
Player XVII: doesn't show hand 
*** SUMMARY ***
Total pot $0.02 | Rake $0 
Seat 1: Esskeetit420/69 (button) folded before Flop (didn't bet)
Seat 2: Scaaalll (small blind) folded before Flop
Seat 3: Player XVII (big blind) collected ($0.02)
Seat 4: SIGREX folded before Flop (didn't bet)
Seat 5: no way yo folded before Flop (didn't bet)
Seat 6: xxRoseIloveu folded before Flop (didn't bet)



PokerStars Zoom Hand #229229583756:  Hold'em No Limit ($0.01/$0.02) - 2021/08/21 21:06:24 CET [2021/08/21 15:06:24 ET]
Table 'Halley' 6-max Seat #1 is the button
Seat 1: billybob2009 ($1.45 in chips) 
Seat 2: diegohgmelo ($2.03 in chips) 
Seat 3: Scaaalll ($2.14 in chips) 
Seat 4: pavlo8855 ($2.06 in chips) 
Seat 5: gasmar_29 ($2.50 in chips) 
Seat 6: Koldun 2636 ($2 in chips) 
diegohgmelo: posts small blind $0.01
Scaaalll: posts big blind $0.02
*** HOLE CARDS ***
Dealt to Scaaalll [4h 9d]
pavlo8855: folds 
diegohgmelo is disconnected 
gasmar_29: folds 
Koldun 2636: folds 
billybob2009: folds 
diegohgmelo: folds 
Uncalled bet ($0.01) returned to Scaaalll
Scaaalll collected $0.02 from pot
Scaaalll: doesn't show hand 
*** SUMMARY ***
Total pot $0.02 | Rake $0 
Seat 1: billybob2009 (button) folded before Flop (didn't bet)
Seat 2: diegohgmelo (small blind) folded before Flop
Seat 3: Scaaalll (big blind) collected ($0.02)
Seat 4: pavlo8855 folded before Flop (didn't bet)
Seat 5: gasmar_29 folded before Flop (didn't bet)
Seat 6: Koldun 2636 folded before Flop (didn't bet)



PokerStars Zoom Hand #229229596044:  Hold'em No Limit ($0.01/$0.02) - 2021/08/21 21:06:51 CET [2021/08/21 15:06:51 ET]
Table 'Halley' 6-max Seat #1 is the button
Seat 1: lucksuckdonk ($3.15 in chips) 
Seat 2: badds ($1.95 in chips) 
Seat 3: bompi rafc ($2.28 in chips) 
Seat 4: KoAlRy ($2 in chips) 
Seat 5: Scaaalll ($2.15 in chips) 
Seat 6: feybys ($1.98 in chips) 
badds: posts small blind $0.01
bompi rafc: posts big blind $0.02
*** HOLE CARDS ***
Dealt to Scaaalll [Td 6d]
KoAlRy: folds 
Scaaalll: folds 
feybys: folds 
lucksuckdonk: folds 
badds: folds 
Uncalled bet ($0.01) returned to bompi rafc
bompi rafc collected $0.02 from pot
bompi rafc: doesn't show hand 
*** SUMMARY ***
Total pot $0.02 | Rake $0 
Seat 1: lucksuckdonk (button) folded before Flop (didn't bet)
Seat 2: badds (small blind) folded before Flop
Seat 3: bompi rafc (big blind) collected ($0.02)
Seat 4: KoAlRy folded before Flop (didn't bet)
Seat 5: Scaaalll folded before Flop (didn't bet)
Seat 6: feybys folded before Flop (didn't bet)



PokerStars Zoom Hand #229229589754:  Hold'em No Limit ($0.01/$0.02) - 2021/08/21 21:06:37 CET [2021/08/21 15:06:37 ET]
Table 'Halley' 6-max Seat #1 is the button
Seat 1: KoAlRy ($2.25 in chips) 
Seat 2: estelionat171 ($0.70 in chips) 
Seat 3: Fanatspartak ($1.74 in chips) 
Seat 4: Finderra ($3.78 in chips) 
Seat 5: diegohgmelo ($2.02 in chips) 
Seat 6: Scaaalll ($2.15 in chips) 
estelionat171: posts small blind $0.01
Fanatspartak: posts big blind $0.02
*** HOLE CARDS ***
Dealt to Scaaalll [As 3s]
Finderra: folds 
diegohgmelo: raises $0.04 to $0.06
Scaaalll: folds 
KoAlRy: folds 
estelionat171: folds 
Fanatspartak: calls $0.04
*** FLOP *** [4h 4d Kc]
Fanatspartak: checks 
diegohgmelo: bets $0.06
Fanatspartak: folds 
Uncalled bet ($0.06) returned to diegohgmelo
diegohgmelo collected $0.13 from pot
diegohgmelo: doesn't show hand 
*** SUMMARY ***
Total pot $0.13 | Rake $0 
Board [4h 4d Kc]
Seat 1: KoAlRy (button) folded before Flop (didn't bet)
Seat 2: estelionat171 (small blind) folded before Flop
Seat 3: Fanatspartak (big blind) folded on the Flop
Seat 4: Finderra folded before Flop (didn't bet)
Seat 5: diegohgmelo collected ($0.13)
Seat 6: Scaaalll folded before Flop (didn't bet)



PokerStars Zoom Hand #229229613732:  Hold'em No Limit ($0.01/$0.02) - 2021/08/21 21:07:30 CET [2021/08/21 15:07:30 ET]
Table 'Halley' 6-max Seat #1 is the button
Seat 1: Scaaalll ($2.10 in chips) 
Seat 2: Anan71 ($0.14 in chips) 
Seat 3: py100ta ($2.21 in chips) 
Seat 4: lyapis75 ($2.15 in chips) 
Seat 5: le_vlimeux ($6.59 in chips) 
Seat 6: Stepanovap52 ($5.19 in chips) 
Anan71: posts small blind $0.01
py100ta: posts big blind $0.02
*** HOLE CARDS ***
Dealt to Scaaalll [9h Jh]
lyapis75: folds 
le_vlimeux: folds 
Stepanovap52: folds 
Scaaalll: raises $0.02 to $0.04
Anan71: raises $0.10 to $0.14 and is all-in
py100ta: folds 
Scaaalll: calls $0.10
*** FLOP *** [As Js 8c]
*** TURN *** [As Js 8c] [Qd]
*** RIVER *** [As Js 8c Qd] [3c]
*** SHOW DOWN ***
Anan71: shows [Qh Kc] (a pair of Queens)
Scaaalll: shows [9h Jh] (a pair of Jacks)
Anan71 collected $0.29 from pot
*** SUMMARY ***
Total pot $0.30 | Rake $0.01 
Board [As Js 8c Qd 3c]
Seat 1: Scaaalll (button) showed [9h Jh] and lost with a pair of Jacks
Seat 2: Anan71 (small blind) showed [Qh Kc] and won ($0.29) with a pair of Queens
Seat 3: py100ta (big blind) folded before Flop
Seat 4: lyapis75 folded before Flop (didn't bet)
Seat 5: le_vlimeux folded before Flop (didn't bet)
Seat 6: Stepanovap52 folded before Flop (didn't bet)



PokerStars Zoom Hand #229229631127:  Hold'em No Limit ($0.01/$0.02) - 2021/08/21 21:08:08 CET [2021/08/21 15:08:08 ET]
Table 'Halley' 6-max Seat #1 is the button
Seat 1: Anan71 ($0.29 in chips) 
Seat 2: Scaaalll ($2 in chips) 
Seat 3: pavlo8855 ($2.21 in chips) 
Seat 4: estelionat171 ($0.67 in chips) 
Seat 5: zizu1014 ($2.67 in chips) 
Seat 6: Lacitoo ($2.19 in chips) 
Scaaalll: posts small blind $0.01
pavlo8855: posts big blind $0.02
*** HOLE CARDS ***
Dealt to Scaaalll [6h 4h]
estelionat171: folds 
zizu1014: folds 
Lacitoo: raises $0.03 to $0.05
Anan71: raises $0.24 to $0.29 and is all-in
Scaaalll: folds 
pavlo8855: folds 
Lacitoo: folds 
Uncalled bet ($0.24) returned to Anan71
Anan71 collected $0.13 from pot
Anan71: doesn't show hand 
Lacitoo is disconnected 
*** SUMMARY ***
Total pot $0.13 | Rake $0 
Seat 1: Anan71 (button) collected ($0.13)
Seat 2: Scaaalll (small blind) folded before Flop
Seat 3: pavlo8855 (big blind) folded before Flop
Seat 4: estelionat171 folded before Flop (didn't bet)
Seat 5: zizu1014 folded before Flop (didn't bet)
Seat 6: Lacitoo folded before Flop



PokerStars Zoom Hand #229229637943:  Hold'em No Limit ($0.01/$0.02) - 2021/08/21 21:08:23 CET [2021/08/21 15:08:23 ET]
Table 'Halley' 6-max Seat #1 is the button
Seat 1: pers_ikG ($2 in chips) 
Seat 2: Superfish I ($2.53 in chips) 
Seat 3: Scaaalll ($2 in chips) 
Seat 4: yositoas ($5.29 in chips) 
Seat 5: CrazyyParis ($2.57 in chips) 
Seat 6: PlayPokerHappy1 ($4.22 in chips) 
Superfish I: posts small blind $0.01
Scaaalll: posts big blind $0.02
*** HOLE CARDS ***
Dealt to Scaaalll [Qh As]
yositoas: folds 
CrazyyParis: folds 
PlayPokerHappy1: folds 
pers_ikG: folds 
Superfish I: folds 
Uncalled bet ($0.01) returned to Scaaalll
Scaaalll collected $0.02 from pot
Scaaalll: doesn't show hand 
*** SUMMARY ***
Total pot $0.02 | Rake $0 
Seat 1: pers_ikG (button) folded before Flop (didn't bet)
Seat 2: Superfish I (small blind) folded before Flop
Seat 3: Scaaalll (big blind) collected ($0.02)
Seat 4: yositoas folded before Flop (didn't bet)
Seat 5: CrazyyParis folded before Flop (didn't bet)
Seat 6: PlayPokerHappy1 folded before Flop (didn't bet)



PokerStars Zoom Hand #229229597911:  Hold'em No Limit ($0.01/$0.02) - 2021/08/21 21:06:56 CET [2021/08/21 15:06:56 ET]
Table 'Halley' 6-max Seat #1 is the button
Seat 1: pers_ikG ($2 in chips) 
Seat 2: S.B.O190 ($6.20 in chips) 
Seat 3: AligatorsBlood ($2.06 in chips) 
Seat 4: Laonikos ($4.24 in chips) 
Seat 5: Scaaalll ($2.15 in chips) 
Seat 6: vicctorlf ($1.96 in chips) 
S.B.O190: posts small blind $0.01
AligatorsBlood: posts big blind $0.02
*** HOLE CARDS ***
Dealt to Scaaalll [Ac Kh]
Laonikos: raises $0.03 to $0.05
Scaaalll: calls $0.05
vicctorlf: folds 
pers_ikG: folds 
S.B.O190: folds 
AligatorsBlood: calls $0.03
*** FLOP *** [Jd 9h 6h]
AligatorsBlood: checks 
Laonikos: bets $0.07
Scaaalll: folds 
AligatorsBlood: calls $0.07
*** TURN *** [Jd 9h 6h] [6s]
AligatorsBlood: checks 
Laonikos: bets $0.13
AligatorsBlood: calls $0.13
*** RIVER *** [Jd 9h 6h 6s] [8s]
AligatorsBlood: checks 
Laonikos: checks 
*** SHOW DOWN ***
AligatorsBlood: shows [8h 8d] (a full house, Eights full of Sixes)
Laonikos: mucks hand 
AligatorsBlood collected $0.54 from pot
*** SUMMARY ***
Total pot $0.56 | Rake $0.02 
Board [Jd 9h 6h 6s 8s]
Seat 1: pers_ikG (button) folded before Flop (didn't bet)
Seat 2: S.B.O190 (small blind) folded before Flop
Seat 3: AligatorsBlood (big blind) showed [8h 8d] and won ($0.54) with a full house, Eights full of Sixes
Seat 4: Laonikos mucked [9s 7s]
Seat 5: Scaaalll folded on the Flop
Seat 6: vicctorlf folded before Flop (didn't bet)



PokerStars Zoom Hand #229229642047:  Hold'em No Limit ($0.01/$0.02) - 2021/08/21 21:08:32 CET [2021/08/21 15:08:32 ET]
Table 'Halley' 6-max Seat #1 is the button
Seat 1: nemat_g ($2.06 in chips) 
Seat 2: pavlo8855 ($2.24 in chips) 
Seat 3: Natali172737 ($2.95 in chips) 
Seat 4: Scaaalll ($2.01 in chips) 
Seat 5: zeraxer ($2 in chips) 
Seat 6: vaaaala ($5.10 in chips) 
pavlo8855: posts small blind $0.01
Natali172737: posts big blind $0.02
*** HOLE CARDS ***
Dealt to Scaaalll [3c As]
Scaaalll: folds 
zeraxer: raises $0.04 to $0.06
vaaaala: folds 
nemat_g: folds 
pavlo8855: folds 
Natali172737: folds 
Uncalled bet ($0.04) returned to zeraxer
zeraxer collected $0.05 from pot
zeraxer: doesn't show hand 
*** SUMMARY ***
Total pot $0.05 | Rake $0 
Seat 1: nemat_g (button) folded before Flop (didn't bet)
Seat 2: pavlo8855 (small blind) folded before Flop
Seat 3: Natali172737 (big blind) folded before Flop
Seat 4: Scaaalll folded before Flop (didn't bet)
Seat 5: zeraxer collected ($0.05)
Seat 6: vaaaala folded before Flop (didn't bet)



PokerStars Zoom Hand #229229644364:  Hold'em No Limit ($0.01/$0.02) - 2021/08/21 21:08:37 CET [2021/08/21 15:08:37 ET]
Table 'Halley' 6-max Seat #1 is the button
Seat 1: Pechorin.G ($2.18 in chips) 
Seat 2: kamiso0904 ($1.27 in chips) 
Seat 3: In2win26 ($1.38 in chips) 
Seat 4: Alex Koshva1 ($1.98 in chips) 
Seat 5: Victor151886 ($2.07 in chips) 
Seat 6: Scaaalll ($2.01 in chips) 
kamiso0904: posts small blind $0.01
In2win26: posts big blind $0.02
*** HOLE CARDS ***
Dealt to Scaaalll [5h Qh]
Alex Koshva1: folds 
Victor151886: folds 
Scaaalll: folds 
Pechorin.G: folds 
kamiso0904: raises $0.04 to $0.06
In2win26: calls $0.04
*** FLOP *** [4h 4c Qc]
kamiso0904: checks 
In2win26: bets $0.06
kamiso0904: calls $0.06
*** TURN *** [4h 4c Qc] [3h]
kamiso0904: checks 
In2win26: checks 
*** RIVER *** [4h 4c Qc 3h] [8c]
kamiso0904: bets $0.10
In2win26: folds 
Uncalled bet ($0.10) returned to kamiso0904
kamiso0904 collected $0.23 from pot
kamiso0904: doesn't show hand 
In2win26 is disconnected 
*** SUMMARY ***
Total pot $0.24 | Rake $0.01 
Board [4h 4c Qc 3h 8c]
Seat 1: Pechorin.G (button) folded before Flop (didn't bet)
Seat 2: kamiso0904 (small blind) collected ($0.23)
Seat 3: In2win26 (big blind) folded on the River
Seat 4: Alex Koshva1 folded before Flop (didn't bet)
Seat 5: Victor151886 folded before Flop (didn't bet)
Seat 6: Scaaalll folded before Flop (didn't bet)



PokerStars Zoom Hand #229229648918:  Hold'em No Limit ($0.01/$0.02) - 2021/08/21 21:08:47 CET [2021/08/21 15:08:47 ET]
Table 'Halley' 6-max Seat #1 is the button
Seat 1: officesu ($2.62 in chips) 
Seat 2: ARTMVSLV ($3.15 in chips) 
Seat 3: 1_KoLizeI_1 ($2.49 in chips) 
Seat 4: Scaaalll ($2.01 in chips) 
Seat 5: gugamoraes ($2.06 in chips) 
Seat 6: rpycmbEM ($3.27 in chips) 
ARTMVSLV: posts small blind $0.01
1_KoLizeI_1: posts big blind $0.02
*** HOLE CARDS ***
Dealt to Scaaalll [Kc Kd]
Scaaalll: raises $0.04 to $0.06
gugamoraes: folds 
rpycmbEM: calls $0.06
officesu: folds 
ARTMVSLV: folds 
1_KoLizeI_1: calls $0.04
*** FLOP *** [4s 5c Js]
1_KoLizeI_1: checks 
Scaaalll: bets $0.12
rpycmbEM: calls $0.12
1_KoLizeI_1: folds 
*** TURN *** [4s 5c Js] [5d]
Scaaalll: bets $0.25
rpycmbEM: calls $0.25
*** RIVER *** [4s 5c Js 5d] [2h]
Scaaalll: bets $0.63
rpycmbEM: folds 
Uncalled bet ($0.63) returned to Scaaalll
Scaaalll collected $0.89 from pot
Scaaalll: doesn't show hand 
*** SUMMARY ***
Total pot $0.93 | Rake $0.04 
Board [4s 5c Js 5d 2h]
Seat 1: officesu (button) folded before Flop (didn't bet)
Seat 2: ARTMVSLV (small blind) folded before Flop
Seat 3: 1_KoLizeI_1 (big blind) folded on the Flop
Seat 4: Scaaalll collected ($0.89)
Seat 5: gugamoraes folded before Flop (didn't bet)
Seat 6: rpycmbEM folded on the River



PokerStars Zoom Hand #229229676493:  Hold'em No Limit ($0.01/$0.02) - 2021/08/21 21:09:48 CET [2021/08/21 15:09:48 ET]
Table 'Halley' 6-max Seat #1 is the button
Seat 1: texashenry2 ($2.16 in chips) 
Seat 2: johniXL ($1.01 in chips) 
Seat 3: leedsrounder ($3.75 in chips) 
Seat 4: Superfish I ($2.47 in chips) 
Seat 5: so0love ($2.61 in chips) 
Seat 6: Scaaalll ($2.47 in chips) 
johniXL: posts small blind $0.01
leedsrounder: posts big blind $0.02
*** HOLE CARDS ***
Dealt to Scaaalll [6s Td]
Superfish I: folds 
so0love: folds 
Scaaalll: folds 
texashenry2: folds 
johniXL: folds 
Uncalled bet ($0.01) returned to leedsrounder
leedsrounder collected $0.02 from pot
leedsrounder: doesn't show hand 
*** SUMMARY ***
Total pot $0.02 | Rake $0 
Seat 1: texashenry2 (button) folded before Flop (didn't bet)
Seat 2: johniXL (small blind) folded before Flop
Seat 3: leedsrounder (big blind) collected ($0.02)
Seat 4: Superfish I folded before Flop (didn't bet)
Seat 5: so0love folded before Flop (didn't bet)
Seat 6: Scaaalll folded before Flop (didn't bet)



PokerStars Zoom Hand #229229678695:  Hold'em No Limit ($0.01/$0.02) - 2021/08/21 21:09:53 CET [2021/08/21 15:09:53 ET]
Table 'Halley' 6-max Seat #1 is the button
Seat 1: Djalmethedj ($1.86 in chips) 
Seat 2: Flankeris ($4.86 in chips) 
Seat 3: jftd123 ($2.13 in chips) 
Seat 4: cacomaz ($1.04 in chips) 
Seat 5: Scaaalll ($2.47 in chips) 
Seat 6: estelionat171 ($0.78 in chips) 
Flankeris: posts small blind $0.01
jftd123: posts big blind $0.02
*** HOLE CARDS ***
Dealt to Scaaalll [Ad As]
cacomaz: folds 
cacomaz is disconnected 
Scaaalll: raises $0.04 to $0.06
estelionat171: folds 
Djalmethedj: folds 
Flankeris: folds 
jftd123: folds 
Uncalled bet ($0.04) returned to Scaaalll
Scaaalll collected $0.05 from pot
Scaaalll: doesn't show hand 
*** SUMMARY ***
Total pot $0.05 | Rake $0 
Seat 1: Djalmethedj (button) folded before Flop (didn't bet)
Seat 2: Flankeris (small blind) folded before Flop
Seat 3: jftd123 (big blind) folded before Flop
Seat 4: cacomaz folded before Flop (didn't bet)
Seat 5: Scaaalll collected ($0.05)
Seat 6: estelionat171 folded before Flop (didn't bet)



PokerStars Zoom Hand #229229704375:  Hold'em No Limit ($0.01/$0.02) - 2021/08/21 21:10:50 CET [2021/08/21 15:10:50 ET]
Table 'Halley' 6-max Seat #1 is the button
Seat 1: gepard35 ($2 in chips) 
Seat 2: derry,me ($1.94 in chips) 
Seat 3: Scaaalll ($2.45 in chips) 
Seat 4: fabor1303 ($3.43 in chips) 
Seat 5: the.fire71 ($3.54 in chips) 
Seat 6: fishh_play ($2.12 in chips) 
derry,me: posts small blind $0.01
Scaaalll: posts big blind $0.02
*** HOLE CARDS ***
Dealt to Scaaalll [2h 8h]
fabor1303: folds 
the.fire71: folds 
fishh_play: raises $0.03 to $0.05
gepard35: folds 
derry,me: folds 
Scaaalll: folds 
Uncalled bet ($0.03) returned to fishh_play
derry,me is disconnected 
fishh_play collected $0.05 from pot
fishh_play: doesn't show hand 
*** SUMMARY ***
Total pot $0.05 | Rake $0 
Seat 1: gepard35 (button) folded before Flop (didn't bet)
Seat 2: derry,me (small blind) folded before Flop
Seat 3: Scaaalll (big blind) folded before Flop
Seat 4: fabor1303 folded before Flop (didn't bet)
Seat 5: the.fire71 folded before Flop (didn't bet)
Seat 6: fishh_play collected ($0.05)



PokerStars Zoom Hand #229229685422:  Hold'em No Limit ($0.01/$0.02) - 2021/08/21 21:10:08 CET [2021/08/21 15:10:08 ET]
Table 'Halley' 6-max Seat #1 is the button
Seat 1: Xlavariable ($4.38 in chips) 
Seat 2: Scaaalll ($2.50 in chips) 
Seat 3: csmall14 ($2 in chips) 
Seat 4: Flankeris ($3.03 in chips) 
Seat 5: SideshowPen ($2 in chips) 
Seat 6: KRandall12 ($0.96 in chips) 
Scaaalll: posts small blind $0.01
csmall14: posts big blind $0.02
*** HOLE CARDS ***
Dealt to Scaaalll [Jc As]
Flankeris: folds 
SideshowPen: folds 
KRandall12: raises $0.03 to $0.05
Xlavariable: calls $0.05
Scaaalll: calls $0.04
csmall14: folds 
*** FLOP *** [Td 6d 2s]
Scaaalll: checks 
KRandall12: bets $0.12
Xlavariable: calls $0.12
Scaaalll: folds 
*** TURN *** [Td 6d 2s] [Kd]
KRandall12: bets $0.16
Xlavariable: folds 
Uncalled bet ($0.16) returned to KRandall12
KRandall12 collected $0.40 from pot
KRandall12: doesn't show hand 
*** SUMMARY ***
Total pot $0.41 | Rake $0.01 
Board [Td 6d 2s Kd]
Seat 1: Xlavariable (button) folded on the Turn
Seat 2: Scaaalll (small blind) folded on the Flop
Seat 3: csmall14 (big blind) folded before Flop
Seat 4: Flankeris folded before Flop (didn't bet)
Seat 5: SideshowPen folded before Flop (didn't bet)
Seat 6: KRandall12 collected ($0.40)



PokerStars Zoom Hand #229229708348:  Hold'em No Limit ($0.01/$0.02) - 2021/08/21 21:10:59 CET [2021/08/21 15:10:59 ET]
Table 'Halley' 6-max Seat #1 is the button
Seat 1: Scaaalll ($2.43 in chips) 
Seat 2: Roubyz ($1.91 in chips) 
Seat 3: Forest404 ($1.44 in chips) 
Seat 4: MollyNW ($0.95 in chips) 
Seat 5: Finderra ($2.09 in chips) 
Seat 6: majo_74 ($2.13 in chips) 
Roubyz: posts small blind $0.01
Forest404: posts big blind $0.02
*** HOLE CARDS ***
Dealt to Scaaalll [7h Kc]
Roubyz is disconnected 
MollyNW: folds 
MollyNW is disconnected 
Finderra: folds 
majo_74: folds 
Scaaalll: raises $0.02 to $0.04
Roubyz: folds 
Forest404: folds 
Uncalled bet ($0.02) returned to Scaaalll
Scaaalll collected $0.05 from pot
Scaaalll: doesn't show hand 
*** SUMMARY ***
Total pot $0.05 | Rake $0 
Seat 1: Scaaalll (button) collected ($0.05)
Seat 2: Roubyz (small blind) folded before Flop
Seat 3: Forest404 (big blind) folded before Flop
Seat 4: MollyNW folded before Flop (didn't bet)
Seat 5: Finderra folded before Flop (didn't bet)
Seat 6: majo_74 folded before Flop (didn't bet)



PokerStars Zoom Hand #229229721055:  Hold'em No Limit ($0.01/$0.02) - 2021/08/21 21:11:27 CET [2021/08/21 15:11:27 ET]
Table 'Halley' 6-max Seat #1 is the button
Seat 1: 77omsk ($6.83 in chips) 
Seat 2: Scaaalll ($2.46 in chips) 
Seat 3: ignat-of 777 ($0.65 in chips) 
Seat 4: nyuta77 ($0.44 in chips) 
Seat 5: RonilsonCosta ($2 in chips) 
Seat 6: solosigueme ($0.70 in chips) 
Scaaalll: posts small blind $0.01
ignat-of 777: posts big blind $0.02
*** HOLE CARDS ***
Dealt to Scaaalll [8h Ts]
nyuta77: folds 
nyuta77 is disconnected 
RonilsonCosta: raises $0.03 to $0.05
solosigueme: folds 
77omsk: folds 
Scaaalll: folds 
ignat-of 777: folds 
Uncalled bet ($0.03) returned to RonilsonCosta
RonilsonCosta collected $0.05 from pot
RonilsonCosta: doesn't show hand 
*** SUMMARY ***
Total pot $0.05 | Rake $0 
Seat 1: 77omsk (button) folded before Flop (didn't bet)
Seat 2: Scaaalll (small blind) folded before Flop
Seat 3: ignat-of 777 (big blind) folded before Flop
Seat 4: nyuta77 folded before Flop (didn't bet)
Seat 5: RonilsonCosta collected ($0.05)
Seat 6: solosigueme folded before Flop (didn't bet)



PokerStars Zoom Hand #229229725953:  Hold'em No Limit ($0.01/$0.02) - 2021/08/21 21:11:38 CET [2021/08/21 15:11:38 ET]
Table 'Halley' 6-max Seat #1 is the button
Seat 1: igara tigara ($1.95 in chips) 
Seat 2: Kergie ($4.33 in chips) 
Seat 3: CrazyyParis ($2.07 in chips) 
Seat 4: Scaaalll ($2.45 in chips) 
Seat 5: andreydgk ($2.17 in chips) 
Seat 6: vaaaala ($7.34 in chips) 
Kergie: posts small blind $0.01
CrazyyParis: posts big blind $0.02
*** HOLE CARDS ***
Dealt to Scaaalll [2d 9c]
Scaaalll: folds 
andreydgk: folds 
vaaaala: folds 
igara tigara: folds 
Kergie: folds 
Uncalled bet ($0.01) returned to CrazyyParis
CrazyyParis collected $0.02 from pot
CrazyyParis: doesn't show hand 
*** SUMMARY ***
Total pot $0.02 | Rake $0 
Seat 1: igara tigara (button) folded before Flop (didn't bet)
Seat 2: Kergie (small blind) folded before Flop
Seat 3: CrazyyParis (big blind) collected ($0.02)
Seat 4: Scaaalll folded before Flop (didn't bet)
Seat 5: andreydgk folded before Flop (didn't bet)
Seat 6: vaaaala folded before Flop (didn't bet)



PokerStars Zoom Hand #229229714614:  Hold'em No Limit ($0.01/$0.02) - 2021/08/21 21:11:14 CET [2021/08/21 15:11:14 ET]
Table 'Halley' 6-max Seat #1 is the button
Seat 1: kahzura ($2 in chips) 
Seat 2: IWMTW ($1.75 in chips) 
Seat 3: johnjohnson11 ($1.18 in chips) 
Seat 4: PlayPokerHappy1 ($7.09 in chips) 
Seat 5: Scaaalll ($2.46 in chips) 
Seat 6: pers_ikG ($3.87 in chips) 
IWMTW: posts small blind $0.01
johnjohnson11: posts big blind $0.02
*** HOLE CARDS ***
Dealt to Scaaalll [Ad 9h]
PlayPokerHappy1: folds 
Scaaalll: folds 
pers_ikG: folds 
kahzura: raises $0.03 to $0.05
IWMTW: calls $0.04
johnjohnson11: calls $0.03
*** FLOP *** [3s Th Jc]
IWMTW: checks 
johnjohnson11: checks 
kahzura: checks 
*** TURN *** [3s Th Jc] [Qd]
IWMTW: checks 
johnjohnson11: bets $0.07
kahzura: folds 
IWMTW: folds 
Uncalled bet ($0.07) returned to johnjohnson11
johnjohnson11 collected $0.14 from pot
johnjohnson11: doesn't show hand 
*** SUMMARY ***
Total pot $0.15 | Rake $0.01 
Board [3s Th Jc Qd]
Seat 1: kahzura (button) folded on the Turn
Seat 2: IWMTW (small blind) folded on the Turn
Seat 3: johnjohnson11 (big blind) collected ($0.14)
Seat 4: PlayPokerHappy1 folded before Flop (didn't bet)
Seat 5: Scaaalll folded before Flop (didn't bet)
Seat 6: pers_ikG folded before Flop (didn't bet)



PokerStars Zoom Hand #229229727803:  Hold'em No Limit ($0.01/$0.02) - 2021/08/21 21:11:42 CET [2021/08/21 15:11:42 ET]
Table 'Halley' 6-max Seat #1 is the button
Seat 1: Scaaalll ($2.45 in chips) 
Seat 2: zairyoku ($2.25 in chips) 
Seat 3: kodart ($1.62 in chips) 
Seat 4: pavlo8855 ($2.07 in chips) 
Seat 5: Tj741 ($2 in chips) 
Seat 6: vaaaala ($2 in chips) 
zairyoku: posts small blind $0.01
kodart: posts big blind $0.02
*** HOLE CARDS ***
Dealt to Scaaalll [Tc Jc]
pavlo8855: folds 
Tj741: folds 
vaaaala: raises $0.04 to $0.06
Scaaalll: calls $0.06
zairyoku: folds 
kodart: folds 
*** FLOP *** [8c 4c 8h]
vaaaala: bets $0.07
Scaaalll: calls $0.07
*** TURN *** [8c 4c 8h] [7h]
vaaaala: checks 
Scaaalll: bets $0.19
vaaaala: folds 
Uncalled bet ($0.19) returned to Scaaalll
Scaaalll collected $0.28 from pot
Scaaalll: doesn't show hand 
*** SUMMARY ***
Total pot $0.29 | Rake $0.01 
Board [8c 4c 8h 7h]
Seat 1: Scaaalll (button) collected ($0.28)
Seat 2: zairyoku (small blind) folded before Flop
Seat 3: kodart (big blind) folded before Flop
Seat 4: pavlo8855 folded before Flop (didn't bet)
Seat 5: Tj741 folded before Flop (didn't bet)
Seat 6: vaaaala folded on the Turn



PokerStars Zoom Hand #229229742306:  Hold'em No Limit ($0.01/$0.02) - 2021/08/21 21:12:14 CET [2021/08/21 15:12:14 ET]
Table 'Halley' 6-max Seat #1 is the button
Seat 1: FabOliveira9 ($2 in chips) 
Seat 2: sg.32rus ($0.63 in chips) 
Seat 3: Scaaalll ($2.60 in chips) 
Seat 4: Asdmald ($1.72 in chips) 
Seat 5: Vit13150 ($3.48 in chips) 
Seat 6: Mikel226 ($2.48 in chips) 
sg.32rus: posts small blind $0.01
Scaaalll: posts big blind $0.02
*** HOLE CARDS ***
Dealt to Scaaalll [Jc 6s]
Asdmald: calls $0.02
Vit13150: folds 
Mikel226: raises $0.04 to $0.06
FabOliveira9: folds 
sg.32rus: folds 
Scaaalll: folds 
Asdmald: calls $0.04
*** FLOP *** [3d Qh 4c]
Asdmald: checks 
Mikel226: checks 
*** TURN *** [3d Qh 4c] [Kd]
Asdmald: bets $0.06
Mikel226: folds 
Uncalled bet ($0.06) returned to Asdmald
Asdmald collected $0.14 from pot
Asdmald: doesn't show hand 
*** SUMMARY ***
Total pot $0.15 | Rake $0.01 
Board [3d Qh 4c Kd]
Seat 1: FabOliveira9 (button) folded before Flop (didn't bet)
Seat 2: sg.32rus (small blind) folded before Flop
Seat 3: Scaaalll (big blind) folded before Flop
Seat 4: Asdmald collected ($0.14)
Seat 5: Vit13150 folded before Flop (didn't bet)
Seat 6: Mikel226 folded on the Turn



PokerStars Zoom Hand #229229748265:  Hold'em No Limit ($0.01/$0.02) - 2021/08/21 21:12:27 CET [2021/08/21 15:12:27 ET]
Table 'Halley' 6-max Seat #1 is the button
Seat 1: LuckyLlama0 ($0.70 in chips) 
Seat 2: PaddyPoland ($2.22 in chips) 
Seat 3: maliniak75 ($1.91 in chips) 
Seat 4: jeroninho ($1 in chips) 
Seat 5: Scaaalll ($2.58 in chips) 
Seat 6: Snegul ($0.96 in chips) 
PaddyPoland: posts small blind $0.01
maliniak75: posts big blind $0.02
*** HOLE CARDS ***
Dealt to Scaaalll [8h Kc]
jeroninho: folds 
Scaaalll: folds 
Snegul: folds 
LuckyLlama0: raises $0.04 to $0.06
PaddyPoland: folds 
maliniak75: folds 
Uncalled bet ($0.04) returned to LuckyLlama0
LuckyLlama0 collected $0.05 from pot
LuckyLlama0: doesn't show hand 
*** SUMMARY ***
Total pot $0.05 | Rake $0 
Seat 1: LuckyLlama0 (button) collected ($0.05)
Seat 2: PaddyPoland (small blind) folded before Flop
Seat 3: maliniak75 (big blind) folded before Flop
Seat 4: jeroninho folded before Flop (didn't bet)
Seat 5: Scaaalll folded before Flop (didn't bet)
Seat 6: Snegul folded before Flop (didn't bet)



PokerStars Zoom Hand #229229751337:  Hold'em No Limit ($0.01/$0.02) - 2021/08/21 21:12:34 CET [2021/08/21 15:12:34 ET]
Table 'Halley' 6-max Seat #1 is the button
Seat 1: squidy4 ($1.90 in chips) 
Seat 2: PlayPokerHappy1 ($2 in chips) 
Seat 3: estelionat171 ($0.81 in chips) 
Seat 4: iPitbull1 ($2.53 in chips) 
Seat 5: miha.3108 ($1.53 in chips) 
Seat 6: Scaaalll ($2.58 in chips) 
PlayPokerHappy1: posts small blind $0.01
estelionat171: posts big blind $0.02
*** HOLE CARDS ***
Dealt to Scaaalll [6h 3d]
iPitbull1: folds 
miha.3108: folds 
Scaaalll: folds 
squidy4: folds 
PlayPokerHappy1: folds 
Uncalled bet ($0.01) returned to estelionat171
estelionat171 collected $0.02 from pot
estelionat171: doesn't show hand 
*** SUMMARY ***
Total pot $0.02 | Rake $0 
Seat 1: squidy4 (button) folded before Flop (didn't bet)
Seat 2: PlayPokerHappy1 (small blind) folded before Flop
Seat 3: estelionat171 (big blind) collected ($0.02)
Seat 4: iPitbull1 folded before Flop (didn't bet)
Seat 5: miha.3108 folded before Flop (didn't bet)
Seat 6: Scaaalll folded before Flop (didn't bet)



PokerStars Zoom Hand #229229753642:  Hold'em No Limit ($0.01/$0.02) - 2021/08/21 21:12:39 CET [2021/08/21 15:12:39 ET]
Table 'Halley' 6-max Seat #1 is the button
Seat 1: AligatorsBlood ($2.56 in chips) 
Seat 2: Scaaalll ($2.58 in chips) 
Seat 3: py100ta ($11.12 in chips) 
Seat 4: danielschuel ($1.79 in chips) 
Seat 5: rAxt24 ($2.66 in chips) 
Seat 6: 78joniboy ($2 in chips) 
Scaaalll: posts small blind $0.01
py100ta: posts big blind $0.02
*** HOLE CARDS ***
Dealt to Scaaalll [2s 2h]
danielschuel: folds 
rAxt24: folds 
78joniboy: folds 
AligatorsBlood: folds 
Scaaalll: raises $0.04 to $0.06
py100ta: folds 
Uncalled bet ($0.04) returned to Scaaalll
Scaaalll collected $0.04 from pot
Scaaalll: doesn't show hand 
*** SUMMARY ***
Total pot $0.04 | Rake $0 
Seat 1: AligatorsBlood (button) folded before Flop (didn't bet)
Seat 2: Scaaalll (small blind) collected ($0.04)
Seat 3: py100ta (big blind) folded before Flop
Seat 4: danielschuel folded before Flop (didn't bet)
Seat 5: rAxt24 folded before Flop (didn't bet)
Seat 6: 78joniboy folded before Flop (didn't bet)



PokerStars Zoom Hand #229229761028:  Hold'em No Limit ($0.01/$0.02) - 2021/08/21 21:12:55 CET [2021/08/21 15:12:55 ET]
Table 'Halley' 6-max Seat #1 is the button
Seat 1: Vit13150 ($3.52 in chips) 
Seat 2: no way yo ($3.66 in chips) 
Seat 3: MyWinCash ($2.31 in chips) 
Seat 4: Scaaalll ($2.60 in chips) 
Seat 5: nodtress ($2 in chips) 
Seat 6: zergmiky ($2.03 in chips) 
no way yo: posts small blind $0.01
MyWinCash: posts big blind $0.02
*** HOLE CARDS ***
Dealt to Scaaalll [Qd 9d]
Scaaalll: raises $0.04 to $0.06
nodtress: folds 
zergmiky: folds 
Vit13150: folds 
no way yo: folds 
MyWinCash: folds 
Uncalled bet ($0.04) returned to Scaaalll
Scaaalll collected $0.05 from pot
Scaaalll: doesn't show hand 
*** SUMMARY ***
Total pot $0.05 | Rake $0 
Seat 1: Vit13150 (button) folded before Flop (didn't bet)
Seat 2: no way yo (small blind) folded before Flop
Seat 3: MyWinCash (big blind) folded before Flop
Seat 4: Scaaalll collected ($0.05)
Seat 5: nodtress folded before Flop (didn't bet)
Seat 6: zergmiky folded before Flop (didn't bet)



PokerStars Zoom Hand #229229768190:  Hold'em No Limit ($0.01/$0.02) - 2021/08/21 21:13:11 CET [2021/08/21 15:13:11 ET]
Table 'Halley' 6-max Seat #1 is the button
Seat 1: Scaaalll ($2.63 in chips) 
Seat 2: BO/\KODAB 22 ($1.50 in chips) 
Seat 3: pers_ikG ($2.70 in chips) 
Seat 4: VasquezSancho96 ($9.44 in chips) 
Seat 5: derry,me ($1.78 in chips) 
Seat 6: Sealing ($1.61 in chips) 
BO/\KODAB 22: posts small blind $0.01
pers_ikG: posts big blind $0.02
*** HOLE CARDS ***
Dealt to Scaaalll [Jh Ac]
derry,me is disconnected 
VasquezSancho96: folds 
derry,me: folds 
Sealing: folds 
Scaaalll: raises $0.02 to $0.04
BO/\KODAB 22: calls $0.03
pers_ikG: calls $0.02
*** FLOP *** [Qh 6h 9s]
BO/\KODAB 22: bets $0.12
pers_ikG: folds 
Scaaalll: folds 
Uncalled bet ($0.12) returned to BO/\KODAB 22
BO/\KODAB 22 collected $0.12 from pot
BO/\KODAB 22: doesn't show hand 
*** SUMMARY ***
Total pot $0.12 | Rake $0 
Board [Qh 6h 9s]
Seat 1: Scaaalll (button) folded on the Flop
Seat 2: BO/\KODAB 22 (small blind) collected ($0.12)
Seat 3: pers_ikG (big blind) folded on the Flop
Seat 4: VasquezSancho96 folded before Flop (didn't bet)
Seat 5: derry,me folded before Flop (didn't bet)
Seat 6: Sealing folded before Flop (didn't bet)



PokerStars Zoom Hand #229229778831:  Hold'em No Limit ($0.01/$0.02) - 2021/08/21 21:13:34 CET [2021/08/21 15:13:34 ET]
Table 'Halley' 6-max Seat #1 is the button
Seat 1: Goose Of Poker ($2.38 in chips) 
Seat 2: EchoMR ($2.19 in chips) 
Seat 3: Scaaalll ($2.59 in chips) 
Seat 4: arsad725 ($6.24 in chips) 
Seat 5: xxRoseIloveu ($5.95 in chips) 
Seat 6: Esskeetit420/69 ($1.94 in chips) 
EchoMR: posts small blind $0.01
Scaaalll: posts big blind $0.02
*** HOLE CARDS ***
Dealt to Scaaalll [2s 9d]
arsad725: folds 
xxRoseIloveu: folds 
Esskeetit420/69: folds 
Goose Of Poker: folds 
EchoMR: raises $0.04 to $0.06
Scaaalll: folds 
Uncalled bet ($0.04) returned to EchoMR
EchoMR collected $0.04 from pot
EchoMR: doesn't show hand 
*** SUMMARY ***
Total pot $0.04 | Rake $0 
Seat 1: Goose Of Poker (button) folded before Flop (didn't bet)
Seat 2: EchoMR (small blind) collected ($0.04)
Seat 3: Scaaalll (big blind) folded before Flop
Seat 4: arsad725 folded before Flop (didn't bet)
Seat 5: xxRoseIloveu folded before Flop (didn't bet)
Seat 6: Esskeetit420/69 folded before Flop (didn't bet)



PokerStars Zoom Hand #229229766373:  Hold'em No Limit ($0.01/$0.02) - 2021/08/21 21:13:07 CET [2021/08/21 15:13:07 ET]
Table 'Halley' 6-max Seat #1 is the button
Seat 1: Siyah Horoz ($2.42 in chips) 
Seat 2: alex2brok ($1.76 in chips) 
Seat 3: unior321 ($0.73 in chips) 
Seat 4: Scaaalll ($2.63 in chips) 
Seat 5: fabor1303 ($2.65 in chips) 
Seat 6: Forest404 ($1.07 in chips) 
alex2brok: posts small blind $0.01
unior321: posts big blind $0.02
*** HOLE CARDS ***
Dealt to Scaaalll [7s 9c]
Scaaalll: folds 
fabor1303: folds 
Forest404: folds 
Siyah Horoz: raises $0.02 to $0.04
alex2brok: folds 
unior321: calls $0.02
*** FLOP *** [6c 5h 2h]
unior321: checks 
Siyah Horoz: bets $0.04
unior321: calls $0.04
*** TURN *** [6c 5h 2h] [4d]
unior321: checks 
Siyah Horoz: checks 
*** RIVER *** [6c 5h 2h 4d] [8h]
unior321: bets $0.08
Siyah Horoz: folds 
Uncalled bet ($0.08) returned to unior321
unior321 collected $0.16 from pot
unior321: doesn't show hand 
*** SUMMARY ***
Total pot $0.17 | Rake $0.01 
Board [6c 5h 2h 4d 8h]
Seat 1: Siyah Horoz (button) folded on the River
Seat 2: alex2brok (small blind) folded before Flop
Seat 3: unior321 (big blind) collected ($0.16)
Seat 4: Scaaalll folded before Flop (didn't bet)
Seat 5: fabor1303 folded before Flop (didn't bet)
Seat 6: Forest404 folded before Flop (didn't bet)



PokerStars Zoom Hand #229229784187:  Hold'em No Limit ($0.01/$0.02) - 2021/08/21 21:13:46 CET [2021/08/21 15:13:46 ET]
Table 'Halley' 6-max Seat #1 is the button
Seat 1: Wegezin ($2.34 in chips) 
Seat 2: xxRoseIloveu ($5.95 in chips) 
Seat 3: Kb013497 ($3.33 in chips) 
Seat 4: Denisov V. ($0.14 in chips) 
Seat 5: Scaaalll ($2.57 in chips) 
Seat 6: NecromiconP ($2 in chips) 
xxRoseIloveu: posts small blind $0.01
Kb013497: posts big blind $0.02
*** HOLE CARDS ***
Dealt to Scaaalll [Kh 5d]
Denisov V.: folds 
Scaaalll: folds 
Denisov V. is disconnected 
NecromiconP: folds 
Wegezin: folds 
xxRoseIloveu: folds 
Uncalled bet ($0.01) returned to Kb013497
Kb013497 collected $0.02 from pot
Kb013497: doesn't show hand 
*** SUMMARY ***
Total pot $0.02 | Rake $0 
Seat 1: Wegezin (button) folded before Flop (didn't bet)
Seat 2: xxRoseIloveu (small blind) folded before Flop
Seat 3: Kb013497 (big blind) collected ($0.02)
Seat 4: Denisov V. folded before Flop (didn't bet)
Seat 5: Scaaalll folded before Flop (didn't bet)
Seat 6: NecromiconP folded before Flop (didn't bet)



PokerStars Zoom Hand #229229786056:  Hold'em No Limit ($0.01/$0.02) - 2021/08/21 21:13:50 CET [2021/08/21 15:13:50 ET]
Table 'Halley' 6-max Seat #1 is the button
Seat 1: MyWinCash ($3.89 in chips) 
Seat 2: Scaaalll ($2.57 in chips) 
Seat 3: z3317111711 ($2.13 in chips) 
Seat 4: WithMyWalker ($2.68 in chips) 
Seat 5: valua976 ($4.04 in chips) 
Seat 6: Ferr4r1430 ($2 in chips) 
Scaaalll: posts small blind $0.01
z3317111711: posts big blind $0.02
*** HOLE CARDS ***
Dealt to Scaaalll [8s 9h]
WithMyWalker: folds 
valua976: folds 
Ferr4r1430: raises $0.04 to $0.06
MyWinCash: folds 
Scaaalll: folds 
z3317111711: folds 
Uncalled bet ($0.04) returned to Ferr4r1430
Ferr4r1430 collected $0.05 from pot
Ferr4r1430: doesn't show hand 
*** SUMMARY ***
Total pot $0.05 | Rake $0 
Seat 1: MyWinCash (button) folded before Flop (didn't bet)
Seat 2: Scaaalll (small blind) folded before Flop
Seat 3: z3317111711 (big blind) folded before Flop
Seat 4: WithMyWalker folded before Flop (didn't bet)
Seat 5: valua976 folded before Flop (didn't bet)
Seat 6: Ferr4r1430 collected ($0.05)



PokerStars Zoom Hand #229229782379:  Hold'em No Limit ($0.01/$0.02) - 2021/08/21 21:13:42 CET [2021/08/21 15:13:42 ET]
Table 'Halley' 6-max Seat #1 is the button
Seat 1: csmall14 ($2.83 in chips) 
Seat 2: pphit ($2.19 in chips) 
Seat 3: ser313131 ($2 in chips) 
Seat 4: FabOliveira9 ($2.06 in chips) 
Seat 5: Ferr4r1430 ($2.01 in chips) 
Seat 6: Scaaalll ($2.57 in chips) 
pphit: posts small blind $0.01
ser313131: posts big blind $0.02
*** HOLE CARDS ***
Dealt to Scaaalll [2h 8c]
FabOliveira9: folds 
Ferr4r1430: folds 
Scaaalll: folds 
Ferr4r1430 is disconnected 
csmall14: raises $0.06 to $0.08
pphit: folds 
ser313131: calls $0.06
*** FLOP *** [9c Tc Kc]
ser313131: checks 
csmall14: checks 
*** TURN *** [9c Tc Kc] [Jd]
ser313131: bets $0.08
csmall14: folds 
Uncalled bet ($0.08) returned to ser313131
ser313131 collected $0.16 from pot
ser313131: doesn't show hand 
*** SUMMARY ***
Total pot $0.17 | Rake $0.01 
Board [9c Tc Kc Jd]
Seat 1: csmall14 (button) folded on the Turn
Seat 2: pphit (small blind) folded before Flop
Seat 3: ser313131 (big blind) collected ($0.16)
Seat 4: FabOliveira9 folded before Flop (didn't bet)
Seat 5: Ferr4r1430 folded before Flop (didn't bet)
Seat 6: Scaaalll folded before Flop (didn't bet)



PokerStars Zoom Hand #229229788336:  Hold'em No Limit ($0.01/$0.02) - 2021/08/21 21:13:55 CET [2021/08/21 15:13:55 ET]
Table 'Halley' 6-max Seat #1 is the button
Seat 1: Scaaalll ($2.56 in chips) 
Seat 2: andreydgk ($4.40 in chips) 
Seat 3: Shadi8 ($2.67 in chips) 
Seat 4: BexleyBoy ($5.56 in chips) 
Seat 5: MinimalFunkd ($3.95 in chips) 
Seat 6: gugamoraes ($2.27 in chips) 
andreydgk: posts small blind $0.01
Shadi8: posts big blind $0.02
*** HOLE CARDS ***
Dealt to Scaaalll [7d Ah]
BexleyBoy: folds 
MinimalFunkd: folds 
gugamoraes: folds 
Scaaalll: raises $0.02 to $0.04
andreydgk: folds 
Shadi8: calls $0.02
*** FLOP *** [Ac 8c 3s]
Shadi8: checks 
Scaaalll: bets $0.06
Shadi8: folds 
Uncalled bet ($0.06) returned to Scaaalll
Scaaalll collected $0.09 from pot
Scaaalll: doesn't show hand 
*** SUMMARY ***
Total pot $0.09 | Rake $0 
Board [Ac 8c 3s]
Seat 1: Scaaalll (button) collected ($0.09)
Seat 2: andreydgk (small blind) folded before Flop
Seat 3: Shadi8 (big blind) folded on the Flop
Seat 4: BexleyBoy folded before Flop (didn't bet)
Seat 5: MinimalFunkd folded before Flop (didn't bet)
Seat 6: gugamoraes folded before Flop (didn't bet)



PokerStars Zoom Hand #229229805610:  Hold'em No Limit ($0.01/$0.02) - 2021/08/21 21:14:33 CET [2021/08/21 15:14:33 ET]
Table 'Halley' 6-max Seat #1 is the button
Seat 1: usenovm ($1.97 in chips) 
Seat 2: Kb013497 ($3.32 in chips) 
Seat 3: Scaaalll ($2.61 in chips) 
Seat 4: MinimalFunkd ($3.96 in chips) 
Seat 5: Asdmald ($1 in chips) 
Seat 6: S1fon4o ($0.97 in chips) 
Kb013497: posts small blind $0.01
Scaaalll: posts big blind $0.02
*** HOLE CARDS ***
Dealt to Scaaalll [Ks 8h]
MinimalFunkd: raises $0.04 to $0.06
Asdmald: folds 
S1fon4o: folds 
usenovm: calls $0.06
Kb013497: folds 
Scaaalll: folds 
*** FLOP *** [2h 6s 7s]
MinimalFunkd: bets $0.06
usenovm: raises $0.06 to $0.12
MinimalFunkd: folds 
Uncalled bet ($0.06) returned to usenovm
usenovm collected $0.26 from pot
usenovm: doesn't show hand 
*** SUMMARY ***
Total pot $0.27 | Rake $0.01 
Board [2h 6s 7s]
Seat 1: usenovm (button) collected ($0.26)
Seat 2: Kb013497 (small blind) folded before Flop
Seat 3: Scaaalll (big blind) folded before Flop
Seat 4: MinimalFunkd folded on the Flop
Seat 5: Asdmald folded before Flop (didn't bet)
Seat 6: S1fon4o folded before Flop (didn't bet)



PokerStars Zoom Hand #229229813386:  Hold'em No Limit ($0.01/$0.02) - 2021/08/21 21:14:50 CET [2021/08/21 15:14:50 ET]
Table 'Halley' 6-max Seat #1 is the button
Seat 1: bossquaid ($2 in chips) 
Seat 2: Ferr4r1430 ($2.01 in chips) 
Seat 3: Siyah Horoz ($2.31 in chips) 
Seat 4: HARRY68rus ($1.87 in chips) 
Seat 5: Re_Dreams ($1.70 in chips) 
Seat 6: Scaaalll ($2.59 in chips) 
Ferr4r1430: posts small blind $0.01
Siyah Horoz: posts big blind $0.02
*** HOLE CARDS ***
Dealt to Scaaalll [6s 4d]
HARRY68rus: folds 
Re_Dreams: folds 
Scaaalll: folds 
bossquaid: folds 
Ferr4r1430: raises $0.04 to $0.06
Siyah Horoz: folds 
Uncalled bet ($0.04) returned to Ferr4r1430
Ferr4r1430 collected $0.04 from pot
Ferr4r1430: doesn't show hand 
*** SUMMARY ***
Total pot $0.04 | Rake $0 
Seat 1: bossquaid (button) folded before Flop (didn't bet)
Seat 2: Ferr4r1430 (small blind) collected ($0.04)
Seat 3: Siyah Horoz (big blind) folded before Flop
Seat 4: HARRY68rus folded before Flop (didn't bet)
Seat 5: Re_Dreams folded before Flop (didn't bet)
Seat 6: Scaaalll folded before Flop (didn't bet)



PokerStars Zoom Hand #229229819300:  Hold'em No Limit ($0.01/$0.02) - 2021/08/21 21:15:03 CET [2021/08/21 15:15:03 ET]
Table 'Halley' 6-max Seat #1 is the button
Seat 1: arturtsutsaev ($0.97 in chips) 
Seat 2: no way yo ($1.46 in chips) 
Seat 3: Sergio14b ($3.66 in chips) 
Seat 4: olga3021221 ($3.86 in chips) 
Seat 5: Scaaalll ($2.59 in chips) 
Seat 6: FishOnPlate ($2 in chips) 
no way yo: posts small blind $0.01
Sergio14b: posts big blind $0.02
*** HOLE CARDS ***
Dealt to Scaaalll [6s Qd]
olga3021221: folds 
arturtsutsaev is disconnected 
Scaaalll: folds 
FishOnPlate: folds 
arturtsutsaev: folds 
no way yo: folds 
Uncalled bet ($0.01) returned to Sergio14b
Sergio14b collected $0.02 from pot
Sergio14b: doesn't show hand 
*** SUMMARY ***
Total pot $0.02 | Rake $0 
Seat 1: arturtsutsaev (button) folded before Flop (didn't bet)
Seat 2: no way yo (small blind) folded before Flop
Seat 3: Sergio14b (big blind) collected ($0.02)
Seat 4: olga3021221 folded before Flop (didn't bet)
Seat 5: Scaaalll folded before Flop (didn't bet)
Seat 6: FishOnPlate folded before Flop (didn't bet)



PokerStars Zoom Hand #229229823041:  Hold'em No Limit ($0.01/$0.02) - 2021/08/21 21:15:11 CET [2021/08/21 15:15:11 ET]
Table 'Halley' 6-max Seat #1 is the button
Seat 1: Lacitoo ($2 in chips) 
Seat 2: unior321 ($0.69 in chips) 
Seat 3: keitho211 ($2 in chips) 
Seat 4: Scaaalll ($2.59 in chips) 
Seat 5: TICTAC06017 ($2.25 in chips) 
Seat 6: Swaino21 ($3.43 in chips) 
unior321: posts small blind $0.01
keitho211: posts big blind $0.02
*** HOLE CARDS ***
Dealt to Scaaalll [5s Ks]
Scaaalll: folds 
TICTAC06017: folds 
Swaino21: folds 
Lacitoo: folds 
Lacitoo is disconnected 
unior321: calls $0.01
keitho211: raises $0.08 to $0.10
unior321: folds 
Uncalled bet ($0.08) returned to keitho211
keitho211 collected $0.04 from pot
keitho211: doesn't show hand 
unior321 is disconnected 
*** SUMMARY ***
Total pot $0.04 | Rake $0 
Seat 1: Lacitoo (button) folded before Flop (didn't bet)
Seat 2: unior321 (small blind) folded before Flop
Seat 3: keitho211 (big blind) collected ($0.04)
Seat 4: Scaaalll folded before Flop (didn't bet)
Seat 5: TICTAC06017 folded before Flop (didn't bet)
Seat 6: Swaino21 folded before Flop (didn't bet)



PokerStars Zoom Hand #229229824894:  Hold'em No Limit ($0.01/$0.02) - 2021/08/21 21:15:14 CET [2021/08/21 15:15:14 ET]
Table 'Halley' 6-max Seat #1 is the button
Seat 1: Forest404 ($1.49 in chips) 
Seat 2: Scaaalll ($2.59 in chips) 
Seat 3: Sparrovv ($2.06 in chips) 
Seat 4: Addon289174 ($2.87 in chips) 
Seat 5: SpartanRace1 ($5 in chips) 
Seat 6: skryg93 ($3.41 in chips) 
Scaaalll: posts small blind $0.01
Sparrovv: posts big blind $0.02
*** HOLE CARDS ***
Dealt to Scaaalll [Kd 9s]
Addon289174: folds 
SpartanRace1: raises $0.02 to $0.04
skryg93: folds 
Forest404: folds 
Scaaalll: folds 
Sparrovv: calls $0.02
*** FLOP *** [Ah 8h Ks]
Sparrovv: checks 
SpartanRace1: checks 
*** TURN *** [Ah 8h Ks] [Kh]
Sparrovv: checks 
SpartanRace1: bets $0.07
Sparrovv: folds 
Uncalled bet ($0.07) returned to SpartanRace1
SpartanRace1 collected $0.09 from pot
SpartanRace1: doesn't show hand 
*** SUMMARY ***
Total pot $0.09 | Rake $0 
Board [Ah 8h Ks Kh]
Seat 1: Forest404 (button) folded before Flop (didn't bet)
Seat 2: Scaaalll (small blind) folded before Flop
Seat 3: Sparrovv (big blind) folded on the Turn
Seat 4: Addon289174 folded before Flop (didn't bet)
Seat 5: SpartanRace1 collected ($0.09)
Seat 6: skryg93 folded before Flop (didn't bet)



PokerStars Zoom Hand #229229836358:  Hold'em No Limit ($0.01/$0.02) - 2021/08/21 21:15:40 CET [2021/08/21 15:15:40 ET]
Table 'Halley' 6-max Seat #1 is the button
Seat 1: Scaaalll ($2.56 in chips) 
Seat 2: Kb013497 ($2.92 in chips) 
Seat 3: S.B.O190 ($2.06 in chips) 
Seat 4: Sprot74 ($2 in chips) 
Seat 5: bigthereal ($1.98 in chips) 
Seat 6: Zer0Go ($2 in chips) 
Kb013497: posts small blind $0.01
S.B.O190: posts big blind $0.02
*** HOLE CARDS ***
Dealt to Scaaalll [Jh Tc]
Sprot74: folds 
bigthereal: raises $0.04 to $0.06
Zer0Go: folds 
Scaaalll: folds 
Kb013497: folds 
S.B.O190: folds 
Uncalled bet ($0.04) returned to bigthereal
bigthereal collected $0.05 from pot
bigthereal: doesn't show hand 
*** SUMMARY ***
Total pot $0.05 | Rake $0 
Seat 1: Scaaalll (button) folded before Flop (didn't bet)
Seat 2: Kb013497 (small blind) folded before Flop
Seat 3: S.B.O190 (big blind) folded before Flop
Seat 4: Sprot74 folded before Flop (didn't bet)
Seat 5: bigthereal collected ($0.05)
Seat 6: Zer0Go folded before Flop (didn't bet)



PokerStars Zoom Hand #229229829518:  Hold'em No Limit ($0.01/$0.02) - 2021/08/21 21:15:24 CET [2021/08/21 15:15:24 ET]
Table 'Halley' 6-max Seat #1 is the button
Seat 1: ugi-dugi ($3.19 in chips) 
Seat 2: CASSIE21462 ($1.98 in chips) 
Seat 3: Scaaalll ($2.58 in chips) 
Seat 4: sg.32rus ($1.58 in chips) 
Seat 5: Armando.Bordi ($2 in chips) 
Seat 6: Naraterre1 ($1.64 in chips) 
CASSIE21462: posts small blind $0.01
Scaaalll: posts big blind $0.02
*** HOLE CARDS ***
Dealt to Scaaalll [Ad 8d]
Naraterre1 is disconnected 
sg.32rus: calls $0.02
Armando.Bordi: folds 
Naraterre1: folds 
ugi-dugi: raises $0.06 to $0.08
CASSIE21462: calls $0.07
Scaaalll: folds 
sg.32rus: calls $0.06
*** FLOP *** [Kc 3s 2s]
CASSIE21462: checks 
sg.32rus: checks 
ugi-dugi: bets $0.10
CASSIE21462: calls $0.10
sg.32rus: calls $0.10
*** TURN *** [Kc 3s 2s] [Ac]
CASSIE21462: bets $1.80 and is all-in
sg.32rus: folds 
ugi-dugi: folds 
Uncalled bet ($1.80) returned to CASSIE21462
CASSIE21462 collected $0.54 from pot
CASSIE21462: doesn't show hand 
*** SUMMARY ***
Total pot $0.56 | Rake $0.02 
Board [Kc 3s 2s Ac]
Seat 1: ugi-dugi (button) folded on the Turn
Seat 2: CASSIE21462 (small blind) collected ($0.54)
Seat 3: Scaaalll (big blind) folded before Flop
Seat 4: sg.32rus folded on the Turn
Seat 5: Armando.Bordi folded before Flop (didn't bet)
Seat 6: Naraterre1 folded before Flop (didn't bet)



PokerStars Zoom Hand #229229843305:  Hold'em No Limit ($0.01/$0.02) - 2021/08/21 21:15:54 CET [2021/08/21 15:15:54 ET]
Table 'Halley' 6-max Seat #1 is the button
Seat 1: CrazyyParis ($2.36 in chips) 
Seat 2: Victor151886 ($4.51 in chips) 
Seat 3: estelionat171 ($0.78 in chips) 
Seat 4: sg.32rus ($0.50 in chips) 
Seat 5: Dulli007 ($3.20 in chips) 
Seat 6: Scaaalll ($2.56 in chips) 
Victor151886: posts small blind $0.01
estelionat171: posts big blind $0.02
*** HOLE CARDS ***
Dealt to Scaaalll [8c 3c]
sg.32rus: folds 
Dulli007: folds 
Scaaalll: folds 
CrazyyParis: folds 
Victor151886: folds 
Uncalled bet ($0.01) returned to estelionat171
estelionat171 collected $0.02 from pot
estelionat171: doesn't show hand 
*** SUMMARY ***
Total pot $0.02 | Rake $0 
Seat 1: CrazyyParis (button) folded before Flop (didn't bet)
Seat 2: Victor151886 (small blind) folded before Flop
Seat 3: estelionat171 (big blind) collected ($0.02)
Seat 4: sg.32rus folded before Flop (didn't bet)
Seat 5: Dulli007 folded before Flop (didn't bet)
Seat 6: Scaaalll folded before Flop (didn't bet)



PokerStars Zoom Hand #229229849861:  Hold'em No Limit ($0.01/$0.02) - 2021/08/21 21:16:08 CET [2021/08/21 15:16:08 ET]
Table 'Halley' 6-max Seat #1 is the button
Seat 1: R4DiUS030 ($3.01 in chips) 
Seat 2: In2win26 ($0.80 in chips) 
Seat 3: vladlen101 ($0.99 in chips) 
Seat 4: sorinysu ($0.81 in chips) 
Seat 5: Scaaalll ($2.56 in chips) 
Seat 6: Murphy1693 ($2.03 in chips) 
In2win26: posts small blind $0.01
vladlen101: posts big blind $0.02
*** HOLE CARDS ***
Dealt to Scaaalll [6c 5d]
In2win26 is disconnected 
sorinysu: folds 
Scaaalll: folds 
sorinysu is disconnected 
Murphy1693: raises $0.04 to $0.06
R4DiUS030: folds 
In2win26: folds 
vladlen101: folds 
Uncalled bet ($0.04) returned to Murphy1693
Murphy1693 collected $0.05 from pot
Murphy1693: doesn't show hand 
*** SUMMARY ***
Total pot $0.05 | Rake $0 
Seat 1: R4DiUS030 (button) folded before Flop (didn't bet)
Seat 2: In2win26 (small blind) folded before Flop
Seat 3: vladlen101 (big blind) folded before Flop
Seat 4: sorinysu folded before Flop (didn't bet)
Seat 5: Scaaalll folded before Flop (didn't bet)
Seat 6: Murphy1693 collected ($0.05)



PokerStars Zoom Hand #229229854051:  Hold'em No Limit ($0.01/$0.02) - 2021/08/21 21:16:18 CET [2021/08/21 15:16:18 ET]
Table 'Halley' 6-max Seat #1 is the button
Seat 1: SpartanRace1 ($6.53 in chips) 
Seat 2: Kergie ($2 in chips) 
Seat 3: majo_74 ($2.26 in chips) 
Seat 4: SIGREX ($2.13 in chips) 
Seat 5: vicctorlf ($1.16 in chips) 
Seat 6: Scaaalll ($2.56 in chips) 
Kergie: posts small blind $0.01
majo_74: posts big blind $0.02
*** HOLE CARDS ***
Dealt to Scaaalll [2s Th]
SIGREX: raises $0.02 to $0.04
vicctorlf: folds 
Scaaalll: folds 
SpartanRace1: folds 
Kergie: raises $1.96 to $2 and is all-in
majo_74: folds 
SIGREX: folds 
Uncalled bet ($1.96) returned to Kergie
Kergie collected $0.10 from pot
Kergie: doesn't show hand 
*** SUMMARY ***
Total pot $0.10 | Rake $0 
Seat 1: SpartanRace1 (button) folded before Flop (didn't bet)
Seat 2: Kergie (small blind) collected ($0.10)
Seat 3: majo_74 (big blind) folded before Flop
Seat 4: SIGREX folded before Flop
Seat 5: vicctorlf folded before Flop (didn't bet)
Seat 6: Scaaalll folded before Flop (didn't bet)



PokerStars Zoom Hand #229229851752:  Hold'em No Limit ($0.01/$0.02) - 2021/08/21 21:16:12 CET [2021/08/21 15:16:12 ET]
Table 'Halley' 6-max Seat #1 is the button
Seat 1: ARTMVSLV ($2.32 in chips) 
Seat 2: 78joniboy ($2.64 in chips) 
Seat 3: gugamoraes ($2.35 in chips) 
Seat 4: Scaaalll ($2.56 in chips) 
Seat 5: SIGREX ($2.13 in chips) 
Seat 6: GoldenRabbit1 ($1.70 in chips) 
78joniboy: posts small blind $0.01
gugamoraes: posts big blind $0.02
*** HOLE CARDS ***
Dealt to Scaaalll [9d 7c]
Scaaalll: folds 
SIGREX: folds 
GoldenRabbit1 has timed out
GoldenRabbit1: folds 
ARTMVSLV: folds 
78joniboy: folds 
Uncalled bet ($0.01) returned to gugamoraes
gugamoraes collected $0.02 from pot
gugamoraes: doesn't show hand 
*** SUMMARY ***
Total pot $0.02 | Rake $0 
Seat 1: ARTMVSLV (button) folded before Flop (didn't bet)
Seat 2: 78joniboy (small blind) folded before Flop
Seat 3: gugamoraes (big blind) collected ($0.02)
Seat 4: Scaaalll folded before Flop (didn't bet)
Seat 5: SIGREX folded before Flop (didn't bet)
Seat 6: GoldenRabbit1 folded before Flop (didn't bet)



PokerStars Zoom Hand #229229860574:  Hold'em No Limit ($0.01/$0.02) - 2021/08/21 21:16:31 CET [2021/08/21 15:16:31 ET]
Table 'Halley' 6-max Seat #1 is the button
Seat 1: Babis97 ($1.18 in chips) 
Seat 2: 77omsk ($5.97 in chips) 
Seat 3: KKARMELO ($2.18 in chips) 
Seat 4: Scaaalll ($2.55 in chips) 
Seat 5: *88VIC88* ($0.76 in chips) 
Seat 6: Alex Koshva1 ($2.34 in chips) 
77omsk: posts small blind $0.01
KKARMELO: posts big blind $0.02
*** HOLE CARDS ***
Dealt to Scaaalll [9d Qs]
Scaaalll: folds 
*88VIC88*: folds 
Alex Koshva1: folds 
Babis97: folds 
77omsk: folds 
Uncalled bet ($0.01) returned to KKARMELO
KKARMELO collected $0.02 from pot
KKARMELO: doesn't show hand 
*** SUMMARY ***
Total pot $0.02 | Rake $0 
Seat 1: Babis97 (button) folded before Flop (didn't bet)
Seat 2: 77omsk (small blind) folded before Flop
Seat 3: KKARMELO (big blind) collected ($0.02)
Seat 4: Scaaalll folded before Flop (didn't bet)
Seat 5: *88VIC88* folded before Flop (didn't bet)
Seat 6: Alex Koshva1 folded before Flop (didn't bet)



PokerStars Zoom Hand #229229863857:  Hold'em No Limit ($0.01/$0.02) - 2021/08/21 21:16:38 CET [2021/08/21 15:16:38 ET]
Table 'Halley' 6-max Seat #1 is the button
Seat 1: Scaaalll ($2.55 in chips) 
Seat 2: Grama480 ($2.04 in chips) 
Seat 3: ARTMVSLV ($2.32 in chips) 
Seat 4: Zhyla95 ($1.99 in chips) 
Seat 5: arturtsutsaev ($1.17 in chips) 
Seat 6: asport4 ($0.84 in chips) 
Grama480: posts small blind $0.01
ARTMVSLV: posts big blind $0.02
*** HOLE CARDS ***
Dealt to Scaaalll [4c 2c]
Zhyla95: folds 
arturtsutsaev: raises $0.04 to $0.06
asport4: folds 
Scaaalll: folds 
Grama480: folds 
ARTMVSLV: folds 
Uncalled bet ($0.04) returned to arturtsutsaev
arturtsutsaev collected $0.05 from pot
arturtsutsaev: doesn't show hand 
*** SUMMARY ***
Total pot $0.05 | Rake $0 
Seat 1: Scaaalll (button) folded before Flop (didn't bet)
Seat 2: Grama480 (small blind) folded before Flop
Seat 3: ARTMVSLV (big blind) folded before Flop
Seat 4: Zhyla95 folded before Flop (didn't bet)
Seat 5: arturtsutsaev collected ($0.05)
Seat 6: asport4 folded before Flop (didn't bet)



PokerStars Zoom Hand #229229858218:  Hold'em No Limit ($0.01/$0.02) - 2021/08/21 21:16:26 CET [2021/08/21 15:16:26 ET]
Table 'Halley' 6-max Seat #1 is the button
Seat 1: kwant33 ($3.69 in chips) 
Seat 2: Scaaalll ($2.56 in chips) 
Seat 3: FabOliveira9 ($2.10 in chips) 
Seat 4: irie-singer ($2.72 in chips) 
Seat 5: yositoas ($4.64 in chips) 
Seat 6: Flankeris ($3.14 in chips) 
Scaaalll: posts small blind $0.01
FabOliveira9: posts big blind $0.02
*** HOLE CARDS ***
Dealt to Scaaalll [8s 6d]
irie-singer: folds 
yositoas: folds 
Flankeris: folds 
kwant33: raises $0.04 to $0.06
Scaaalll: folds 
FabOliveira9: calls $0.04
*** FLOP *** [2d 7c 3h]
FabOliveira9: checks 
kwant33: bets $0.09
FabOliveira9: folds 
Uncalled bet ($0.09) returned to kwant33
kwant33 collected $0.13 from pot
kwant33: doesn't show hand 
*** SUMMARY ***
Total pot $0.13 | Rake $0 
Board [2d 7c 3h]
Seat 1: kwant33 (button) collected ($0.13)
Seat 2: Scaaalll (small blind) folded before Flop
Seat 3: FabOliveira9 (big blind) folded on the Flop
Seat 4: irie-singer folded before Flop (didn't bet)
Seat 5: yositoas folded before Flop (didn't bet)
Seat 6: Flankeris folded before Flop (didn't bet)



PokerStars Zoom Hand #229229868997:  Hold'em No Limit ($0.01/$0.02) - 2021/08/21 21:16:49 CET [2021/08/21 15:16:49 ET]
Table 'Halley' 6-max Seat #1 is the button
Seat 1: Sharabora ($1.07 in chips) 
Seat 2: Haraldo550 ($1.91 in chips) 
Seat 3: Scaaalll ($2.55 in chips) 
Seat 4: fabor1303 ($3.55 in chips) 
Seat 5: Finderra ($1.99 in chips) 
Seat 6: Xlavariable ($2.50 in chips) 
Haraldo550: posts small blind $0.01
Scaaalll: posts big blind $0.02
*** HOLE CARDS ***
Dealt to Scaaalll [4s 2s]
fabor1303: folds 
Finderra: folds 
Xlavariable: raises $0.04 to $0.06
Sharabora: folds 
Haraldo550: folds 
Haraldo550 is disconnected 
Scaaalll: folds 
Uncalled bet ($0.04) returned to Xlavariable
Xlavariable collected $0.05 from pot
Xlavariable: doesn't show hand 
*** SUMMARY ***
Total pot $0.05 | Rake $0 
Seat 1: Sharabora (button) folded before Flop (didn't bet)
Seat 2: Haraldo550 (small blind) folded before Flop
Seat 3: Scaaalll (big blind) folded before Flop
Seat 4: fabor1303 folded before Flop (didn't bet)
Seat 5: Finderra folded before Flop (didn't bet)
Seat 6: Xlavariable collected ($0.05)



PokerStars Zoom Hand #229229880144:  Hold'em No Limit ($0.01/$0.02) - 2021/08/21 21:17:13 CET [2021/08/21 15:17:13 ET]
Table 'Halley' 6-max Seat #1 is the button
Seat 1: fabor1303 ($2.62 in chips) 
Seat 2: Scaaalll ($2.53 in chips) 
Seat 3: GoldenRabbit1 ($1.69 in chips) 
Seat 4: ggGoldenPunk ($1.25 in chips) 
Seat 5: Nihility77 ($2.16 in chips) 
Seat 6: HellNative ($4.48 in chips) 
Scaaalll: posts small blind $0.01
GoldenRabbit1: posts big blind $0.02
*** HOLE CARDS ***
Dealt to Scaaalll [3s 5d]
ggGoldenPunk: folds 
Nihility77: folds 
HellNative: folds 
fabor1303: folds 
Scaaalll: folds 
Uncalled bet ($0.01) returned to GoldenRabbit1
GoldenRabbit1 collected $0.02 from pot
GoldenRabbit1: doesn't show hand 
*** SUMMARY ***
Total pot $0.02 | Rake $0 
Seat 1: fabor1303 (button) folded before Flop (didn't bet)
Seat 2: Scaaalll (small blind) folded before Flop
Seat 3: GoldenRabbit1 (big blind) collected ($0.02)
Seat 4: ggGoldenPunk folded before Flop (didn't bet)
Seat 5: Nihility77 folded before Flop (didn't bet)
Seat 6: HellNative folded before Flop (didn't bet)



PokerStars Zoom Hand #229229885817:  Hold'em No Limit ($0.01/$0.02) - 2021/08/21 21:17:25 CET [2021/08/21 15:17:25 ET]
Table 'Halley' 6-max Seat #1 is the button
Seat 1: keldh ($2.05 in chips) 
Seat 2: olga3021221 ($3.88 in chips) 
Seat 3: Fedor_Gar ($2.65 in chips) 
Seat 4: 78joniboy ($2 in chips) 
Seat 5: teutonknight ($2.05 in chips) 
Seat 6: Scaaalll ($2.52 in chips) 
olga3021221: posts small blind $0.01
Fedor_Gar: posts big blind $0.02
*** HOLE CARDS ***
Dealt to Scaaalll [Jc 6s]
78joniboy: folds 
teutonknight: raises $0.05 to $0.07
Scaaalll: folds 
keldh: folds 
olga3021221: folds 
Fedor_Gar: folds 
Uncalled bet ($0.05) returned to teutonknight
teutonknight collected $0.05 from pot
teutonknight: doesn't show hand 
*** SUMMARY ***
Total pot $0.05 | Rake $0 
Seat 1: keldh (button) folded before Flop (didn't bet)
Seat 2: olga3021221 (small blind) folded before Flop
Seat 3: Fedor_Gar (big blind) folded before Flop
Seat 4: 78joniboy folded before Flop (didn't bet)
Seat 5: teutonknight collected ($0.05)
Seat 6: Scaaalll folded before Flop (didn't bet)



PokerStars Zoom Hand #229229887651:  Hold'em No Limit ($0.01/$0.02) - 2021/08/21 21:17:29 CET [2021/08/21 15:17:29 ET]
Table 'Halley' 6-max Seat #1 is the button
Seat 1: emte1kaa ($4.08 in chips) 
Seat 2: syndikkat ($2.05 in chips) 
Seat 3: Saint_ANBU ($2 in chips) 
Seat 4: arsad725 ($8.18 in chips) 
Seat 5: Scaaalll ($2.52 in chips) 
Seat 6: Oprichnick90 ($5.42 in chips) 
syndikkat: posts small blind $0.01
Saint_ANBU: posts big blind $0.02
*** HOLE CARDS ***
Dealt to Scaaalll [5h Qh]
arsad725: folds 
Scaaalll: folds 
Oprichnick90: raises $0.03 to $0.05
emte1kaa: folds 
syndikkat: raises $0.13 to $0.18
Saint_ANBU: folds 
Oprichnick90: calls $0.13
*** FLOP *** [6c Qd Ah]
syndikkat: bets $0.14
Oprichnick90: folds 
Uncalled bet ($0.14) returned to syndikkat
syndikkat collected $0.37 from pot
syndikkat: doesn't show hand 
*** SUMMARY ***
Total pot $0.38 | Rake $0.01 
Board [6c Qd Ah]
Seat 1: emte1kaa (button) folded before Flop (didn't bet)
Seat 2: syndikkat (small blind) collected ($0.37)
Seat 3: Saint_ANBU (big blind) folded before Flop
Seat 4: arsad725 folded before Flop (didn't bet)
Seat 5: Scaaalll folded before Flop (didn't bet)
Seat 6: Oprichnick90 folded on the Flop



PokerStars Zoom Hand #229229889952:  Hold'em No Limit ($0.01/$0.02) - 2021/08/21 21:17:34 CET [2021/08/21 15:17:34 ET]
Table 'Halley' 6-max Seat #1 is the button
Seat 1: Scaaalll ($2.52 in chips) 
Seat 2: vicctorlf ($1.13 in chips) 
Seat 3: IWMTW ($1.47 in chips) 
Seat 4: leedsrounder ($3.67 in chips) 
Seat 5: keitho211 ($2.20 in chips) 
Seat 6: kodart ($1.36 in chips) 
vicctorlf: posts small blind $0.01
IWMTW: posts big blind $0.02
*** HOLE CARDS ***
Dealt to Scaaalll [3h 4s]
leedsrounder: folds 
keitho211: folds 
kodart: folds 
Scaaalll: folds 
vicctorlf: raises $0.04 to $0.06
IWMTW: calls $0.04
*** FLOP *** [Jc Ad 9c]
vicctorlf: bets $0.12
IWMTW: calls $0.12
*** TURN *** [Jc Ad 9c] [7d]
vicctorlf: checks 
IWMTW: checks 
*** RIVER *** [Jc Ad 9c 7d] [6h]
vicctorlf: bets $0.18
IWMTW: calls $0.18
*** SHOW DOWN ***
vicctorlf: shows [Qh Js] (a pair of Jacks)
IWMTW: shows [As 8c] (a pair of Aces)
IWMTW collected $0.69 from pot
*** SUMMARY ***
Total pot $0.72 | Rake $0.03 
Board [Jc Ad 9c 7d 6h]
Seat 1: Scaaalll (button) folded before Flop (didn't bet)
Seat 2: vicctorlf (small blind) showed [Qh Js] and lost with a pair of Jacks
Seat 3: IWMTW (big blind) showed [As 8c] and won ($0.69) with a pair of Aces
Seat 4: leedsrounder folded before Flop (didn't bet)
Seat 5: keitho211 folded before Flop (didn't bet)
Seat 6: kodart folded before Flop (didn't bet)



PokerStars Zoom Hand #229229891826:  Hold'em No Limit ($0.01/$0.02) - 2021/08/21 21:17:38 CET [2021/08/21 15:17:38 ET]
Table 'Halley' 6-max Seat #1 is the button
Seat 1: Sergio14b ($3.74 in chips) 
Seat 2: Pechorin.G ($2.13 in chips) 
Seat 3: 77omsk ($6.19 in chips) 
Seat 4: Siyah Horoz ($2.23 in chips) 
Seat 5: Scaaalll ($2.52 in chips) 
Seat 6: ffffj ($3.56 in chips) 
Pechorin.G: posts small blind $0.01
77omsk: posts big blind $0.02
*** HOLE CARDS ***
Dealt to Scaaalll [Jd Ks]
Siyah Horoz: folds 
Scaaalll: raises $0.04 to $0.06
ffffj: folds 
Sergio14b: folds 
Pechorin.G: raises $0.18 to $0.24
77omsk: folds 
Scaaalll: folds 
Uncalled bet ($0.18) returned to Pechorin.G
Pechorin.G collected $0.14 from pot
Pechorin.G: doesn't show hand 
*** SUMMARY ***
Total pot $0.14 | Rake $0 
Seat 1: Sergio14b (button) folded before Flop (didn't bet)
Seat 2: Pechorin.G (small blind) collected ($0.14)
Seat 3: 77omsk (big blind) folded before Flop
Seat 4: Siyah Horoz folded before Flop (didn't bet)
Seat 5: Scaaalll folded before Flop
Seat 6: ffffj folded before Flop (didn't bet)



PokerStars Zoom Hand #229229914796:  Hold'em No Limit ($0.01/$0.02) - 2021/08/21 21:18:11 CET [2021/08/21 15:18:11 ET]
Table 'Halley' 6-max Seat #1 is the button
Seat 1: DURO.RIVAL ($2 in chips) 
Seat 2: Mad_Clock ($3.36 in chips) 
Seat 3: Scaaalll ($2.46 in chips) 
Seat 4: egroj1700 ($2 in chips) 
Seat 5: CordiPS ($4.61 in chips) 
Seat 6: SIGREX ($2 in chips) 
Mad_Clock: posts small blind $0.01
Scaaalll: posts big blind $0.02
*** HOLE CARDS ***
Dealt to Scaaalll [5d Kh]
egroj1700: folds 
CordiPS: folds 
SIGREX: folds 
DURO.RIVAL: folds 
Mad_Clock: folds 
Uncalled bet ($0.01) returned to Scaaalll
Scaaalll collected $0.02 from pot
Scaaalll: doesn't show hand 
*** SUMMARY ***
Total pot $0.02 | Rake $0 
Seat 1: DURO.RIVAL (button) folded before Flop (didn't bet)
Seat 2: Mad_Clock (small blind) folded before Flop
Seat 3: Scaaalll (big blind) collected ($0.02)
Seat 4: egroj1700 folded before Flop (didn't bet)
Seat 5: CordiPS folded before Flop (didn't bet)
Seat 6: SIGREX folded before Flop (didn't bet)



PokerStars Zoom Hand #229229931163:  Hold'em No Limit ($0.01/$0.02) - 2021/08/21 21:18:25 CET [2021/08/21 15:18:25 ET]
Table 'Halley' 6-max Seat #1 is the button
Seat 1: gepard35 ($2 in chips) 
Seat 2: Scaaalll ($2.47 in chips) 
Seat 3: Sergio14b ($3.74 in chips) 
Seat 4: Gerar NB ($2.14 in chips) 
Seat 5: 2m4m4 ($1.49 in chips) 
Seat 6: Hallyson_23 ($2.02 in chips) 
Scaaalll: posts small blind $0.01
Sergio14b: posts big blind $0.02
*** HOLE CARDS ***
Dealt to Scaaalll [9d Kh]
Gerar NB: folds 
2m4m4: raises $0.03 to $0.05
Hallyson_23: folds 
gepard35: folds 
Scaaalll: folds 
Sergio14b: folds 
Uncalled bet ($0.03) returned to 2m4m4
2m4m4 collected $0.05 from pot
2m4m4: doesn't show hand 
*** SUMMARY ***
Total pot $0.05 | Rake $0 
Seat 1: gepard35 (button) folded before Flop (didn't bet)
Seat 2: Scaaalll (small blind) folded before Flop
Seat 3: Sergio14b (big blind) folded before Flop
Seat 4: Gerar NB folded before Flop (didn't bet)
Seat 5: 2m4m4 collected ($0.05)
Seat 6: Hallyson_23 folded before Flop (didn't bet)



PokerStars Zoom Hand #229229911129:  Hold'em No Limit ($0.01/$0.02) - 2021/08/21 21:18:03 CET [2021/08/21 15:18:03 ET]
Table 'Halley' 6-max Seat #1 is the button
Seat 1: Denisov V. ($1.03 in chips) 
Seat 2: Sprot74 ($2.31 in chips) 
Seat 3: Quad Jacks21 ($2.66 in chips) 
Seat 4: Scaaalll ($2.46 in chips) 
Seat 5: emte1kaa ($1.84 in chips) 
Seat 6: Naraterre1 ($1.71 in chips) 
Sprot74: posts small blind $0.01
Quad Jacks21: posts big blind $0.02
*** HOLE CARDS ***
Dealt to Scaaalll [Qs 2d]
Naraterre1 is disconnected 
Denisov V. is disconnected 
Scaaalll: folds 
emte1kaa: folds 
Naraterre1: folds 
Denisov V.: folds 
Sprot74: raises $0.03 to $0.05
Quad Jacks21: calls $0.03
*** FLOP *** [Th 5c Td]
Sprot74: checks 
Quad Jacks21: bets $0.06
Sprot74: calls $0.06
*** TURN *** [Th 5c Td] [8d]
Sprot74: checks 
Quad Jacks21: bets $0.16
Sprot74: calls $0.16
*** RIVER *** [Th 5c Td 8d] [9h]
Sprot74: checks 
Quad Jacks21: checks 
*** SHOW DOWN ***
Sprot74: shows [Tc Jh] (three of a kind, Tens)
Quad Jacks21: mucks hand 
Sprot74 collected $0.52 from pot
*** SUMMARY ***
Total pot $0.54 | Rake $0.02 
Board [Th 5c Td 8d 9h]
Seat 1: Denisov V. (button) folded before Flop (didn't bet)
Seat 2: Sprot74 (small blind) showed [Tc Jh] and won ($0.52) with three of a kind, Tens
Seat 3: Quad Jacks21 (big blind) mucked [9d Qh]
Seat 4: Scaaalll folded before Flop (didn't bet)
Seat 5: emte1kaa folded before Flop (didn't bet)
Seat 6: Naraterre1 folded before Flop (didn't bet)



PokerStars Zoom Hand #229229937216:  Hold'em No Limit ($0.01/$0.02) - 2021/08/21 21:18:38 CET [2021/08/21 15:18:38 ET]
Table 'Halley' 6-max Seat #1 is the button
Seat 1: Scaaalll ($2.46 in chips) 
Seat 2: SideshowPen ($2.55 in chips) 
Seat 3: RChinenov ($2 in chips) 
Seat 4: hartssss ($3.52 in chips) 
Seat 5: PapiMik3 ($2 in chips) 
Seat 6: volf55321 ($1.88 in chips) 
SideshowPen: posts small blind $0.01
RChinenov: posts big blind $0.02
*** HOLE CARDS ***
Dealt to Scaaalll [2h 9h]
hartssss: raises $0.04 to $0.06
volf55321 is disconnected 
PapiMik3: folds 
volf55321: folds 
Scaaalll: folds 
SideshowPen: folds 
RChinenov: folds 
Uncalled bet ($0.04) returned to hartssss
hartssss collected $0.05 from pot
hartssss: doesn't show hand 
*** SUMMARY ***
Total pot $0.05 | Rake $0 
Seat 1: Scaaalll (button) folded before Flop (didn't bet)
Seat 2: SideshowPen (small blind) folded before Flop
Seat 3: RChinenov (big blind) folded before Flop
Seat 4: hartssss collected ($0.05)
Seat 5: PapiMik3 folded before Flop (didn't bet)
Seat 6: volf55321 folded before Flop (didn't bet)



PokerStars Zoom Hand #229229939996:  Hold'em No Limit ($0.01/$0.02) - 2021/08/21 21:18:44 CET [2021/08/21 15:18:44 ET]
Table 'Halley' 6-max Seat #1 is the button
Seat 1: Quantum771 ($2.43 in chips) 
Seat 2: agusdecarca ($5.83 in chips) 
Seat 3: Scaaalll ($2.46 in chips) 
Seat 4: le_vlimeux ($5.22 in chips) 
Seat 5: Laonikos ($3.14 in chips) 
Seat 6: PapiMik3 ($2 in chips) 
agusdecarca: posts small blind $0.01
Scaaalll: posts big blind $0.02
*** HOLE CARDS ***
Dealt to Scaaalll [7h 8d]
le_vlimeux: folds 
Laonikos: folds 
PapiMik3: folds 
Quantum771: raises $0.03 to $0.05
agusdecarca: folds 
Scaaalll: folds 
Uncalled bet ($0.03) returned to Quantum771
Quantum771 collected $0.05 from pot
Quantum771: doesn't show hand 
*** SUMMARY ***
Total pot $0.05 | Rake $0 
Seat 1: Quantum771 (button) collected ($0.05)
Seat 2: agusdecarca (small blind) folded before Flop
Seat 3: Scaaalll (big blind) folded before Flop
Seat 4: le_vlimeux folded before Flop (didn't bet)
Seat 5: Laonikos folded before Flop (didn't bet)
Seat 6: PapiMik3 folded before Flop (didn't bet)



PokerStars Zoom Hand #229229945123:  Hold'em No Limit ($0.01/$0.02) - 2021/08/21 21:18:55 CET [2021/08/21 15:18:55 ET]
Table 'Halley' 6-max Seat #1 is the button
Seat 1: bigbaddaddy9 ($3.75 in chips) 
Seat 2: HellNative ($2.69 in chips) 
Seat 3: nodtress ($2.26 in chips) 
Seat 4: sg.32rus ($0.48 in chips) 
Seat 5: pavlo590 ($2.04 in chips) 
Seat 6: Scaaalll ($2.44 in chips) 
HellNative: posts small blind $0.01
nodtress: posts big blind $0.02
*** HOLE CARDS ***
Dealt to Scaaalll [Ah 2d]
sg.32rus: folds 
pavlo590: folds 
Scaaalll: folds 
pavlo590 is disconnected 
bigbaddaddy9: raises $0.06 to $0.08
HellNative: folds 
nodtress: folds 
Uncalled bet ($0.06) returned to bigbaddaddy9
bigbaddaddy9 collected $0.05 from pot
bigbaddaddy9: doesn't show hand 
*** SUMMARY ***
Total pot $0.05 | Rake $0 
Seat 1: bigbaddaddy9 (button) collected ($0.05)
Seat 2: HellNative (small blind) folded before Flop
Seat 3: nodtress (big blind) folded before Flop
Seat 4: sg.32rus folded before Flop (didn't bet)
Seat 5: pavlo590 folded before Flop (didn't bet)
Seat 6: Scaaalll folded before Flop (didn't bet)



PokerStars Zoom Hand #229229955917:  Hold'em No Limit ($0.01/$0.02) - 2021/08/21 21:19:18 CET [2021/08/21 15:19:18 ET]
Table 'Halley' 6-max Seat #1 is the button
Seat 1: Scaaalll ($2.44 in chips) 
Seat 2: MrsMugda ($1.56 in chips) 
Seat 3: Stormzilla ($2 in chips) 
Seat 4: drwal286 ($4.31 in chips) 
Seat 5: dorro61966 ($0.87 in chips) 
Seat 6: Freiflug66 ($2.08 in chips) 
MrsMugda: posts small blind $0.01
Stormzilla: posts big blind $0.02
*** HOLE CARDS ***
Dealt to Scaaalll [Td 5s]
drwal286: raises $0.02 to $0.04
dorro61966: folds 
Freiflug66: folds 
Scaaalll: folds 
MrsMugda: folds 
Stormzilla: folds 
Uncalled bet ($0.02) returned to drwal286
drwal286 collected $0.05 from pot
drwal286: doesn't show hand 
*** SUMMARY ***
Total pot $0.05 | Rake $0 
Seat 1: Scaaalll (button) folded before Flop (didn't bet)
Seat 2: MrsMugda (small blind) folded before Flop
Seat 3: Stormzilla (big blind) folded before Flop
Seat 4: drwal286 collected ($0.05)
Seat 5: dorro61966 folded before Flop (didn't bet)
Seat 6: Freiflug66 folded before Flop (didn't bet)



PokerStars Zoom Hand #229229947922:  Hold'em No Limit ($0.01/$0.02) - 2021/08/21 21:19:01 CET [2021/08/21 15:19:01 ET]
Table 'Halley' 6-max Seat #1 is the button
Seat 1: ash1448 ($10.23 in chips) 
Seat 2: jolisabe ($1.98 in chips) 
Seat 3: iPitbull1 ($2.26 in chips) 
Seat 4: Rooster26396 ($1.54 in chips) 
Seat 5: Scaaalll ($2.44 in chips) 
Seat 6: Kkamm ($2 in chips) 
jolisabe: posts small blind $0.01
iPitbull1: posts big blind $0.02
*** HOLE CARDS ***
Dealt to Scaaalll [Jd 3c]
Rooster26396: calls $0.02
Scaaalll: folds 
Kkamm: folds 
ash1448: folds 
jolisabe: raises $0.02 to $0.04
iPitbull1: folds 
Rooster26396: calls $0.02
*** FLOP *** [Qc 3s Js]
jolisabe: bets $0.03
Rooster26396: calls $0.03
*** TURN *** [Qc 3s Js] [5d]
jolisabe: checks 
Rooster26396: checks 
*** RIVER *** [Qc 3s Js 5d] [8d]
jolisabe: checks 
Rooster26396: bets $0.10
jolisabe: calls $0.10
*** SHOW DOWN ***
Rooster26396: shows [Qh Kh] (a pair of Queens)
jolisabe: mucks hand 
Rooster26396 collected $0.35 from pot
*** SUMMARY ***
Total pot $0.36 | Rake $0.01 
Board [Qc 3s Js 5d 8d]
Seat 1: ash1448 (button) folded before Flop (didn't bet)
Seat 2: jolisabe (small blind) mucked [As 7h]
Seat 3: iPitbull1 (big blind) folded before Flop
Seat 4: Rooster26396 showed [Qh Kh] and won ($0.35) with a pair of Queens
Seat 5: Scaaalll folded before Flop (didn't bet)
Seat 6: Kkamm folded before Flop (didn't bet)



PokerStars Zoom Hand #229229952680:  Hold'em No Limit ($0.01/$0.02) - 2021/08/21 21:19:11 CET [2021/08/21 15:19:11 ET]
Table 'Halley' 6-max Seat #1 is the button
Seat 1: Naraterre1 ($1.61 in chips) 
Seat 2: rodrigoasor ($1.53 in chips) 
Seat 3: S.B.O190 ($17.34 in chips) 
Seat 4: Scaaalll ($2.44 in chips) 
Seat 5: JCharrod ($2.66 in chips) 
Seat 6: causavera ($2.02 in chips) 
rodrigoasor: posts small blind $0.01
S.B.O190: posts big blind $0.02
*** HOLE CARDS ***
Dealt to Scaaalll [2s Js]
Scaaalll: folds 
JCharrod: raises $0.05 to $0.07
causavera: folds 
Naraterre1: calls $0.07
rodrigoasor: folds 
S.B.O190: calls $0.05
*** FLOP *** [9c Qh 4c]
S.B.O190: checks 
JCharrod: bets $0.15
Naraterre1: raises $0.33 to $0.48
S.B.O190: folds 
JCharrod: calls $0.33
*** TURN *** [9c Qh 4c] [8s]
JCharrod: checks 
Naraterre1: bets $1.06 and is all-in
JCharrod: folds 
Uncalled bet ($1.06) returned to Naraterre1
Naraterre1 collected $1.14 from pot
Naraterre1: doesn't show hand 
*** SUMMARY ***
Total pot $1.18 | Rake $0.04 
Board [9c Qh 4c 8s]
Seat 1: Naraterre1 (button) collected ($1.14)
Seat 2: rodrigoasor (small blind) folded before Flop
Seat 3: S.B.O190 (big blind) folded on the Flop
Seat 4: Scaaalll folded before Flop (didn't bet)
Seat 5: JCharrod folded on the Turn
Seat 6: causavera folded before Flop (didn't bet)



PokerStars Zoom Hand #229229957739:  Hold'em No Limit ($0.01/$0.02) - 2021/08/21 21:19:23 CET [2021/08/21 15:19:23 ET]
Table 'Halley' 6-max Seat #1 is the button
Seat 1: Ogni ($5.95 in chips) 
Seat 2: Scaaalll ($2.44 in chips) 
Seat 3: skatocharlie ($3.39 in chips) 
Seat 4: Xlavariable ($3.08 in chips) 
Seat 5: le_vlimeux ($5.22 in chips) 
Seat 6: aenehev ($5.35 in chips) 
Scaaalll: posts small blind $0.01
skatocharlie: posts big blind $0.02
*** HOLE CARDS ***
Dealt to Scaaalll [6c 3h]
Xlavariable: raises $0.04 to $0.06
le_vlimeux: folds 
aenehev: calls $0.06
Ogni: folds 
Scaaalll: folds 
skatocharlie: folds 
*** FLOP *** [7c Ts 4d]
Xlavariable: checks 
aenehev: checks 
*** TURN *** [7c Ts 4d] [Qh]
Xlavariable: bets $0.04
aenehev: raises $0.04 to $0.08
Xlavariable: calls $0.04
*** RIVER *** [7c Ts 4d Qh] [2d]
Xlavariable: checks 
aenehev: bets $0.15
Xlavariable: folds 
Uncalled bet ($0.15) returned to aenehev
aenehev collected $0.30 from pot
aenehev: doesn't show hand 
*** SUMMARY ***
Total pot $0.31 | Rake $0.01 
Board [7c Ts 4d Qh 2d]
Seat 1: Ogni (button) folded before Flop (didn't bet)
Seat 2: Scaaalll (small blind) folded before Flop
Seat 3: skatocharlie (big blind) folded before Flop
Seat 4: Xlavariable folded on the River
Seat 5: le_vlimeux folded before Flop (didn't bet)
Seat 6: aenehev collected ($0.30)



PokerStars Zoom Hand #229229959597:  Hold'em No Limit ($0.01/$0.02) - 2021/08/21 21:19:26 CET [2021/08/21 15:19:26 ET]
Table 'Halley' 6-max Seat #1 is the button
Seat 1: ser313131 ($2.18 in chips) 
Seat 2: 78joniboy ($3.17 in chips) 
Seat 3: Gerar NB ($3.58 in chips) 
Seat 4: ffffj ($3.47 in chips) 
Seat 5: L00TS254 ($3.13 in chips) 
Seat 6: Scaaalll ($2.43 in chips) 
78joniboy: posts small blind $0.01
Gerar NB: posts big blind $0.02
*** HOLE CARDS ***
Dealt to Scaaalll [Jh Kc]
ffffj: raises $0.02 to $0.04
L00TS254: folds 
Scaaalll: calls $0.04
ser313131: folds 
78joniboy: calls $0.03
Gerar NB: calls $0.02
*** FLOP *** [4d Tc Ah]
78joniboy: checks 
Gerar NB: checks 
ffffj: checks 
Scaaalll: checks 
*** TURN *** [4d Tc Ah] [8c]
78joniboy: checks 
Gerar NB: bets $0.15
ffffj: folds 
Scaaalll: folds 
78joniboy: folds 
Uncalled bet ($0.15) returned to Gerar NB
Gerar NB collected $0.15 from pot
Gerar NB: doesn't show hand 
*** SUMMARY ***
Total pot $0.16 | Rake $0.01 
Board [4d Tc Ah 8c]
Seat 1: ser313131 (button) folded before Flop (didn't bet)
Seat 2: 78joniboy (small blind) folded on the Turn
Seat 3: Gerar NB (big blind) collected ($0.15)
Seat 4: ffffj folded on the Turn
Seat 5: L00TS254 folded before Flop (didn't bet)
Seat 6: Scaaalll folded on the Turn



PokerStars Zoom Hand #229229983184:  Hold'em No Limit ($0.01/$0.02) - 2021/08/21 21:20:17 CET [2021/08/21 15:20:17 ET]
Table 'Halley' 6-max Seat #1 is the button
Seat 1: HellNative ($2.77 in chips) 
Seat 2: iPitbull1 ($2.44 in chips) 
Seat 3: Goose Of Poker ($2.86 in chips) 
Seat 4: Scaaalll ($2.39 in chips) 
Seat 5: arsad725 ($7.02 in chips) 
Seat 6: S.B.O190 ($17.27 in chips) 
iPitbull1: posts small blind $0.01
Goose Of Poker: posts big blind $0.02
*** HOLE CARDS ***
Dealt to Scaaalll [5d 5s]
Scaaalll: raises $0.04 to $0.06
arsad725: folds 
S.B.O190: folds 
HellNative: folds 
iPitbull1: raises $0.14 to $0.20
Goose Of Poker: folds 
Scaaalll: folds 
Uncalled bet ($0.14) returned to iPitbull1
iPitbull1 collected $0.14 from pot
iPitbull1: doesn't show hand 
*** SUMMARY ***
Total pot $0.14 | Rake $0 
Seat 1: HellNative (button) folded before Flop (didn't bet)
Seat 2: iPitbull1 (small blind) collected ($0.14)
Seat 3: Goose Of Poker (big blind) folded before Flop
Seat 4: Scaaalll folded before Flop
Seat 5: arsad725 folded before Flop (didn't bet)
Seat 6: S.B.O190 folded before Flop (didn't bet)



PokerStars Zoom Hand #229229993435:  Hold'em No Limit ($0.01/$0.02) - 2021/08/21 21:20:39 CET [2021/08/21 15:20:39 ET]
Table 'Halley' 6-max Seat #1 is the button
Seat 1: bossquaid ($2.64 in chips) 
Seat 2: nodtress ($2.15 in chips) 
Seat 3: Scaaalll ($2.33 in chips) 
Seat 4: kahzura ($2.17 in chips) 
Seat 5: WithMyWalker ($3.18 in chips) 
Seat 6: syndikkat ($2.25 in chips) 
nodtress: posts small blind $0.01
Scaaalll: posts big blind $0.02
*** HOLE CARDS ***
Dealt to Scaaalll [7d As]
kahzura: folds 
WithMyWalker: folds 
syndikkat: folds 
bossquaid: folds 
nodtress: folds 
Uncalled bet ($0.01) returned to Scaaalll
Scaaalll collected $0.02 from pot
Scaaalll: doesn't show hand 
*** SUMMARY ***
Total pot $0.02 | Rake $0 
Seat 1: bossquaid (button) folded before Flop (didn't bet)
Seat 2: nodtress (small blind) folded before Flop
Seat 3: Scaaalll (big blind) collected ($0.02)
Seat 4: kahzura folded before Flop (didn't bet)
Seat 5: WithMyWalker folded before Flop (didn't bet)
Seat 6: syndikkat folded before Flop (didn't bet)



PokerStars Zoom Hand #229229998950:  Hold'em No Limit ($0.01/$0.02) - 2021/08/21 21:20:51 CET [2021/08/21 15:20:51 ET]
Table 'Halley' 6-max Seat #1 is the button
Seat 1: walterCARP86 ($1.26 in chips) 
Seat 2: ponomarinho ($2.27 in chips) 
Seat 3: KoAlRy ($2.02 in chips) 
Seat 4: Flavinho ;D ($2.71 in chips) 
Seat 5: HellNative ($3.36 in chips) 
Seat 6: Scaaalll ($2.34 in chips) 
ponomarinho: posts small blind $0.01
KoAlRy: posts big blind $0.02
*** HOLE CARDS ***
Dealt to Scaaalll [Ac Js]
Flavinho ;D: folds 
HellNative: folds 
Scaaalll: raises $0.04 to $0.06
walterCARP86: calls $0.06
ponomarinho: folds 
KoAlRy: calls $0.04
*** FLOP *** [Td 6c 6s]
KoAlRy: checks 
Scaaalll: bets $0.12
walterCARP86: calls $0.12
KoAlRy: folds 
*** TURN *** [Td 6c 6s] [6h]
Scaaalll: checks 
walterCARP86: bets $0.24
Scaaalll: folds 
Uncalled bet ($0.24) returned to walterCARP86
walterCARP86 collected $0.41 from pot
walterCARP86: doesn't show hand 
*** SUMMARY ***
Total pot $0.43 | Rake $0.02 
Board [Td 6c 6s 6h]
Seat 1: walterCARP86 (button) collected ($0.41)
Seat 2: ponomarinho (small blind) folded before Flop
Seat 3: KoAlRy (big blind) folded on the Flop
Seat 4: Flavinho ;D folded before Flop (didn't bet)
Seat 5: HellNative folded before Flop (didn't bet)
Seat 6: Scaaalll folded on the Turn



PokerStars Zoom Hand #229230029556:  Hold'em No Limit ($0.01/$0.02) - 2021/08/21 21:21:57 CET [2021/08/21 15:21:57 ET]
Table 'Halley' 6-max Seat #1 is the button
Seat 1: Xlavariable ($2.88 in chips) 
Seat 2: FicheroQuit ($2.47 in chips) 
Seat 3: Mr_gama2019 ($2.21 in chips) 
Seat 4: BATAL00001 ($1.47 in chips) 
Seat 5: Scaaalll ($2.16 in chips) 
Seat 6: Syd Wright ($2.06 in chips) 
FicheroQuit: posts small blind $0.01
Mr_gama2019: posts big blind $0.02
*** HOLE CARDS ***
Dealt to Scaaalll [4h 3c]
BATAL00001: raises $1.45 to $1.47 and is all-in
Scaaalll: folds 
Syd Wright: folds 
Xlavariable: folds 
FicheroQuit: folds 
Mr_gama2019: folds 
Uncalled bet ($1.45) returned to BATAL00001
BATAL00001 collected $0.05 from pot
BATAL00001: doesn't show hand 
Mr_gama2019 is disconnected 
*** SUMMARY ***
Total pot $0.05 | Rake $0 
Seat 1: Xlavariable (button) folded before Flop (didn't bet)
Seat 2: FicheroQuit (small blind) folded before Flop
Seat 3: Mr_gama2019 (big blind) folded before Flop
Seat 4: BATAL00001 collected ($0.05)
Seat 5: Scaaalll folded before Flop (didn't bet)
Seat 6: Syd Wright folded before Flop (didn't bet)



PokerStars Zoom Hand #229230031386:  Hold'em No Limit ($0.01/$0.02) - 2021/08/21 21:22:02 CET [2021/08/21 15:22:02 ET]
Table 'Halley' 6-max Seat #1 is the button
Seat 1: FabOliveira9 ($2.35 in chips) 
Seat 2: Scaaalll ($2.16 in chips) 
Seat 3: Sprot74 ($2.03 in chips) 
Seat 4: Saint_ANBU ($3.61 in chips) 
Seat 5: no way yo ($1.40 in chips) 
Seat 6: sorinysu ($1.05 in chips) 
Scaaalll: posts small blind $0.01
Sprot74: posts big blind $0.02
*** HOLE CARDS ***
Dealt to Scaaalll [8d 8c]
Saint_ANBU: folds 
no way yo: folds 
sorinysu: raises $0.04 to $0.06
FabOliveira9: folds 
Scaaalll: calls $0.05
Sprot74: folds 
*** FLOP *** [Kd 2s 7h]
Scaaalll: checks 
sorinysu: bets $0.07
Scaaalll: calls $0.07
*** TURN *** [Kd 2s 7h] [9c]
Scaaalll: checks 
sorinysu: bets $0.10
Scaaalll: calls $0.10
*** RIVER *** [Kd 2s 7h 9c] [5d]
Scaaalll: checks 
sorinysu: bets $0.10
Scaaalll: folds 
Uncalled bet ($0.10) returned to sorinysu
sorinysu collected $0.46 from pot
sorinysu: doesn't show hand 
*** SUMMARY ***
Total pot $0.48 | Rake $0.02 
Board [Kd 2s 7h 9c 5d]
Seat 1: FabOliveira9 (button) folded before Flop (didn't bet)
Seat 2: Scaaalll (small blind) folded on the River
Seat 3: Sprot74 (big blind) folded before Flop
Seat 4: Saint_ANBU folded before Flop (didn't bet)
Seat 5: no way yo folded before Flop (didn't bet)
Seat 6: sorinysu collected ($0.46)



PokerStars Zoom Hand #229230063634:  Hold'em No Limit ($0.01/$0.02) - 2021/08/21 21:23:10 CET [2021/08/21 15:23:10 ET]
Table 'Halley' 6-max Seat #1 is the button
Seat 1: Scaaalll ($2 in chips) 
Seat 2: FishOnPlate ($2 in chips) 
Seat 3: Zastrzol ($2 in chips) 
Seat 4: fabor1303 ($3.36 in chips) 
Seat 5: alexant77 ($1.38 in chips) 
Seat 6: Gerar NB ($2 in chips) 
FishOnPlate: posts small blind $0.01
Zastrzol: posts big blind $0.02
*** HOLE CARDS ***
Dealt to Scaaalll [Qc Jd]
fabor1303: raises $0.03 to $0.05
alexant77: folds 
Gerar NB: folds 
Scaaalll: folds 
FishOnPlate: folds 
Zastrzol: calls $0.03
*** FLOP *** [7h Td 2c]
Zastrzol: checks 
fabor1303: bets $0.03
Zastrzol: calls $0.03
*** TURN *** [7h Td 2c] [9h]
Zastrzol: checks 
fabor1303: bets $0.08
Zastrzol: calls $0.08
*** RIVER *** [7h Td 2c 9h] [5s]
Zastrzol: checks 
fabor1303: bets $0.10
Zastrzol: folds 
Uncalled bet ($0.10) returned to fabor1303
fabor1303 collected $0.32 from pot
fabor1303: doesn't show hand 
Zastrzol is disconnected 
*** SUMMARY ***
Total pot $0.33 | Rake $0.01 
Board [7h Td 2c 9h 5s]
Seat 1: Scaaalll (button) folded before Flop (didn't bet)
Seat 2: FishOnPlate (small blind) folded before Flop
Seat 3: Zastrzol (big blind) folded on the River
Seat 4: fabor1303 collected ($0.32)
Seat 5: alexant77 folded before Flop (didn't bet)
Seat 6: Gerar NB folded before Flop (didn't bet)



PokerStars Zoom Hand #229230072970:  Hold'em No Limit ($0.01/$0.02) - 2021/08/21 21:23:31 CET [2021/08/21 15:23:31 ET]
Table 'Halley' 6-max Seat #1 is the button
Seat 1: IWMTW ($1.81 in chips) 
Seat 2: gugamoraes ($2 in chips) 
Seat 3: Scaaalll ($2 in chips) 
Seat 4: MrK_Leuven ($2.93 in chips) 
Seat 5: Quantum771 ($2.10 in chips) 
Seat 6: Mikel226 ($1.97 in chips) 
gugamoraes: posts small blind $0.01
Scaaalll: posts big blind $0.02
*** HOLE CARDS ***
Dealt to Scaaalll [9h 9s]
MrK_Leuven: folds 
Quantum771: folds 
Mikel226: raises $0.04 to $0.06
IWMTW: folds 
gugamoraes: folds 
Scaaalll: calls $0.04
*** FLOP *** [Tc 4s 5d]
Scaaalll: checks 
Mikel226: checks 
*** TURN *** [Tc 4s 5d] [2h]
Scaaalll: checks 
Mikel226: checks 
*** RIVER *** [Tc 4s 5d 2h] [3h]
Scaaalll: checks 
Mikel226: bets $0.07
Scaaalll: folds 
Uncalled bet ($0.07) returned to Mikel226
Mikel226 collected $0.13 from pot
Mikel226: doesn't show hand 
*** SUMMARY ***
Total pot $0.13 | Rake $0 
Board [Tc 4s 5d 2h 3h]
Seat 1: IWMTW (button) folded before Flop (didn't bet)
Seat 2: gugamoraes (small blind) folded before Flop
Seat 3: Scaaalll (big blind) folded on the River
Seat 4: MrK_Leuven folded before Flop (didn't bet)
Seat 5: Quantum771 folded before Flop (didn't bet)
Seat 6: Mikel226 collected ($0.13)



PokerStars Zoom Hand #229230093341:  Hold'em No Limit ($0.01/$0.02) - 2021/08/21 21:24:13 CET [2021/08/21 15:24:13 ET]
Table 'Halley' 6-max Seat #1 is the button
Seat 1: Ufiltreret ($2.07 in chips) 
Seat 2: kisaku4 ($2.01 in chips) 
Seat 3: fabor1303 ($3.52 in chips) 
Seat 4: DUFFTDOG ($7.59 in chips) 
Seat 5: Scaaalll ($2 in chips) 
Seat 6: Gerar NB ($2 in chips) 
kisaku4: posts small blind $0.01
fabor1303: posts big blind $0.02
*** HOLE CARDS ***
Dealt to Scaaalll [8d Ts]
DUFFTDOG: raises $0.03 to $0.05
Scaaalll: folds 
Gerar NB: folds 
Ufiltreret: folds 
kisaku4: folds 
fabor1303: calls $0.03
*** FLOP *** [9d Th 9h]
fabor1303: checks 
DUFFTDOG: bets $0.08
fabor1303: folds 
Uncalled bet ($0.08) returned to DUFFTDOG
DUFFTDOG collected $0.11 from pot
DUFFTDOG: doesn't show hand 
*** SUMMARY ***
Total pot $0.11 | Rake $0 
Board [9d Th 9h]
Seat 1: Ufiltreret (button) folded before Flop (didn't bet)
Seat 2: kisaku4 (small blind) folded before Flop
Seat 3: fabor1303 (big blind) folded on the Flop
Seat 4: DUFFTDOG collected ($0.11)
Seat 5: Scaaalll folded before Flop (didn't bet)
Seat 6: Gerar NB folded before Flop (didn't bet)



PokerStars Zoom Hand #229230095280:  Hold'em No Limit ($0.01/$0.02) - 2021/08/21 21:24:17 CET [2021/08/21 15:24:17 ET]
Table 'Halley' 6-max Seat #1 is the button
Seat 1: bigthereal ($2.30 in chips) 
Seat 2: Scaaalll ($2 in chips) 
Seat 3: z3317111711 ($2.11 in chips) 
Seat 4: Kkamm ($2.62 in chips) 
Seat 5: curyurzeda ($2.64 in chips) 
Seat 6: ciucibaby ($4.37 in chips) 
Scaaalll: posts small blind $0.01
z3317111711: posts big blind $0.02
*** HOLE CARDS ***
Dealt to Scaaalll [As 9s]
Kkamm: folds 
curyurzeda: raises $0.08 to $0.10
ciucibaby: folds 
bigthereal: folds 
Scaaalll: folds 
z3317111711: folds 
Uncalled bet ($0.08) returned to curyurzeda
curyurzeda collected $0.05 from pot
curyurzeda: doesn't show hand 
*** SUMMARY ***
Total pot $0.05 | Rake $0 
Seat 1: bigthereal (button) folded before Flop (didn't bet)
Seat 2: Scaaalll (small blind) folded before Flop
Seat 3: z3317111711 (big blind) folded before Flop
Seat 4: Kkamm folded before Flop (didn't bet)
Seat 5: curyurzeda collected ($0.05)
Seat 6: ciucibaby folded before Flop (didn't bet)



PokerStars Zoom Hand #229230104128:  Hold'em No Limit ($0.01/$0.02) - 2021/08/21 21:24:36 CET [2021/08/21 15:24:36 ET]
Table 'Halley' 6-max Seat #1 is the button
Seat 1: Grashüpferchen ($0.97 in chips) 
Seat 2: lyapis75 ($2.18 in chips) 
Seat 3: zergmiky ($2.02 in chips) 
Seat 4: Scaaalll ($2 in chips) 
Seat 5: Flankeris ($2.93 in chips) 
Seat 6: 7LEV77 ($1.06 in chips) 
lyapis75: posts small blind $0.01
zergmiky: posts big blind $0.02
*** HOLE CARDS ***
Dealt to Scaaalll [Js 9h]
Scaaalll: folds 
Flankeris: folds 
7LEV77: folds 
Grashüpferchen: folds 
lyapis75: raises $0.04 to $0.06
zergmiky: raises $0.10 to $0.16
lyapis75: raises $2.02 to $2.18 and is all-in
zergmiky: folds 
Uncalled bet ($2.02) returned to lyapis75
lyapis75 collected $0.32 from pot
lyapis75: doesn't show hand 
*** SUMMARY ***
Total pot $0.32 | Rake $0 
Seat 1: Grashüpferchen (button) folded before Flop (didn't bet)
Seat 2: lyapis75 (small blind) collected ($0.32)
Seat 3: zergmiky (big blind) folded before Flop
Seat 4: Scaaalll folded before Flop (didn't bet)
Seat 5: Flankeris folded before Flop (didn't bet)
Seat 6: 7LEV77 folded before Flop (didn't bet)



PokerStars Zoom Hand #229230110734:  Hold'em No Limit ($0.01/$0.02) - 2021/08/21 21:24:50 CET [2021/08/21 15:24:50 ET]
Table 'Halley' 6-max Seat #1 is the button
Seat 1: Scaaalll ($2 in chips) 
Seat 2: markzoom6894 ($3.13 in chips) 
Seat 3: zairyoku ($2.49 in chips) 
Seat 4: ROMIR777 ($0.55 in chips) 
Seat 5: sg.32rus ($1.59 in chips) 
Seat 6: gasmar_29 ($3.55 in chips) 
markzoom6894: posts small blind $0.01
zairyoku: posts big blind $0.02
*** HOLE CARDS ***
Dealt to Scaaalll [3h 5c]
ROMIR777: folds 
ROMIR777 is disconnected 
sg.32rus: calls $0.02
gasmar_29: folds 
Scaaalll: folds 
markzoom6894: folds 
zairyoku: checks 
*** FLOP *** [9s 8c 8d]
zairyoku: checks 
sg.32rus: bets $0.08
zairyoku: folds 
Uncalled bet ($0.08) returned to sg.32rus
sg.32rus collected $0.05 from pot
sg.32rus: doesn't show hand 
*** SUMMARY ***
Total pot $0.05 | Rake $0 
Board [9s 8c 8d]
Seat 1: Scaaalll (button) folded before Flop (didn't bet)
Seat 2: markzoom6894 (small blind) folded before Flop
Seat 3: zairyoku (big blind) folded on the Flop
Seat 4: ROMIR777 folded before Flop (didn't bet)
Seat 5: sg.32rus collected ($0.05)
Seat 6: gasmar_29 folded before Flop (didn't bet)



PokerStars Zoom Hand #229230107861:  Hold'em No Limit ($0.01/$0.02) - 2021/08/21 21:24:44 CET [2021/08/21 15:24:44 ET]
Table 'Halley' 6-max Seat #1 is the button
Seat 1: qpsq ($2 in chips) 
Seat 2: kwant33 ($3.51 in chips) 
Seat 3: py100ta ($11.50 in chips) 
Seat 4: SpartanRace1 ($8.37 in chips) 
Seat 5: Gyapszi958 ($1.91 in chips) 
Seat 6: Scaaalll ($2 in chips) 
kwant33: posts small blind $0.01
py100ta: posts big blind $0.02
*** HOLE CARDS ***
Dealt to Scaaalll [5h Th]
SpartanRace1: folds 
Gyapszi958: folds 
Scaaalll: folds 
qpsq: folds 
kwant33: raises $0.04 to $0.06
py100ta: raises $0.14 to $0.20
kwant33: calls $0.14
*** FLOP *** [4s Tc 7s]
kwant33: bets $0.20
py100ta: calls $0.20
*** TURN *** [4s Tc 7s] [7h]
kwant33: checks 
py100ta: bets $0.61
kwant33: folds 
Uncalled bet ($0.61) returned to py100ta
py100ta collected $0.77 from pot
py100ta: doesn't show hand 
*** SUMMARY ***
Total pot $0.80 | Rake $0.03 
Board [4s Tc 7s 7h]
Seat 1: qpsq (button) folded before Flop (didn't bet)
Seat 2: kwant33 (small blind) folded on the Turn
Seat 3: py100ta (big blind) collected ($0.77)
Seat 4: SpartanRace1 folded before Flop (didn't bet)
Seat 5: Gyapszi958 folded before Flop (didn't bet)
Seat 6: Scaaalll folded before Flop (didn't bet)



PokerStars Zoom Hand #229230115450:  Hold'em No Limit ($0.01/$0.02) - 2021/08/21 21:25:00 CET [2021/08/21 15:25:00 ET]
Table 'Halley' 6-max Seat #1 is the button
Seat 1: ARTMVSLV ($2.27 in chips) 
Seat 2: S.B.O190 ($11.28 in chips) 
Seat 3: Scaaalll ($2 in chips) 
Seat 4: zergmiky ($2 in chips) 
Seat 5: ADWish ($1.51 in chips) 
Seat 6: Kb013497 ($2.31 in chips) 
S.B.O190: posts small blind $0.01
Scaaalll: posts big blind $0.02
*** HOLE CARDS ***
Dealt to Scaaalll [4c Kd]
zergmiky: folds 
ADWish: folds 
Kb013497: folds 
ARTMVSLV: raises $0.02 to $0.04
S.B.O190: folds 
Scaaalll: folds 
Uncalled bet ($0.02) returned to ARTMVSLV
ARTMVSLV collected $0.05 from pot
ARTMVSLV: doesn't show hand 
*** SUMMARY ***
Total pot $0.05 | Rake $0 
Seat 1: ARTMVSLV (button) collected ($0.05)
Seat 2: S.B.O190 (small blind) folded before Flop
Seat 3: Scaaalll (big blind) folded before Flop
Seat 4: zergmiky folded before Flop (didn't bet)
Seat 5: ADWish folded before Flop (didn't bet)
Seat 6: Kb013497 folded before Flop (didn't bet)



PokerStars Zoom Hand #229230124921:  Hold'em No Limit ($0.01/$0.02) - 2021/08/21 21:25:20 CET [2021/08/21 15:25:20 ET]
Table 'Halley' 6-max Seat #1 is the button
Seat 1: FabOliveira9 ($2.87 in chips) 
Seat 2: Scaaalll ($2 in chips) 
Seat 3: STE1NBERG ($2.20 in chips) 
Seat 4: Forest404 ($1.10 in chips) 
Seat 5: Kb013497 ($2.31 in chips) 
Seat 6: EchoMR ($2.46 in chips) 
Scaaalll: posts small blind $0.01
STE1NBERG: posts big blind $0.02
*** HOLE CARDS ***
Dealt to Scaaalll [Ah 4h]
EchoMR is disconnected 
Forest404: folds 
Kb013497: folds 
EchoMR: folds 
FabOliveira9: raises $0.03 to $0.05
Scaaalll: calls $0.04
STE1NBERG: folds 
*** FLOP *** [6h 7s Kc]
Scaaalll: checks 
FabOliveira9: bets $0.04
Scaaalll: folds 
Uncalled bet ($0.04) returned to FabOliveira9
FabOliveira9 collected $0.12 from pot
FabOliveira9: doesn't show hand 
*** SUMMARY ***
Total pot $0.12 | Rake $0 
Board [6h 7s Kc]
Seat 1: FabOliveira9 (button) collected ($0.12)
Seat 2: Scaaalll (small blind) folded on the Flop
Seat 3: STE1NBERG (big blind) folded before Flop
Seat 4: Forest404 folded before Flop (didn't bet)
Seat 5: Kb013497 folded before Flop (didn't bet)
Seat 6: EchoMR folded before Flop (didn't bet)



PokerStars Zoom Hand #229230146417:  Hold'em No Limit ($0.01/$0.02) - 2021/08/21 21:25:58 CET [2021/08/21 15:25:58 ET]
Table 'Halley' 6-max Seat #1 is the button
Seat 1: Fanatspartak ($0.98 in chips) 
Seat 2: 6i3oH77 ($7.48 in chips) 
Seat 3: kodart ($1.89 in chips) 
Seat 4: MirkoV224 ($2.47 in chips) 
Seat 5: Scaaalll ($2 in chips) 
Seat 6: zairyoku ($2.52 in chips) 
6i3oH77: posts small blind $0.01
kodart: posts big blind $0.02
*** HOLE CARDS ***
Dealt to Scaaalll [As Kh]
MirkoV224: folds 
6i3oH77 is disconnected 
Scaaalll: raises $0.04 to $0.06
zairyoku: folds 
Fanatspartak: folds 
6i3oH77: folds 
kodart: folds 
Uncalled bet ($0.04) returned to Scaaalll
Scaaalll collected $0.05 from pot
Scaaalll: doesn't show hand 
*** SUMMARY ***
Total pot $0.05 | Rake $0 
Seat 1: Fanatspartak (button) folded before Flop (didn't bet)
Seat 2: 6i3oH77 (small blind) folded before Flop
Seat 3: kodart (big blind) folded before Flop
Seat 4: MirkoV224 folded before Flop (didn't bet)
Seat 5: Scaaalll collected ($0.05)
Seat 6: zairyoku folded before Flop (didn't bet)



PokerStars Zoom Hand #229230134304:  Hold'em No Limit ($0.01/$0.02) - 2021/08/21 21:25:40 CET [2021/08/21 15:25:40 ET]
Table 'Halley' 6-max Seat #1 is the button
Seat 1: S1fon4o ($0.48 in chips) 
Seat 2: FabOliveira9 ($3.35 in chips) 
Seat 3: takeatrip180 ($3.09 in chips) 
Seat 4: Scaaalll ($2 in chips) 
Seat 5: zbixxx ($2.07 in chips) 
Seat 6: ottke88 ($2.72 in chips) 
FabOliveira9: posts small blind $0.01
takeatrip180: posts big blind $0.02
*** HOLE CARDS ***
Dealt to Scaaalll [Ac 3c]
Scaaalll has timed out
Scaaalll: folds 
zbixxx: raises $0.04 to $0.06
ottke88: folds 
S1fon4o: folds 
ottke88 is disconnected 
FabOliveira9: calls $0.05
takeatrip180: calls $0.04
*** FLOP *** [Ks Td 8s]
FabOliveira9: checks 
takeatrip180: bets $0.09
zbixxx: folds 
FabOliveira9: folds 
Uncalled bet ($0.09) returned to takeatrip180
takeatrip180 collected $0.17 from pot
takeatrip180: doesn't show hand 
*** SUMMARY ***
Total pot $0.18 | Rake $0.01 
Board [Ks Td 8s]
Seat 1: S1fon4o (button) folded before Flop (didn't bet)
Seat 2: FabOliveira9 (small blind) folded on the Flop
Seat 3: takeatrip180 (big blind) collected ($0.17)
Seat 4: Scaaalll folded before Flop (didn't bet)
Seat 5: zbixxx folded on the Flop
Seat 6: ottke88 folded before Flop (didn't bet)



PokerStars Zoom Hand #229230152436:  Hold'em No Limit ($0.01/$0.02) - 2021/08/21 21:26:11 CET [2021/08/21 15:26:11 ET]
Table 'Halley' 6-max Seat #1 is the button
Seat 1: ARTMVSLV ($4.68 in chips) 
Seat 2: JDGGrinder ($3.22 in chips) 
Seat 3: pphit ($4.28 in chips) 
Seat 4: Scaaalll ($2.03 in chips) 
Seat 5: vtashmat1 ($2 in chips) 
Seat 6: CrazyyParis ($2 in chips) 
JDGGrinder: posts small blind $0.01
pphit: posts big blind $0.02
*** HOLE CARDS ***
Dealt to Scaaalll [Qh 7s]
Scaaalll: folds 
vtashmat1: folds 
CrazyyParis: folds 
ARTMVSLV: raises $0.02 to $0.04
JDGGrinder: calls $0.03
pphit: folds 
*** FLOP *** [5c 6h Jh]
JDGGrinder: checks 
ARTMVSLV: bets $0.04
JDGGrinder: folds 
Uncalled bet ($0.04) returned to ARTMVSLV
ARTMVSLV collected $0.10 from pot
ARTMVSLV: doesn't show hand 
*** SUMMARY ***
Total pot $0.10 | Rake $0 
Board [5c 6h Jh]
Seat 1: ARTMVSLV (button) collected ($0.10)
Seat 2: JDGGrinder (small blind) folded on the Flop
Seat 3: pphit (big blind) folded before Flop
Seat 4: Scaaalll folded before Flop (didn't bet)
Seat 5: vtashmat1 folded before Flop (didn't bet)
Seat 6: CrazyyParis folded before Flop (didn't bet)



PokerStars Zoom Hand #229230156189:  Hold'em No Limit ($0.01/$0.02) - 2021/08/21 21:26:20 CET [2021/08/21 15:26:20 ET]
Table 'Halley' 6-max Seat #1 is the button
Seat 1: vicctorlf ($2.69 in chips) 
Seat 2: Shadi8 ($2.54 in chips) 
Seat 3: Scaaalll ($2.03 in chips) 
Seat 4: Fen4ik59 ($0.70 in chips) 
Seat 5: Ruslan076 ($1.08 in chips) 
Seat 6: ser313131 ($2.71 in chips) 
Shadi8: posts small blind $0.01
Scaaalll: posts big blind $0.02
*** HOLE CARDS ***
Dealt to Scaaalll [5h Qs]
Fen4ik59: folds 
Ruslan076: calls $0.02
ser313131: calls $0.02
vicctorlf: folds 
Shadi8: folds 
Scaaalll: checks 
*** FLOP *** [3h 2s 4h]
Scaaalll: checks 
Ruslan076: bets $0.02
ser313131: calls $0.02
Scaaalll: calls $0.02
*** TURN *** [3h 2s 4h] [3s]
Scaaalll: checks 
Ruslan076: bets $0.02
ser313131: calls $0.02
Scaaalll: calls $0.02
*** RIVER *** [3h 2s 4h 3s] [7d]
Scaaalll: checks 
Ruslan076: checks 
ser313131: checks 
*** SHOW DOWN ***
Scaaalll: shows [5h Qs] (a pair of Threes)
Ruslan076: shows [2h Ad] (two pair, Threes and Deuces)
ser313131: mucks hand 
Ruslan076 collected $0.18 from pot
*** SUMMARY ***
Total pot $0.19 | Rake $0.01 
Board [3h 2s 4h 3s 7d]
Seat 1: vicctorlf (button) folded before Flop (didn't bet)
Seat 2: Shadi8 (small blind) folded before Flop
Seat 3: Scaaalll (big blind) showed [5h Qs] and lost with a pair of Threes
Seat 4: Fen4ik59 folded before Flop (didn't bet)
Seat 5: Ruslan076 showed [2h Ad] and won ($0.18) with two pair, Threes and Deuces
Seat 6: ser313131 mucked [Td 2d]



PokerStars Zoom Hand #229230179508:  Hold'em No Limit ($0.01/$0.02) - 2021/08/21 21:27:10 CET [2021/08/21 15:27:10 ET]
Table 'Halley' 6-max Seat #1 is the button
Seat 1: Scaaalll ($2 in chips) 
Seat 2: klausC3 ($5.46 in chips) 
Seat 3: puratiino ($1.85 in chips) 
Seat 4: bt710 ($2.19 in chips) 
Seat 5: Henry Chinasky ($2.45 in chips) 
Seat 6: kahzura ($2 in chips) 
klausC3: posts small blind $0.01
puratiino: posts big blind $0.02
*** HOLE CARDS ***
Dealt to Scaaalll [Js Jh]
bt710: folds 
Henry Chinasky: folds 
kahzura: folds 
Scaaalll: raises $0.02 to $0.04
klausC3: folds 
puratiino: folds 
Uncalled bet ($0.02) returned to Scaaalll
Scaaalll collected $0.05 from pot
Scaaalll: doesn't show hand 
*** SUMMARY ***
Total pot $0.05 | Rake $0 
Seat 1: Scaaalll (button) collected ($0.05)
Seat 2: klausC3 (small blind) folded before Flop
Seat 3: puratiino (big blind) folded before Flop
Seat 4: bt710 folded before Flop (didn't bet)
Seat 5: Henry Chinasky folded before Flop (didn't bet)
Seat 6: kahzura folded before Flop (didn't bet)



PokerStars Zoom Hand #229230190068:  Hold'em No Limit ($0.01/$0.02) - 2021/08/21 21:27:32 CET [2021/08/21 15:27:32 ET]
Table 'Halley' 6-max Seat #1 is the button
Seat 1: Pechorin.G ($2 in chips) 
Seat 2: greenthum33 ($4.10 in chips) 
Seat 3: lucksuckdonk ($5.64 in chips) 
Seat 4: rodrigoasor ($0.10 in chips) 
Seat 5: Gabr Ribeiro ($2.33 in chips) 
Seat 6: Scaaalll ($2.03 in chips) 
greenthum33: posts small blind $0.01
lucksuckdonk: posts big blind $0.02
*** HOLE CARDS ***
Dealt to Scaaalll [Th As]
rodrigoasor: folds 
Gabr Ribeiro: folds 
Scaaalll: raises $0.04 to $0.06
Pechorin.G: folds 
greenthum33: folds 
lucksuckdonk: folds 
Uncalled bet ($0.04) returned to Scaaalll
Scaaalll collected $0.05 from pot
Scaaalll: doesn't show hand 
*** SUMMARY ***
Total pot $0.05 | Rake $0 
Seat 1: Pechorin.G (button) folded before Flop (didn't bet)
Seat 2: greenthum33 (small blind) folded before Flop
Seat 3: lucksuckdonk (big blind) folded before Flop
Seat 4: rodrigoasor folded before Flop (didn't bet)
Seat 5: Gabr Ribeiro folded before Flop (didn't bet)
Seat 6: Scaaalll collected ($0.05)



PokerStars Zoom Hand #229230201291:  Hold'em No Limit ($0.01/$0.02) - 2021/08/21 21:27:56 CET [2021/08/21 15:27:56 ET]
Table 'Halley' 6-max Seat #1 is the button
Seat 1: Scaaalll ($2.06 in chips) 
Seat 2: drwal286 ($1.50 in chips) 
Seat 3: basyan111 ($2.43 in chips) 
Seat 4: ximik D V ($2.06 in chips) 
Seat 5: romochka1992 ($2.04 in chips) 
Seat 6: ggGoldenPunk ($4.66 in chips) 
drwal286: posts small blind $0.01
basyan111: posts big blind $0.02
*** HOLE CARDS ***
Dealt to Scaaalll [2s 8s]
ximik D V: folds 
romochka1992: raises $0.04 to $0.06
ggGoldenPunk: folds 
Scaaalll: folds 
drwal286: folds 
basyan111: folds 
Uncalled bet ($0.04) returned to romochka1992
romochka1992 collected $0.05 from pot
romochka1992: doesn't show hand 
basyan111 is disconnected 
*** SUMMARY ***
Total pot $0.05 | Rake $0 
Seat 1: Scaaalll (button) folded before Flop (didn't bet)
Seat 2: drwal286 (small blind) folded before Flop
Seat 3: basyan111 (big blind) folded before Flop
Seat 4: ximik D V folded before Flop (didn't bet)
Seat 5: romochka1992 collected ($0.05)
Seat 6: ggGoldenPunk folded before Flop (didn't bet)



PokerStars Zoom Hand #229230204104:  Hold'em No Limit ($0.01/$0.02) - 2021/08/21 21:28:02 CET [2021/08/21 15:28:02 ET]
Table 'Halley' 6-max Seat #1 is the button
Seat 1: EevAA190 ($2 in chips) 
Seat 2: Scaaalll ($2.06 in chips) 
Seat 3: zairyoku ($2.50 in chips) 
Seat 4: Lighio ($3.95 in chips) 
Seat 5: Freiflug66 ($2.63 in chips) 
Seat 6: rodrigoaduar ($0.13 in chips) 
Scaaalll: posts small blind $0.01
zairyoku: posts big blind $0.02
*** HOLE CARDS ***
Dealt to Scaaalll [Js 2d]
Lighio: folds 
Freiflug66: raises $0.05 to $0.07
rodrigoaduar: calls $0.07
EevAA190: folds 
Scaaalll: folds 
zairyoku: folds 
*** FLOP *** [4s 5d 9c]
Freiflug66: bets $0.09
rodrigoaduar: calls $0.06 and is all-in
Uncalled bet ($0.03) returned to Freiflug66
*** TURN *** [4s 5d 9c] [8h]
*** RIVER *** [4s 5d 9c 8h] [9d]
*** SHOW DOWN ***
Freiflug66: shows [Kd Jh] (a pair of Nines)
rodrigoaduar: shows [8c Qs] (two pair, Nines and Eights)
rodrigoaduar collected $0.28 from pot
*** SUMMARY ***
Total pot $0.29 | Rake $0.01 
Board [4s 5d 9c 8h 9d]
Seat 1: EevAA190 (button) folded before Flop (didn't bet)
Seat 2: Scaaalll (small blind) folded before Flop
Seat 3: zairyoku (big blind) folded before Flop
Seat 4: Lighio folded before Flop (didn't bet)
Seat 5: Freiflug66 showed [Kd Jh] and lost with a pair of Nines
Seat 6: rodrigoaduar showed [8c Qs] and won ($0.28) with two pair, Nines and Eights



PokerStars Zoom Hand #229230222940:  Hold'em No Limit ($0.01/$0.02) - 2021/08/21 21:28:42 CET [2021/08/21 15:28:42 ET]
Table 'Halley' 6-max Seat #1 is the button
Seat 1: DURO.RIVAL ($2.02 in chips) 
Seat 2: igara tigara ($1.78 in chips) 
Seat 3: z1z2z315 ($0.64 in chips) 
Seat 4: Scaaalll ($2.03 in chips) 
Seat 5: romochka1992 ($1.39 in chips) 
Seat 6: pavlo590 ($2.08 in chips) 
igara tigara: posts small blind $0.01
z1z2z315: posts big blind $0.02
*** HOLE CARDS ***
Dealt to Scaaalll [9h Ac]
Scaaalll: folds 
romochka1992: folds 
pavlo590: folds 
pavlo590 is disconnected 
DURO.RIVAL: folds 
igara tigara: folds 
Uncalled bet ($0.01) returned to z1z2z315
z1z2z315 collected $0.02 from pot
z1z2z315: doesn't show hand 
*** SUMMARY ***
Total pot $0.02 | Rake $0 
Seat 1: DURO.RIVAL (button) folded before Flop (didn't bet)
Seat 2: igara tigara (small blind) folded before Flop
Seat 3: z1z2z315 (big blind) collected ($0.02)
Seat 4: Scaaalll folded before Flop (didn't bet)
Seat 5: romochka1992 folded before Flop (didn't bet)
Seat 6: pavlo590 folded before Flop (didn't bet)



PokerStars Zoom Hand #229230206983:  Hold'em No Limit ($0.01/$0.02) - 2021/08/21 21:28:08 CET [2021/08/21 15:28:08 ET]
Table 'Halley' 6-max Seat #1 is the button
Seat 1: STE1NBERG ($3.53 in chips) 
Seat 2: Shadi8 ($3.17 in chips) 
Seat 3: ignat-of 777 ($0.97 in chips) 
Seat 4: Loto70 ($2.19 in chips) 
Seat 5: Scaaalll ($2.05 in chips) 
Seat 6: TNTKM ($1.65 in chips) 
Shadi8: posts small blind $0.01
ignat-of 777: posts big blind $0.02
*** HOLE CARDS ***
Dealt to Scaaalll [4c 9c]
Loto70: folds 
Scaaalll: folds 
TNTKM has timed out
TNTKM: folds 
STE1NBERG: folds 
TNTKM is disconnected 
Shadi8: raises $0.04 to $0.06
ignat-of 777: raises $0.12 to $0.18
Shadi8: calls $0.12
*** FLOP *** [2c Kd Jc]
Shadi8: checks 
ignat-of 777: bets $0.18
Shadi8: calls $0.18
*** TURN *** [2c Kd Jc] [9h]
Shadi8: checks 
ignat-of 777: checks 
*** RIVER *** [2c Kd Jc 9h] [5h]
Shadi8: checks 
ignat-of 777: checks 
*** SHOW DOWN ***
Shadi8: shows [2h Ah] (a pair of Deuces)
ignat-of 777: mucks hand 
Shadi8 collected $0.69 from pot
*** SUMMARY ***
Total pot $0.72 | Rake $0.03 
Board [2c Kd Jc 9h 5h]
Seat 1: STE1NBERG (button) folded before Flop (didn't bet)
Seat 2: Shadi8 (small blind) showed [2h Ah] and won ($0.69) with a pair of Deuces
Seat 3: ignat-of 777 (big blind) mucked [Qc As]
Seat 4: Loto70 folded before Flop (didn't bet)
Seat 5: Scaaalll folded before Flop (didn't bet)
Seat 6: TNTKM folded before Flop (didn't bet)



PokerStars Zoom Hand #229230196735:  Hold'em No Limit ($0.01/$0.02) - 2021/08/21 21:27:47 CET [2021/08/21 15:27:47 ET]
Table 'Halley' 6-max Seat #1 is the button
Seat 1: 2hoesonmydick ($1.97 in chips) 
Seat 2: arsad725 ($5.93 in chips) 
Seat 3: Denisov V. ($1.13 in chips) 
Seat 4: kodart ($1.97 in chips) 
Seat 5: ARTMVSLV ($2 in chips) 
Seat 6: Scaaalll ($2.06 in chips) 
arsad725: posts small blind $0.01
Denisov V.: posts big blind $0.02
*** HOLE CARDS ***
Dealt to Scaaalll [Qh 6d]
kodart: folds 
ARTMVSLV: folds 
Scaaalll: folds 
2hoesonmydick: raises $0.03 to $0.05
arsad725: calls $0.04
Denisov V.: calls $0.03
*** FLOP *** [5c 7d 2h]
arsad725: bets $0.07
Denisov V.: calls $0.07
2hoesonmydick: folds 
*** TURN *** [5c 7d 2h] [2d]
2hoesonmydick is disconnected 
arsad725: checks 
Denisov V.: bets $0.28
arsad725: raises $0.28 to $0.56
Denisov V.: calls $0.28
*** RIVER *** [5c 7d 2h 2d] [3c]
arsad725: bets $0.68
Denisov V.: folds 
Uncalled bet ($0.68) returned to arsad725
arsad725 collected $1.36 from pot
arsad725: doesn't show hand 
Denisov V. is disconnected 
*** SUMMARY ***
Total pot $1.41 | Rake $0.05 
Board [5c 7d 2h 2d 3c]
Seat 1: 2hoesonmydick (button) folded on the Flop
Seat 2: arsad725 (small blind) collected ($1.36)
Seat 3: Denisov V. (big blind) folded on the River
Seat 4: kodart folded before Flop (didn't bet)
Seat 5: ARTMVSLV folded before Flop (didn't bet)
Seat 6: Scaaalll folded before Flop (didn't bet)



PokerStars Zoom Hand #229230224782:  Hold'em No Limit ($0.01/$0.02) - 2021/08/21 21:28:46 CET [2021/08/21 15:28:46 ET]
Table 'Halley' 6-max Seat #1 is the button
Seat 1: lafocaramona ($3.69 in chips) 
Seat 2: 78joniboy ($2.02 in chips) 
Seat 3: johniXL ($0.90 in chips) 
Seat 4: Scaaalll ($2.03 in chips) 
Seat 5: texashenry2 ($1.17 in chips) 
Seat 6: CASSIE21462 ($7.58 in chips) 
78joniboy: posts small blind $0.01
johniXL: posts big blind $0.02
*** HOLE CARDS ***
Dealt to Scaaalll [8h Kh]
Scaaalll: folds 
texashenry2: folds 
lafocaramona is disconnected 
CASSIE21462: folds 
lafocaramona: folds 
78joniboy: raises $0.04 to $0.06
johniXL: folds 
Uncalled bet ($0.04) returned to 78joniboy
78joniboy collected $0.04 from pot
78joniboy: doesn't show hand 
*** SUMMARY ***
Total pot $0.04 | Rake $0 
Seat 1: lafocaramona (button) folded before Flop (didn't bet)
Seat 2: 78joniboy (small blind) collected ($0.04)
Seat 3: johniXL (big blind) folded before Flop
Seat 4: Scaaalll folded before Flop (didn't bet)
Seat 5: texashenry2 folded before Flop (didn't bet)
Seat 6: CASSIE21462 folded before Flop (didn't bet)



PokerStars Zoom Hand #229230226646:  Hold'em No Limit ($0.01/$0.02) - 2021/08/21 21:28:50 CET [2021/08/21 15:28:50 ET]
Table 'Halley' 6-max Seat #1 is the button
Seat 1: NecromiconP ($3.14 in chips) 
Seat 2: Scaaalll ($2.03 in chips) 
Seat 3: tuolau ($1.35 in chips) 
Seat 4: DaporteWins ($2 in chips) 
Seat 5: kickBrain ($4.29 in chips) 
Seat 6: lafocaramona ($3.69 in chips) 
Scaaalll: posts small blind $0.01
tuolau: posts big blind $0.02
*** HOLE CARDS ***
Dealt to Scaaalll [Kh 5s]
DaporteWins: folds 
kickBrain: folds 
lafocaramona: folds 
lafocaramona is disconnected 
NecromiconP: folds 
Scaaalll: folds 
Uncalled bet ($0.01) returned to tuolau
tuolau collected $0.02 from pot
tuolau: doesn't show hand 
*** SUMMARY ***
Total pot $0.02 | Rake $0 
Seat 1: NecromiconP (button) folded before Flop (didn't bet)
Seat 2: Scaaalll (small blind) folded before Flop
Seat 3: tuolau (big blind) collected ($0.02)
Seat 4: DaporteWins folded before Flop (didn't bet)
Seat 5: kickBrain folded before Flop (didn't bet)
Seat 6: lafocaramona folded before Flop (didn't bet)



PokerStars Zoom Hand #229230228460:  Hold'em No Limit ($0.01/$0.02) - 2021/08/21 21:28:55 CET [2021/08/21 15:28:55 ET]
Table 'Halley' 6-max Seat #1 is the button
Seat 1: Scaaalll ($2.02 in chips) 
Seat 2: moirl55 ($1.90 in chips) 
Seat 3: HDYD18 ($3.32 in chips) 
Seat 4: zbixxx ($2.40 in chips) 
Seat 5: Kb013497 ($3.27 in chips) 
Seat 6: lustranik ($5.04 in chips) 
moirl55: posts small blind $0.01
HDYD18: posts big blind $0.02
*** HOLE CARDS ***
Dealt to Scaaalll [8c Kh]
zbixxx: folds 
Kb013497: folds 
lustranik: folds 
moirl55 is disconnected 
Scaaalll: raises $0.02 to $0.04
moirl55: folds 
HDYD18: folds 
Uncalled bet ($0.02) returned to Scaaalll
Scaaalll collected $0.05 from pot
Scaaalll: doesn't show hand 
*** SUMMARY ***
Total pot $0.05 | Rake $0 
Seat 1: Scaaalll (button) collected ($0.05)
Seat 2: moirl55 (small blind) folded before Flop
Seat 3: HDYD18 (big blind) folded before Flop
Seat 4: zbixxx folded before Flop (didn't bet)
Seat 5: Kb013497 folded before Flop (didn't bet)
Seat 6: lustranik folded before Flop (didn't bet)



PokerStars Zoom Hand #229230220132:  Hold'em No Limit ($0.01/$0.02) - 2021/08/21 21:28:37 CET [2021/08/21 15:28:37 ET]
Table 'Halley' 6-max Seat #1 is the button
Seat 1: squidy4 ($6.55 in chips) 
Seat 2: TESTGOSHI ($2.59 in chips) 
Seat 3: memphisreigns ($3.64 in chips) 
Seat 4: ARTMVSLV ($2 in chips) 
Seat 5: Scaaalll ($2.03 in chips) 
Seat 6: Gibsondelux ($1.65 in chips) 
TESTGOSHI: posts small blind $0.01
memphisreigns: posts big blind $0.02
*** HOLE CARDS ***
Dealt to Scaaalll [Ks 9c]
Gibsondelux is disconnected 
ARTMVSLV: folds 
Scaaalll: folds 
Gibsondelux: folds 
squidy4: raises $0.04 to $0.06
TESTGOSHI: folds 
memphisreigns: calls $0.04
*** FLOP *** [Td 5d 4c]
memphisreigns: checks 
squidy4: bets $0.05
memphisreigns: raises $0.12 to $0.17
squidy4: folds 
Uncalled bet ($0.12) returned to memphisreigns
memphisreigns collected $0.22 from pot
memphisreigns: doesn't show hand 
*** SUMMARY ***
Total pot $0.23 | Rake $0.01 
Board [Td 5d 4c]
Seat 1: squidy4 (button) folded on the Flop
Seat 2: TESTGOSHI (small blind) folded before Flop
Seat 3: memphisreigns (big blind) collected ($0.22)
Seat 4: ARTMVSLV folded before Flop (didn't bet)
Seat 5: Scaaalll folded before Flop (didn't bet)
Seat 6: Gibsondelux folded before Flop (didn't bet)



PokerStars Zoom Hand #229230209760:  Hold'em No Limit ($0.01/$0.02) - 2021/08/21 21:28:14 CET [2021/08/21 15:28:14 ET]
Table 'Halley' 6-max Seat #1 is the button
Seat 1: 77omsk ($7.21 in chips) 
Seat 2: Loto70 ($2.01 in chips) 
Seat 3: Scaaalll ($2.05 in chips) 
Seat 4: MKIronCrAAzy ($5.38 in chips) 
Seat 5: man070707 ($1.31 in chips) 
Seat 6: Oprichnick90 ($2.59 in chips) 
Loto70: posts small blind $0.01
Scaaalll: posts big blind $0.02
*** HOLE CARDS ***
Dealt to Scaaalll [Ts Ac]
MKIronCrAAzy: folds 
man070707: folds 
man070707 is disconnected 
Oprichnick90: raises $0.03 to $0.05
77omsk: raises $0.10 to $0.15
Loto70: folds 
Scaaalll: folds 
Oprichnick90: calls $0.10
*** FLOP *** [3c 3h 8d]
Oprichnick90: checks 
77omsk: bets $0.18
Oprichnick90: calls $0.18
*** TURN *** [3c 3h 8d] [Kh]
Oprichnick90: checks 
77omsk: checks 
*** RIVER *** [3c 3h 8d Kh] [Kd]
Oprichnick90: checks 
77omsk: checks 
*** SHOW DOWN ***
Oprichnick90: shows [8h 9h] (two pair, Kings and Eights)
77omsk: shows [Th Tc] (two pair, Kings and Tens)
77omsk collected $0.67 from pot
*** SUMMARY ***
Total pot $0.69 | Rake $0.02 
Board [3c 3h 8d Kh Kd]
Seat 1: 77omsk (button) showed [Th Tc] and won ($0.67) with two pair, Kings and Tens
Seat 2: Loto70 (small blind) folded before Flop
Seat 3: Scaaalll (big blind) folded before Flop
Seat 4: MKIronCrAAzy folded before Flop (didn't bet)
Seat 5: man070707 folded before Flop (didn't bet)
Seat 6: Oprichnick90 showed [8h 9h] and lost with two pair, Kings and Eights



PokerStars Zoom Hand #229230233160:  Hold'em No Limit ($0.01/$0.02) - 2021/08/21 21:29:04 CET [2021/08/21 15:29:04 ET]
Table 'Halley' 6-max Seat #1 is the button
Seat 1: Murileus ($2.66 in chips) 
Seat 2: romochka1992 ($1.42 in chips) 
Seat 3: Scaaalll ($2.05 in chips) 
Seat 4: ADWish ($1.28 in chips) 
Seat 5: Walde21216 ($1.97 in chips) 
Seat 6: greenthum33 ($3.67 in chips) 
romochka1992: posts small blind $0.01
Scaaalll: posts big blind $0.02
*** HOLE CARDS ***
Dealt to Scaaalll [5s 8c]
ADWish: folds 
Walde21216: calls $0.02
greenthum33: folds 
Murileus: folds 
romochka1992: raises $0.06 to $0.08
Scaaalll: folds 
Walde21216: calls $0.06
*** FLOP *** [3s 7h Kc]
romochka1992: bets $0.10
Walde21216: folds 
Uncalled bet ($0.10) returned to romochka1992
romochka1992 collected $0.17 from pot
romochka1992: doesn't show hand 
*** SUMMARY ***
Total pot $0.18 | Rake $0.01 
Board [3s 7h Kc]
Seat 1: Murileus (button) folded before Flop (didn't bet)
Seat 2: romochka1992 (small blind) collected ($0.17)
Seat 3: Scaaalll (big blind) folded before Flop
Seat 4: ADWish folded before Flop (didn't bet)
Seat 5: Walde21216 folded on the Flop
Seat 6: greenthum33 folded before Flop (didn't bet)



PokerStars Zoom Hand #229230241363:  Hold'em No Limit ($0.01/$0.02) - 2021/08/21 21:29:23 CET [2021/08/21 15:29:23 ET]
Table 'Halley' 6-max Seat #1 is the button
Seat 1: 1_KoLizeI_1 ($2.42 in chips) 
Seat 2: Plmax94 ($1.60 in chips) 
Seat 3: JTbukowski ($1.42 in chips) 
Seat 4: Scaaalll ($2.03 in chips) 
Seat 5: NecromiconP ($2.21 in chips) 
Seat 6: Saint_ANBU ($3.53 in chips) 
Plmax94: posts small blind $0.01
JTbukowski: posts big blind $0.02
*** HOLE CARDS ***
Dealt to Scaaalll [Kd 3d]
Scaaalll: folds 
NecromiconP: folds 
Saint_ANBU: folds 
1_KoLizeI_1: folds 
Plmax94: folds 
Uncalled bet ($0.01) returned to JTbukowski
JTbukowski collected $0.02 from pot
JTbukowski: doesn't show hand 
*** SUMMARY ***
Total pot $0.02 | Rake $0 
Seat 1: 1_KoLizeI_1 (button) folded before Flop (didn't bet)
Seat 2: Plmax94 (small blind) folded before Flop
Seat 3: JTbukowski (big blind) collected ($0.02)
Seat 4: Scaaalll folded before Flop (didn't bet)
Seat 5: NecromiconP folded before Flop (didn't bet)
Seat 6: Saint_ANBU folded before Flop (didn't bet)



PokerStars Zoom Hand #229230245993:  Hold'em No Limit ($0.01/$0.02) - 2021/08/21 21:29:32 CET [2021/08/21 15:29:32 ET]
Table 'Halley' 6-max Seat #1 is the button
Seat 1: loukon579 ($3.55 in chips) 
Seat 2: lagesz32 ($1.92 in chips) 
Seat 3: BurnmasterX ($1.78 in chips) 
Seat 4: tema87 ($2.01 in chips) 
Seat 5: Sprot74 ($2.07 in chips) 
Seat 6: Scaaalll ($2.03 in chips) 
lagesz32: posts small blind $0.01
BurnmasterX: posts big blind $0.02
*** HOLE CARDS ***
Dealt to Scaaalll [Js 8c]
tema87: folds 
tema87 is disconnected 
Sprot74: folds 
Scaaalll: folds 
loukon579: calls $0.02
lagesz32: calls $0.01
BurnmasterX: checks 
*** FLOP *** [Ah Qh 8d]
lagesz32: checks 
BurnmasterX: checks 
loukon579: bets $0.70
lagesz32: folds 
lagesz32 is disconnected 
BurnmasterX: folds 
Uncalled bet ($0.70) returned to loukon579
loukon579 collected $0.06 from pot
loukon579: doesn't show hand 
*** SUMMARY ***
Total pot $0.06 | Rake $0 
Board [Ah Qh 8d]
Seat 1: loukon579 (button) collected ($0.06)
Seat 2: lagesz32 (small blind) folded on the Flop
Seat 3: BurnmasterX (big blind) folded on the Flop
Seat 4: tema87 folded before Flop (didn't bet)
Seat 5: Sprot74 folded before Flop (didn't bet)
Seat 6: Scaaalll folded before Flop (didn't bet)



PokerStars Zoom Hand #229230258562:  Hold'em No Limit ($0.01/$0.02) - 2021/08/21 21:30:00 CET [2021/08/21 15:30:00 ET]
Table 'Halley' 6-max Seat #1 is the button
Seat 1: Scaaalll ($2.02 in chips) 
Seat 2: satti1337 ($2 in chips) 
Seat 3: tsantanapoker ($3.43 in chips) 
Seat 4: lsd paper ($0.54 in chips) 
Seat 5: ctaceo ($2.12 in chips) 
Seat 6: EevAA190 ($2 in chips) 
satti1337: posts small blind $0.01
tsantanapoker: posts big blind $0.02
*** HOLE CARDS ***
Dealt to Scaaalll [9s 7c]
lsd paper: folds 
ctaceo: folds 
EevAA190: folds 
Scaaalll: folds 
lsd paper is disconnected 
satti1337: folds 
Uncalled bet ($0.01) returned to tsantanapoker
tsantanapoker collected $0.02 from pot
tsantanapoker: doesn't show hand 
*** SUMMARY ***
Total pot $0.02 | Rake $0 
Seat 1: Scaaalll (button) folded before Flop (didn't bet)
Seat 2: satti1337 (small blind) folded before Flop
Seat 3: tsantanapoker (big blind) collected ($0.02)
Seat 4: lsd paper folded before Flop (didn't bet)
Seat 5: ctaceo folded before Flop (didn't bet)
Seat 6: EevAA190 folded before Flop (didn't bet)



PokerStars Zoom Hand #229230260959:  Hold'em No Limit ($0.01/$0.02) - 2021/08/21 21:30:05 CET [2021/08/21 15:30:05 ET]
Table 'Halley' 6-max Seat #1 is the button
Seat 1: GeraKremmov ($1.70 in chips) 
Seat 2: Fedor_Gar ($2.36 in chips) 
Seat 3: pavlo8855 ($2 in chips) 
Seat 4: elmex886 ($2 in chips) 
Seat 5: maliniak75 ($1.64 in chips) 
Seat 6: Scaaalll ($2.02 in chips) 
Fedor_Gar: posts small blind $0.01
pavlo8855: posts big blind $0.02
*** HOLE CARDS ***
Dealt to Scaaalll [4d 4s]
elmex886: folds 
maliniak75: folds 
Scaaalll: raises $0.04 to $0.06
GeraKremmov: raises $0.15 to $0.21
Fedor_Gar: folds 
pavlo8855: folds 
Scaaalll: folds 
Uncalled bet ($0.15) returned to GeraKremmov
GeraKremmov collected $0.15 from pot
GeraKremmov: doesn't show hand 
*** SUMMARY ***
Total pot $0.15 | Rake $0 
Seat 1: GeraKremmov (button) collected ($0.15)
Seat 2: Fedor_Gar (small blind) folded before Flop
Seat 3: pavlo8855 (big blind) folded before Flop
Seat 4: elmex886 folded before Flop (didn't bet)
Seat 5: maliniak75 folded before Flop (didn't bet)
Seat 6: Scaaalll folded before Flop



PokerStars Zoom Hand #229230249701:  Hold'em No Limit ($0.01/$0.02) - 2021/08/21 21:29:40 CET [2021/08/21 15:29:40 ET]
Table 'Halley' 6-max Seat #1 is the button
Seat 1: Feliciano16 ($2.02 in chips) 
Seat 2: Scaaalll ($2.03 in chips) 
Seat 3: ARTMVSLV ($2 in chips) 
Seat 4: vtashmat1 ($3.26 in chips) 
Seat 5: Grama480 ($1.75 in chips) 
Seat 6: DaporteWins ($2.06 in chips) 
Scaaalll: posts small blind $0.01
ARTMVSLV: posts big blind $0.02
*** HOLE CARDS ***
Dealt to Scaaalll [8c Th]
vtashmat1 has timed out
vtashmat1: folds 
Grama480: folds 
DaporteWins: raises $0.03 to $0.05
Feliciano16: folds 
Scaaalll: folds 
ARTMVSLV: calls $0.03
*** FLOP *** [6s 2h Qh]
ARTMVSLV: checks 
DaporteWins: bets $0.07
ARTMVSLV: calls $0.07
*** TURN *** [6s 2h Qh] [6h]
ARTMVSLV: checks 
DaporteWins: bets $0.16
ARTMVSLV: calls $0.16
*** RIVER *** [6s 2h Qh 6h] [7s]
ARTMVSLV: checks 
DaporteWins: bets $0.22
ARTMVSLV: calls $0.22
*** SHOW DOWN ***
DaporteWins: shows [Ah Qs] (two pair, Queens and Sixes)
ARTMVSLV: shows [6d Kd] (three of a kind, Sixes)
ARTMVSLV collected $0.97 from pot
*** SUMMARY ***
Total pot $1.01 | Rake $0.04 
Board [6s 2h Qh 6h 7s]
Seat 1: Feliciano16 (button) folded before Flop (didn't bet)
Seat 2: Scaaalll (small blind) folded before Flop
Seat 3: ARTMVSLV (big blind) showed [6d Kd] and won ($0.97) with three of a kind, Sixes
Seat 4: vtashmat1 folded before Flop (didn't bet)
Seat 5: Grama480 folded before Flop (didn't bet)
Seat 6: DaporteWins showed [Ah Qs] and lost with two pair, Queens and Sixes



PokerStars Zoom Hand #229230297188:  Hold'em No Limit ($0.01/$0.02) - 2021/08/21 21:31:19 CET [2021/08/21 15:31:19 ET]
Table 'Halley' 6-max Seat #1 is the button
Seat 1: PapiMik3 ($2.14 in chips) 
Seat 2: elmex886 ($2.11 in chips) 
Seat 3: arrow17 ($2 in chips) 
Seat 4: keitho211 ($7.79 in chips) 
Seat 5: Scaaalll ($2 in chips) 
Seat 6: nodtress ($2.68 in chips) 
elmex886: posts small blind $0.01
arrow17: posts big blind $0.02
*** HOLE CARDS ***
Dealt to Scaaalll [7h 5s]
keitho211: folds 
Scaaalll: folds 
nodtress: folds 
PapiMik3: folds 
elmex886: folds 
Uncalled bet ($0.01) returned to arrow17
arrow17 collected $0.02 from pot
arrow17: doesn't show hand 
*** SUMMARY ***
Total pot $0.02 | Rake $0 
Seat 1: PapiMik3 (button) folded before Flop (didn't bet)
Seat 2: elmex886 (small blind) folded before Flop
Seat 3: arrow17 (big blind) collected ($0.02)
Seat 4: keitho211 folded before Flop (didn't bet)
Seat 5: Scaaalll folded before Flop (didn't bet)
Seat 6: nodtress folded before Flop (didn't bet)



PokerStars Zoom Hand #229230279096:  Hold'em No Limit ($0.01/$0.02) - 2021/08/21 21:30:43 CET [2021/08/21 15:30:43 ET]
Table 'Halley' 6-max Seat #1 is the button
Seat 1: klausC3 ($5.43 in chips) 
Seat 2: pavel28918012 ($2.01 in chips) 
Seat 3: fishh_play ($3.59 in chips) 
Seat 4: usenovm ($1.68 in chips) 
Seat 5: Scaaalll ($2 in chips) 
Seat 6: Nihility77 ($2.14 in chips) 
pavel28918012: posts small blind $0.01
fishh_play: posts big blind $0.02
*** HOLE CARDS ***
Dealt to Scaaalll [6c Kd]
usenovm: folds 
Scaaalll has timed out
Scaaalll: folds 
Nihility77: folds 
klausC3: raises $0.04 to $0.06
pavel28918012: folds 
fishh_play: calls $0.04
*** FLOP *** [7c 9d 8s]
fishh_play: bets $0.08
klausC3: calls $0.08
*** TURN *** [7c 9d 8s] [4c]
fishh_play: bets $0.16
klausC3: calls $0.16
*** RIVER *** [7c 9d 8s 4c] [Ks]
fishh_play: checks 
klausC3: checks 
*** SHOW DOWN ***
fishh_play: shows [Td Ah] (high card Ace)
klausC3: shows [8c Tc] (a pair of Eights)
klausC3 collected $0.59 from pot
*** SUMMARY ***
Total pot $0.61 | Rake $0.02 
Board [7c 9d 8s 4c Ks]
Seat 1: klausC3 (button) showed [8c Tc] and won ($0.59) with a pair of Eights
Seat 2: pavel28918012 (small blind) folded before Flop
Seat 3: fishh_play (big blind) showed [Td Ah] and lost with high card Ace
Seat 4: usenovm folded before Flop (didn't bet)
Seat 5: Scaaalll folded before Flop (didn't bet)
Seat 6: Nihility77 folded before Flop (didn't bet)



PokerStars Zoom Hand #229230299098:  Hold'em No Limit ($0.01/$0.02) - 2021/08/21 21:31:23 CET [2021/08/21 15:31:23 ET]
Table 'Halley' 6-max Seat #1 is the button
Seat 1: vladlen101 ($1.38 in chips) 
Seat 2: maliniak75 ($0.42 in chips) 
Seat 3: Azrael AR ($2.18 in chips) 
Seat 4: Scaaalll ($2 in chips) 
Seat 5: FCB-JW71 ($1.62 in chips) 
Seat 6: nodtress ($2.68 in chips) 
maliniak75: posts small blind $0.01
Azrael AR: posts big blind $0.02
*** HOLE CARDS ***
Dealt to Scaaalll [Qs 7s]
Scaaalll: folds 
FCB-JW71: raises $0.05 to $0.07
nodtress: folds 
vladlen101: folds 
maliniak75: folds 
Azrael AR: folds 
Uncalled bet ($0.05) returned to FCB-JW71
FCB-JW71 collected $0.05 from pot
FCB-JW71: doesn't show hand 
*** SUMMARY ***
Total pot $0.05 | Rake $0 
Seat 1: vladlen101 (button) folded before Flop (didn't bet)
Seat 2: maliniak75 (small blind) folded before Flop
Seat 3: Azrael AR (big blind) folded before Flop
Seat 4: Scaaalll folded before Flop (didn't bet)
Seat 5: FCB-JW71 collected ($0.05)
Seat 6: nodtress folded before Flop (didn't bet)



PokerStars Zoom Hand #229230290717:  Hold'em No Limit ($0.01/$0.02) - 2021/08/21 21:31:06 CET [2021/08/21 15:31:06 ET]
Table 'Halley' 6-max Seat #1 is the button
Seat 1: syndikkat ($2 in chips) 
Seat 2: Flankeris ($10.21 in chips) 
Seat 3: Scaaalll ($2 in chips) 
Seat 4: lsd paper ($0.46 in chips) 
Seat 5: 77omsk ($7.29 in chips) 
Seat 6: ximik D V ($2 in chips) 
Flankeris: posts small blind $0.01
Scaaalll: posts big blind $0.02
*** HOLE CARDS ***
Dealt to Scaaalll [Qs 7c]
lsd paper: folds 
lsd paper is disconnected 
77omsk: folds 
ximik D V: raises $0.04 to $0.06
syndikkat: calls $0.06
Flankeris: folds 
Scaaalll: folds 
*** FLOP *** [3h 9d 7s]
ximik D V: checks 
syndikkat: bets $0.11
ximik D V: calls $0.11
*** TURN *** [3h 9d 7s] [Ac]
ximik D V: bets $0.29
syndikkat: folds 
Uncalled bet ($0.29) returned to ximik D V
ximik D V collected $0.36 from pot
ximik D V: doesn't show hand 
*** SUMMARY ***
Total pot $0.37 | Rake $0.01 
Board [3h 9d 7s Ac]
Seat 1: syndikkat (button) folded on the Turn
Seat 2: Flankeris (small blind) folded before Flop
Seat 3: Scaaalll (big blind) folded before Flop
Seat 4: lsd paper folded before Flop (didn't bet)
Seat 5: 77omsk folded before Flop (didn't bet)
Seat 6: ximik D V collected ($0.36)



PokerStars Zoom Hand #229230300852:  Hold'em No Limit ($0.01/$0.02) - 2021/08/21 21:31:27 CET [2021/08/21 15:31:27 ET]
Table 'Halley' 6-max Seat #1 is the button
Seat 1: Scaaalll ($2 in chips) 
Seat 2: NecromiconP ($3.21 in chips) 
Seat 3: 77omsk ($4.49 in chips) 
Seat 4: AKirill34 ($1.20 in chips) 
Seat 5: lucksuckdonk ($3.61 in chips) 
Seat 6: ca$hmeoutsid ($2 in chips) 
NecromiconP: posts small blind $0.01
77omsk: posts big blind $0.02
*** HOLE CARDS ***
Dealt to Scaaalll [2s 5c]
AKirill34: folds 
lucksuckdonk: folds 
AKirill34 is disconnected 
ca$hmeoutsid: raises $0.04 to $0.06
Scaaalll: folds 
NecromiconP: calls $0.05
77omsk: folds 
*** FLOP *** [4d 9h 2h]
NecromiconP: checks 
ca$hmeoutsid: bets $0.07
NecromiconP: folds 
Uncalled bet ($0.07) returned to ca$hmeoutsid
ca$hmeoutsid collected $0.14 from pot
ca$hmeoutsid: doesn't show hand 
*** SUMMARY ***
Total pot $0.14 | Rake $0 
Board [4d 9h 2h]
Seat 1: Scaaalll (button) folded before Flop (didn't bet)
Seat 2: NecromiconP (small blind) folded on the Flop
Seat 3: 77omsk (big blind) folded before Flop
Seat 4: AKirill34 folded before Flop (didn't bet)
Seat 5: lucksuckdonk folded before Flop (didn't bet)
Seat 6: ca$hmeoutsid collected ($0.14)



PokerStars Zoom Hand #229230302716:  Hold'em No Limit ($0.01/$0.02) - 2021/08/21 21:31:31 CET [2021/08/21 15:31:31 ET]
Table 'Halley' 6-max Seat #1 is the button
Seat 1: igara tigara ($2.62 in chips) 
Seat 2: Scaaalll ($2 in chips) 
Seat 3: Mikalai M. ($0.45 in chips) 
Seat 4: pipecmolodec ($2 in chips) 
Seat 5: arsad725 ($6.98 in chips) 
Seat 6: romochka1992 ($1.44 in chips) 
Scaaalll: posts small blind $0.01
Mikalai M.: posts big blind $0.02
*** HOLE CARDS ***
Dealt to Scaaalll [Jh Qc]
pipecmolodec: folds 
arsad725: folds 
romochka1992: folds 
igara tigara: folds 
Scaaalll: raises $0.04 to $0.06
Mikalai M.: calls $0.04
*** FLOP *** [8d 9s 4s]
Scaaalll: bets $0.08
Mikalai M.: folds 
Uncalled bet ($0.08) returned to Scaaalll
Scaaalll collected $0.12 from pot
Scaaalll: doesn't show hand 
Mikalai M. is disconnected 
*** SUMMARY ***
Total pot $0.12 | Rake $0 
Board [8d 9s 4s]
Seat 1: igara tigara (button) folded before Flop (didn't bet)
Seat 2: Scaaalll (small blind) collected ($0.12)
Seat 3: Mikalai M. (big blind) folded on the Flop
Seat 4: pipecmolodec folded before Flop (didn't bet)
Seat 5: arsad725 folded before Flop (didn't bet)
Seat 6: romochka1992 folded before Flop (didn't bet)



PokerStars Zoom Hand #229230319817:  Hold'em No Limit ($0.01/$0.02) - 2021/08/21 21:32:08 CET [2021/08/21 15:32:08 ET]
Table 'Halley' 6-max Seat #1 is the button
Seat 1: Plmax94 ($1.47 in chips) 
Seat 2: Flankeris ($6.17 in chips) 
Seat 3: flexitunes ($0.78 in chips) 
Seat 4: xmaksimus ($2 in chips) 
Seat 5: Scaaalll ($2.06 in chips) 
Seat 6: csmall14 ($2.01 in chips) 
Flankeris: posts small blind $0.01
flexitunes: posts big blind $0.02
*** HOLE CARDS ***
Dealt to Scaaalll [As Jd]
xmaksimus: folds 
Scaaalll: raises $0.04 to $0.06
csmall14: folds 
Plmax94: folds 
Flankeris: folds 
flexitunes: calls $0.04
*** FLOP *** [7s 6s 3c]
flexitunes: checks 
Scaaalll: bets $0.08
flexitunes: raises $0.09 to $0.17
Scaaalll: folds 
Uncalled bet ($0.09) returned to flexitunes
flexitunes collected $0.28 from pot
flexitunes: doesn't show hand 
*** SUMMARY ***
Total pot $0.29 | Rake $0.01 
Board [7s 6s 3c]
Seat 1: Plmax94 (button) folded before Flop (didn't bet)
Seat 2: Flankeris (small blind) folded before Flop
Seat 3: flexitunes (big blind) collected ($0.28)
Seat 4: xmaksimus folded before Flop (didn't bet)
Seat 5: Scaaalll folded on the Flop
Seat 6: csmall14 folded before Flop (didn't bet)



PokerStars Zoom Hand #229230338131:  Hold'em No Limit ($0.01/$0.02) - 2021/08/21 21:32:46 CET [2021/08/21 15:32:46 ET]
Table 'Halley' 6-max Seat #1 is the button
Seat 1: iPitbull1 ($4.03 in chips) 
Seat 2: lsd paper ($0.29 in chips) 
Seat 3: Scaaalll ($2 in chips) 
Seat 4: DaporteWins ($2 in chips) 
Seat 5: Gamer577 ($2.03 in chips) 
Seat 6: valet_hai ($0.98 in chips) 
lsd paper: posts small blind $0.01
Scaaalll: posts big blind $0.02
*** HOLE CARDS ***
Dealt to Scaaalll [7s Qs]
DaporteWins: folds 
Gamer577: folds 
lsd paper is disconnected 
valet_hai: folds 
iPitbull1: folds 
lsd paper: folds 
Uncalled bet ($0.01) returned to Scaaalll
Scaaalll collected $0.02 from pot
Scaaalll: doesn't show hand 
*** SUMMARY ***
Total pot $0.02 | Rake $0 
Seat 1: iPitbull1 (button) folded before Flop (didn't bet)
Seat 2: lsd paper (small blind) folded before Flop
Seat 3: Scaaalll (big blind) collected ($0.02)
Seat 4: DaporteWins folded before Flop (didn't bet)
Seat 5: Gamer577 folded before Flop (didn't bet)
Seat 6: valet_hai folded before Flop (didn't bet)



PokerStars Zoom Hand #229230342746:  Hold'em No Limit ($0.01/$0.02) - 2021/08/21 21:32:56 CET [2021/08/21 15:32:56 ET]
Table 'Halley' 6-max Seat #1 is the button
Seat 1: ser313131 ($2.30 in chips) 
Seat 2: kisaku4 ($2 in chips) 
Seat 3: MrRussia777 ($1.04 in chips) 
Seat 4: malandro733 ($2.02 in chips) 
Seat 5: thi_spe ($2.58 in chips) 
Seat 6: Scaaalll ($2.01 in chips) 
kisaku4: posts small blind $0.01
MrRussia777: posts big blind $0.02
*** HOLE CARDS ***
Dealt to Scaaalll [5c 8d]
malandro733: folds 
thi_spe: folds 
Scaaalll: folds 
ser313131: raises $0.02 to $0.04
kisaku4: folds 
MrRussia777: calls $0.02
*** FLOP *** [Jc 2h 3s]
MrRussia777: checks 
ser313131: bets $0.07
MrRussia777: folds 
Uncalled bet ($0.07) returned to ser313131
ser313131 collected $0.09 from pot
ser313131: doesn't show hand 
*** SUMMARY ***
Total pot $0.09 | Rake $0 
Board [Jc 2h 3s]
Seat 1: ser313131 (button) collected ($0.09)
Seat 2: kisaku4 (small blind) folded before Flop
Seat 3: MrRussia777 (big blind) folded on the Flop
Seat 4: malandro733 folded before Flop (didn't bet)
Seat 5: thi_spe folded before Flop (didn't bet)
Seat 6: Scaaalll folded before Flop (didn't bet)



PokerStars Zoom Hand #229230346501:  Hold'em No Limit ($0.01/$0.02) - 2021/08/21 21:33:04 CET [2021/08/21 15:33:04 ET]
Table 'Halley' 6-max Seat #1 is the button
Seat 1: dkno77 ($1.85 in chips) 
Seat 2: Scaaalll ($2.01 in chips) 
Seat 3: snowy_96 ($2 in chips) 
Seat 4: Daveys14 ($0.87 in chips) 
Seat 5: Shadi8 ($2.63 in chips) 
Seat 6: EevAA190 ($3.89 in chips) 
Scaaalll: posts small blind $0.01
snowy_96: posts big blind $0.02
*** HOLE CARDS ***
Dealt to Scaaalll [7c 6s]
Daveys14: calls $0.02
Shadi8: folds 
EevAA190: folds 
dkno77: raises $0.02 to $0.04
Scaaalll: folds 
snowy_96: folds 
Daveys14: calls $0.02
*** FLOP *** [8d Ah 7s]
Daveys14: checks 
dkno77: bets $0.06
Daveys14: calls $0.06
*** TURN *** [8d Ah 7s] [Td]
Daveys14: bets $0.06
dkno77: calls $0.06
*** RIVER *** [8d Ah 7s Td] [Ts]
Daveys14: bets $0.30
dkno77: folds 
Uncalled bet ($0.30) returned to Daveys14
Daveys14 collected $0.34 from pot
Daveys14: doesn't show hand 
*** SUMMARY ***
Total pot $0.35 | Rake $0.01 
Board [8d Ah 7s Td Ts]
Seat 1: dkno77 (button) folded on the River
Seat 2: Scaaalll (small blind) folded before Flop
Seat 3: snowy_96 (big blind) folded before Flop
Seat 4: Daveys14 collected ($0.34)
Seat 5: Shadi8 folded before Flop (didn't bet)
Seat 6: EevAA190 folded before Flop (didn't bet)



PokerStars Zoom Hand #229230344660:  Hold'em No Limit ($0.01/$0.02) - 2021/08/21 21:33:00 CET [2021/08/21 15:33:00 ET]
Table 'Halley' 6-max Seat #1 is the button
Seat 1: Scaaalll ($2.01 in chips) 
Seat 2: amergedon ($1.04 in chips) 
Seat 3: ximik D V ($2.10 in chips) 
Seat 4: ChowMangao ($2.10 in chips) 
Seat 5: sg.32rus ($1.40 in chips) 
Seat 6: 77omsk ($7.30 in chips) 
amergedon: posts small blind $0.01
ximik D V: posts big blind $0.02
*** HOLE CARDS ***
Dealt to Scaaalll [Kd 7c]
ChowMangao: raises $0.03 to $0.05
sg.32rus: folds 
77omsk: folds 
Scaaalll: folds 
amergedon: calls $0.04
ximik D V: folds 
*** FLOP *** [Th Kh 4s]
amergedon: bets $0.06
ChowMangao: calls $0.06
*** TURN *** [Th Kh 4s] [4h]
amergedon: checks 
ChowMangao: checks 
*** RIVER *** [Th Kh 4s 4h] [Jh]
amergedon: bets $0.23
ChowMangao: raises $0.77 to $1
amergedon: calls $0.70 and is all-in
Uncalled bet ($0.07) returned to ChowMangao
*** SHOW DOWN ***
ChowMangao: shows [Jc Jd] (a full house, Jacks full of Fours)
amergedon: shows [Qh Qs] (a flush, King high)
ChowMangao collected $2.03 from pot
*** SUMMARY ***
Total pot $2.10 | Rake $0.07 
Board [Th Kh 4s 4h Jh]
Seat 1: Scaaalll (button) folded before Flop (didn't bet)
Seat 2: amergedon (small blind) showed [Qh Qs] and lost with a flush, King high
Seat 3: ximik D V (big blind) folded before Flop
Seat 4: ChowMangao showed [Jc Jd] and won ($2.03) with a full house, Jacks full of Fours
Seat 5: sg.32rus folded before Flop (didn't bet)
Seat 6: 77omsk folded before Flop (didn't bet)



PokerStars Zoom Hand #229230351189:  Hold'em No Limit ($0.01/$0.02) - 2021/08/21 21:33:15 CET [2021/08/21 15:33:15 ET]
Table 'Halley' 6-max Seat #1 is the button
Seat 1: ugi-dugi ($2 in chips) 
Seat 2: snowy_96 ($2 in chips) 
Seat 3: Gamer577 ($2.02 in chips) 
Seat 4: Scaaalll ($2 in chips) 
Seat 5: olga3021221 ($2.56 in chips) 
Seat 6: no way yo ($1.08 in chips) 
snowy_96: posts small blind $0.01
Gamer577: posts big blind $0.02
*** HOLE CARDS ***
Dealt to Scaaalll [5c 4h]
Scaaalll: folds 
olga3021221: raises $0.03 to $0.05
no way yo: folds 
ugi-dugi: folds 
snowy_96: calls $0.04
Gamer577: calls $0.03
*** FLOP *** [9c 7s Td]
snowy_96: checks 
Gamer577: checks 
olga3021221: checks 
*** TURN *** [9c 7s Td] [4s]
snowy_96: bets $0.06
Gamer577: calls $0.06
olga3021221: folds 
*** RIVER *** [9c 7s Td 4s] [2h]
snowy_96: checks 
Gamer577: checks 
*** SHOW DOWN ***
snowy_96: shows [Tc Ac] (a pair of Tens)
Gamer577: mucks hand 
snowy_96 collected $0.26 from pot
*** SUMMARY ***
Total pot $0.27 | Rake $0.01 
Board [9c 7s Td 4s 2h]
Seat 1: ugi-dugi (button) folded before Flop (didn't bet)
Seat 2: snowy_96 (small blind) showed [Tc Ac] and won ($0.26) with a pair of Tens
Seat 3: Gamer577 (big blind) mucked [Kc Qc]
Seat 4: Scaaalll folded before Flop (didn't bet)
Seat 5: olga3021221 folded on the Turn
Seat 6: no way yo folded before Flop (didn't bet)



PokerStars Zoom Hand #229230368940:  Hold'em No Limit ($0.01/$0.02) - 2021/08/21 21:33:53 CET [2021/08/21 15:33:53 ET]
Table 'Halley' 6-max Seat #1 is the button
Seat 1: ugi-dugi ($2 in chips) 
Seat 2: NOLUWDtC ($2.53 in chips) 
Seat 3: Scaaalll ($2 in chips) 
Seat 4: Sharabora ($0.79 in chips) 
Seat 5: Koldun 2636 ($3.58 in chips) 
Seat 6: staviko ($2.33 in chips) 
NOLUWDtC: posts small blind $0.01
Scaaalll: posts big blind $0.02
*** HOLE CARDS ***
Dealt to Scaaalll [7c Kh]
Sharabora: folds 
Koldun 2636: raises $0.03 to $0.05
staviko: folds 
ugi-dugi: folds 
NOLUWDtC: folds 
NOLUWDtC is disconnected 
Scaaalll: folds 
Uncalled bet ($0.03) returned to Koldun 2636
Koldun 2636 collected $0.05 from pot
Koldun 2636: doesn't show hand 
*** SUMMARY ***
Total pot $0.05 | Rake $0 
Seat 1: ugi-dugi (button) folded before Flop (didn't bet)
Seat 2: NOLUWDtC (small blind) folded before Flop
Seat 3: Scaaalll (big blind) folded before Flop
Seat 4: Sharabora folded before Flop (didn't bet)
Seat 5: Koldun 2636 collected ($0.05)
Seat 6: staviko folded before Flop (didn't bet)



PokerStars Zoom Hand #229230376375:  Hold'em No Limit ($0.01/$0.02) - 2021/08/21 21:34:08 CET [2021/08/21 15:34:08 ET]
Table 'Halley' 6-max Seat #1 is the button
Seat 1: Sharabora ($0.76 in chips) 
Seat 2: Toschi07 ($1.12 in chips) 
Seat 3: Ryota 8 Suzui ($0.89 in chips) 
Seat 4: meikoz ($2 in chips) 
Seat 5: Scaaalll ($2 in chips) 
Seat 6: PlayPokerHappy1 ($2 in chips) 
Toschi07: posts small blind $0.01
Ryota 8 Suzui: posts big blind $0.02
*** HOLE CARDS ***
Dealt to Scaaalll [Kc 7h]
meikoz: folds 
Scaaalll: folds 
PlayPokerHappy1: folds 
Sharabora: folds 
Toschi07: folds 
Uncalled bet ($0.01) returned to Ryota 8 Suzui
Ryota 8 Suzui collected $0.02 from pot
Ryota 8 Suzui: doesn't show hand 
*** SUMMARY ***
Total pot $0.02 | Rake $0 
Seat 1: Sharabora (button) folded before Flop (didn't bet)
Seat 2: Toschi07 (small blind) folded before Flop
Seat 3: Ryota 8 Suzui (big blind) collected ($0.02)
Seat 4: meikoz folded before Flop (didn't bet)
Seat 5: Scaaalll folded before Flop (didn't bet)
Seat 6: PlayPokerHappy1 folded before Flop (didn't bet)



PokerStars Zoom Hand #229230353107:  Hold'em No Limit ($0.01/$0.02) - 2021/08/21 21:33:18 CET [2021/08/21 15:33:18 ET]
Table 'Halley' 6-max Seat #1 is the button
Seat 1: IIWardyII ($3.67 in chips) 
Seat 2: NecromiconP ($3.12 in chips) 
Seat 3: Syd Wright ($2 in chips) 
Seat 4: Kb013497 ($2.23 in chips) 
Seat 5: Baksit79 ($2.96 in chips) 
Seat 6: Scaaalll ($2 in chips) 
NecromiconP: posts small blind $0.01
Syd Wright: posts big blind $0.02
*** HOLE CARDS ***
Dealt to Scaaalll [7c Kc]
Kb013497 has timed out
Kb013497: folds 
Baksit79: raises $0.05 to $0.07
Scaaalll: folds 
IIWardyII: folds 
NecromiconP: folds 
Syd Wright: folds 
Uncalled bet ($0.05) returned to Baksit79
Baksit79 collected $0.05 from pot
Baksit79: doesn't show hand 
*** SUMMARY ***
Total pot $0.05 | Rake $0 
Seat 1: IIWardyII (button) folded before Flop (didn't bet)
Seat 2: NecromiconP (small blind) folded before Flop
Seat 3: Syd Wright (big blind) folded before Flop
Seat 4: Kb013497 folded before Flop (didn't bet)
Seat 5: Baksit79 collected ($0.05)
Seat 6: Scaaalll folded before Flop (didn't bet)



PokerStars Zoom Hand #229230359111:  Hold'em No Limit ($0.01/$0.02) - 2021/08/21 21:33:31 CET [2021/08/21 15:33:31 ET]
Table 'Halley' 6-max Seat #1 is the button
Seat 1: Fedor_Gar ($2 in chips) 
Seat 2: STE1NBERG ($3.47 in chips) 
Seat 3: pavlo8855 ($2 in chips) 
Seat 4: Ferr4r1430 ($3.70 in chips) 
Seat 5: Scaaalll ($2 in chips) 
Seat 6: ferx1989 ($3.75 in chips) 
STE1NBERG: posts small blind $0.01
pavlo8855: posts big blind $0.02
*** HOLE CARDS ***
Dealt to Scaaalll [Js 3s]
Ferr4r1430: folds 
Ferr4r1430 is disconnected 
Scaaalll: folds 
ferx1989: raises $0.04 to $0.06
Fedor_Gar: calls $0.06
STE1NBERG: folds 
pavlo8855: calls $0.04
*** FLOP *** [Qc 7s 6h]
pavlo8855: checks 
ferx1989: checks 
Fedor_Gar: bets $0.09
pavlo8855: calls $0.09
ferx1989: folds 
*** TURN *** [Qc 7s 6h] [3h]
pavlo8855: checks 
Fedor_Gar: bets $0.24
pavlo8855: calls $0.24
*** RIVER *** [Qc 7s 6h 3h] [Td]
pavlo8855: checks 
Fedor_Gar: checks 
*** SHOW DOWN ***
pavlo8855: shows [Qd Kh] (a pair of Queens)
Fedor_Gar: mucks hand 
pavlo8855 collected $0.82 from pot
*** SUMMARY ***
Total pot $0.85 | Rake $0.03 
Board [Qc 7s 6h 3h Td]
Seat 1: Fedor_Gar (button) mucked [5h 5d]
Seat 2: STE1NBERG (small blind) folded before Flop
Seat 3: pavlo8855 (big blind) showed [Qd Kh] and won ($0.82) with a pair of Queens
Seat 4: Ferr4r1430 folded before Flop (didn't bet)
Seat 5: Scaaalll folded before Flop (didn't bet)
Seat 6: ferx1989 folded on the Flop



PokerStars Zoom Hand #229230364213:  Hold'em No Limit ($0.01/$0.02) - 2021/08/21 21:33:42 CET [2021/08/21 15:33:42 ET]
Table 'Halley' 6-max Seat #1 is the button
Seat 1: jaamonra ($2.11 in chips) 
Seat 2: Sinad1302 ($3.10 in chips) 
Seat 3: martifact ($2 in chips) 
Seat 4: courneyea79 ($1.94 in chips) 
Seat 5: FabOliveira9 ($2.89 in chips) 
Seat 6: Scaaalll ($2 in chips) 
Sinad1302: posts small blind $0.01
martifact: posts big blind $0.02
*** HOLE CARDS ***
Dealt to Scaaalll [Td Ah]
courneyea79: raises $0.04 to $0.06
FabOliveira9: calls $0.06
Sinad1302 is disconnected 
Scaaalll: folds 
jaamonra: folds 
Sinad1302: folds 
martifact: raises $0.19 to $0.25
courneyea79: calls $0.19
FabOliveira9: folds 
*** FLOP *** [Kh 7d 6d]
martifact: bets $0.41
courneyea79: raises $1.28 to $1.69 and is all-in
martifact: folds 
Uncalled bet ($1.28) returned to courneyea79
courneyea79 collected $1.34 from pot
courneyea79: doesn't show hand 
*** SUMMARY ***
Total pot $1.39 | Rake $0.05 
Board [Kh 7d 6d]
Seat 1: jaamonra (button) folded before Flop (didn't bet)
Seat 2: Sinad1302 (small blind) folded before Flop
Seat 3: martifact (big blind) folded on the Flop
Seat 4: courneyea79 collected ($1.34)
Seat 5: FabOliveira9 folded before Flop
Seat 6: Scaaalll folded before Flop (didn't bet)



PokerStars Zoom Hand #229230378226:  Hold'em No Limit ($0.01/$0.02) - 2021/08/21 21:34:12 CET [2021/08/21 15:34:12 ET]
Table 'Halley' 6-max Seat #1 is the button
Seat 1: gasmar_29 ($4.53 in chips) 
Seat 2: Scaaalll ($2 in chips) 
Seat 3: IamFixxed ($5.77 in chips) 
Seat 4: Jones278 ($2.61 in chips) 
Seat 5: le_vlimeux ($5.29 in chips) 
Seat 6: mrfastflow ($1.85 in chips) 
Scaaalll: posts small blind $0.01
IamFixxed: posts big blind $0.02
*** HOLE CARDS ***
Dealt to Scaaalll [7c Ac]
Jones278: raises $0.04 to $0.06
le_vlimeux: folds 
mrfastflow: folds 
gasmar_29: folds 
Scaaalll: folds 
IamFixxed: folds 
Uncalled bet ($0.04) returned to Jones278
Jones278 collected $0.05 from pot
Jones278: doesn't show hand 
*** SUMMARY ***
Total pot $0.05 | Rake $0 
Seat 1: gasmar_29 (button) folded before Flop (didn't bet)
Seat 2: Scaaalll (small blind) folded before Flop
Seat 3: IamFixxed (big blind) folded before Flop
Seat 4: Jones278 collected ($0.05)
Seat 5: le_vlimeux folded before Flop (didn't bet)
Seat 6: mrfastflow folded before Flop (didn't bet)



PokerStars Zoom Hand #229230389567:  Hold'em No Limit ($0.01/$0.02) - 2021/08/21 21:34:36 CET [2021/08/21 15:34:36 ET]
Table 'Halley' 6-max Seat #1 is the button
Seat 1: kahzura ($2.03 in chips) 
Seat 2: steph206 ($1.63 in chips) 
Seat 3: bt710 ($2.08 in chips) 
Seat 4: Scaaalll ($2 in chips) 
Seat 5: Saint_ANBU ($2 in chips) 
Seat 6: Syd Wright ($2.01 in chips) 
steph206: posts small blind $0.01
bt710: posts big blind $0.02
*** HOLE CARDS ***
Dealt to Scaaalll [6h Ts]
Scaaalll: folds 
Saint_ANBU: folds 
Syd Wright: folds 
kahzura: folds 
steph206: folds 
Uncalled bet ($0.01) returned to bt710
bt710 collected $0.02 from pot
bt710: doesn't show hand 
*** SUMMARY ***
Total pot $0.02 | Rake $0 
Seat 1: kahzura (button) folded before Flop (didn't bet)
Seat 2: steph206 (small blind) folded before Flop
Seat 3: bt710 (big blind) collected ($0.02)
Seat 4: Scaaalll folded before Flop (didn't bet)
Seat 5: Saint_ANBU folded before Flop (didn't bet)
Seat 6: Syd Wright folded before Flop (didn't bet)



PokerStars Zoom Hand #229230392744:  Hold'em No Limit ($0.01/$0.02) - 2021/08/21 21:34:43 CET [2021/08/21 15:34:43 ET]
Table 'Halley' 6-max Seat #1 is the button
Seat 1: klausC3 ($5.87 in chips) 
Seat 2: GiordanoBrn ($2.03 in chips) 
Seat 3: Scaaalll ($2 in chips) 
Seat 4: johniXL ($0.60 in chips) 
Seat 5: NOLUWDtC ($2.49 in chips) 
Seat 6: G1olight ($2.07 in chips) 
GiordanoBrn: posts small blind $0.01
Scaaalll: posts big blind $0.02
*** HOLE CARDS ***
Dealt to Scaaalll [8s Jc]
G1olight is disconnected 
johniXL: folds 
NOLUWDtC: raises $0.04 to $0.06
G1olight: folds 
klausC3: folds 
GiordanoBrn: folds 
Scaaalll: folds 
Uncalled bet ($0.04) returned to NOLUWDtC
GiordanoBrn is disconnected 
NOLUWDtC collected $0.05 from pot
NOLUWDtC: doesn't show hand 
*** SUMMARY ***
Total pot $0.05 | Rake $0 
Seat 1: klausC3 (button) folded before Flop (didn't bet)
Seat 2: GiordanoBrn (small blind) folded before Flop
Seat 3: Scaaalll (big blind) folded before Flop
Seat 4: johniXL folded before Flop (didn't bet)
Seat 5: NOLUWDtC collected ($0.05)
Seat 6: G1olight folded before Flop (didn't bet)



PokerStars Zoom Hand #229230395918:  Hold'em No Limit ($0.01/$0.02) - 2021/08/21 21:34:50 CET [2021/08/21 15:34:50 ET]
Table 'Halley' 6-max Seat #1 is the button
Seat 1: timasblemba ($3.96 in chips) 
Seat 2: Scaaalll ($2 in chips) 
Seat 3: Ichverdammt ($1.04 in chips) 
Seat 4: Henry Chinasky ($2.44 in chips) 
Seat 5: malandro733 ($3.89 in chips) 
Seat 6: kahzura ($2.03 in chips) 
Scaaalll: posts small blind $0.01
Ichverdammt: posts big blind $0.02
*** HOLE CARDS ***
Dealt to Scaaalll [7h Qd]
Henry Chinasky: folds 
malandro733: folds 
kahzura: folds 
timasblemba: folds 
Scaaalll: folds 
Uncalled bet ($0.01) returned to Ichverdammt
Ichverdammt collected $0.02 from pot
Ichverdammt: doesn't show hand 
*** SUMMARY ***
Total pot $0.02 | Rake $0 
Seat 1: timasblemba (button) folded before Flop (didn't bet)
Seat 2: Scaaalll (small blind) folded before Flop
Seat 3: Ichverdammt (big blind) collected ($0.02)
Seat 4: Henry Chinasky folded before Flop (didn't bet)
Seat 5: malandro733 folded before Flop (didn't bet)
Seat 6: kahzura folded before Flop (didn't bet)



PokerStars Zoom Hand #229230385715:  Hold'em No Limit ($0.01/$0.02) - 2021/08/21 21:34:28 CET [2021/08/21 15:34:28 ET]
Table 'Halley' 6-max Seat #1 is the button
Seat 1: Scaaalll ($2 in chips) 
Seat 2: FabOliveira9 ($2.83 in chips) 
Seat 3: Ferr4r1430 ($3.67 in chips) 
Seat 4: skatocharlie ($2.42 in chips) 
Seat 5: felipeciji ($2.30 in chips) 
Seat 6: takeatrip180 ($3.95 in chips) 
FabOliveira9: posts small blind $0.01
Ferr4r1430: posts big blind $0.02
*** HOLE CARDS ***
Dealt to Scaaalll [9d 3s]
skatocharlie: folds 
felipeciji: folds 
takeatrip180: raises $0.04 to $0.06
Scaaalll: folds 
FabOliveira9: calls $0.05
Ferr4r1430: calls $0.04
*** FLOP *** [4c As 5c]
FabOliveira9: checks 
Ferr4r1430: checks 
takeatrip180: bets $0.17
FabOliveira9: folds 
Ferr4r1430: folds 
Uncalled bet ($0.17) returned to takeatrip180
takeatrip180 collected $0.17 from pot
takeatrip180: doesn't show hand 
Ferr4r1430 is disconnected 
*** SUMMARY ***
Total pot $0.18 | Rake $0.01 
Board [4c As 5c]
Seat 1: Scaaalll (button) folded before Flop (didn't bet)
Seat 2: FabOliveira9 (small blind) folded on the Flop
Seat 3: Ferr4r1430 (big blind) folded on the Flop
Seat 4: skatocharlie folded before Flop (didn't bet)
Seat 5: felipeciji folded before Flop (didn't bet)
Seat 6: takeatrip180 collected ($0.17)



PokerStars Zoom Hand #229230402346:  Hold'em No Limit ($0.01/$0.02) - 2021/08/21 21:35:05 CET [2021/08/21 15:35:05 ET]
Table 'Halley' 6-max Seat #1 is the button
Seat 1: NecromiconP ($2.74 in chips) 
Seat 2: felipeciji ($2 in chips) 
Seat 3: Shumayloff ($1.85 in chips) 
Seat 4: Scaaalll ($2 in chips) 
Seat 5: Aroma Iceland ($6.07 in chips) 
Seat 6: corazoncelta ($1.46 in chips) 
felipeciji: posts small blind $0.01
Shumayloff: posts big blind $0.02
*** HOLE CARDS ***
Dealt to Scaaalll [Ks Js]
Scaaalll: raises $0.04 to $0.06
Aroma Iceland: folds 
corazoncelta: folds 
NecromiconP: folds 
felipeciji: folds 
Shumayloff: raises $0.13 to $0.19
Scaaalll: folds 
Uncalled bet ($0.13) returned to Shumayloff
Shumayloff collected $0.13 from pot
Shumayloff: doesn't show hand 
*** SUMMARY ***
Total pot $0.13 | Rake $0 
Seat 1: NecromiconP (button) folded before Flop (didn't bet)
Seat 2: felipeciji (small blind) folded before Flop
Seat 3: Shumayloff (big blind) collected ($0.13)
Seat 4: Scaaalll folded before Flop
Seat 5: Aroma Iceland folded before Flop (didn't bet)
Seat 6: corazoncelta folded before Flop (didn't bet)



PokerStars Zoom Hand #229230400063:  Hold'em No Limit ($0.01/$0.02) - 2021/08/21 21:34:59 CET [2021/08/21 15:34:59 ET]
Table 'Halley' 6-max Seat #1 is the button
Seat 1: z1z2z315 ($0.93 in chips) 
Seat 2: Nihility77 ($2.61 in chips) 
Seat 3: ib0man ($2 in chips) 
Seat 4: Scaaalll ($2 in chips) 
Seat 5: bigbaddaddy9 ($6.47 in chips) 
Seat 6: kickBrain ($6.47 in chips) 
Nihility77: posts small blind $0.01
ib0man: posts big blind $0.02
*** HOLE CARDS ***
Dealt to Scaaalll [7s 6d]
Scaaalll: folds 
bigbaddaddy9: calls $0.02
kickBrain: folds 
z1z2z315: folds 
Nihility77: raises $0.08 to $0.10
ib0man: folds 
bigbaddaddy9: calls $0.08
*** FLOP *** [9s 6h 4s]
Nihility77: checks 
bigbaddaddy9: bets $0.16
Nihility77: folds 
Uncalled bet ($0.16) returned to bigbaddaddy9
bigbaddaddy9 collected $0.21 from pot
bigbaddaddy9: doesn't show hand 
*** SUMMARY ***
Total pot $0.22 | Rake $0.01 
Board [9s 6h 4s]
Seat 1: z1z2z315 (button) folded before Flop (didn't bet)
Seat 2: Nihility77 (small blind) folded on the Flop
Seat 3: ib0man (big blind) folded before Flop
Seat 4: Scaaalll folded before Flop (didn't bet)
Seat 5: bigbaddaddy9 collected ($0.21)
Seat 6: kickBrain folded before Flop (didn't bet)



PokerStars Zoom Hand #229230411596:  Hold'em No Limit ($0.01/$0.02) - 2021/08/21 21:35:24 CET [2021/08/21 15:35:24 ET]
Table 'Halley' 6-max Seat #1 is the button
Seat 1: Scaaalll ($2 in chips) 
Seat 2: 2m4m4 ($2.64 in chips) 
Seat 3: Kb013497 ($2.40 in chips) 
Seat 4: belbo888 ($3.46 in chips) 
Seat 5: Ferr4r1430 ($3.60 in chips) 
Seat 6: superstar1070 ($0.96 in chips) 
2m4m4: posts small blind $0.01
Kb013497: posts big blind $0.02
*** HOLE CARDS ***
Dealt to Scaaalll [2s 5s]
belbo888: folds 
Ferr4r1430: folds 
Ferr4r1430 is disconnected 
superstar1070: raises $0.04 to $0.06
Scaaalll: folds 
2m4m4: folds 
Kb013497: folds 
Uncalled bet ($0.04) returned to superstar1070
superstar1070 collected $0.05 from pot
superstar1070: doesn't show hand 
*** SUMMARY ***
Total pot $0.05 | Rake $0 
Seat 1: Scaaalll (button) folded before Flop (didn't bet)
Seat 2: 2m4m4 (small blind) folded before Flop
Seat 3: Kb013497 (big blind) folded before Flop
Seat 4: belbo888 folded before Flop (didn't bet)
Seat 5: Ferr4r1430 folded before Flop (didn't bet)
Seat 6: superstar1070 collected ($0.05)



PokerStars Zoom Hand #229230419130:  Hold'em No Limit ($0.01/$0.02) - 2021/08/21 21:35:41 CET [2021/08/21 15:35:41 ET]
Table 'Halley' 6-max Seat #1 is the button
Seat 1: Haraldo550 ($3.11 in chips) 
Seat 2: Scaaalll ($2 in chips) 
Seat 3: belbo888 ($3.45 in chips) 
Seat 4: Gamer577 ($2.49 in chips) 
Seat 5: 1_KoLizeI_1 ($2.70 in chips) 
Seat 6: sg.32rus ($1.49 in chips) 
Scaaalll: posts small blind $0.01
belbo888: posts big blind $0.02
*** HOLE CARDS ***
Dealt to Scaaalll [Qh 8c]
Gamer577: folds 
Haraldo550 is disconnected 
1_KoLizeI_1: folds 
sg.32rus: folds 
Haraldo550: folds 
Scaaalll: folds 
Uncalled bet ($0.01) returned to belbo888
belbo888 collected $0.02 from pot
belbo888: doesn't show hand 
*** SUMMARY ***
Total pot $0.02 | Rake $0 
Seat 1: Haraldo550 (button) folded before Flop (didn't bet)
Seat 2: Scaaalll (small blind) folded before Flop
Seat 3: belbo888 (big blind) collected ($0.02)
Seat 4: Gamer577 folded before Flop (didn't bet)
Seat 5: 1_KoLizeI_1 folded before Flop (didn't bet)
Seat 6: sg.32rus folded before Flop (didn't bet)



PokerStars Zoom Hand #229230425227:  Hold'em No Limit ($0.01/$0.02) - 2021/08/21 21:35:53 CET [2021/08/21 15:35:53 ET]
Table 'Halley' 6-max Seat #1 is the button
Seat 1: zbixxx ($4.17 in chips) 
Seat 2: arrow17 ($2.01 in chips) 
Seat 3: olga3021221 ($2.52 in chips) 
Seat 4: amario89 ($2.23 in chips) 
Seat 5: Pray_to_win ($2.59 in chips) 
Seat 6: Scaaalll ($2 in chips) 
arrow17: posts small blind $0.01
olga3021221: posts big blind $0.02
*** HOLE CARDS ***
Dealt to Scaaalll [5s Ad]
amario89: raises $0.02 to $0.04
Pray_to_win: folds 
Scaaalll: folds 
Pray_to_win is disconnected 
zbixxx: raises $0.10 to $0.14
arrow17: folds 
olga3021221: folds 
amario89: folds 
Uncalled bet ($0.10) returned to zbixxx
zbixxx collected $0.11 from pot
zbixxx: doesn't show hand 
*** SUMMARY ***
Total pot $0.11 | Rake $0 
Seat 1: zbixxx (button) collected ($0.11)
Seat 2: arrow17 (small blind) folded before Flop
Seat 3: olga3021221 (big blind) folded before Flop
Seat 4: amario89 folded before Flop
Seat 5: Pray_to_win folded before Flop (didn't bet)
Seat 6: Scaaalll folded before Flop (didn't bet)



PokerStars Zoom Hand #229230416289:  Hold'em No Limit ($0.01/$0.02) - 2021/08/21 21:35:35 CET [2021/08/21 15:35:35 ET]
Table 'Halley' 6-max Seat #1 is the button
Seat 1: felipeciji ($2.27 in chips) 
Seat 2: zbixxx ($3.88 in chips) 
Seat 3: Scaaalll ($2 in chips) 
Seat 4: Andrey30071990 ($1.87 in chips) 
Seat 5: Grashüpferchen ($0.61 in chips) 
Seat 6: Bufre ($3.09 in chips) 
zbixxx: posts small blind $0.01
Scaaalll: posts big blind $0.02
*** HOLE CARDS ***
Dealt to Scaaalll [Th 2s]
Andrey30071990: raises $0.05 to $0.07
Grashüpferchen: folds 
Bufre: calls $0.07
felipeciji: folds 
zbixxx: folds 
Scaaalll: folds 
*** FLOP *** [Kc Ac 2d]
Andrey30071990: checks 
Bufre: bets $0.02
Andrey30071990: calls $0.02
*** TURN *** [Kc Ac 2d] [4h]
Andrey30071990: checks 
Bufre: bets $0.04
Andrey30071990: calls $0.04
*** RIVER *** [Kc Ac 2d 4h] [Ah]
Andrey30071990: checks 
Bufre: bets $0.06
Andrey30071990: calls $0.06
*** SHOW DOWN ***
Bufre: shows [8c 8h] (two pair, Aces and Eights)
Andrey30071990: mucks hand 
Bufre collected $0.40 from pot
*** SUMMARY ***
Total pot $0.41 | Rake $0.01 
Board [Kc Ac 2d 4h Ah]
Seat 1: felipeciji (button) folded before Flop (didn't bet)
Seat 2: zbixxx (small blind) folded before Flop
Seat 3: Scaaalll (big blind) folded before Flop
Seat 4: Andrey30071990 mucked [6s 6h]
Seat 5: Grashüpferchen folded before Flop (didn't bet)
Seat 6: Bufre showed [8c 8h] and won ($0.40) with two pair, Aces and Eights



PokerStars Zoom Hand #229230427042:  Hold'em No Limit ($0.01/$0.02) - 2021/08/21 21:35:57 CET [2021/08/21 15:35:57 ET]
Table 'Halley' 6-max Seat #1 is the button
Seat 1: ryancudmore ($2 in chips) 
Seat 2: MrRussia777 ($0.83 in chips) 
Seat 3: yannikdaehne ($7.61 in chips) 
Seat 4: no way yo ($3.16 in chips) 
Seat 5: Scaaalll ($2 in chips) 
Seat 6: Grashüpferchen ($0.58 in chips) 
MrRussia777: posts small blind $0.01
yannikdaehne: posts big blind $0.02
*** HOLE CARDS ***
Dealt to Scaaalll [2h 6c]
no way yo: folds 
ryancudmore is disconnected 
Scaaalll: folds 
Grashüpferchen: folds 
ryancudmore: folds 
MrRussia777: raises $0.04 to $0.06
yannikdaehne: calls $0.04
*** FLOP *** [6s 6h 4s]
MrRussia777: bets $0.06
yannikdaehne: calls $0.06
*** TURN *** [6s 6h 4s] [Ad]
MrRussia777: checks 
yannikdaehne: bets $0.08
MrRussia777: calls $0.08
*** RIVER *** [6s 6h 4s Ad] [Jh]
MrRussia777: checks 
yannikdaehne: checks 
*** SHOW DOWN ***
MrRussia777: shows [7s 7c] (two pair, Sevens and Sixes)
yannikdaehne: shows [Ac 7h] (two pair, Aces and Sixes)
yannikdaehne collected $0.39 from pot
*** SUMMARY ***
Total pot $0.40 | Rake $0.01 
Board [6s 6h 4s Ad Jh]
Seat 1: ryancudmore (button) folded before Flop (didn't bet)
Seat 2: MrRussia777 (small blind) showed [7s 7c] and lost with two pair, Sevens and Sixes
Seat 3: yannikdaehne (big blind) showed [Ac 7h] and won ($0.39) with two pair, Aces and Sixes
Seat 4: no way yo folded before Flop (didn't bet)
Seat 5: Scaaalll folded before Flop (didn't bet)
Seat 6: Grashüpferchen folded before Flop (didn't bet)



PokerStars Zoom Hand #229230414423:  Hold'em No Limit ($0.01/$0.02) - 2021/08/21 21:35:31 CET [2021/08/21 15:35:31 ET]
Table 'Halley' 6-max Seat #1 is the button
Seat 1: Ferr4r1430 ($3.60 in chips) 
Seat 2: fabor1303 ($4.10 in chips) 
Seat 3: malandro733 ($2.04 in chips) 
Seat 4: Scaaalll ($2 in chips) 
Seat 5: GeraKremmov ($2.02 in chips) 
Seat 6: SaRCh_Ale ($2 in chips) 
fabor1303: posts small blind $0.01
malandro733: posts big blind $0.02
*** HOLE CARDS ***
Dealt to Scaaalll [Kc 3h]
Scaaalll: folds 
GeraKremmov: raises $0.04 to $0.06
SaRCh_Ale: folds 
Ferr4r1430: raises $0.15 to $0.21
fabor1303: folds 
malandro733: folds 
GeraKremmov: raises $0.45 to $0.66
Ferr4r1430: calls $0.45
*** FLOP *** [2c Ts 4h]
GeraKremmov: checks 
Ferr4r1430: checks 
*** TURN *** [2c Ts 4h] [8h]
GeraKremmov: bets $0.75
Ferr4r1430: calls $0.75
*** RIVER *** [2c Ts 4h 8h] [Kh]
GeraKremmov: bets $0.61 and is all-in
Ferr4r1430: calls $0.61
*** SHOW DOWN ***
GeraKremmov: shows [Jh Jc] (a pair of Jacks)
Ferr4r1430: shows [Qc Qd] (a pair of Queens)
Ferr4r1430 collected $3.93 from pot
*** SUMMARY ***
Total pot $4.07 | Rake $0.14 
Board [2c Ts 4h 8h Kh]
Seat 1: Ferr4r1430 (button) showed [Qc Qd] and won ($3.93) with a pair of Queens
Seat 2: fabor1303 (small blind) folded before Flop
Seat 3: malandro733 (big blind) folded before Flop
Seat 4: Scaaalll folded before Flop (didn't bet)
Seat 5: GeraKremmov showed [Jh Jc] and lost with a pair of Jacks
Seat 6: SaRCh_Ale folded before Flop (didn't bet)



PokerStars Zoom Hand #229230431672:  Hold'em No Limit ($0.01/$0.02) - 2021/08/21 21:36:07 CET [2021/08/21 15:36:07 ET]
Table 'Halley' 6-max Seat #1 is the button
Seat 1: Scaaalll ($2 in chips) 
Seat 2: Syd Wright ($2 in chips) 
Seat 3: is2011 ($2 in chips) 
Seat 4: loukon579 ($3.94 in chips) 
Seat 5: johniXL ($1.12 in chips) 
Seat 6: py100ta ($2.14 in chips) 
Syd Wright: posts small blind $0.01
is2011: posts big blind $0.02
*** HOLE CARDS ***
Dealt to Scaaalll [4h 5d]
loukon579: calls $0.02
johniXL: calls $0.02
py100ta: folds 
Scaaalll: folds 
Syd Wright: folds 
is2011: checks 
*** FLOP *** [Qh 8c 4s]
is2011: checks 
loukon579: bets $0.46
johniXL: folds 
is2011: folds 
Uncalled bet ($0.46) returned to loukon579
loukon579 collected $0.07 from pot
loukon579: doesn't show hand 
*** SUMMARY ***
Total pot $0.07 | Rake $0 
Board [Qh 8c 4s]
Seat 1: Scaaalll (button) folded before Flop (didn't bet)
Seat 2: Syd Wright (small blind) folded before Flop
Seat 3: is2011 (big blind) folded on the Flop
Seat 4: loukon579 collected ($0.07)
Seat 5: johniXL folded on the Flop
Seat 6: py100ta folded before Flop (didn't bet)



PokerStars Zoom Hand #229230443190:  Hold'em No Limit ($0.01/$0.02) - 2021/08/21 21:36:32 CET [2021/08/21 15:36:32 ET]
Table 'Halley' 6-max Seat #1 is the button
Seat 1: jaamonra ($2.16 in chips) 
Seat 2: Bufre ($4.66 in chips) 
Seat 3: Scaaalll ($2 in chips) 
Seat 4: ARTMVSLV ($2.06 in chips) 
Seat 5: zbixxx ($2.05 in chips) 
Seat 6: ser313131 ($3.44 in chips) 
Bufre: posts small blind $0.01
Scaaalll: posts big blind $0.02
*** HOLE CARDS ***
Dealt to Scaaalll [Ah 6h]
ARTMVSLV: folds 
zbixxx: raises $0.04 to $0.06
ser313131: folds 
jaamonra: folds 
Bufre: folds 
Scaaalll: folds 
Uncalled bet ($0.04) returned to zbixxx
zbixxx collected $0.05 from pot
zbixxx: doesn't show hand 
*** SUMMARY ***
Total pot $0.05 | Rake $0 
Seat 1: jaamonra (button) folded before Flop (didn't bet)
Seat 2: Bufre (small blind) folded before Flop
Seat 3: Scaaalll (big blind) folded before Flop
Seat 4: ARTMVSLV folded before Flop (didn't bet)
Seat 5: zbixxx collected ($0.05)
Seat 6: ser313131 folded before Flop (didn't bet)



PokerStars Zoom Hand #229230449167:  Hold'em No Limit ($0.01/$0.02) - 2021/08/21 21:36:45 CET [2021/08/21 15:36:45 ET]
Table 'Halley' 6-max Seat #1 is the button
Seat 1: Runway26 ($1.98 in chips) 
Seat 2: ADWish ($1.70 in chips) 
Seat 3: jaamonra ($2.15 in chips) 
Seat 4: VoidEclipse ($1.98 in chips) 
Seat 5: Scaaalll ($2 in chips) 
Seat 6: vtashmat1 ($2 in chips) 
ADWish: posts small blind $0.01
jaamonra: posts big blind $0.02
*** HOLE CARDS ***
Dealt to Scaaalll [Kh Qc]
VoidEclipse: folds 
Scaaalll: raises $0.04 to $0.06
vtashmat1: folds 
Runway26: folds 
ADWish: folds 
jaamonra: folds 
Uncalled bet ($0.04) returned to Scaaalll
Scaaalll collected $0.05 from pot
Scaaalll: doesn't show hand 
*** SUMMARY ***
Total pot $0.05 | Rake $0 
Seat 1: Runway26 (button) folded before Flop (didn't bet)
Seat 2: ADWish (small blind) folded before Flop
Seat 3: jaamonra (big blind) folded before Flop
Seat 4: VoidEclipse folded before Flop (didn't bet)
Seat 5: Scaaalll collected ($0.05)
Seat 6: vtashmat1 folded before Flop (didn't bet)



PokerStars Zoom Hand #229230454304:  Hold'em No Limit ($0.01/$0.02) - 2021/08/21 21:36:56 CET [2021/08/21 15:36:56 ET]
Table 'Halley' 6-max Seat #1 is the button
Seat 1: Nihility77 ($4.78 in chips) 
Seat 2: Scaaalll ($2.03 in chips) 
Seat 3: malandro733 ($3.21 in chips) 
Seat 4: KRandall12 ($0.86 in chips) 
Seat 5: CASSIE21462 ($4.91 in chips) 
Seat 6: fishh_play ($4.13 in chips) 
Scaaalll: posts small blind $0.01
malandro733: posts big blind $0.02
*** HOLE CARDS ***
Dealt to Scaaalll [Kh Qd]
KRandall12: folds 
CASSIE21462: folds 
fishh_play: folds 
Nihility77: folds 
Scaaalll: raises $0.04 to $0.06
malandro733: folds 
Uncalled bet ($0.04) returned to Scaaalll
Scaaalll collected $0.04 from pot
Scaaalll: doesn't show hand 
*** SUMMARY ***
Total pot $0.04 | Rake $0 
Seat 1: Nihility77 (button) folded before Flop (didn't bet)
Seat 2: Scaaalll (small blind) collected ($0.04)
Seat 3: malandro733 (big blind) folded before Flop
Seat 4: KRandall12 folded before Flop (didn't bet)
Seat 5: CASSIE21462 folded before Flop (didn't bet)
Seat 6: fishh_play folded before Flop (didn't bet)



PokerStars Zoom Hand #229230436635:  Hold'em No Limit ($0.01/$0.02) - 2021/08/21 21:36:19 CET [2021/08/21 15:36:19 ET]
Table 'Halley' 6-max Seat #1 is the button
Seat 1: gy67 ($3.50 in chips) 
Seat 2: bigbaddaddy9 ($6.86 in chips) 
Seat 3: Xlavariable ($2.11 in chips) 
Seat 4: Begon505 ($1.35 in chips) 
Seat 5: mixi08 ($1.42 in chips) 
Seat 6: Scaaalll ($2 in chips) 
bigbaddaddy9: posts small blind $0.01
Xlavariable: posts big blind $0.02
*** HOLE CARDS ***
Dealt to Scaaalll [8s 2h]
Begon505: raises $0.03 to $0.05
mixi08: folds 
Scaaalll: folds 
gy67: folds 
bigbaddaddy9: calls $0.04
Xlavariable: folds 
*** FLOP *** [4d 2s Jd]
bigbaddaddy9: bets $0.12
Begon505: calls $0.12
*** TURN *** [4d 2s Jd] [3c]
bigbaddaddy9: bets $0.18
Begon505: raises $0.58 to $0.76
bigbaddaddy9: folds 
Uncalled bet ($0.58) returned to Begon505
Begon505 collected $0.69 from pot
Begon505: doesn't show hand 
*** SUMMARY ***
Total pot $0.72 | Rake $0.03 
Board [4d 2s Jd 3c]
Seat 1: gy67 (button) folded before Flop (didn't bet)
Seat 2: bigbaddaddy9 (small blind) folded on the Turn
Seat 3: Xlavariable (big blind) folded before Flop
Seat 4: Begon505 collected ($0.69)
Seat 5: mixi08 folded before Flop (didn't bet)
Seat 6: Scaaalll folded before Flop (didn't bet)



PokerStars Zoom Hand #229230462169:  Hold'em No Limit ($0.01/$0.02) - 2021/08/21 21:37:13 CET [2021/08/21 15:37:13 ET]
Table 'Halley' 6-max Seat #1 is the button
Seat 1: Scaaalll ($2.05 in chips) 
Seat 2: nodtress ($2.72 in chips) 
Seat 3: tviskas ($2.51 in chips) 
Seat 4: usenovm ($2.04 in chips) 
Seat 5: AVGEV ($2.02 in chips) 
Seat 6: LegendaryLRS ($2.31 in chips) 
nodtress: posts small blind $0.01
tviskas: posts big blind $0.02
*** HOLE CARDS ***
Dealt to Scaaalll [Kc 6h]
usenovm: folds 
AVGEV: folds 
AVGEV is disconnected 
LegendaryLRS: folds 
Scaaalll: folds 
nodtress: raises $0.03 to $0.05
tviskas: calls $0.03
*** FLOP *** [8h As 6d]
nodtress: checks 
tviskas: bets $0.05
nodtress: folds 
Uncalled bet ($0.05) returned to tviskas
tviskas collected $0.10 from pot
tviskas: doesn't show hand 
*** SUMMARY ***
Total pot $0.10 | Rake $0 
Board [8h As 6d]
Seat 1: Scaaalll (button) folded before Flop (didn't bet)
Seat 2: nodtress (small blind) folded on the Flop
Seat 3: tviskas (big blind) collected ($0.10)
Seat 4: usenovm folded before Flop (didn't bet)
Seat 5: AVGEV folded before Flop (didn't bet)
Seat 6: LegendaryLRS folded before Flop (didn't bet)



PokerStars Zoom Hand #229230468296:  Hold'em No Limit ($0.01/$0.02) - 2021/08/21 21:37:27 CET [2021/08/21 15:37:27 ET]
Table 'Halley' 6-max Seat #1 is the button
Seat 1: dominik7315 ($1.55 in chips) 
Seat 2: ugi-dugi ($3.53 in chips) 
Seat 3: kickBrain ($3.95 in chips) 
Seat 4: Scaaalll ($2.05 in chips) 
Seat 5: iPitbull1 ($3.74 in chips) 
Seat 6: Fanatspartak ($1 in chips) 
ugi-dugi: posts small blind $0.01
kickBrain: posts big blind $0.02
*** HOLE CARDS ***
Dealt to Scaaalll [7d 7h]
dominik7315 is disconnected 
Scaaalll: raises $0.04 to $0.06
iPitbull1: folds 
Fanatspartak: calls $0.06
dominik7315: folds 
ugi-dugi: folds 
kickBrain: folds 
*** FLOP *** [2s Ac 5h]
Scaaalll: bets $0.08
Fanatspartak: raises $0.15 to $0.23
Scaaalll: folds 
Uncalled bet ($0.15) returned to Fanatspartak
Fanatspartak collected $0.30 from pot
Fanatspartak: doesn't show hand 
*** SUMMARY ***
Total pot $0.31 | Rake $0.01 
Board [2s Ac 5h]
Seat 1: dominik7315 (button) folded before Flop (didn't bet)
Seat 2: ugi-dugi (small blind) folded before Flop
Seat 3: kickBrain (big blind) folded before Flop
Seat 4: Scaaalll folded on the Flop
Seat 5: iPitbull1 folded before Flop (didn't bet)
Seat 6: Fanatspartak collected ($0.30)



PokerStars Zoom Hand #229230479888:  Hold'em No Limit ($0.01/$0.02) - 2021/08/21 21:37:52 CET [2021/08/21 15:37:52 ET]
Table 'Halley' 6-max Seat #1 is the button
Seat 1: Red Sky 15 ($6.67 in chips) 
Seat 2: JDGGrinder ($3.15 in chips) 
Seat 3: CordiPS ($3.50 in chips) 
Seat 4: snowy_96 ($2 in chips) 
Seat 5: 77omsk ($3.71 in chips) 
Seat 6: Scaaalll ($2 in chips) 
JDGGrinder: posts small blind $0.01
CordiPS: posts big blind $0.02
*** HOLE CARDS ***
Dealt to Scaaalll [3h 7c]
snowy_96: folds 
77omsk: folds 
Scaaalll: folds 
Red Sky 15: raises $0.04 to $0.06
JDGGrinder: folds 
CordiPS: folds 
Uncalled bet ($0.04) returned to Red Sky 15
Red Sky 15 collected $0.05 from pot
Red Sky 15: doesn't show hand 
*** SUMMARY ***
Total pot $0.05 | Rake $0 
Seat 1: Red Sky 15 (button) collected ($0.05)
Seat 2: JDGGrinder (small blind) folded before Flop
Seat 3: CordiPS (big blind) folded before Flop
Seat 4: snowy_96 folded before Flop (didn't bet)
Seat 5: 77omsk folded before Flop (didn't bet)
Seat 6: Scaaalll folded before Flop (didn't bet)



PokerStars Zoom Hand #229230481739:  Hold'em No Limit ($0.01/$0.02) - 2021/08/21 21:37:56 CET [2021/08/21 15:37:56 ET]
Table 'Halley' 6-max Seat #1 is the button
Seat 1: Coldact ($2.40 in chips) 
Seat 2: Victor151886 ($3.36 in chips) 
Seat 3: usenovm ($1.69 in chips) 
Seat 4: feybys ($2 in chips) 
Seat 5: Scaaalll ($2 in chips) 
Seat 6: so0love ($4.41 in chips) 
Victor151886: posts small blind $0.01
usenovm: posts big blind $0.02
*** HOLE CARDS ***
Dealt to Scaaalll [Js 6d]
feybys: folds 
Scaaalll: folds 
so0love: folds 
Coldact: raises $0.06 to $0.08
Victor151886: folds 
usenovm: folds 
Uncalled bet ($0.06) returned to Coldact
Coldact collected $0.05 from pot
Coldact: doesn't show hand 
*** SUMMARY ***
Total pot $0.05 | Rake $0 
Seat 1: Coldact (button) collected ($0.05)
Seat 2: Victor151886 (small blind) folded before Flop
Seat 3: usenovm (big blind) folded before Flop
Seat 4: feybys folded before Flop (didn't bet)
Seat 5: Scaaalll folded before Flop (didn't bet)
Seat 6: so0love folded before Flop (didn't bet)



PokerStars Zoom Hand #229230484043:  Hold'em No Limit ($0.01/$0.02) - 2021/08/21 21:38:01 CET [2021/08/21 15:38:01 ET]
Table 'Halley' 6-max Seat #1 is the button
Seat 1: nV6TR ($3.32 in chips) 
Seat 2: HellNative ($2.31 in chips) 
Seat 3: Scaaalll ($2 in chips) 
Seat 4: VoidEclipse ($1.98 in chips) 
Seat 5: woop333 ($1.04 in chips) 
Seat 6: klausC3 ($4 in chips) 
HellNative: posts small blind $0.01
Scaaalll: posts big blind $0.02
*** HOLE CARDS ***
Dealt to Scaaalll [7c 9d]
VoidEclipse: folds 
woop333: calls $0.02
klausC3: folds 
nV6TR: folds 
HellNative: folds 
Scaaalll: checks 
*** FLOP *** [As Ts 8d]
Scaaalll: checks 
woop333: bets $0.05
Scaaalll: calls $0.05
*** TURN *** [As Ts 8d] [Jc]
Scaaalll: checks 
woop333: bets $0.02
Scaaalll: raises $0.14 to $0.16
woop333: calls $0.14
*** RIVER *** [As Ts 8d Jc] [Kc]
Scaaalll: bets $0.23
woop333: calls $0.23
*** SHOW DOWN ***
Scaaalll: shows [7c 9d] (a straight, Seven to Jack)
woop333: mucks hand 
Scaaalll collected $0.89 from pot
*** SUMMARY ***
Total pot $0.93 | Rake $0.04 
Board [As Ts 8d Jc Kc]
Seat 1: nV6TR (button) folded before Flop (didn't bet)
Seat 2: HellNative (small blind) folded before Flop
Seat 3: Scaaalll (big blind) showed [7c 9d] and won ($0.89) with a straight, Seven to Jack
Seat 4: VoidEclipse folded before Flop (didn't bet)
Seat 5: woop333 mucked [Kh Ad]
Seat 6: klausC3 folded before Flop (didn't bet)



PokerStars Zoom Hand #229230505714:  Hold'em No Limit ($0.01/$0.02) - 2021/08/21 21:38:47 CET [2021/08/21 15:38:47 ET]
Table 'Halley' 6-max Seat #1 is the button
Seat 1: Alfmasterrr ($2.59 in chips) 
Seat 2: Scaaalll ($2.43 in chips) 
Seat 3: gasmar_29 ($2.35 in chips) 
Seat 4: jaamonra ($3.86 in chips) 
Seat 5: Kergie ($9.50 in chips) 
Seat 6: Ne0net ($3.19 in chips) 
Scaaalll: posts small blind $0.01
gasmar_29: posts big blind $0.02
*** HOLE CARDS ***
Dealt to Scaaalll [8d 7h]
jaamonra: folds 
Kergie: folds 
Ne0net: raises $0.04 to $0.06
Alfmasterrr: folds 
Scaaalll: folds 
gasmar_29: folds 
Uncalled bet ($0.04) returned to Ne0net
Ne0net collected $0.05 from pot
Ne0net: doesn't show hand 
*** SUMMARY ***
Total pot $0.05 | Rake $0 
Seat 1: Alfmasterrr (button) folded before Flop (didn't bet)
Seat 2: Scaaalll (small blind) folded before Flop
Seat 3: gasmar_29 (big blind) folded before Flop
Seat 4: jaamonra folded before Flop (didn't bet)
Seat 5: Kergie folded before Flop (didn't bet)
Seat 6: Ne0net collected ($0.05)



PokerStars Zoom Hand #229230507610:  Hold'em No Limit ($0.01/$0.02) - 2021/08/21 21:38:51 CET [2021/08/21 15:38:51 ET]
Table 'Halley' 6-max Seat #1 is the button
Seat 1: jaamonra ($3.86 in chips) 
Seat 2: KoAlRy ($2.27 in chips) 
Seat 3: MrK_Leuven ($3.54 in chips) 
Seat 4: Scaaalll ($2.42 in chips) 
Seat 5: Gerar NB ($2.63 in chips) 
Seat 6: VoidEclipse ($2 in chips) 
KoAlRy: posts small blind $0.01
MrK_Leuven: posts big blind $0.02
*** HOLE CARDS ***
Dealt to Scaaalll [7c 2c]
Scaaalll: folds 
Gerar NB: folds 
VoidEclipse: raises $0.03 to $0.05
jaamonra: folds 
KoAlRy: folds 
MrK_Leuven: calls $0.03
*** FLOP *** [4c Ts 4d]
MrK_Leuven: checks 
VoidEclipse: bets $0.04
MrK_Leuven: raises $0.16 to $0.20
VoidEclipse: folds 
Uncalled bet ($0.16) returned to MrK_Leuven
MrK_Leuven collected $0.18 from pot
MrK_Leuven: doesn't show hand 
*** SUMMARY ***
Total pot $0.19 | Rake $0.01 
Board [4c Ts 4d]
Seat 1: jaamonra (button) folded before Flop (didn't bet)
Seat 2: KoAlRy (small blind) folded before Flop
Seat 3: MrK_Leuven (big blind) collected ($0.18)
Seat 4: Scaaalll folded before Flop (didn't bet)
Seat 5: Gerar NB folded before Flop (didn't bet)
Seat 6: VoidEclipse folded on the Flop



PokerStars Zoom Hand #229230514575:  Hold'em No Limit ($0.01/$0.02) - 2021/08/21 21:39:06 CET [2021/08/21 15:39:06 ET]
Table 'Halley' 6-max Seat #1 is the button
Seat 1: no way yo ($0.86 in chips) 
Seat 2: CrazyyParis ($2.08 in chips) 
Seat 3: ZNFR77 ($1.21 in chips) 
Seat 4: twobii668 ($0.97 in chips) 
Seat 5: Scaaalll ($2.42 in chips) 
Seat 6: sorinysu ($0.39 in chips) 
CrazyyParis: posts small blind $0.01
ZNFR77: posts big blind $0.02
*** HOLE CARDS ***
Dealt to Scaaalll [4h 2h]
twobii668: folds 
twobii668 is disconnected 
Scaaalll: folds 
sorinysu: folds 
sorinysu is disconnected 
no way yo: raises $0.02 to $0.04
CrazyyParis: folds 
ZNFR77: folds 
Uncalled bet ($0.02) returned to no way yo
no way yo collected $0.05 from pot
no way yo: doesn't show hand 
*** SUMMARY ***
Total pot $0.05 | Rake $0 
Seat 1: no way yo (button) collected ($0.05)
Seat 2: CrazyyParis (small blind) folded before Flop
Seat 3: ZNFR77 (big blind) folded before Flop
Seat 4: twobii668 folded before Flop (didn't bet)
Seat 5: Scaaalll folded before Flop (didn't bet)
Seat 6: sorinysu folded before Flop (didn't bet)



PokerStars Zoom Hand #229230519596:  Hold'em No Limit ($0.01/$0.02) - 2021/08/21 21:39:17 CET [2021/08/21 15:39:17 ET]
Table 'Halley' 6-max Seat #1 is the button
Seat 1: romochka1992 ($2.16 in chips) 
Seat 2: Kb013497 ($1.81 in chips) 
Seat 3: Scaaalll ($2.42 in chips) 
Seat 4: Xlavariable ($4.98 in chips) 
Seat 5: Fanatspartak ($1.05 in chips) 
Seat 6: kcyxa ($1.97 in chips) 
Kb013497: posts small blind $0.01
Scaaalll: posts big blind $0.02
*** HOLE CARDS ***
Dealt to Scaaalll [Th Jc]
Xlavariable: folds 
kcyxa is disconnected 
Fanatspartak: raises $0.04 to $0.06
kcyxa: folds 
romochka1992: folds 
Kb013497: folds 
Scaaalll: folds 
Uncalled bet ($0.04) returned to Fanatspartak
Fanatspartak collected $0.05 from pot
Fanatspartak: doesn't show hand 
*** SUMMARY ***
Total pot $0.05 | Rake $0 
Seat 1: romochka1992 (button) folded before Flop (didn't bet)
Seat 2: Kb013497 (small blind) folded before Flop
Seat 3: Scaaalll (big blind) folded before Flop
Seat 4: Xlavariable folded before Flop (didn't bet)
Seat 5: Fanatspartak collected ($0.05)
Seat 6: kcyxa folded before Flop (didn't bet)



PokerStars Zoom Hand #229230512726:  Hold'em No Limit ($0.01/$0.02) - 2021/08/21 21:39:02 CET [2021/08/21 15:39:02 ET]
Table 'Halley' 6-max Seat #1 is the button
Seat 1: Scaaalll ($2.42 in chips) 
Seat 2: z3317111711 ($2.25 in chips) 
Seat 3: ash1448 ($11.04 in chips) 
Seat 4: tsantanapoker ($0.87 in chips) 
Seat 5: RaulacateFolds ($2.02 in chips) 
Seat 6: SpartanRace1 ($7.23 in chips) 
z3317111711: posts small blind $0.01
ash1448: posts big blind $0.02
*** HOLE CARDS ***
Dealt to Scaaalll [Jd 5c]
tsantanapoker: folds 
tsantanapoker is disconnected 
RaulacateFolds: raises $0.04 to $0.06
SpartanRace1: folds 
Scaaalll: folds 
z3317111711: folds 
ash1448: folds 
Uncalled bet ($0.04) returned to RaulacateFolds
RaulacateFolds collected $0.05 from pot
RaulacateFolds: doesn't show hand 
*** SUMMARY ***
Total pot $0.05 | Rake $0 
Seat 1: Scaaalll (button) folded before Flop (didn't bet)
Seat 2: z3317111711 (small blind) folded before Flop
Seat 3: ash1448 (big blind) folded before Flop
Seat 4: tsantanapoker folded before Flop (didn't bet)
Seat 5: RaulacateFolds collected ($0.05)
Seat 6: SpartanRace1 folded before Flop (didn't bet)



PokerStars Zoom Hand #229230538029:  Hold'em No Limit ($0.01/$0.02) - 2021/08/21 21:39:47 CET [2021/08/21 15:39:47 ET]
Table 'Halley' 6-max Seat #1 is the button
Seat 1: johniXL ($0.79 in chips) 
Seat 2: ser313131 ($2.19 in chips) 
Seat 3: gasmar_29 ($3.43 in chips) 
Seat 4: Scaaalll ($2.39 in chips) 
Seat 5: Koldun 2636 ($5.44 in chips) 
Seat 6: Gibsondelux ($2.62 in chips) 
ser313131: posts small blind $0.01
gasmar_29: posts big blind $0.02
*** HOLE CARDS ***
Dealt to Scaaalll [Ts 5s]
Scaaalll: folds 
Koldun 2636: folds 
Gibsondelux: folds 
johniXL: folds 
Gibsondelux is disconnected 
ser313131: folds 
Uncalled bet ($0.01) returned to gasmar_29
gasmar_29 collected $0.02 from pot
gasmar_29: doesn't show hand 
*** SUMMARY ***
Total pot $0.02 | Rake $0 
Seat 1: johniXL (button) folded before Flop (didn't bet)
Seat 2: ser313131 (small blind) folded before Flop
Seat 3: gasmar_29 (big blind) collected ($0.02)
Seat 4: Scaaalll folded before Flop (didn't bet)
Seat 5: Koldun 2636 folded before Flop (didn't bet)
Seat 6: Gibsondelux folded before Flop (didn't bet)



PokerStars Zoom Hand #229230531120:  Hold'em No Limit ($0.01/$0.02) - 2021/08/21 21:39:32 CET [2021/08/21 15:39:32 ET]
Table 'Halley' 6-max Seat #1 is the button
Seat 1: ARTMVSLV ($2.14 in chips) 
Seat 2: Scaaalll ($2.40 in chips) 
Seat 3: S1fon4o ($0.80 in chips) 
Seat 4: mrfastflow ($1.34 in chips) 
Seat 5: aptainSpliff ($2.03 in chips) 
Seat 6: Spartans987 ($0.95 in chips) 
Scaaalll: posts small blind $0.01
S1fon4o: posts big blind $0.02
*** HOLE CARDS ***
Dealt to Scaaalll [Jh 5c]
mrfastflow: folds 
aptainSpliff: folds 
aptainSpliff is disconnected 
Spartans987: calls $0.02
ARTMVSLV: raises $0.08 to $0.10
Scaaalll: folds 
S1fon4o: folds 
Spartans987: folds 
Uncalled bet ($0.08) returned to ARTMVSLV
ARTMVSLV collected $0.07 from pot
ARTMVSLV: doesn't show hand 
Spartans987 is disconnected 
*** SUMMARY ***
Total pot $0.07 | Rake $0 
Seat 1: ARTMVSLV (button) collected ($0.07)
Seat 2: Scaaalll (small blind) folded before Flop
Seat 3: S1fon4o (big blind) folded before Flop
Seat 4: mrfastflow folded before Flop (didn't bet)
Seat 5: aptainSpliff folded before Flop (didn't bet)
Seat 6: Spartans987 folded before Flop



PokerStars Zoom Hand #229230516816:  Hold'em No Limit ($0.01/$0.02) - 2021/08/21 21:39:11 CET [2021/08/21 15:39:11 ET]
Table 'Halley' 6-max Seat #1 is the button
Seat 1: pphit ($2.40 in chips) 
Seat 2: dkno77 ($1.67 in chips) 
Seat 3: maressen ($2.94 in chips) 
Seat 4: estelionat171 ($1.09 in chips) 
Seat 5: Fedor_Gar ($4.05 in chips) 
Seat 6: Scaaalll ($2.42 in chips) 
dkno77: posts small blind $0.01
maressen: posts big blind $0.02
*** HOLE CARDS ***
Dealt to Scaaalll [5s 7d]
estelionat171: raises $0.02 to $0.04
Fedor_Gar: folds 
Scaaalll: folds 
pphit: folds 
dkno77: folds 
maressen: raises $0.14 to $0.18
estelionat171: calls $0.14
*** FLOP *** [3d 6h Jh]
maressen: checks 
estelionat171: checks 
*** TURN *** [3d 6h Jh] [Th]
maressen: bets $0.18
estelionat171: raises $0.73 to $0.91 and is all-in
maressen: calls $0.73
*** RIVER *** [3d 6h Jh Th] [8c]
*** SHOW DOWN ***
maressen: shows [Js Jc] (three of a kind, Jacks)
estelionat171: shows [Ks Kd] (a pair of Kings)
maressen collected $2.11 from pot
*** SUMMARY ***
Total pot $2.19 | Rake $0.08 
Board [3d 6h Jh Th 8c]
Seat 1: pphit (button) folded before Flop (didn't bet)
Seat 2: dkno77 (small blind) folded before Flop
Seat 3: maressen (big blind) showed [Js Jc] and won ($2.11) with three of a kind, Jacks
Seat 4: estelionat171 showed [Ks Kd] and lost with a pair of Kings
Seat 5: Fedor_Gar folded before Flop (didn't bet)
Seat 6: Scaaalll folded before Flop (didn't bet)



PokerStars Zoom Hand #229230535739:  Hold'em No Limit ($0.01/$0.02) - 2021/08/21 21:39:41 CET [2021/08/21 15:39:41 ET]
Table 'Halley' 6-max Seat #1 is the button
Seat 1: Scaaalll ($2.39 in chips) 
Seat 2: iPitbull1 ($4.38 in chips) 
Seat 3: campeão1425 ($0.39 in chips) 
Seat 4: Gamer577 ($3.74 in chips) 
Seat 5: usenovm ($2.06 in chips) 
Seat 6: nemat_g ($1.94 in chips) 
iPitbull1: posts small blind $0.01
campeão1425: posts big blind $0.02
*** HOLE CARDS ***
Dealt to Scaaalll [4d Jc]
Gamer577: folds 
usenovm: folds 
nemat_g: folds 
Scaaalll: folds 
iPitbull1: raises $0.04 to $0.06
campeão1425: calls $0.04
*** FLOP *** [Qs 4c 3h]
iPitbull1: checks 
campeão1425: checks 
*** TURN *** [Qs 4c 3h] [5c]
iPitbull1: bets $0.07
campeão1425: folds 
Uncalled bet ($0.07) returned to iPitbull1
iPitbull1 collected $0.12 from pot
iPitbull1: doesn't show hand 
campeão1425 is disconnected 
*** SUMMARY ***
Total pot $0.12 | Rake $0 
Board [Qs 4c 3h 5c]
Seat 1: Scaaalll (button) folded before Flop (didn't bet)
Seat 2: iPitbull1 (small blind) collected ($0.12)
Seat 3: campeão1425 (big blind) folded on the Turn
Seat 4: Gamer577 folded before Flop (didn't bet)
Seat 5: usenovm folded before Flop (didn't bet)
Seat 6: nemat_g folded before Flop (didn't bet)



PokerStars Zoom Hand #229230532977:  Hold'em No Limit ($0.01/$0.02) - 2021/08/21 21:39:36 CET [2021/08/21 15:39:36 ET]
Table 'Halley' 6-max Seat #1 is the button
Seat 1: arrow17 ($2 in chips) 
Seat 2: CrazyyParis ($2.14 in chips) 
Seat 3: mgort1988 ($2.03 in chips) 
Seat 4: nitzed12 ($2.21 in chips) 
Seat 5: Scaaalll ($2.39 in chips) 
Seat 6: KingsPoke185 ($0.43 in chips) 
CrazyyParis: posts small blind $0.01
mgort1988: posts big blind $0.02
*** HOLE CARDS ***
Dealt to Scaaalll [6c 5d]
nitzed12: raises $0.03 to $0.05
Scaaalll: folds 
KingsPoke185: calls $0.05
arrow17: folds 
CrazyyParis: folds 
mgort1988: folds 
*** FLOP *** [Ac Qc 7d]
nitzed12: bets $0.07
KingsPoke185: calls $0.07
*** TURN *** [Ac Qc 7d] [3d]
nitzed12: bets $0.20
KingsPoke185: raises $0.11 to $0.31 and is all-in
nitzed12: calls $0.11
*** RIVER *** [Ac Qc 7d 3d] [9h]
*** SHOW DOWN ***
nitzed12: shows [Kd Jd] (high card Ace)
KingsPoke185: shows [6s As] (a pair of Aces)
KingsPoke185 collected $0.86 from pot
*** SUMMARY ***
Total pot $0.89 | Rake $0.03 
Board [Ac Qc 7d 3d 9h]
Seat 1: arrow17 (button) folded before Flop (didn't bet)
Seat 2: CrazyyParis (small blind) folded before Flop
Seat 3: mgort1988 (big blind) folded before Flop
Seat 4: nitzed12 showed [Kd Jd] and lost with high card Ace
Seat 5: Scaaalll folded before Flop (didn't bet)
Seat 6: KingsPoke185 showed [6s As] and won ($0.86) with a pair of Aces



PokerStars Zoom Hand #229230547762:  Hold'em No Limit ($0.01/$0.02) - 2021/08/21 21:40:07 CET [2021/08/21 15:40:07 ET]
Table 'Halley' 6-max Seat #1 is the button
Seat 1: gasmar_29 ($2.36 in chips) 
Seat 2: Bomb Mgl ($1.69 in chips) 
Seat 3: Scaaalll ($2.39 in chips) 
Seat 4: sg.32rus ($1.18 in chips) 
Seat 5: ARTMVSLV ($2 in chips) 
Seat 6: herbas ($2 in chips) 
Bomb Mgl: posts small blind $0.01
Scaaalll: posts big blind $0.02
*** HOLE CARDS ***
Dealt to Scaaalll [7h 7c]
Bomb Mgl is disconnected 
sg.32rus: folds 
ARTMVSLV: folds 
herbas: folds 
gasmar_29: folds 
Bomb Mgl: folds 
Uncalled bet ($0.01) returned to Scaaalll
Scaaalll collected $0.02 from pot
Scaaalll: doesn't show hand 
*** SUMMARY ***
Total pot $0.02 | Rake $0 
Seat 1: gasmar_29 (button) folded before Flop (didn't bet)
Seat 2: Bomb Mgl (small blind) folded before Flop
Seat 3: Scaaalll (big blind) collected ($0.02)
Seat 4: sg.32rus folded before Flop (didn't bet)
Seat 5: ARTMVSLV folded before Flop (didn't bet)
Seat 6: herbas folded before Flop (didn't bet)



PokerStars Zoom Hand #229230554628:  Hold'em No Limit ($0.01/$0.02) - 2021/08/21 21:40:22 CET [2021/08/21 15:40:22 ET]
Table 'Halley' 6-max Seat #1 is the button
Seat 1: Scaaalll ($2.40 in chips) 
Seat 2: KRandall12 ($0.85 in chips) 
Seat 3: ciucibaby ($3.96 in chips) 
Seat 4: fishh_play ($2.70 in chips) 
Seat 5: laetschnbene ($4.71 in chips) 
Seat 6: gasmar_29 ($4.16 in chips) 
KRandall12: posts small blind $0.01
ciucibaby: posts big blind $0.02
*** HOLE CARDS ***
Dealt to Scaaalll [Ah 4c]
fishh_play: folds 
laetschnbene: raises $0.04 to $0.06
gasmar_29: folds 
Scaaalll: folds 
KRandall12: folds 
ciucibaby: folds 
Uncalled bet ($0.04) returned to laetschnbene
laetschnbene collected $0.05 from pot
laetschnbene: doesn't show hand 
*** SUMMARY ***
Total pot $0.05 | Rake $0 
Seat 1: Scaaalll (button) folded before Flop (didn't bet)
Seat 2: KRandall12 (small blind) folded before Flop
Seat 3: ciucibaby (big blind) folded before Flop
Seat 4: fishh_play folded before Flop (didn't bet)
Seat 5: laetschnbene collected ($0.05)
Seat 6: gasmar_29 folded before Flop (didn't bet)



PokerStars Zoom Hand #229230539912:  Hold'em No Limit ($0.01/$0.02) - 2021/08/21 21:39:51 CET [2021/08/21 15:39:51 ET]
Table 'Halley' 6-max Seat #1 is the button
Seat 1: arrow17 ($2 in chips) 
Seat 2: qpsq ($3.99 in chips) 
Seat 3: *88VIC88* ($2 in chips) 
Seat 4: Pysgodyn ($2 in chips) 
Seat 5: nemat_g ($1.94 in chips) 
Seat 6: Scaaalll ($2.39 in chips) 
qpsq: posts small blind $0.01
*88VIC88*: posts big blind $0.02
*** HOLE CARDS ***
Dealt to Scaaalll [7c 5c]
Pysgodyn: folds 
nemat_g: raises $0.04 to $0.06
Scaaalll: folds 
arrow17: calls $0.06
qpsq: folds 
*88VIC88*: folds 
*** FLOP *** [Qd Kc 2d]
nemat_g: checks 
arrow17: bets $0.09
nemat_g: calls $0.09
*** TURN *** [Qd Kc 2d] [Ts]
nemat_g: checks 
arrow17: checks 
*** RIVER *** [Qd Kc 2d Ts] [Qc]
nemat_g: checks 
arrow17: checks 
*** SHOW DOWN ***
nemat_g: shows [4c Ac] (a pair of Queens)
arrow17: shows [6s 6c] (two pair, Queens and Sixes)
arrow17 collected $0.32 from pot
*** SUMMARY ***
Total pot $0.33 | Rake $0.01 
Board [Qd Kc 2d Ts Qc]
Seat 1: arrow17 (button) showed [6s 6c] and won ($0.32) with two pair, Queens and Sixes
Seat 2: qpsq (small blind) folded before Flop
Seat 3: *88VIC88* (big blind) folded before Flop
Seat 4: Pysgodyn folded before Flop (didn't bet)
Seat 5: nemat_g showed [4c Ac] and lost with a pair of Queens
Seat 6: Scaaalll folded before Flop (didn't bet)



PokerStars Zoom Hand #229230559264:  Hold'em No Limit ($0.01/$0.02) - 2021/08/21 21:40:32 CET [2021/08/21 15:40:32 ET]
Table 'Halley' 6-max Seat #1 is the button
Seat 1: HellNative ($3.88 in chips) 
Seat 2: FishOnPlate ($2 in chips) 
Seat 3: BIITRU ($4.02 in chips) 
Seat 4: olga3021221 ($2.23 in chips) 
Seat 5: Scaaalll ($2.40 in chips) 
Seat 6: Runway26 ($2.18 in chips) 
FishOnPlate: posts small blind $0.01
BIITRU: posts big blind $0.02
*** HOLE CARDS ***
Dealt to Scaaalll [3c 3h]
olga3021221: folds 
Scaaalll: raises $0.04 to $0.06
Runway26: folds 
HellNative: folds 
FishOnPlate: folds 
BIITRU: raises $0.12 to $0.18
Scaaalll: folds 
Uncalled bet ($0.12) returned to BIITRU
BIITRU collected $0.13 from pot
BIITRU: doesn't show hand 
*** SUMMARY ***
Total pot $0.13 | Rake $0 
Seat 1: HellNative (button) folded before Flop (didn't bet)
Seat 2: FishOnPlate (small blind) folded before Flop
Seat 3: BIITRU (big blind) collected ($0.13)
Seat 4: olga3021221 folded before Flop (didn't bet)
Seat 5: Scaaalll folded before Flop
Seat 6: Runway26 folded before Flop (didn't bet)



PokerStars Zoom Hand #229230569872:  Hold'em No Limit ($0.01/$0.02) - 2021/08/21 21:40:56 CET [2021/08/21 15:40:56 ET]
Table 'Halley' 6-max Seat #1 is the button
Seat 1: FabOliveira9 ($2.76 in chips) 
Seat 2: Scaaalll ($2.34 in chips) 
Seat 3: Bufre ($4.40 in chips) 
Seat 4: ib0man ($2.28 in chips) 
Seat 5: campeão1425 ($0.57 in chips) 
Seat 6: Flankeris ($3.95 in chips) 
Scaaalll: posts small blind $0.01
Bufre: posts big blind $0.02
*** HOLE CARDS ***
Dealt to Scaaalll [7c 9h]
ib0man: raises $0.03 to $0.05
campeão1425: folds 
campeão1425 is disconnected 
Flankeris: folds 
FabOliveira9: folds 
Scaaalll: folds 
Bufre: folds 
Uncalled bet ($0.03) returned to ib0man
ib0man collected $0.05 from pot
ib0man: doesn't show hand 
*** SUMMARY ***
Total pot $0.05 | Rake $0 
Seat 1: FabOliveira9 (button) folded before Flop (didn't bet)
Seat 2: Scaaalll (small blind) folded before Flop
Seat 3: Bufre (big blind) folded before Flop
Seat 4: ib0man collected ($0.05)
Seat 5: campeão1425 folded before Flop (didn't bet)
Seat 6: Flankeris folded before Flop (didn't bet)



PokerStars Zoom Hand #229230572146:  Hold'em No Limit ($0.01/$0.02) - 2021/08/21 21:41:01 CET [2021/08/21 15:41:01 ET]
Table 'Halley' 6-max Seat #1 is the button
Seat 1: AlexGTPS ($1.86 in chips) 
Seat 2: lukzmodric10 ($2.37 in chips) 
Seat 3: PapiMik3 ($2.14 in chips) 
Seat 4: Scaaalll ($2.33 in chips) 
Seat 5: someone0611 ($1.66 in chips) 
Seat 6: Benjani1412 ($2.12 in chips) 
lukzmodric10: posts small blind $0.01
PapiMik3: posts big blind $0.02
*** HOLE CARDS ***
Dealt to Scaaalll [Th 5s]
Scaaalll: folds 
someone0611: folds 
Benjani1412: raises $0.04 to $0.06
AlexGTPS: raises $0.18 to $0.24
lukzmodric10: folds 
PapiMik3: folds 
Benjani1412: folds 
Uncalled bet ($0.18) returned to AlexGTPS
AlexGTPS collected $0.15 from pot
AlexGTPS: doesn't show hand 
*** SUMMARY ***
Total pot $0.15 | Rake $0 
Seat 1: AlexGTPS (button) collected ($0.15)
Seat 2: lukzmodric10 (small blind) folded before Flop
Seat 3: PapiMik3 (big blind) folded before Flop
Seat 4: Scaaalll folded before Flop (didn't bet)
Seat 5: someone0611 folded before Flop (didn't bet)
Seat 6: Benjani1412 folded before Flop



PokerStars Zoom Hand #229230576203:  Hold'em No Limit ($0.01/$0.02) - 2021/08/21 21:41:09 CET [2021/08/21 15:41:09 ET]
Table 'Halley' 6-max Seat #1 is the button
Seat 1: gasmar_29 ($4.13 in chips) 
Seat 2: ChowMangao ($3.51 in chips) 
Seat 3: ctaceo ($2.17 in chips) 
Seat 4: Scaaalll ($2.33 in chips) 
Seat 5: Finderra ($3.86 in chips) 
Seat 6: ugi-dugi ($3.36 in chips) 
ChowMangao: posts small blind $0.01
ctaceo: posts big blind $0.02
*** HOLE CARDS ***
Dealt to Scaaalll [Ac 8h]
Scaaalll: folds 
Finderra: raises $0.04 to $0.06
ugi-dugi: folds 
gasmar_29: folds 
ChowMangao: folds 
ctaceo: folds 
Uncalled bet ($0.04) returned to Finderra
Finderra collected $0.05 from pot
Finderra: doesn't show hand 
*** SUMMARY ***
Total pot $0.05 | Rake $0 
Seat 1: gasmar_29 (button) folded before Flop (didn't bet)
Seat 2: ChowMangao (small blind) folded before Flop
Seat 3: ctaceo (big blind) folded before Flop
Seat 4: Scaaalll folded before Flop (didn't bet)
Seat 5: Finderra collected ($0.05)
Seat 6: ugi-dugi folded before Flop (didn't bet)



PokerStars Zoom Hand #229230581786:  Hold'em No Limit ($0.01/$0.02) - 2021/08/21 21:41:22 CET [2021/08/21 15:41:22 ET]
Table 'Halley' 6-max Seat #1 is the button
Seat 1: Finkey99 ($5.25 in chips) 
Seat 2: PapiMik3 ($2.35 in chips) 
Seat 3: Scaaalll ($2.32 in chips) 
Seat 4: bananAAbandit ($2.09 in chips) 
Seat 5: ash1448 ($3.02 in chips) 
Seat 6: Xlavariable ($2.42 in chips) 
PapiMik3: posts small blind $0.01
Scaaalll: posts big blind $0.02
*** HOLE CARDS ***
Dealt to Scaaalll [8h 3h]
bananAAbandit: folds 
ash1448: folds 
Xlavariable: folds 
Finkey99: folds 
PapiMik3: raises $0.04 to $0.06
Scaaalll: folds 
Uncalled bet ($0.04) returned to PapiMik3
PapiMik3 collected $0.04 from pot
PapiMik3: doesn't show hand 
*** SUMMARY ***
Total pot $0.04 | Rake $0 
Seat 1: Finkey99 (button) folded before Flop (didn't bet)
Seat 2: PapiMik3 (small blind) collected ($0.04)
Seat 3: Scaaalll (big blind) folded before Flop
Seat 4: bananAAbandit folded before Flop (didn't bet)
Seat 5: ash1448 folded before Flop (didn't bet)
Seat 6: Xlavariable folded before Flop (didn't bet)



PokerStars Zoom Hand #229230573950:  Hold'em No Limit ($0.01/$0.02) - 2021/08/21 21:41:04 CET [2021/08/21 15:41:04 ET]
Table 'Halley' 6-max Seat #1 is the button
Seat 1: kahzura ($2.53 in chips) 
Seat 2: boa juice ($1.58 in chips) 
Seat 3: mrfastflow ($2.05 in chips) 
Seat 4: Janey44 ($5.05 in chips) 
Seat 5: martifact ($1.19 in chips) 
Seat 6: Scaaalll ($2.33 in chips) 
boa juice: posts small blind $0.01
mrfastflow: posts big blind $0.02
*** HOLE CARDS ***
Dealt to Scaaalll [Kh 8c]
Janey44: calls $0.02
martifact: raises $0.07 to $0.09
Scaaalll: folds 
kahzura: calls $0.09
boa juice: folds 
boa juice is disconnected 
mrfastflow: folds 
Janey44: calls $0.07
*** FLOP *** [Ac 6d 5d]
Janey44: bets $0.14
martifact: folds 
kahzura: folds 
Uncalled bet ($0.14) returned to Janey44
Janey44 collected $0.29 from pot
Janey44: doesn't show hand 
*** SUMMARY ***
Total pot $0.30 | Rake $0.01 
Board [Ac 6d 5d]
Seat 1: kahzura (button) folded on the Flop
Seat 2: boa juice (small blind) folded before Flop
Seat 3: mrfastflow (big blind) folded before Flop
Seat 4: Janey44 collected ($0.29)
Seat 5: martifact folded on the Flop
Seat 6: Scaaalll folded before Flop (didn't bet)



PokerStars Zoom Hand #229230578557:  Hold'em No Limit ($0.01/$0.02) - 2021/08/21 21:41:14 CET [2021/08/21 15:41:14 ET]
Table 'Halley' 6-max Seat #1 is the button
Seat 1: csmall14 ($2.42 in chips) 
Seat 2: Scaaalll ($2.33 in chips) 
Seat 3: Adekvat.ua ($2.58 in chips) 
Seat 4: sorinysu ($0.56 in chips) 
Seat 5: KIraMan ($5 in chips) 
Seat 6: pavlo8855 ($2 in chips) 
Scaaalll: posts small blind $0.01
Adekvat.ua: posts big blind $0.02
*** HOLE CARDS ***
Dealt to Scaaalll [3h 4d]
sorinysu: calls $0.02
KIraMan: folds 
pavlo8855: folds 
csmall14: folds 
Scaaalll: folds 
Adekvat.ua: raises $2.20 to $2.22
sorinysu: calls $0.54 and is all-in
Uncalled bet ($1.66) returned to Adekvat.ua
*** FLOP *** [Tc 2h 7d]
*** TURN *** [Tc 2h 7d] [6c]
*** RIVER *** [Tc 2h 7d 6c] [7s]
*** SHOW DOWN ***
Adekvat.ua: shows [Kh As] (a pair of Sevens)
sorinysu: shows [5c 5d] (two pair, Sevens and Fives)
sorinysu cashed out the hand for $0.58 | Cash Out Fee $0.01
*** SUMMARY ***
Total pot $1.13 | Rake $0.04 
Board [Tc 2h 7d 6c 7s]
Seat 1: csmall14 (button) folded before Flop (didn't bet)
Seat 2: Scaaalll (small blind) folded before Flop
Seat 3: Adekvat.ua (big blind) showed [Kh As] and lost with a pair of Sevens
Seat 4: sorinysu showed [5c 5d] and won ($1.09) with two pair, Sevens and Fives (pot not awarded as player cashed out)
Seat 5: KIraMan folded before Flop (didn't bet)
Seat 6: pavlo8855 folded before Flop (didn't bet)



PokerStars Zoom Hand #229230590551:  Hold'em No Limit ($0.01/$0.02) - 2021/08/21 21:41:40 CET [2021/08/21 15:41:40 ET]
Table 'Halley' 6-max Seat #1 is the button
Seat 1: 1_KoLizeI_1 ($3.23 in chips) 
Seat 2: jolisabe ($1.48 in chips) 
Seat 3: TESTGOSHI ($1.59 in chips) 
Seat 4: valet_hai ($0.57 in chips) 
Seat 5: Scaaalll ($2.30 in chips) 
Seat 6: SIGREX ($2.66 in chips) 
jolisabe: posts small blind $0.01
TESTGOSHI: posts big blind $0.02
*** HOLE CARDS ***
Dealt to Scaaalll [2c As]
valet_hai: raises $0.55 to $0.57 and is all-in
Scaaalll: folds 
SIGREX: folds 
1_KoLizeI_1: folds 
jolisabe: folds 
TESTGOSHI: folds 
Uncalled bet ($0.55) returned to valet_hai
valet_hai collected $0.05 from pot
valet_hai: doesn't show hand 
*** SUMMARY ***
Total pot $0.05 | Rake $0 
Seat 1: 1_KoLizeI_1 (button) folded before Flop (didn't bet)
Seat 2: jolisabe (small blind) folded before Flop
Seat 3: TESTGOSHI (big blind) folded before Flop
Seat 4: valet_hai collected ($0.05)
Seat 5: Scaaalll folded before Flop (didn't bet)
Seat 6: SIGREX folded before Flop (didn't bet)



PokerStars Zoom Hand #229230588673:  Hold'em No Limit ($0.01/$0.02) - 2021/08/21 21:41:36 CET [2021/08/21 15:41:36 ET]
Table 'Halley' 6-max Seat #1 is the button
Seat 1: Scaaalll ($2.30 in chips) 
Seat 2: takeatrip180 ($0.54 in chips) 
Seat 3: JTbukowski ($1.01 in chips) 
Seat 4: zbixxx ($2 in chips) 
Seat 5: pavel28918012 ($1.81 in chips) 
Seat 6: Fedor_Gar ($2.13 in chips) 
takeatrip180: posts small blind $0.01
JTbukowski: posts big blind $0.02
*** HOLE CARDS ***
Dealt to Scaaalll [2s 9h]
zbixxx: folds 
pavel28918012: folds 
Fedor_Gar: raises $0.03 to $0.05
Scaaalll: folds 
takeatrip180: folds 
JTbukowski: folds 
Uncalled bet ($0.03) returned to Fedor_Gar
Fedor_Gar collected $0.05 from pot
Fedor_Gar: doesn't show hand 
*** SUMMARY ***
Total pot $0.05 | Rake $0 
Seat 1: Scaaalll (button) folded before Flop (didn't bet)
Seat 2: takeatrip180 (small blind) folded before Flop
Seat 3: JTbukowski (big blind) folded before Flop
Seat 4: zbixxx folded before Flop (didn't bet)
Seat 5: pavel28918012 folded before Flop (didn't bet)
Seat 6: Fedor_Gar collected ($0.05)



PokerStars Zoom Hand #229230592410:  Hold'em No Limit ($0.01/$0.02) - 2021/08/21 21:41:45 CET [2021/08/21 15:41:45 ET]
Table 'Halley' 6-max Seat #1 is the button
Seat 1: Manager2414 ($1.97 in chips) 
Seat 2: 2hoesonmydick ($3.01 in chips) 
Seat 3: mity3333 ($4.29 in chips) 
Seat 4: Scaaalll ($2.30 in chips) 
Seat 5: RonilsonCosta ($2 in chips) 
Seat 6: Na4a1nika ($1.88 in chips) 
2hoesonmydick: posts small blind $0.01
mity3333: posts big blind $0.02
*** HOLE CARDS ***
Dealt to Scaaalll [Qs Kc]
2hoesonmydick is disconnected 
Scaaalll: raises $0.04 to $0.06
RonilsonCosta: folds 
Na4a1nika: folds 
Manager2414: raises $0.15 to $0.21
2hoesonmydick: folds 
mity3333: folds 
Scaaalll: folds 
Uncalled bet ($0.15) returned to Manager2414
Manager2414 collected $0.15 from pot
Manager2414: doesn't show hand 
*** SUMMARY ***
Total pot $0.15 | Rake $0 
Seat 1: Manager2414 (button) collected ($0.15)
Seat 2: 2hoesonmydick (small blind) folded before Flop
Seat 3: mity3333 (big blind) folded before Flop
Seat 4: Scaaalll folded before Flop
Seat 5: RonilsonCosta folded before Flop (didn't bet)
Seat 6: Na4a1nika folded before Flop (didn't bet)



PokerStars Zoom Hand #229230586797:  Hold'em No Limit ($0.01/$0.02) - 2021/08/21 21:41:32 CET [2021/08/21 15:41:32 ET]
Table 'Halley' 6-max Seat #1 is the button
Seat 1: geo8787891 ($4.23 in chips) 
Seat 2: Saint_ANBU ($4.71 in chips) 
Seat 3: SaRCh_Ale ($2.58 in chips) 
Seat 4: Victor151886 ($3.17 in chips) 
Seat 5: iPitbull1 ($2.03 in chips) 
Seat 6: Scaaalll ($2.30 in chips) 
Saint_ANBU: posts small blind $0.01
SaRCh_Ale: posts big blind $0.02
*** HOLE CARDS ***
Dealt to Scaaalll [6h 4c]
Victor151886 has timed out
Victor151886: folds 
iPitbull1: folds 
Scaaalll: folds 
geo8787891: calls $0.02
Saint_ANBU: raises $0.06 to $0.08
SaRCh_Ale: folds 
geo8787891: calls $0.06
*** FLOP *** [Ts 5h Kh]
Saint_ANBU: bets $0.09
geo8787891: calls $0.09
*** TURN *** [Ts 5h Kh] [9s]
Saint_ANBU: bets $0.26
geo8787891: calls $0.26
*** RIVER *** [Ts 5h Kh 9s] [3h]
Saint_ANBU: checks 
geo8787891: checks 
*** SHOW DOWN ***
Saint_ANBU: shows [Qc Kd] (a pair of Kings)
geo8787891: mucks hand 
Saint_ANBU collected $0.85 from pot
*** SUMMARY ***
Total pot $0.88 | Rake $0.03 
Board [Ts 5h Kh 9s 3h]
Seat 1: geo8787891 (button) mucked [Tc Jh]
Seat 2: Saint_ANBU (small blind) showed [Qc Kd] and won ($0.85) with a pair of Kings
Seat 3: SaRCh_Ale (big blind) folded before Flop
Seat 4: Victor151886 folded before Flop (didn't bet)
Seat 5: iPitbull1 folded before Flop (didn't bet)
Seat 6: Scaaalll folded before Flop (didn't bet)



PokerStars Zoom Hand #229230604914:  Hold'em No Limit ($0.01/$0.02) - 2021/08/21 21:42:11 CET [2021/08/21 15:42:11 ET]
Table 'Halley' 6-max Seat #1 is the button
Seat 1: Sinad1302 ($3.51 in chips) 
Seat 2: Scaaalll ($2.22 in chips) 
Seat 3: phlopit ($2.06 in chips) 
Seat 4: Soko 1381 ($1.98 in chips) 
Seat 5: pavlo590 ($2.03 in chips) 
Seat 6: Kb013497 ($1.80 in chips) 
Scaaalll: posts small blind $0.01
phlopit: posts big blind $0.02
*** HOLE CARDS ***
Dealt to Scaaalll [Td 5c]
Soko 1381: folds 
pavlo590: folds 
pavlo590 is disconnected 
Kb013497: folds 
Sinad1302: raises $0.04 to $0.06
Scaaalll: folds 
phlopit: folds 
Uncalled bet ($0.04) returned to Sinad1302
Sinad1302 collected $0.05 from pot
Sinad1302: doesn't show hand 
*** SUMMARY ***
Total pot $0.05 | Rake $0 
Seat 1: Sinad1302 (button) collected ($0.05)
Seat 2: Scaaalll (small blind) folded before Flop
Seat 3: phlopit (big blind) folded before Flop
Seat 4: Soko 1381 folded before Flop (didn't bet)
Seat 5: pavlo590 folded before Flop (didn't bet)
Seat 6: Kb013497 folded before Flop (didn't bet)



PokerStars Zoom Hand #229230597520:  Hold'em No Limit ($0.01/$0.02) - 2021/08/21 21:41:56 CET [2021/08/21 15:41:56 ET]
Table 'Halley' 6-max Seat #1 is the button
Seat 1: mrfastflow ($1.19 in chips) 
Seat 2: SpartanRace1 ($11.05 in chips) 
Seat 3: Scaaalll ($2.24 in chips) 
Seat 4: 1_KoLizeI_1 ($3.22 in chips) 
Seat 5: RaulacateFolds ($2.43 in chips) 
Seat 6: IamFixxed ($5.66 in chips) 
SpartanRace1: posts small blind $0.01
Scaaalll: posts big blind $0.02
*** HOLE CARDS ***
Dealt to Scaaalll [6s 2d]
1_KoLizeI_1: folds 
RaulacateFolds: folds 
IamFixxed: raises $0.03 to $0.05
mrfastflow: raises $0.15 to $0.20
SpartanRace1: folds 
Scaaalll: folds 
IamFixxed: calls $0.15
*** FLOP *** [9c 7d Ah]
IamFixxed: checks 
mrfastflow: bets $0.21
IamFixxed: raises $0.55 to $0.76
mrfastflow: raises $0.23 to $0.99 and is all-in
IamFixxed: calls $0.23
*** TURN *** [9c 7d Ah] [3s]
*** RIVER *** [9c 7d Ah 3s] [Jh]
*** SHOW DOWN ***
IamFixxed: shows [Ac Td] (a pair of Aces)
mrfastflow: shows [Qd As] (a pair of Aces - Queen kicker)
mrfastflow cashed out the hand for $1.90 | Cash Out Fee $0.02
*** SUMMARY ***
Total pot $2.41 | Rake $0.08 
Board [9c 7d Ah 3s Jh]
Seat 1: mrfastflow (button) showed [Qd As] and won ($2.33) with a pair of Aces (pot not awarded as player cashed out)
Seat 2: SpartanRace1 (small blind) folded before Flop
Seat 3: Scaaalll (big blind) folded before Flop
Seat 4: 1_KoLizeI_1 folded before Flop (didn't bet)
Seat 5: RaulacateFolds folded before Flop (didn't bet)
Seat 6: IamFixxed showed [Ac Td] and lost with a pair of Aces



PokerStars Zoom Hand #229230602646:  Hold'em No Limit ($0.01/$0.02) - 2021/08/21 21:42:07 CET [2021/08/21 15:42:07 ET]
Table 'Halley' 6-max Seat #1 is the button
Seat 1: nitzed12 ($2.52 in chips) 
Seat 2: gugamoraes ($2.05 in chips) 
Seat 3: JaguarAndy17 ($2 in chips) 
Seat 4: Scaaalll ($2.22 in chips) 
Seat 5: Benjani1412 ($2.06 in chips) 
Seat 6: MIT_PKR ($2.41 in chips) 
gugamoraes: posts small blind $0.01
JaguarAndy17: posts big blind $0.02
*** HOLE CARDS ***
Dealt to Scaaalll [Ac 8h]
Scaaalll: folds 
Benjani1412: folds 
MIT_PKR: raises $0.03 to $0.05
nitzed12: folds 
gugamoraes: calls $0.04
JaguarAndy17: folds 
*** FLOP *** [9s 5c 3c]
JaguarAndy17 is disconnected 
gugamoraes: checks 
MIT_PKR: bets $0.04
gugamoraes: folds 
Uncalled bet ($0.04) returned to MIT_PKR
MIT_PKR collected $0.12 from pot
MIT_PKR: doesn't show hand 
*** SUMMARY ***
Total pot $0.12 | Rake $0 
Board [9s 5c 3c]
Seat 1: nitzed12 (button) folded before Flop (didn't bet)
Seat 2: gugamoraes (small blind) folded on the Flop
Seat 3: JaguarAndy17 (big blind) folded before Flop
Seat 4: Scaaalll folded before Flop (didn't bet)
Seat 5: Benjani1412 folded before Flop (didn't bet)
Seat 6: MIT_PKR collected ($0.12)



PokerStars Zoom Hand #229230607187:  Hold'em No Limit ($0.01/$0.02) - 2021/08/21 21:42:16 CET [2021/08/21 15:42:16 ET]
Table 'Halley' 6-max Seat #1 is the button
Seat 1: AshoT#001 ($1.50 in chips) 
Seat 2: iPitbull1 ($2.01 in chips) 
Seat 3: keldh ($4.65 in chips) 
Seat 4: gy67 ($3.24 in chips) 
Seat 5: Scaaalll ($2.21 in chips) 
Seat 6: RonilsonCosta ($2.10 in chips) 
iPitbull1: posts small blind $0.01
keldh: posts big blind $0.02
*** HOLE CARDS ***
Dealt to Scaaalll [Ks 7d]
gy67: calls $0.02
Scaaalll: folds 
RonilsonCosta: folds 
AshoT#001: raises $0.07 to $0.09
iPitbull1: calls $0.08
keldh: folds 
gy67: calls $0.07
*** FLOP *** [4h 6h 4s]
iPitbull1: bets $0.14
gy67: folds 
AshoT#001: raises $0.28 to $0.42
iPitbull1: folds 
Uncalled bet ($0.28) returned to AshoT#001
AshoT#001 collected $0.55 from pot
AshoT#001: doesn't show hand 
*** SUMMARY ***
Total pot $0.57 | Rake $0.02 
Board [4h 6h 4s]
Seat 1: AshoT#001 (button) collected ($0.55)
Seat 2: iPitbull1 (small blind) folded on the Flop
Seat 3: keldh (big blind) folded before Flop
Seat 4: gy67 folded on the Flop
Seat 5: Scaaalll folded before Flop (didn't bet)
Seat 6: RonilsonCosta folded before Flop (didn't bet)



PokerStars Zoom Hand #229230612318:  Hold'em No Limit ($0.01/$0.02) - 2021/08/21 21:42:27 CET [2021/08/21 15:42:27 ET]
Table 'Halley' 6-max Seat #1 is the button
Seat 1: Scaaalll ($2.21 in chips) 
Seat 2: mrfastflow ($2.81 in chips) 
Seat 3: sorinysu ($0.30 in chips) 
Seat 4: Allekccc ($1.89 in chips) 
Seat 5: Ruopolo1982 ($2.07 in chips) 
Seat 6: arrow17 ($2 in chips) 
mrfastflow: posts small blind $0.01
sorinysu: posts big blind $0.02
*** HOLE CARDS ***
Dealt to Scaaalll [Qc 9d]
Allekccc: raises $0.02 to $0.04
Ruopolo1982: folds 
arrow17: raises $0.14 to $0.18
Scaaalll: folds 
mrfastflow: folds 
sorinysu: folds 
Allekccc: calls $0.14
*** FLOP *** [As Ts 2c]
sorinysu is disconnected 
Allekccc: checks 
arrow17: bets $0.19
Allekccc: calls $0.19
*** TURN *** [As Ts 2c] [6h]
Allekccc: checks 
arrow17: checks 
*** RIVER *** [As Ts 2c 6h] [7c]
Allekccc: checks 
arrow17: bets $0.40
Allekccc: calls $0.40
*** SHOW DOWN ***
arrow17: shows [Qs Ad] (a pair of Aces)
Allekccc: mucks hand 
arrow17 collected $1.52 from pot
*** SUMMARY ***
Total pot $1.57 | Rake $0.05 
Board [As Ts 2c 6h 7c]
Seat 1: Scaaalll (button) folded before Flop (didn't bet)
Seat 2: mrfastflow (small blind) folded before Flop
Seat 3: sorinysu (big blind) folded before Flop
Seat 4: Allekccc mucked [3c Ac]
Seat 5: Ruopolo1982 folded before Flop (didn't bet)
Seat 6: arrow17 showed [Qs Ad] and won ($1.52) with a pair of Aces



PokerStars Zoom Hand #229230626657:  Hold'em No Limit ($0.01/$0.02) - 2021/08/21 21:42:58 CET [2021/08/21 15:42:58 ET]
Table 'Halley' 6-max Seat #1 is the button
Seat 1: Saint_ANBU ($2.82 in chips) 
Seat 2: CAHbKA777111 ($0.50 in chips) 
Seat 3: Jujiluju ($3.54 in chips) 
Seat 4: pavlo8855 ($2.27 in chips) 
Seat 5: Tabitaji ($4.09 in chips) 
Seat 6: Scaaalll ($2.19 in chips) 
CAHbKA777111: posts small blind $0.01
Jujiluju: posts big blind $0.02
*** HOLE CARDS ***
Dealt to Scaaalll [Tc 4d]
pavlo8855: folds 
Tabitaji: folds 
Scaaalll: folds 
Saint_ANBU: folds 
CAHbKA777111: raises $0.03 to $0.05
Jujiluju: calls $0.03
*** FLOP *** [5h 4h 6s]
CAHbKA777111: checks 
Jujiluju: checks 
*** TURN *** [5h 4h 6s] [5d]
CAHbKA777111: checks 
Jujiluju: checks 
*** RIVER *** [5h 4h 6s 5d] [7c]
CAHbKA777111: checks 
Jujiluju: checks 
*** SHOW DOWN ***
CAHbKA777111: shows [Ad Td] (a pair of Fives)
Jujiluju: shows [Ah Jd] (a pair of Fives - Ace+Jack kicker)
Jujiluju collected $0.10 from pot
*** SUMMARY ***
Total pot $0.10 | Rake $0 
Board [5h 4h 6s 5d 7c]
Seat 1: Saint_ANBU (button) folded before Flop (didn't bet)
Seat 2: CAHbKA777111 (small blind) showed [Ad Td] and lost with a pair of Fives
Seat 3: Jujiluju (big blind) showed [Ah Jd] and won ($0.10) with a pair of Fives
Seat 4: pavlo8855 folded before Flop (didn't bet)
Seat 5: Tabitaji folded before Flop (didn't bet)
Seat 6: Scaaalll folded before Flop (didn't bet)



PokerStars Zoom Hand #229230617335:  Hold'em No Limit ($0.01/$0.02) - 2021/08/21 21:42:38 CET [2021/08/21 15:42:38 ET]
Table 'Halley' 6-max Seat #1 is the button
Seat 1: feybys ($2.42 in chips) 
Seat 2: dinoVIEIRA ($2 in chips) 
Seat 3: Scaaalll ($2.21 in chips) 
Seat 4: Finkey99 ($5.06 in chips) 
Seat 5: Amigo113 ($2 in chips) 
Seat 6: Loto70 ($2 in chips) 
dinoVIEIRA: posts small blind $0.01
Scaaalll: posts big blind $0.02
*** HOLE CARDS ***
Dealt to Scaaalll [2s Js]
Finkey99: raises $0.03 to $0.05
Amigo113: folds 
Loto70: folds 
feybys: calls $0.05
dinoVIEIRA: folds 
Scaaalll: folds 
*** FLOP *** [2d 2c 2h]
Finkey99: checks 
feybys: checks 
*** TURN *** [2d 2c 2h] [4s]
Finkey99: checks 
feybys: checks 
*** RIVER *** [2d 2c 2h 4s] [Jh]
Finkey99: checks 
feybys: bets $0.13
Finkey99: folds 
Uncalled bet ($0.13) returned to feybys
feybys collected $0.13 from pot
feybys: doesn't show hand 
*** SUMMARY ***
Total pot $0.13 | Rake $0 
Board [2d 2c 2h 4s Jh]
Seat 1: feybys (button) collected ($0.13)
Seat 2: dinoVIEIRA (small blind) folded before Flop
Seat 3: Scaaalll (big blind) folded before Flop
Seat 4: Finkey99 folded on the River
Seat 5: Amigo113 folded before Flop (didn't bet)
Seat 6: Loto70 folded before Flop (didn't bet)



PokerStars Zoom Hand #229230630319:  Hold'em No Limit ($0.01/$0.02) - 2021/08/21 21:43:06 CET [2021/08/21 15:43:06 ET]
Table 'Halley' 6-max Seat #1 is the button
Seat 1: Scaaalll ($2.18 in chips) 
Seat 2: LegendaryLRS ($3.15 in chips) 
Seat 3: zbixxx ($4.35 in chips) 
Seat 4: SpartanRace1 ($7.19 in chips) 
Seat 5: Koldun 2636 ($3.02 in chips) 
Seat 6: xFruJensen ($1.87 in chips) 
LegendaryLRS: posts small blind $0.01
zbixxx: posts big blind $0.02
*** HOLE CARDS ***
Dealt to Scaaalll [4s 6s]
SpartanRace1: folds 
Koldun 2636: folds 
xFruJensen: folds 
Scaaalll: folds 
LegendaryLRS: raises $0.04 to $0.06
zbixxx: calls $0.04
*** FLOP *** [Th Kc 8c]
LegendaryLRS: checks 
zbixxx: bets $0.07
LegendaryLRS: calls $0.07
*** TURN *** [Th Kc 8c] [2c]
LegendaryLRS: checks 
zbixxx: checks 
*** RIVER *** [Th Kc 8c 2c] [8d]
LegendaryLRS: checks 
zbixxx: bets $0.08
LegendaryLRS: calls $0.08
*** SHOW DOWN ***
zbixxx: shows [Tc 9d] (two pair, Tens and Eights)
LegendaryLRS: mucks hand 
zbixxx collected $0.41 from pot
*** SUMMARY ***
Total pot $0.42 | Rake $0.01 
Board [Th Kc 8c 2c 8d]
Seat 1: Scaaalll (button) folded before Flop (didn't bet)
Seat 2: LegendaryLRS (small blind) mucked [Qd Ah]
Seat 3: zbixxx (big blind) showed [Tc 9d] and won ($0.41) with two pair, Tens and Eights
Seat 4: SpartanRace1 folded before Flop (didn't bet)
Seat 5: Koldun 2636 folded before Flop (didn't bet)
Seat 6: xFruJensen folded before Flop (didn't bet)



PokerStars Zoom Hand #229230633095:  Hold'em No Limit ($0.01/$0.02) - 2021/08/21 21:43:13 CET [2021/08/21 15:43:13 ET]
Table 'Halley' 6-max Seat #1 is the button
Seat 1: WithMyWalker ($2.87 in chips) 
Seat 2: Loto70 ($2.16 in chips) 
Seat 3: CASSIE21462 ($5.70 in chips) 
Seat 4: MsSuffolk ($2.23 in chips) 
Seat 5: SpartanRace1 ($7.55 in chips) 
Seat 6: Scaaalll ($2.18 in chips) 
Loto70: posts small blind $0.01
CASSIE21462: posts big blind $0.02
*** HOLE CARDS ***
Dealt to Scaaalll [4h Ah]
MsSuffolk: folds 
SpartanRace1: folds 
Scaaalll: raises $0.04 to $0.06
WithMyWalker: folds 
Loto70: folds 
CASSIE21462: calls $0.04
*** FLOP *** [8h Td 7h]
CASSIE21462: checks 
Scaaalll: bets $0.09
CASSIE21462: calls $0.09
*** TURN *** [8h Td 7h] [Ad]
CASSIE21462: checks 
Scaaalll: bets $0.15
CASSIE21462: calls $0.15
*** RIVER *** [8h Td 7h Ad] [4c]
CASSIE21462: checks 
Scaaalll: bets $0.33
CASSIE21462: folds 
Uncalled bet ($0.33) returned to Scaaalll
Scaaalll collected $0.59 from pot
Scaaalll: doesn't show hand 
*** SUMMARY ***
Total pot $0.61 | Rake $0.02 
Board [8h Td 7h Ad 4c]
Seat 1: WithMyWalker (button) folded before Flop (didn't bet)
Seat 2: Loto70 (small blind) folded before Flop
Seat 3: CASSIE21462 (big blind) folded on the River
Seat 4: MsSuffolk folded before Flop (didn't bet)
Seat 5: SpartanRace1 folded before Flop (didn't bet)
Seat 6: Scaaalll collected ($0.59)



PokerStars Zoom Hand #229230628550:  Hold'em No Limit ($0.01/$0.02) - 2021/08/21 21:43:03 CET [2021/08/21 15:43:03 ET]
Table 'Halley' 6-max Seat #1 is the button
Seat 1: dinoVIEIRA ($2 in chips) 
Seat 2: Scaaalll ($2.19 in chips) 
Seat 3: ARTMVSLV ($2.08 in chips) 
Seat 4: negrutsenior ($1.56 in chips) 
Seat 5: pavlo590 ($2 in chips) 
Seat 6: lukzmodric10 ($2.44 in chips) 
Scaaalll: posts small blind $0.01
ARTMVSLV: posts big blind $0.02
*** HOLE CARDS ***
Dealt to Scaaalll [Jc 5c]
pavlo590 is disconnected 
negrutsenior: raises $0.02 to $0.04
pavlo590: folds 
lukzmodric10: folds 
dinoVIEIRA: raises $0.10 to $0.14
Scaaalll: folds 
ARTMVSLV: folds 
negrutsenior: calls $0.10
*** FLOP *** [Th Jh 4s]
negrutsenior: checks 
dinoVIEIRA: bets $0.20
negrutsenior: calls $0.20
*** TURN *** [Th Jh 4s] [Kc]
negrutsenior: checks 
dinoVIEIRA: bets $0.52
negrutsenior: raises $0.70 to $1.22 and is all-in
dinoVIEIRA: calls $0.70
*** RIVER *** [Th Jh 4s Kc] [3h]
*** SHOW DOWN ***
negrutsenior: shows [Qh Ah] (a flush, Ace high)
dinoVIEIRA: shows [Kh Kd] (three of a kind, Kings)
negrutsenior collected $3.04 from pot
*** SUMMARY ***
Total pot $3.15 | Rake $0.11 
Board [Th Jh 4s Kc 3h]
Seat 1: dinoVIEIRA (button) showed [Kh Kd] and lost with three of a kind, Kings
Seat 2: Scaaalll (small blind) folded before Flop
Seat 3: ARTMVSLV (big blind) folded before Flop
Seat 4: negrutsenior showed [Qh Ah] and won ($3.04) with a flush, Ace high
Seat 5: pavlo590 folded before Flop (didn't bet)
Seat 6: lukzmodric10 folded before Flop (didn't bet)



PokerStars Zoom Hand #229230655930:  Hold'em No Limit ($0.01/$0.02) - 2021/08/21 21:44:03 CET [2021/08/21 15:44:03 ET]
Table 'Halley' 6-max Seat #1 is the button
Seat 1: qpsq ($5.31 in chips) 
Seat 2: Clavis Noa ($3.46 in chips) 
Seat 3: solosigueme ($4.93 in chips) 
Seat 4: Scaaalll ($2.47 in chips) 
Seat 5: kahzura ($2.88 in chips) 
Seat 6: Oprichnick90 ($4.25 in chips) 
Clavis Noa: posts small blind $0.01
solosigueme: posts big blind $0.02
*** HOLE CARDS ***
Dealt to Scaaalll [2d 4h]
Scaaalll: folds 
kahzura: raises $0.04 to $0.06
Oprichnick90: folds 
qpsq: folds 
Clavis Noa: folds 
solosigueme: folds 
Uncalled bet ($0.04) returned to kahzura
kahzura collected $0.05 from pot
kahzura: doesn't show hand 
*** SUMMARY ***
Total pot $0.05 | Rake $0 
Seat 1: qpsq (button) folded before Flop (didn't bet)
Seat 2: Clavis Noa (small blind) folded before Flop
Seat 3: solosigueme (big blind) folded before Flop
Seat 4: Scaaalll folded before Flop (didn't bet)
Seat 5: kahzura collected ($0.05)
Seat 6: Oprichnick90 folded before Flop (didn't bet)



PokerStars Zoom Hand #229230657781:  Hold'em No Limit ($0.01/$0.02) - 2021/08/21 21:44:07 CET [2021/08/21 15:44:07 ET]
Table 'Halley' 6-max Seat #1 is the button
Seat 1: twiti174 ($5.30 in chips) 
Seat 2: 48159348 ($1.72 in chips) 
Seat 3: kboskov123 ($1.67 in chips) 
Seat 4: arrow17 ($2.03 in chips) 
Seat 5: Scaaalll ($2.47 in chips) 
Seat 6: morjachok8888 ($1.89 in chips) 
48159348: posts small blind $0.01
kboskov123: posts big blind $0.02
*** HOLE CARDS ***
Dealt to Scaaalll [Kh 7d]
arrow17: folds 
Scaaalll: folds 
twiti174 is disconnected 
morjachok8888: raises $0.05 to $0.07
twiti174: folds 
48159348: folds 
kboskov123: folds 
Uncalled bet ($0.05) returned to morjachok8888
morjachok8888 collected $0.05 from pot
morjachok8888: doesn't show hand 
*** SUMMARY ***
Total pot $0.05 | Rake $0 
Seat 1: twiti174 (button) folded before Flop (didn't bet)
Seat 2: 48159348 (small blind) folded before Flop
Seat 3: kboskov123 (big blind) folded before Flop
Seat 4: arrow17 folded before Flop (didn't bet)
Seat 5: Scaaalll folded before Flop (didn't bet)
Seat 6: morjachok8888 collected ($0.05)



PokerStars Zoom Hand #229230659590:  Hold'em No Limit ($0.01/$0.02) - 2021/08/21 21:44:11 CET [2021/08/21 15:44:11 ET]
Table 'Halley' 6-max Seat #1 is the button
Seat 1: stealth_ua ($3.48 in chips) 
Seat 2: LegendaryLRS ($2.44 in chips) 
Seat 3: Scaaalll ($2.47 in chips) 
Seat 4: Finkey99 ($4.98 in chips) 
Seat 5: so0love ($4.27 in chips) 
Seat 6: ramalhorod ($4.50 in chips) 
LegendaryLRS: posts small blind $0.01
Scaaalll: posts big blind $0.02
*** HOLE CARDS ***
Dealt to Scaaalll [8h 2c]
Finkey99: folds 
so0love: folds 
ramalhorod: folds 
ramalhorod is disconnected 
stealth_ua: raises $0.03 to $0.05
LegendaryLRS: folds 
Scaaalll: folds 
Uncalled bet ($0.03) returned to stealth_ua
stealth_ua collected $0.05 from pot
stealth_ua: doesn't show hand 
*** SUMMARY ***
Total pot $0.05 | Rake $0 
Seat 1: stealth_ua (button) collected ($0.05)
Seat 2: LegendaryLRS (small blind) folded before Flop
Seat 3: Scaaalll (big blind) folded before Flop
Seat 4: Finkey99 folded before Flop (didn't bet)
Seat 5: so0love folded before Flop (didn't bet)
Seat 6: ramalhorod folded before Flop (didn't bet)



PokerStars Zoom Hand #229230665588:  Hold'em No Limit ($0.01/$0.02) - 2021/08/21 21:44:23 CET [2021/08/21 15:44:23 ET]
Table 'Halley' 6-max Seat #1 is the button
Seat 1: Allekccc ($1.87 in chips) 
Seat 2: Scaaalll ($2.45 in chips) 
Seat 3: zergmiky ($2.32 in chips) 
Seat 4: bananAAbandit ($2.01 in chips) 
Seat 5: meps88 ($2.77 in chips) 
Seat 6: Milhouse1119 ($2.14 in chips) 
Scaaalll: posts small blind $0.01
zergmiky: posts big blind $0.02
*** HOLE CARDS ***
Dealt to Scaaalll [9d Ks]
bananAAbandit: folds 
Milhouse1119 is disconnected 
meps88: folds 
Milhouse1119: folds 
Allekccc: folds 
Scaaalll: raises $0.04 to $0.06
zergmiky: folds 
Uncalled bet ($0.04) returned to Scaaalll
Scaaalll collected $0.04 from pot
Scaaalll: doesn't show hand 
*** SUMMARY ***
Total pot $0.04 | Rake $0 
Seat 1: Allekccc (button) folded before Flop (didn't bet)
Seat 2: Scaaalll (small blind) collected ($0.04)
Seat 3: zergmiky (big blind) folded before Flop
Seat 4: bananAAbandit folded before Flop (didn't bet)
Seat 5: meps88 folded before Flop (didn't bet)
Seat 6: Milhouse1119 folded before Flop (didn't bet)



PokerStars Zoom Hand #229230672891:  Hold'em No Limit ($0.01/$0.02) - 2021/08/21 21:44:40 CET [2021/08/21 15:44:40 ET]
Table 'Halley' 6-max Seat #1 is the button
Seat 1: 1_KoLizeI_1 ($3.32 in chips) 
Seat 2: Finderra ($2 in chips) 
Seat 3: Fedor_Gar ($2.07 in chips) 
Seat 4: SaRCh_Ale ($1.93 in chips) 
Seat 5: fishh_play ($5.24 in chips) 
Seat 6: Scaaalll ($2.47 in chips) 
Finderra: posts small blind $0.01
Fedor_Gar: posts big blind $0.02
*** HOLE CARDS ***
Dealt to Scaaalll [7c 9s]
SaRCh_Ale: folds 
fishh_play: folds 
Scaaalll: folds 
1_KoLizeI_1: folds 
Finderra: folds 
Uncalled bet ($0.01) returned to Fedor_Gar
Fedor_Gar collected $0.02 from pot
Fedor_Gar: doesn't show hand 
*** SUMMARY ***
Total pot $0.02 | Rake $0 
Seat 1: 1_KoLizeI_1 (button) folded before Flop (didn't bet)
Seat 2: Finderra (small blind) folded before Flop
Seat 3: Fedor_Gar (big blind) collected ($0.02)
Seat 4: SaRCh_Ale folded before Flop (didn't bet)
Seat 5: fishh_play folded before Flop (didn't bet)
Seat 6: Scaaalll folded before Flop (didn't bet)



PokerStars Zoom Hand #229230671097:  Hold'em No Limit ($0.01/$0.02) - 2021/08/21 21:44:36 CET [2021/08/21 15:44:36 ET]
Table 'Halley' 6-max Seat #1 is the button
Seat 1: VasquezSancho96 ($8.27 in chips) 
Seat 2: arsad725 ($6.64 in chips) 
Seat 3: pphit ($2.34 in chips) 
Seat 4: SIGREX ($2.26 in chips) 
Seat 5: Scaaalll ($2.47 in chips) 
Seat 6: maliniak75 ($1.95 in chips) 
arsad725: posts small blind $0.01
pphit: posts big blind $0.02
*** HOLE CARDS ***
Dealt to Scaaalll [7s Td]
SIGREX: folds 
Scaaalll: folds 
maliniak75: folds 
VasquezSancho96: raises $0.02 to $0.04
arsad725: folds 
pphit: folds 
Uncalled bet ($0.02) returned to VasquezSancho96
VasquezSancho96 collected $0.05 from pot
VasquezSancho96: doesn't show hand 
*** SUMMARY ***
Total pot $0.05 | Rake $0 
Seat 1: VasquezSancho96 (button) collected ($0.05)
Seat 2: arsad725 (small blind) folded before Flop
Seat 3: pphit (big blind) folded before Flop
Seat 4: SIGREX folded before Flop (didn't bet)
Seat 5: Scaaalll folded before Flop (didn't bet)
Seat 6: maliniak75 folded before Flop (didn't bet)



PokerStars Zoom Hand #229230674633:  Hold'em No Limit ($0.01/$0.02) - 2021/08/21 21:44:43 CET [2021/08/21 15:44:43 ET]
Table 'Halley' 6-max Seat #1 is the button
Seat 1: Scaaalll ($2.47 in chips) 
Seat 2: IamScald ($2.32 in chips) 
Seat 3: VovaSerega ($2 in chips) 
Seat 4: Shcherbak252 ($1.80 in chips) 
Seat 5: Fanatspartak ($0.77 in chips) 
Seat 6: Slirey ($2.95 in chips) 
IamScald: posts small blind $0.01
VovaSerega: posts big blind $0.02
*** HOLE CARDS ***
Dealt to Scaaalll [9s As]
Shcherbak252: folds 
Fanatspartak: folds 
Slirey: calls $0.02
Scaaalll: raises $0.06 to $0.08
IamScald: calls $0.07
VovaSerega: folds 
Slirey: calls $0.06
*** FLOP *** [Qs 9c Jd]
IamScald: checks 
Slirey: checks 
Scaaalll: checks 
*** TURN *** [Qs 9c Jd] [Js]
IamScald: checks 
Slirey: checks 
Scaaalll: bets $0.14
IamScald: folds 
IamScald is disconnected 
Slirey: folds 
Uncalled bet ($0.14) returned to Scaaalll
Scaaalll collected $0.25 from pot
Scaaalll: doesn't show hand 
Slirey is disconnected 
*** SUMMARY ***
Total pot $0.26 | Rake $0.01 
Board [Qs 9c Jd Js]
Seat 1: Scaaalll (button) collected ($0.25)
Seat 2: IamScald (small blind) folded on the Turn
Seat 3: VovaSerega (big blind) folded before Flop
Seat 4: Shcherbak252 folded before Flop (didn't bet)
Seat 5: Fanatspartak folded before Flop (didn't bet)
Seat 6: Slirey folded on the Turn



PokerStars Zoom Hand #229230705543:  Hold'em No Limit ($0.01/$0.02) - 2021/08/21 21:45:52 CET [2021/08/21 15:45:52 ET]
Table 'Halley' 6-max Seat #1 is the button
Seat 1: fujiriver ($1.40 in chips) 
Seat 2: Jujiluju ($1.11 in chips) 
Seat 3: Scaaalll ($2.64 in chips) 
Seat 4: Benjani1412 ($2.20 in chips) 
Seat 5: qpsq ($4.03 in chips) 
Seat 6: BurnmasterX ($2.82 in chips) 
Jujiluju: posts small blind $0.01
Scaaalll: posts big blind $0.02
*** HOLE CARDS ***
Dealt to Scaaalll [4h 6c]
Benjani1412: folds 
qpsq: folds 
fujiriver is disconnected 
BurnmasterX: raises $0.02 to $0.04
fujiriver: folds 
Jujiluju: raises $0.10 to $0.14
Scaaalll: folds 
BurnmasterX: calls $0.10
*** FLOP *** [3s Kc Jh]
Jujiluju: bets $0.29
BurnmasterX: calls $0.29
*** TURN *** [3s Kc Jh] [6s]
Jujiluju: bets $0.68 and is all-in
BurnmasterX: calls $0.68
*** RIVER *** [3s Kc Jh 6s] [2d]
*** SHOW DOWN ***
Jujiluju: shows [Ah Kh] (a pair of Kings)
BurnmasterX: shows [Ts Js] (a pair of Jacks)
Jujiluju collected $2.16 from pot
*** SUMMARY ***
Total pot $2.24 | Rake $0.08 
Board [3s Kc Jh 6s 2d]
Seat 1: fujiriver (button) folded before Flop (didn't bet)
Seat 2: Jujiluju (small blind) showed [Ah Kh] and won ($2.16) with a pair of Kings
Seat 3: Scaaalll (big blind) folded before Flop
Seat 4: Benjani1412 folded before Flop (didn't bet)
Seat 5: qpsq folded before Flop (didn't bet)
Seat 6: BurnmasterX showed [Ts Js] and lost with a pair of Jacks



PokerStars Zoom Hand #229230710456:  Hold'em No Limit ($0.01/$0.02) - 2021/08/21 21:46:03 CET [2021/08/21 15:46:03 ET]
Table 'Halley' 6-max Seat #1 is the button
Seat 1: flexitunes ($4.31 in chips) 
Seat 2: Scaaalll ($2.62 in chips) 
Seat 3: ugi-dugi ($2.97 in chips) 
Seat 4: nitzed12 ($2.44 in chips) 
Seat 5: MIT_PKR ($2.61 in chips) 
Seat 6: ARTMVSLV ($2.03 in chips) 
Scaaalll: posts small blind $0.01
ugi-dugi: posts big blind $0.02
*** HOLE CARDS ***
Dealt to Scaaalll [Jc Tc]
nitzed12: folds 
MIT_PKR: raises $0.03 to $0.05
ARTMVSLV: folds 
flexitunes: folds 
Scaaalll: calls $0.04
ugi-dugi: folds 
*** FLOP *** [6s 9h Ah]
Scaaalll: checks 
MIT_PKR: bets $0.04
Scaaalll: folds 
Uncalled bet ($0.04) returned to MIT_PKR
MIT_PKR collected $0.12 from pot
MIT_PKR: doesn't show hand 
*** SUMMARY ***
Total pot $0.12 | Rake $0 
Board [6s 9h Ah]
Seat 1: flexitunes (button) folded before Flop (didn't bet)
Seat 2: Scaaalll (small blind) folded on the Flop
Seat 3: ugi-dugi (big blind) folded before Flop
Seat 4: nitzed12 folded before Flop (didn't bet)
Seat 5: MIT_PKR collected ($0.12)
Seat 6: ARTMVSLV folded before Flop (didn't bet)



PokerStars Zoom Hand #229230703781:  Hold'em No Limit ($0.01/$0.02) - 2021/08/21 21:45:47 CET [2021/08/21 15:45:47 ET]
Table 'Halley' 6-max Seat #1 is the button
Seat 1: Smaill174 ($1.48 in chips) 
Seat 2: arrow17 ($2.05 in chips) 
Seat 3: Artur1987PL ($1.29 in chips) 
Seat 4: Scaaalll ($2.64 in chips) 
Seat 5: Xlavariable ($4.65 in chips) 
Seat 6: JannikSPoker ($2 in chips) 
arrow17: posts small blind $0.01
Artur1987PL: posts big blind $0.02
*** HOLE CARDS ***
Dealt to Scaaalll [6h 2s]
Scaaalll: folds 
Xlavariable: folds 
JannikSPoker: folds 
JannikSPoker is disconnected 
Smaill174: raises $0.04 to $0.06
arrow17: folds 
Artur1987PL: calls $0.04
*** FLOP *** [9d 8c Ts]
Artur1987PL: checks 
Smaill174: bets $0.10
Artur1987PL: calls $0.10
*** TURN *** [9d 8c Ts] [6s]
Artur1987PL: checks 
Smaill174: checks 
*** RIVER *** [9d 8c Ts 6s] [Jc]
Artur1987PL: bets $0.32
Smaill174: folds 
Uncalled bet ($0.32) returned to Artur1987PL
Artur1987PL collected $0.32 from pot
Artur1987PL: doesn't show hand 
*** SUMMARY ***
Total pot $0.33 | Rake $0.01 
Board [9d 8c Ts 6s Jc]
Seat 1: Smaill174 (button) folded on the River
Seat 2: arrow17 (small blind) folded before Flop
Seat 3: Artur1987PL (big blind) collected ($0.32)
Seat 4: Scaaalll folded before Flop (didn't bet)
Seat 5: Xlavariable folded before Flop (didn't bet)
Seat 6: JannikSPoker folded before Flop (didn't bet)



PokerStars Zoom Hand #229230729128:  Hold'em No Limit ($0.01/$0.02) - 2021/08/21 21:46:43 CET [2021/08/21 15:46:43 ET]
Table 'Halley' 6-max Seat #1 is the button
Seat 1: Scaaalll ($2.57 in chips) 
Seat 2: Ne0net ($2 in chips) 
Seat 3: Blaackie ($2.12 in chips) 
Seat 4: HellNative ($2.59 in chips) 
Seat 5: Mikeloko182 ($2 in chips) 
Seat 6: szajm ($0.85 in chips) 
Ne0net: posts small blind $0.01
Blaackie: posts big blind $0.02
*** HOLE CARDS ***
Dealt to Scaaalll [Kd Td]
HellNative: folds 
Mikeloko182: folds 
szajm: folds 
szajm is disconnected 
Scaaalll: raises $0.02 to $0.04
Ne0net: folds 
Blaackie: folds 
Uncalled bet ($0.02) returned to Scaaalll
Scaaalll collected $0.05 from pot
Scaaalll: doesn't show hand 
*** SUMMARY ***
Total pot $0.05 | Rake $0 
Seat 1: Scaaalll (button) collected ($0.05)
Seat 2: Ne0net (small blind) folded before Flop
Seat 3: Blaackie (big blind) folded before Flop
Seat 4: HellNative folded before Flop (didn't bet)
Seat 5: Mikeloko182 folded before Flop (didn't bet)
Seat 6: szajm folded before Flop (didn't bet)



PokerStars Zoom Hand #229230727304:  Hold'em No Limit ($0.01/$0.02) - 2021/08/21 21:46:40 CET [2021/08/21 15:46:40 ET]
Table 'Halley' 6-max Seat #1 is the button
Seat 1: nitzed12 ($2.44 in chips) 
Seat 2: pphit ($2 in chips) 
Seat 3: ryancudmore ($3.29 in chips) 
Seat 4: MIT_PKR ($4.50 in chips) 
Seat 5: Scaaalll ($2.57 in chips) 
Seat 6: iPitbull1 ($2 in chips) 
pphit: posts small blind $0.01
ryancudmore: posts big blind $0.02
*** HOLE CARDS ***
Dealt to Scaaalll [8s 3h]
MIT_PKR: folds 
Scaaalll: folds 
iPitbull1: folds 
nitzed12: raises $0.03 to $0.05
pphit: folds 
ryancudmore: calls $0.03
*** FLOP *** [2d Ks Ad]
ryancudmore: checks 
nitzed12: bets $0.06
ryancudmore: folds 
Uncalled bet ($0.06) returned to nitzed12
nitzed12 collected $0.11 from pot
nitzed12: doesn't show hand 
ryancudmore is disconnected 
*** SUMMARY ***
Total pot $0.11 | Rake $0 
Board [2d Ks Ad]
Seat 1: nitzed12 (button) collected ($0.11)
Seat 2: pphit (small blind) folded before Flop
Seat 3: ryancudmore (big blind) folded on the Flop
Seat 4: MIT_PKR folded before Flop (didn't bet)
Seat 5: Scaaalll folded before Flop (didn't bet)
Seat 6: iPitbull1 folded before Flop (didn't bet)



PokerStars Zoom Hand #229230735586:  Hold'em No Limit ($0.01/$0.02) - 2021/08/21 21:46:57 CET [2021/08/21 15:46:57 ET]
Table 'Halley' 6-max Seat #1 is the button
Seat 1: Berti281 ($2.03 in chips) 
Seat 2: zbixxx ($2.82 in chips) 
Seat 3: Toha240707 ($3.15 in chips) 
Seat 4: rodrigoasor ($1.09 in chips) 
Seat 5: babymaza0907 ($2.63 in chips) 
Seat 6: Scaaalll ($2.60 in chips) 
zbixxx: posts small blind $0.01
Toha240707: posts big blind $0.02
*** HOLE CARDS ***
Dealt to Scaaalll [9c 6d]
rodrigoasor: raises $0.04 to $0.06
babymaza0907: folds 
Toha240707 is disconnected 
Scaaalll: folds 
Berti281: calls $0.06
zbixxx: folds 
Toha240707: folds 
*** FLOP *** [2h 5s Jh]
rodrigoasor: bets $0.14
Berti281: folds 
Uncalled bet ($0.14) returned to rodrigoasor
rodrigoasor collected $0.14 from pot
rodrigoasor: doesn't show hand 
*** SUMMARY ***
Total pot $0.15 | Rake $0.01 
Board [2h 5s Jh]
Seat 1: Berti281 (button) folded on the Flop
Seat 2: zbixxx (small blind) folded before Flop
Seat 3: Toha240707 (big blind) folded before Flop
Seat 4: rodrigoasor collected ($0.14)
Seat 5: babymaza0907 folded before Flop (didn't bet)
Seat 6: Scaaalll folded before Flop (didn't bet)



PokerStars Zoom Hand #229230765683:  Hold'em No Limit ($0.01/$0.02) - 2021/08/21 21:48:04 CET [2021/08/21 15:48:04 ET]
Table 'Halley' 6-max Seat #1 is the button
Seat 1: KoAlRy ($2 in chips) 
Seat 2: Scaaalll ($2.50 in chips) 
Seat 3: SchinkenToni ($2.74 in chips) 
Seat 4: pavlo8855 ($2 in chips) 
Seat 5: 77omsk ($9.55 in chips) 
Seat 6: uniicecube ($1.86 in chips) 
Scaaalll: posts small blind $0.01
SchinkenToni: posts big blind $0.02
*** HOLE CARDS ***
Dealt to Scaaalll [4s Kc]
pavlo8855: folds 
77omsk: raises $0.03 to $0.05
uniicecube: folds 
KoAlRy: folds 
Scaaalll: folds 
SchinkenToni: folds 
Uncalled bet ($0.03) returned to 77omsk
77omsk collected $0.05 from pot
77omsk: doesn't show hand 
*** SUMMARY ***
Total pot $0.05 | Rake $0 
Seat 1: KoAlRy (button) folded before Flop (didn't bet)
Seat 2: Scaaalll (small blind) folded before Flop
Seat 3: SchinkenToni (big blind) folded before Flop
Seat 4: pavlo8855 folded before Flop (didn't bet)
Seat 5: 77omsk collected ($0.05)
Seat 6: uniicecube folded before Flop (didn't bet)



PokerStars Zoom Hand #229230771541:  Hold'em No Limit ($0.01/$0.02) - 2021/08/21 21:48:17 CET [2021/08/21 15:48:17 ET]
Table 'Halley' 6-max Seat #1 is the button
Seat 1: zeus11983 ($2.07 in chips) 
Seat 2: Jujiluju ($3.43 in chips) 
Seat 3: Berti281 ($2 in chips) 
Seat 4: HellNative ($3.09 in chips) 
Seat 5: arsad725 ($6.52 in chips) 
Seat 6: Scaaalll ($2.49 in chips) 
Jujiluju: posts small blind $0.01
Berti281: posts big blind $0.02
*** HOLE CARDS ***
Dealt to Scaaalll [Jh 4c]
HellNative: raises $0.02 to $0.04
arsad725: folds 
Scaaalll: folds 
zeus11983: folds 
Jujiluju: folds 
Berti281: folds 
Uncalled bet ($0.02) returned to HellNative
HellNative collected $0.05 from pot
HellNative: doesn't show hand 
*** SUMMARY ***
Total pot $0.05 | Rake $0 
Seat 1: zeus11983 (button) folded before Flop (didn't bet)
Seat 2: Jujiluju (small blind) folded before Flop
Seat 3: Berti281 (big blind) folded before Flop
Seat 4: HellNative collected ($0.05)
Seat 5: arsad725 folded before Flop (didn't bet)
Seat 6: Scaaalll folded before Flop (didn't bet)



PokerStars Zoom Hand #229230739767:  Hold'em No Limit ($0.01/$0.02) - 2021/08/21 21:47:06 CET [2021/08/21 15:47:06 ET]
Table 'Halley' 6-max Seat #1 is the button
Seat 1: Lamazflush ($1.77 in chips) 
Seat 2: Jujiluju ($3.54 in chips) 
Seat 3: Scaaalll ($2.60 in chips) 
Seat 4: davidalejag ($1.90 in chips) 
Seat 5: GamblersDream ($2.08 in chips) 
Seat 6: Artur1987PL ($1.45 in chips) 
Jujiluju: posts small blind $0.01
Scaaalll: posts big blind $0.02
*** HOLE CARDS ***
Dealt to Scaaalll [3d 3c]
davidalejag: raises $0.04 to $0.06
GamblersDream: calls $0.06
Artur1987PL: raises $0.04 to $0.10
Lamazflush: folds 
Jujiluju: folds 
Lamazflush is disconnected 
Scaaalll: calls $0.08
davidalejag: calls $0.04
GamblersDream: calls $0.04
*** FLOP *** [Ac Qd 6s]
Scaaalll: checks 
davidalejag: checks 
GamblersDream: checks 
Artur1987PL: bets $0.18
Scaaalll: folds 
davidalejag: calls $0.18
GamblersDream: calls $0.18
*** TURN *** [Ac Qd 6s] [Ah]
davidalejag: checks 
GamblersDream: checks 
Artur1987PL: bets $0.38
davidalejag: calls $0.38
GamblersDream: folds 
*** RIVER *** [Ac Qd 6s Ah] [Kh]
davidalejag: checks 
Artur1987PL: checks 
*** SHOW DOWN ***
davidalejag: shows [Jc As] (three of a kind, Aces)
Artur1987PL: mucks hand 
davidalejag collected $1.65 from pot
*** SUMMARY ***
Total pot $1.71 | Rake $0.06 
Board [Ac Qd 6s Ah Kh]
Seat 1: Lamazflush (button) folded before Flop (didn't bet)
Seat 2: Jujiluju (small blind) folded before Flop
Seat 3: Scaaalll (big blind) folded on the Flop
Seat 4: davidalejag showed [Jc As] and won ($1.65) with three of a kind, Aces
Seat 5: GamblersDream folded on the Turn
Seat 6: Artur1987PL mucked [Js 9c]



PokerStars Zoom Hand #229230763368:  Hold'em No Limit ($0.01/$0.02) - 2021/08/21 21:47:58 CET [2021/08/21 15:47:58 ET]
Table 'Halley' 6-max Seat #1 is the button
Seat 1: ugi-dugi ($2.45 in chips) 
Seat 2: ggluglul ($1.01 in chips) 
Seat 3: RoughRafff ($2 in chips) 
Seat 4: Oprichnick90 ($4.23 in chips) 
Seat 5: Scaaalll ($2.50 in chips) 
Seat 6: H0mmer99 ($1.84 in chips) 
ggluglul: posts small blind $0.01
RoughRafff: posts big blind $0.02
*** HOLE CARDS ***
Dealt to Scaaalll [9h 7d]
Oprichnick90: folds 
Scaaalll: folds 
H0mmer99: folds 
ugi-dugi: folds 
ggluglul: calls $0.01
RoughRafff: checks 
*** FLOP *** [4h 9s 2s]
ggluglul: bets $0.02
RoughRafff: calls $0.02
*** TURN *** [4h 9s 2s] [4d]
ggluglul: bets $0.04
RoughRafff: folds 
Uncalled bet ($0.04) returned to ggluglul
ggluglul collected $0.08 from pot
ggluglul: doesn't show hand 
*** SUMMARY ***
Total pot $0.08 | Rake $0 
Board [4h 9s 2s 4d]
Seat 1: ugi-dugi (button) folded before Flop (didn't bet)
Seat 2: ggluglul (small blind) collected ($0.08)
Seat 3: RoughRafff (big blind) folded on the Turn
Seat 4: Oprichnick90 folded before Flop (didn't bet)
Seat 5: Scaaalll folded before Flop (didn't bet)
Seat 6: H0mmer99 folded before Flop (didn't bet)



PokerStars Zoom Hand #229230767476:  Hold'em No Limit ($0.01/$0.02) - 2021/08/21 21:48:08 CET [2021/08/21 15:48:08 ET]
Table 'Halley' 6-max Seat #1 is the button
Seat 1: caiolima99 ($2.61 in chips) 
Seat 2: EevAA190 ($2 in chips) 
Seat 3: HellNative ($2.58 in chips) 
Seat 4: Scaaalll ($2.49 in chips) 
Seat 5: boa juice ($1.29 in chips) 
Seat 6: bananAAbandit ($2.06 in chips) 
EevAA190: posts small blind $0.01
HellNative: posts big blind $0.02
*** HOLE CARDS ***
Dealt to Scaaalll [Qd 8d]
boa juice is disconnected 
Scaaalll: folds 
boa juice: folds 
bananAAbandit: folds 
caiolima99: raises $0.04 to $0.06
EevAA190: raises $0.12 to $0.18
HellNative: folds 
caiolima99: folds 
Uncalled bet ($0.12) returned to EevAA190
EevAA190 collected $0.14 from pot
EevAA190: doesn't show hand 
*** SUMMARY ***
Total pot $0.14 | Rake $0 
Seat 1: caiolima99 (button) folded before Flop
Seat 2: EevAA190 (small blind) collected ($0.14)
Seat 3: HellNative (big blind) folded before Flop
Seat 4: Scaaalll folded before Flop (didn't bet)
Seat 5: boa juice folded before Flop (didn't bet)
Seat 6: bananAAbandit folded before Flop (didn't bet)



PokerStars Zoom Hand #229230774338:  Hold'em No Limit ($0.01/$0.02) - 2021/08/21 21:48:23 CET [2021/08/21 15:48:23 ET]
Table 'Halley' 6-max Seat #1 is the button
Seat 1: Scaaalll ($2.49 in chips) 
Seat 2: Kb013497 ($2.46 in chips) 
Seat 3: bober2702 ($3.64 in chips) 
Seat 4: Jujiluju ($1.56 in chips) 
Seat 5: Dron4uk UA ($2.85 in chips) 
Seat 6: puratiino ($0.30 in chips) 
Kb013497: posts small blind $0.01
bober2702: posts big blind $0.02
*** HOLE CARDS ***
Dealt to Scaaalll [2d 7s]
Jujiluju: raises $0.05 to $0.07
Dron4uk UA: calls $0.07
puratiino: folds 
Scaaalll: folds 
Kb013497: folds 
bober2702: folds 
*** FLOP *** [Ks 2s Jh]
Jujiluju: bets $0.08
Dron4uk UA: calls $0.08
*** TURN *** [Ks 2s Jh] [8h]
Jujiluju: checks 
Dron4uk UA: checks 
*** RIVER *** [Ks 2s Jh 8h] [5c]
Jujiluju: checks 
Dron4uk UA: checks 
*** SHOW DOWN ***
Jujiluju: shows [Qs Ad] (high card Ace)
Dron4uk UA: shows [9c 9s] (a pair of Nines)
Dron4uk UA collected $0.32 from pot
*** SUMMARY ***
Total pot $0.33 | Rake $0.01 
Board [Ks 2s Jh 8h 5c]
Seat 1: Scaaalll (button) folded before Flop (didn't bet)
Seat 2: Kb013497 (small blind) folded before Flop
Seat 3: bober2702 (big blind) folded before Flop
Seat 4: Jujiluju showed [Qs Ad] and lost with high card Ace
Seat 5: Dron4uk UA showed [9c 9s] and won ($0.32) with a pair of Nines
Seat 6: puratiino folded before Flop (didn't bet)



PokerStars Zoom Hand #229230776152:  Hold'em No Limit ($0.01/$0.02) - 2021/08/21 21:48:27 CET [2021/08/21 15:48:27 ET]
Table 'Halley' 6-max Seat #1 is the button
Seat 1: vladlen101 ($0.74 in chips) 
Seat 2: LuckyCheewey ($5.73 in chips) 
Seat 3: ctaceo ($2.01 in chips) 
Seat 4: Scaaalll ($2.49 in chips) 
Seat 5: Koldun 2636 ($5.10 in chips) 
Seat 6: felipeciji ($2.03 in chips) 
LuckyCheewey: posts small blind $0.01
ctaceo: posts big blind $0.02
*** HOLE CARDS ***
Dealt to Scaaalll [5h Kc]
Scaaalll: folds 
Koldun 2636: raises $0.03 to $0.05
felipeciji: folds 
vladlen101: folds 
LuckyCheewey: calls $0.04
ctaceo: folds 
*** FLOP *** [6c 4d 7c]
LuckyCheewey: checks 
Koldun 2636: bets $0.06
LuckyCheewey: folds 
Uncalled bet ($0.06) returned to Koldun 2636
Koldun 2636 collected $0.12 from pot
Koldun 2636: doesn't show hand 
*** SUMMARY ***
Total pot $0.12 | Rake $0 
Board [6c 4d 7c]
Seat 1: vladlen101 (button) folded before Flop (didn't bet)
Seat 2: LuckyCheewey (small blind) folded on the Flop
Seat 3: ctaceo (big blind) folded before Flop
Seat 4: Scaaalll folded before Flop (didn't bet)
Seat 5: Koldun 2636 collected ($0.12)
Seat 6: felipeciji folded before Flop (didn't bet)



PokerStars Zoom Hand #229230779288:  Hold'em No Limit ($0.01/$0.02) - 2021/08/21 21:48:34 CET [2021/08/21 15:48:34 ET]
Table 'Halley' 6-max Seat #1 is the button
Seat 1: rodrigoasor ($0.90 in chips) 
Seat 2: M1muro ($2 in chips) 
Seat 3: Scaaalll ($2.49 in chips) 
Seat 4: malandro733 ($2 in chips) 
Seat 5: dkno77 ($1.49 in chips) 
Seat 6: sorinysu ($0.66 in chips) 
M1muro: posts small blind $0.01
Scaaalll: posts big blind $0.02
*** HOLE CARDS ***
Dealt to Scaaalll [As 8s]
malandro733: folds 
dkno77: folds 
sorinysu: calls $0.02
rodrigoasor: raises $0.04 to $0.06
M1muro: folds 
Scaaalll: calls $0.04
sorinysu: calls $0.04
*** FLOP *** [Ks Jd Jh]
Scaaalll: checks 
sorinysu: checks 
rodrigoasor: checks 
*** TURN *** [Ks Jd Jh] [7s]
Scaaalll: checks 
sorinysu: checks 
rodrigoasor: checks 
*** RIVER *** [Ks Jd Jh 7s] [3d]
Scaaalll: checks 
sorinysu: checks 
rodrigoasor: bets $0.09
sorinysu is disconnected 
Scaaalll: folds 
sorinysu: folds 
Uncalled bet ($0.09) returned to rodrigoasor
rodrigoasor collected $0.18 from pot
rodrigoasor: doesn't show hand 
*** SUMMARY ***
Total pot $0.19 | Rake $0.01 
Board [Ks Jd Jh 7s 3d]
Seat 1: rodrigoasor (button) collected ($0.18)
Seat 2: M1muro (small blind) folded before Flop
Seat 3: Scaaalll (big blind) folded on the River
Seat 4: malandro733 folded before Flop (didn't bet)
Seat 5: dkno77 folded before Flop (didn't bet)
Seat 6: sorinysu folded on the River



PokerStars Zoom Hand #229230811014:  Hold'em No Limit ($0.01/$0.02) - 2021/08/21 21:49:44 CET [2021/08/21 15:49:44 ET]
Table 'Halley' 6-max Seat #1 is the button
Seat 1: H0mmer99 ($1.74 in chips) 
Seat 2: Scaaalll ($2.43 in chips) 
Seat 3: bmnev ($2.03 in chips) 
Seat 4: ppluiaule ($2.22 in chips) 
Seat 5: Smirgeline ($1.15 in chips) 
Seat 6: stipe 31 ($2.26 in chips) 
Scaaalll: posts small blind $0.01
bmnev: posts big blind $0.02
*** HOLE CARDS ***
Dealt to Scaaalll [7s 6s]
ppluiaule: folds 
Smirgeline: calls $0.02
stipe 31: calls $0.02
H0mmer99: folds 
Scaaalll: calls $0.01
bmnev: checks 
*** FLOP *** [3s Kc Ac]
Scaaalll: checks 
bmnev: checks 
Smirgeline: checks 
stipe 31: checks 
*** TURN *** [3s Kc Ac] [8h]
Scaaalll: checks 
bmnev: checks 
Smirgeline: checks 
stipe 31: checks 
*** RIVER *** [3s Kc Ac 8h] [Ah]
Scaaalll: checks 
bmnev: checks 
Smirgeline: checks 
stipe 31: checks 
*** SHOW DOWN ***
Scaaalll: shows [7s 6s] (a pair of Aces)
bmnev: shows [Qs 7h] (a pair of Aces - King+Queen kicker)
Smirgeline: mucks hand 
stipe 31: shows [2s As] (three of a kind, Aces)
stipe 31 collected $0.08 from pot
*** SUMMARY ***
Total pot $0.08 | Rake $0 
Board [3s Kc Ac 8h Ah]
Seat 1: H0mmer99 (button) folded before Flop (didn't bet)
Seat 2: Scaaalll (small blind) showed [7s 6s] and lost with a pair of Aces
Seat 3: bmnev (big blind) showed [Qs 7h] and lost with a pair of Aces
Seat 4: ppluiaule folded before Flop (didn't bet)
Seat 5: Smirgeline mucked [9d Jd]
Seat 6: stipe 31 showed [2s As] and won ($0.08) with three of a kind, Aces



PokerStars Zoom Hand #229230841418:  Hold'em No Limit ($0.01/$0.02) - 2021/08/21 21:50:50 CET [2021/08/21 15:50:50 ET]
Table 'Halley' 6-max Seat #1 is the button
Seat 1: Scaaalll ($2.41 in chips) 
Seat 2: Smirgeline ($1.13 in chips) 
Seat 3: csmall14 ($3.08 in chips) 
Seat 4: GamblersDream ($2.14 in chips) 
Seat 5: Clavis Noa ($3.44 in chips) 
Seat 6: Koldun 2636 ($2.66 in chips) 
Smirgeline: posts small blind $0.01
csmall14: posts big blind $0.02
*** HOLE CARDS ***
Dealt to Scaaalll [5d 2d]
GamblersDream: folds 
Clavis Noa: folds 
Koldun 2636: folds 
Scaaalll: folds 
Smirgeline: folds 
Uncalled bet ($0.01) returned to csmall14
csmall14 collected $0.02 from pot
csmall14: doesn't show hand 
*** SUMMARY ***
Total pot $0.02 | Rake $0 
Seat 1: Scaaalll (button) folded before Flop (didn't bet)
Seat 2: Smirgeline (small blind) folded before Flop
Seat 3: csmall14 (big blind) collected ($0.02)
Seat 4: GamblersDream folded before Flop (didn't bet)
Seat 5: Clavis Noa folded before Flop (didn't bet)
Seat 6: Koldun 2636 folded before Flop (didn't bet)



PokerStars Zoom Hand #229230846390:  Hold'em No Limit ($0.01/$0.02) - 2021/08/21 21:51:01 CET [2021/08/21 15:51:01 ET]
Table 'Halley' 6-max Seat #1 is the button
Seat 1: MsSuffolk ($3.21 in chips) 
Seat 2: moirl55 ($2.32 in chips) 
Seat 3: Reipinguimm ($2 in chips) 
Seat 4: maliniak75 ($1.85 in chips) 
Seat 5: Scaaalll ($2.41 in chips) 
Seat 6: gasmar_29 ($6.18 in chips) 
moirl55: posts small blind $0.01
Reipinguimm: posts big blind $0.02
*** HOLE CARDS ***
Dealt to Scaaalll [6h 6c]
maliniak75: folds 
Scaaalll: raises $0.04 to $0.06
gasmar_29: raises $0.12 to $0.18
MsSuffolk: folds 
moirl55: folds 
Reipinguimm: folds 
moirl55 is disconnected 
Scaaalll: folds 
Uncalled bet ($0.12) returned to gasmar_29
gasmar_29 collected $0.15 from pot
gasmar_29: doesn't show hand 
*** SUMMARY ***
Total pot $0.15 | Rake $0 
Seat 1: MsSuffolk (button) folded before Flop (didn't bet)
Seat 2: moirl55 (small blind) folded before Flop
Seat 3: Reipinguimm (big blind) folded before Flop
Seat 4: maliniak75 folded before Flop (didn't bet)
Seat 5: Scaaalll folded before Flop
Seat 6: gasmar_29 collected ($0.15)



PokerStars Zoom Hand #229230857680:  Hold'em No Limit ($0.01/$0.02) - 2021/08/21 21:51:26 CET [2021/08/21 15:51:26 ET]
Table 'Halley' 6-max Seat #1 is the button
Seat 1: SKV_1985 ($2.54 in chips) 
Seat 2: Forest404 ($3.59 in chips) 
Seat 3: HDYD18 ($6.25 in chips) 
Seat 4: Ruslan076 ($1.06 in chips) 
Seat 5: LuckyCheewey ($5.69 in chips) 
Seat 6: Scaaalll ($2.35 in chips) 
Forest404: posts small blind $0.01
HDYD18: posts big blind $0.02
*** HOLE CARDS ***
Dealt to Scaaalll [Th 2h]
Ruslan076: folds 
LuckyCheewey: folds 
Ruslan076 is disconnected 
Scaaalll: folds 
SKV_1985: folds 
Forest404: folds 
Uncalled bet ($0.01) returned to HDYD18
HDYD18 collected $0.02 from pot
HDYD18: doesn't show hand 
*** SUMMARY ***
Total pot $0.02 | Rake $0 
Seat 1: SKV_1985 (button) folded before Flop (didn't bet)
Seat 2: Forest404 (small blind) folded before Flop
Seat 3: HDYD18 (big blind) collected ($0.02)
Seat 4: Ruslan076 folded before Flop (didn't bet)
Seat 5: LuckyCheewey folded before Flop (didn't bet)
Seat 6: Scaaalll folded before Flop (didn't bet)



PokerStars Zoom Hand #229230862216:  Hold'em No Limit ($0.01/$0.02) - 2021/08/21 21:51:36 CET [2021/08/21 15:51:36 ET]
Table 'Halley' 6-max Seat #1 is the button
Seat 1: cowboy9100529 ($3.41 in chips) 
Seat 2: so0love ($3.91 in chips) 
Seat 3: meikoz ($2.84 in chips) 
Seat 4: Scaaalll ($2.35 in chips) 
Seat 5: BigTestIcicle ($1.47 in chips) 
Seat 6: Flankeris ($10.30 in chips) 
so0love: posts small blind $0.01
meikoz: posts big blind $0.02
*** HOLE CARDS ***
Dealt to Scaaalll [Kd 7d]
Scaaalll: folds 
BigTestIcicle: folds 
Flankeris: folds 
cowboy9100529: folds 
cowboy9100529 is disconnected 
so0love: folds 
Uncalled bet ($0.01) returned to meikoz
meikoz collected $0.02 from pot
meikoz: doesn't show hand 
*** SUMMARY ***
Total pot $0.02 | Rake $0 
Seat 1: cowboy9100529 (button) folded before Flop (didn't bet)
Seat 2: so0love (small blind) folded before Flop
Seat 3: meikoz (big blind) collected ($0.02)
Seat 4: Scaaalll folded before Flop (didn't bet)
Seat 5: BigTestIcicle folded before Flop (didn't bet)
Seat 6: Flankeris folded before Flop (didn't bet)



PokerStars Zoom Hand #229230864038:  Hold'em No Limit ($0.01/$0.02) - 2021/08/21 21:51:40 CET [2021/08/21 15:51:40 ET]
Table 'Halley' 6-max Seat #1 is the button
Seat 1: Healthys07 ($4.97 in chips) 
Seat 2: estelionat171 ($1.45 in chips) 
Seat 3: Scaaalll ($2.35 in chips) 
Seat 4: LuckyCheewey ($5.69 in chips) 
Seat 5: RoughRafff ($2.03 in chips) 
Seat 6: Kb013497 ($2.89 in chips) 
estelionat171: posts small blind $0.01
Scaaalll: posts big blind $0.02
*** HOLE CARDS ***
Dealt to Scaaalll [Kh 7c]
LuckyCheewey: raises $0.05 to $0.07
RoughRafff: folds 
Kb013497: folds 
Healthys07: folds 
estelionat171: folds 
Scaaalll: folds 
Uncalled bet ($0.05) returned to LuckyCheewey
LuckyCheewey collected $0.05 from pot
LuckyCheewey: doesn't show hand 
*** SUMMARY ***
Total pot $0.05 | Rake $0 
Seat 1: Healthys07 (button) folded before Flop (didn't bet)
Seat 2: estelionat171 (small blind) folded before Flop
Seat 3: Scaaalll (big blind) folded before Flop
Seat 4: LuckyCheewey collected ($0.05)
Seat 5: RoughRafff folded before Flop (didn't bet)
Seat 6: Kb013497 folded before Flop (didn't bet)



PokerStars Zoom Hand #229230870751:  Hold'em No Limit ($0.01/$0.02) - 2021/08/21 21:51:56 CET [2021/08/21 15:51:56 ET]
Table 'Halley' 6-max Seat #1 is the button
Seat 1: Ichverdammt ($0.76 in chips) 
Seat 2: ARTMVSLV ($3.08 in chips) 
Seat 3: Born2win868 ($3.25 in chips) 
Seat 4: pphit ($2.44 in chips) 
Seat 5: Scaaalll ($2.33 in chips) 
Seat 6: Benjani1412 ($5.28 in chips) 
ARTMVSLV: posts small blind $0.01
Born2win868: posts big blind $0.02
*** HOLE CARDS ***
Dealt to Scaaalll [Td Ah]
pphit: folds 
Scaaalll: raises $0.04 to $0.06
Benjani1412: folds 
Ichverdammt: folds 
ARTMVSLV: folds 
Born2win868: raises $0.13 to $0.19
Scaaalll: folds 
Uncalled bet ($0.13) returned to Born2win868
Born2win868 collected $0.13 from pot
Born2win868: doesn't show hand 
*** SUMMARY ***
Total pot $0.13 | Rake $0 
Seat 1: Ichverdammt (button) folded before Flop (didn't bet)
Seat 2: ARTMVSLV (small blind) folded before Flop
Seat 3: Born2win868 (big blind) collected ($0.13)
Seat 4: pphit folded before Flop (didn't bet)
Seat 5: Scaaalll folded before Flop
Seat 6: Benjani1412 folded before Flop (didn't bet)



PokerStars Zoom Hand #229230881456:  Hold'em No Limit ($0.01/$0.02) - 2021/08/21 21:52:20 CET [2021/08/21 15:52:20 ET]
Table 'Halley' 6-max Seat #1 is the button
Seat 1: plmanuelpl ($1.31 in chips) 
Seat 2: Scaaalll ($2.27 in chips) 
Seat 3: curyurzeda ($2.52 in chips) 
Seat 4: BIITRU ($5.48 in chips) 
Seat 5: pavlo8855 ($2 in chips) 
Seat 6: queen830 ($3.34 in chips) 
Scaaalll: posts small blind $0.01
curyurzeda: posts big blind $0.02
*** HOLE CARDS ***
Dealt to Scaaalll [8h 4s]
BIITRU: folds 
pavlo8855: folds 
queen830: folds 
plmanuelpl has timed out
plmanuelpl: folds 
Scaaalll: folds 
Uncalled bet ($0.01) returned to curyurzeda
plmanuelpl is disconnected 
curyurzeda collected $0.02 from pot
curyurzeda: doesn't show hand 
*** SUMMARY ***
Total pot $0.02 | Rake $0 
Seat 1: plmanuelpl (button) folded before Flop (didn't bet)
Seat 2: Scaaalll (small blind) folded before Flop
Seat 3: curyurzeda (big blind) collected ($0.02)
Seat 4: BIITRU folded before Flop (didn't bet)
Seat 5: pavlo8855 folded before Flop (didn't bet)
Seat 6: queen830 folded before Flop (didn't bet)



PokerStars Zoom Hand #229230891239:  Hold'em No Limit ($0.01/$0.02) - 2021/08/21 21:52:31 CET [2021/08/21 15:52:31 ET]
Table 'Halley' 6-max Seat #1 is the button
Seat 1: Scaaalll ($2.26 in chips) 
Seat 2: nodtress ($2.37 in chips) 
Seat 3: ME-262-XX ($1.07 in chips) 
Seat 4: alecha11 ($2.42 in chips) 
Seat 5: BigTestIcicle ($2.35 in chips) 
Seat 6: KIBA7660 ($1.85 in chips) 
nodtress: posts small blind $0.01
ME-262-XX: posts big blind $0.02
*** HOLE CARDS ***
Dealt to Scaaalll [Ac 9d]
alecha11: folds 
BigTestIcicle: folds 
KIBA7660: folds 
KIBA7660 is disconnected 
Scaaalll: raises $0.02 to $0.04
nodtress: folds 
ME-262-XX: folds 
Uncalled bet ($0.02) returned to Scaaalll
Scaaalll collected $0.05 from pot
Scaaalll: doesn't show hand 
*** SUMMARY ***
Total pot $0.05 | Rake $0 
Seat 1: Scaaalll (button) collected ($0.05)
Seat 2: nodtress (small blind) folded before Flop
Seat 3: ME-262-XX (big blind) folded before Flop
Seat 4: alecha11 folded before Flop (didn't bet)
Seat 5: BigTestIcicle folded before Flop (didn't bet)
Seat 6: KIBA7660 folded before Flop (didn't bet)



PokerStars Zoom Hand #229230900699:  Hold'em No Limit ($0.01/$0.02) - 2021/08/21 21:52:52 CET [2021/08/21 15:52:52 ET]
Table 'Halley' 6-max Seat #1 is the button
Seat 1: Pechorin.G ($2.24 in chips) 
Seat 2: Nihility77 ($3.09 in chips) 
Seat 3: RonilsonCosta ($2 in chips) 
Seat 4: arsad725 ($3.50 in chips) 
Seat 5: so0love ($3.85 in chips) 
Seat 6: Scaaalll ($2.29 in chips) 
Nihility77: posts small blind $0.01
RonilsonCosta: posts big blind $0.02
*** HOLE CARDS ***
Dealt to Scaaalll [5c Tc]
arsad725: folds 
so0love: folds 
Scaaalll: folds 
Pechorin.G: folds 
Nihility77: folds 
Uncalled bet ($0.01) returned to RonilsonCosta
RonilsonCosta collected $0.02 from pot
RonilsonCosta: doesn't show hand 
*** SUMMARY ***
Total pot $0.02 | Rake $0 
Seat 1: Pechorin.G (button) folded before Flop (didn't bet)
Seat 2: Nihility77 (small blind) folded before Flop
Seat 3: RonilsonCosta (big blind) collected ($0.02)
Seat 4: arsad725 folded before Flop (didn't bet)
Seat 5: so0love folded before Flop (didn't bet)
Seat 6: Scaaalll folded before Flop (didn't bet)



PokerStars Zoom Hand #229230902487:  Hold'em No Limit ($0.01/$0.02) - 2021/08/21 21:52:56 CET [2021/08/21 15:52:56 ET]
Table 'Halley' 6-max Seat #1 is the button
Seat 1: meikoz ($2.29 in chips) 
Seat 2: ser313131 ($2.77 in chips) 
Seat 3: Scaaalll ($2.29 in chips) 
Seat 4: hotdog1948 ($3.74 in chips) 
Seat 5: ctaceo ($2.17 in chips) 
Seat 6: Jujiluju ($2.61 in chips) 
ser313131: posts small blind $0.01
Scaaalll: posts big blind $0.02
*** HOLE CARDS ***
Dealt to Scaaalll [2s 8d]
hotdog1948: folds 
ctaceo: folds 
hotdog1948 is disconnected 
Jujiluju: folds 
meikoz: folds 
ser313131: raises $0.02 to $0.04
Scaaalll: folds 
Uncalled bet ($0.02) returned to ser313131
ser313131 collected $0.04 from pot
ser313131: doesn't show hand 
*** SUMMARY ***
Total pot $0.04 | Rake $0 
Seat 1: meikoz (button) folded before Flop (didn't bet)
Seat 2: ser313131 (small blind) collected ($0.04)
Seat 3: Scaaalll (big blind) folded before Flop
Seat 4: hotdog1948 folded before Flop (didn't bet)
Seat 5: ctaceo folded before Flop (didn't bet)
Seat 6: Jujiluju folded before Flop (didn't bet)



PokerStars Zoom Hand #229230883698:  Hold'em No Limit ($0.01/$0.02) - 2021/08/21 21:52:25 CET [2021/08/21 15:52:25 ET]
Table 'Halley' 6-max Seat #1 is the button
Seat 1: BadBeat Bert ($1.61 in chips) 
Seat 2: HellNative ($3.04 in chips) 
Seat 3: SIGREX ($2.16 in chips) 
Seat 4: Scaaalll ($2.26 in chips) 
Seat 5: Iluvatar922 ($9.57 in chips) 
Seat 6: Red Sky 15 ($5.70 in chips) 
HellNative: posts small blind $0.01
SIGREX: posts big blind $0.02
*** HOLE CARDS ***
Dealt to Scaaalll [Tc 6c]
Scaaalll: folds 
Iluvatar922: raises $0.03 to $0.05
Red Sky 15: calls $0.05
BadBeat Bert: folds 
HellNative: calls $0.04
SIGREX: calls $0.03
*** FLOP *** [9c 8s 5d]
HellNative: checks 
SIGREX: bets $0.13
Iluvatar922: folds 
Red Sky 15: calls $0.13
HellNative: folds 
*** TURN *** [9c 8s 5d] [7s]
SIGREX: checks 
Red Sky 15: bets $0.22
SIGREX: calls $0.22
*** RIVER *** [9c 8s 5d 7s] [Ah]
SIGREX: checks 
Red Sky 15: checks 
*** SHOW DOWN ***
SIGREX: shows [8c 8h] (three of a kind, Eights)
Red Sky 15: mucks hand 
SIGREX collected $0.87 from pot
*** SUMMARY ***
Total pot $0.90 | Rake $0.03 
Board [9c 8s 5d 7s Ah]
Seat 1: BadBeat Bert (button) folded before Flop (didn't bet)
Seat 2: HellNative (small blind) folded on the Flop
Seat 3: SIGREX (big blind) showed [8c 8h] and won ($0.87) with three of a kind, Eights
Seat 4: Scaaalll folded before Flop (didn't bet)
Seat 5: Iluvatar922 folded on the Flop
Seat 6: Red Sky 15 mucked [7h Th]



PokerStars Zoom Hand #229230910633:  Hold'em No Limit ($0.01/$0.02) - 2021/08/21 21:53:13 CET [2021/08/21 15:53:13 ET]
Table 'Halley' 6-max Seat #1 is the button
Seat 1: zergmiky ($4.30 in chips) 
Seat 2: meerwolf1 ($1.44 in chips) 
Seat 3: gasmar_29 ($6.27 in chips) 
Seat 4: Ruopolo1982 ($2.27 in chips) 
Seat 5: Scaaalll ($2.27 in chips) 
Seat 6: xFruJensen ($0.87 in chips) 
meerwolf1: posts small blind $0.01
gasmar_29: posts big blind $0.02
*** HOLE CARDS ***
Dealt to Scaaalll [7s 7c]
Ruopolo1982: folds 
Scaaalll: raises $0.04 to $0.06
xFruJensen: folds 
zergmiky: folds 
meerwolf1: calls $0.05
gasmar_29: calls $0.04
*** FLOP *** [4h Td As]
meerwolf1: checks 
gasmar_29: checks 
Scaaalll: checks 
*** TURN *** [4h Td As] [Tc]
meerwolf1: checks 
gasmar_29: checks 
Scaaalll: checks 
*** RIVER *** [4h Td As Tc] [Kd]
meerwolf1: bets $0.17
gasmar_29: folds 
Scaaalll: folds 
Uncalled bet ($0.17) returned to meerwolf1
meerwolf1 collected $0.17 from pot
meerwolf1: doesn't show hand 
*** SUMMARY ***
Total pot $0.18 | Rake $0.01 
Board [4h Td As Tc Kd]
Seat 1: zergmiky (button) folded before Flop (didn't bet)
Seat 2: meerwolf1 (small blind) collected ($0.17)
Seat 3: gasmar_29 (big blind) folded on the River
Seat 4: Ruopolo1982 folded before Flop (didn't bet)
Seat 5: Scaaalll folded on the River
Seat 6: xFruJensen folded before Flop (didn't bet)



PokerStars Zoom Hand #229230934294:  Hold'em No Limit ($0.01/$0.02) - 2021/08/21 21:54:05 CET [2021/08/21 15:54:05 ET]
Table 'Halley' 6-max Seat #1 is the button
Seat 1: fede venegas ($2.76 in chips) 
Seat 2: Fanatspartak ($1.50 in chips) 
Seat 3: meikoz ($2.18 in chips) 
Seat 4: pphit ($2 in chips) 
Seat 5: Scaaalll ($2.21 in chips) 
Seat 6: davidalejag ($1.98 in chips) 
Fanatspartak: posts small blind $0.01
meikoz: posts big blind $0.02
*** HOLE CARDS ***
Dealt to Scaaalll [7s Qd]
pphit: folds 
Scaaalll: folds 
davidalejag: folds 
fede venegas: folds 
Fanatspartak: raises $0.02 to $0.04
meikoz: folds 
Uncalled bet ($0.02) returned to Fanatspartak
Fanatspartak collected $0.04 from pot
Fanatspartak: doesn't show hand 
*** SUMMARY ***
Total pot $0.04 | Rake $0 
Seat 1: fede venegas (button) folded before Flop (didn't bet)
Seat 2: Fanatspartak (small blind) collected ($0.04)
Seat 3: meikoz (big blind) folded before Flop
Seat 4: pphit folded before Flop (didn't bet)
Seat 5: Scaaalll folded before Flop (didn't bet)
Seat 6: davidalejag folded before Flop (didn't bet)



PokerStars Zoom Hand #229230945372:  Hold'em No Limit ($0.01/$0.02) - 2021/08/21 21:54:31 CET [2021/08/21 15:54:31 ET]
Table 'Halley' 6-max Seat #1 is the button
Seat 1: CordiPS ($3.20 in chips) 
Seat 2: zeus11983 ($2.06 in chips) 
Seat 3: arrow17 ($2 in chips) 
Seat 4: DaporteWins ($3.11 in chips) 
Seat 5: IamScald ($1.28 in chips) 
Seat 6: Scaaalll ($2.20 in chips) 
zeus11983: posts small blind $0.01
arrow17: posts big blind $0.02
*** HOLE CARDS ***
Dealt to Scaaalll [3h 8s]
DaporteWins: folds 
IamScald: folds 
Scaaalll: folds 
IamScald is disconnected 
CordiPS: raises $0.03 to $0.05
zeus11983: folds 
arrow17: folds 
Uncalled bet ($0.03) returned to CordiPS
CordiPS collected $0.05 from pot
CordiPS: doesn't show hand 
*** SUMMARY ***
Total pot $0.05 | Rake $0 
Seat 1: CordiPS (button) collected ($0.05)
Seat 2: zeus11983 (small blind) folded before Flop
Seat 3: arrow17 (big blind) folded before Flop
Seat 4: DaporteWins folded before Flop (didn't bet)
Seat 5: IamScald folded before Flop (didn't bet)
Seat 6: Scaaalll folded before Flop (didn't bet)



PokerStars Zoom Hand #229230947163:  Hold'em No Limit ($0.01/$0.02) - 2021/08/21 21:54:35 CET [2021/08/21 15:54:35 ET]
Table 'Halley' 6-max Seat #1 is the button
Seat 1: amario89 ($2.10 in chips) 
Seat 2: lucksuckdonk ($3.46 in chips) 
Seat 3: Scaaalll ($2.20 in chips) 
Seat 4: ctaceo ($2.22 in chips) 
Seat 5: gasmar_29 ($4.50 in chips) 
Seat 6: pavlo8855 ($2.04 in chips) 
lucksuckdonk: posts small blind $0.01
Scaaalll: posts big blind $0.02
*** HOLE CARDS ***
Dealt to Scaaalll [Jh Jc]
ctaceo: raises $0.03 to $0.05
gasmar_29: folds 
pavlo8855: folds 
amario89: folds 
lucksuckdonk: folds 
Scaaalll: calls $0.03
*** FLOP *** [7s 6c Kh]
Scaaalll: checks 
ctaceo: bets $0.06
Scaaalll: calls $0.06
*** TURN *** [7s 6c Kh] [6d]
Scaaalll: checks 
ctaceo: checks 
*** RIVER *** [7s 6c Kh 6d] [2c]
Scaaalll: bets $0.14
ctaceo: folds 
Uncalled bet ($0.14) returned to Scaaalll
Scaaalll collected $0.22 from pot
Scaaalll: doesn't show hand 
*** SUMMARY ***
Total pot $0.23 | Rake $0.01 
Board [7s 6c Kh 6d 2c]
Seat 1: amario89 (button) folded before Flop (didn't bet)
Seat 2: lucksuckdonk (small blind) folded before Flop
Seat 3: Scaaalll (big blind) collected ($0.22)
Seat 4: ctaceo folded on the River
Seat 5: gasmar_29 folded before Flop (didn't bet)
Seat 6: pavlo8855 folded before Flop (didn't bet)



PokerStars Zoom Hand #229230940538:  Hold'em No Limit ($0.01/$0.02) - 2021/08/21 21:54:20 CET [2021/08/21 15:54:20 ET]
Table 'Halley' 6-max Seat #1 is the button
Seat 1: olga3021221 ($3.51 in chips) 
Seat 2: Scaaalll ($2.21 in chips) 
Seat 3: BIITRU ($5.47 in chips) 
Seat 4: Shoxuzb ($4.05 in chips) 
Seat 5: Coldact ($0.47 in chips) 
Seat 6: SGALINAE ($2.37 in chips) 
Scaaalll: posts small blind $0.01
BIITRU: posts big blind $0.02
*** HOLE CARDS ***
Dealt to Scaaalll [7s 2d]
Shoxuzb: folds 
Shoxuzb is disconnected 
Coldact: folds 
SGALINAE: calls $0.02
olga3021221: calls $0.02
Scaaalll: folds 
BIITRU: raises $0.07 to $0.09
SGALINAE: calls $0.07
olga3021221: folds 
*** FLOP *** [2s 5s Th]
BIITRU: checks 
SGALINAE: bets $0.10
BIITRU: calls $0.10
*** TURN *** [2s 5s Th] [Jd]
BIITRU: checks 
SGALINAE: bets $0.20
BIITRU: calls $0.20
*** RIVER *** [2s 5s Th Jd] [Ah]
BIITRU: checks 
SGALINAE: bets $0.39
BIITRU: raises $4.69 to $5.08 and is all-in
SGALINAE: folds 
Uncalled bet ($4.69) returned to BIITRU
BIITRU collected $1.53 from pot
BIITRU: doesn't show hand 
*** SUMMARY ***
Total pot $1.59 | Rake $0.06 
Board [2s 5s Th Jd Ah]
Seat 1: olga3021221 (button) folded before Flop
Seat 2: Scaaalll (small blind) folded before Flop
Seat 3: BIITRU (big blind) collected ($1.53)
Seat 4: Shoxuzb folded before Flop (didn't bet)
Seat 5: Coldact folded before Flop (didn't bet)
Seat 6: SGALINAE folded on the River



PokerStars Zoom Hand #229230967123:  Hold'em No Limit ($0.01/$0.02) - 2021/08/21 21:55:26 CET [2021/08/21 15:55:26 ET]
Table 'Halley' 6-max Seat #1 is the button
Seat 1: Scaaalll ($2.31 in chips) 
Seat 2: Mad_Clock ($2.14 in chips) 
Seat 3: malandro733 ($2 in chips) 
Seat 4: arrow17 ($2 in chips) 
Seat 5: gasmar_29 ($3.73 in chips) 
Seat 6: SKV_1985 ($2.03 in chips) 
Mad_Clock: posts small blind $0.01
malandro733: posts big blind $0.02
*** HOLE CARDS ***
Dealt to Scaaalll [7d 8d]
arrow17: folds 
gasmar_29: folds 
SKV_1985: raises $0.04 to $0.06
Scaaalll: calls $0.06
Mad_Clock: folds 
malandro733: calls $0.04
*** FLOP *** [Ad Qc Ah]
malandro733: checks 
SKV_1985: bets $0.12
Scaaalll: folds 
malandro733: folds 
Uncalled bet ($0.12) returned to SKV_1985
SKV_1985 collected $0.18 from pot
SKV_1985: doesn't show hand 
*** SUMMARY ***
Total pot $0.19 | Rake $0.01 
Board [Ad Qc Ah]
Seat 1: Scaaalll (button) folded on the Flop
Seat 2: Mad_Clock (small blind) folded before Flop
Seat 3: malandro733 (big blind) folded on the Flop
Seat 4: arrow17 folded before Flop (didn't bet)
Seat 5: gasmar_29 folded before Flop (didn't bet)
Seat 6: SKV_1985 collected ($0.18)



PokerStars Zoom Hand #229230975787:  Hold'em No Limit ($0.01/$0.02) - 2021/08/21 21:55:55 CET [2021/08/21 15:55:55 ET]
Table 'Halley' 6-max Seat #1 is the button
Seat 1: Henry Chinasky ($18.46 in chips) 
Seat 2: malandro733 ($2 in chips) 
Seat 3: Forest404 ($1.98 in chips) 
Seat 4: aenehev ($5.98 in chips) 
Seat 5: Scaaalll ($2.25 in chips) 
Seat 6: AbusiveLion ($1.95 in chips) 
malandro733: posts small blind $0.01
Forest404: posts big blind $0.02
*** HOLE CARDS ***
Dealt to Scaaalll [7s Ks]
aenehev: folds 
Scaaalll: folds 
AbusiveLion: raises $0.04 to $0.06
Henry Chinasky: folds 
malandro733: folds 
Forest404: folds 
Uncalled bet ($0.04) returned to AbusiveLion
AbusiveLion collected $0.05 from pot
AbusiveLion: doesn't show hand 
*** SUMMARY ***
Total pot $0.05 | Rake $0 
Seat 1: Henry Chinasky (button) folded before Flop (didn't bet)
Seat 2: malandro733 (small blind) folded before Flop
Seat 3: Forest404 (big blind) folded before Flop
Seat 4: aenehev folded before Flop (didn't bet)
Seat 5: Scaaalll folded before Flop (didn't bet)
Seat 6: AbusiveLion collected ($0.05)



PokerStars Zoom Hand #229230984137:  Hold'em No Limit ($0.01/$0.02) - 2021/08/21 21:56:22 CET [2021/08/21 15:56:22 ET]
Table 'Halley' 6-max Seat #1 is the button
Seat 1: humo97 ($2.33 in chips) 
Seat 2: Scaaalll ($2.23 in chips) 
Seat 3: zergmiky ($4.20 in chips) 
Seat 4: HellNative ($2.07 in chips) 
Seat 5: Alex Koshva1 ($2.44 in chips) 
Seat 6: Ne0net ($2.11 in chips) 
Scaaalll: posts small blind $0.01
zergmiky: posts big blind $0.02
*** HOLE CARDS ***
Dealt to Scaaalll [Ks 6c]
HellNative: folds 
Alex Koshva1: folds 
Ne0net: folds 
humo97: raises $0.02 to $0.04
Scaaalll: folds 
zergmiky: folds 
Uncalled bet ($0.02) returned to humo97
humo97 collected $0.05 from pot
humo97: doesn't show hand 
*** SUMMARY ***
Total pot $0.05 | Rake $0 
Seat 1: humo97 (button) collected ($0.05)
Seat 2: Scaaalll (small blind) folded before Flop
Seat 3: zergmiky (big blind) folded before Flop
Seat 4: HellNative folded before Flop (didn't bet)
Seat 5: Alex Koshva1 folded before Flop (didn't bet)
Seat 6: Ne0net folded before Flop (didn't bet)



PokerStars Zoom Hand #229230989400:  Hold'em No Limit ($0.01/$0.02) - 2021/08/21 21:56:39 CET [2021/08/21 15:56:39 ET]
Table 'Halley' 6-max Seat #1 is the button
Seat 1: meps88 ($3.98 in chips) 
Seat 2: JCharrod ($2.81 in chips) 
Seat 3: Kreodont1987 ($5.25 in chips) 
Seat 4: Scaaalll ($2.22 in chips) 
Seat 5: wopl ($1.69 in chips) 
Seat 6: fishh_play ($3.33 in chips) 
JCharrod: posts small blind $0.01
Kreodont1987: posts big blind $0.02
*** HOLE CARDS ***
Dealt to Scaaalll [9h 5c]
Scaaalll: folds 
wopl: calls $0.02
fishh_play: folds 
meps88: folds 
JCharrod: raises $0.06 to $0.08
Kreodont1987: folds 
wopl: calls $0.06
*** FLOP *** [As Ts Qs]
JCharrod: bets $0.12
wopl: folds 
Uncalled bet ($0.12) returned to JCharrod
JCharrod collected $0.17 from pot
JCharrod: doesn't show hand 
*** SUMMARY ***
Total pot $0.18 | Rake $0.01 
Board [As Ts Qs]
Seat 1: meps88 (button) folded before Flop (didn't bet)
Seat 2: JCharrod (small blind) collected ($0.17)
Seat 3: Kreodont1987 (big blind) folded before Flop
Seat 4: Scaaalll folded before Flop (didn't bet)
Seat 5: wopl folded on the Flop
Seat 6: fishh_play folded before Flop (didn't bet)



PokerStars Zoom Hand #229230986053:  Hold'em No Limit ($0.01/$0.02) - 2021/08/21 21:56:28 CET [2021/08/21 15:56:28 ET]
Table 'Halley' 6-max Seat #1 is the button
Seat 1: arsad725 ($7.22 in chips) 
Seat 2: EstiBan18 ($2.44 in chips) 
Seat 3: felipeciji ($2 in chips) 
Seat 4: feedwizard ($2 in chips) 
Seat 5: NecromiconP ($2.85 in chips) 
Seat 6: Scaaalll ($2.22 in chips) 
EstiBan18: posts small blind $0.01
felipeciji: posts big blind $0.02
*** HOLE CARDS ***
Dealt to Scaaalll [6c 9h]
feedwizard: folds 
NecromiconP: calls $0.02
Scaaalll: folds 
arsad725: folds 
EstiBan18: folds 
felipeciji: checks 
*** FLOP *** [7s 3d 5d]
felipeciji: checks 
NecromiconP: checks 
*** TURN *** [7s 3d 5d] [2d]
felipeciji: bets $0.05
NecromiconP: folds 
Uncalled bet ($0.05) returned to felipeciji
felipeciji collected $0.05 from pot
felipeciji: doesn't show hand 
*** SUMMARY ***
Total pot $0.05 | Rake $0 
Board [7s 3d 5d 2d]
Seat 1: arsad725 (button) folded before Flop (didn't bet)
Seat 2: EstiBan18 (small blind) folded before Flop
Seat 3: felipeciji (big blind) collected ($0.05)
Seat 4: feedwizard folded before Flop (didn't bet)
Seat 5: NecromiconP folded on the Turn
Seat 6: Scaaalll folded before Flop (didn't bet)



PokerStars Zoom Hand #229230980073:  Hold'em No Limit ($0.01/$0.02) - 2021/08/21 21:56:09 CET [2021/08/21 15:56:09 ET]
Table 'Halley' 6-max Seat #1 is the button
Seat 1: smaaen93 ($1 in chips) 
Seat 2: romnic1929 ($3.58 in chips) 
Seat 3: Scaaalll ($2.25 in chips) 
Seat 4: Hantsirg ($1.62 in chips) 
Seat 5: Blaackie ($1.99 in chips) 
Seat 6: stealth_ua ($4.27 in chips) 
romnic1929: posts small blind $0.01
Scaaalll: posts big blind $0.02
*** HOLE CARDS ***
Dealt to Scaaalll [2h Kh]
Hantsirg: raises $0.02 to $0.04
Blaackie: folds 
stealth_ua: calls $0.04
smaaen93: calls $0.04
romnic1929: calls $0.03
Scaaalll: folds 
*** FLOP *** [3s 8s 8h]
romnic1929: checks 
Hantsirg: checks 
stealth_ua: checks 
smaaen93: checks 
*** TURN *** [3s 8s 8h] [9c]
romnic1929: checks 
Hantsirg: checks 
stealth_ua: checks 
smaaen93: bets $0.02
romnic1929: calls $0.02
Hantsirg: calls $0.02
stealth_ua: calls $0.02
*** RIVER *** [3s 8s 8h 9c] [6h]
romnic1929: bets $0.12
Hantsirg: folds 
Hantsirg is disconnected 
stealth_ua: folds 
smaaen93: calls $0.12
*** SHOW DOWN ***
romnic1929: shows [7c 5c] (a straight, Five to Nine)
smaaen93: mucks hand 
romnic1929 collected $0.48 from pot
*** SUMMARY ***
Total pot $0.50 | Rake $0.02 
Board [3s 8s 8h 9c 6h]
Seat 1: smaaen93 (button) mucked [Js 9h]
Seat 2: romnic1929 (small blind) showed [7c 5c] and won ($0.48) with a straight, Five to Nine
Seat 3: Scaaalll (big blind) folded before Flop
Seat 4: Hantsirg folded on the River
Seat 5: Blaackie folded before Flop (didn't bet)
Seat 6: stealth_ua folded on the River



PokerStars Zoom Hand #229230990655:  Hold'em No Limit ($0.01/$0.02) - 2021/08/21 21:56:43 CET [2021/08/21 15:56:43 ET]
Table 'Halley' 6-max Seat #1 is the button
Seat 1: Scaaalll ($2.22 in chips) 
Seat 2: Begon505 ($1.10 in chips) 
Seat 3: VasquezSancho96 ($8.33 in chips) 
Seat 4: valet_hai ($0.99 in chips) 
Seat 5: NecromiconP ($3.15 in chips) 
Seat 6: AtZ3899 ($1.06 in chips) 
Begon505: posts small blind $0.01
VasquezSancho96: posts big blind $0.02
*** HOLE CARDS ***
Dealt to Scaaalll [9h 8h]
valet_hai: folds 
NecromiconP: folds 
AtZ3899: folds 
Scaaalll: raises $0.02 to $0.04
Begon505: folds 
VasquezSancho96: raises $0.02 to $0.06
Scaaalll: calls $0.02
*** FLOP *** [Jh 5d 9d]
VasquezSancho96: checks 
Scaaalll: bets $0.08
VasquezSancho96: folds 
Uncalled bet ($0.08) returned to Scaaalll
Scaaalll collected $0.13 from pot
Scaaalll: doesn't show hand 
*** SUMMARY ***
Total pot $0.13 | Rake $0 
Board [Jh 5d 9d]
Seat 1: Scaaalll (button) collected ($0.13)
Seat 2: Begon505 (small blind) folded before Flop
Seat 3: VasquezSancho96 (big blind) folded on the Flop
Seat 4: valet_hai folded before Flop (didn't bet)
Seat 5: NecromiconP folded before Flop (didn't bet)
Seat 6: AtZ3899 folded before Flop (didn't bet)



PokerStars Zoom Hand #229231005408:  Hold'em No Limit ($0.01/$0.02) - 2021/08/21 21:57:30 CET [2021/08/21 15:57:30 ET]
Table 'Halley' 6-max Seat #1 is the button
Seat 1: zbixxx ($5.60 in chips) 
Seat 2: ARTMVSLV ($2.83 in chips) 
Seat 3: Finkey99 ($7.20 in chips) 
Seat 4: Scaaalll ($2.29 in chips) 
Seat 5: NecromiconP ($2.82 in chips) 
Seat 6: HubertFroh ($2.05 in chips) 
ARTMVSLV: posts small blind $0.01
Finkey99: posts big blind $0.02
*** HOLE CARDS ***
Dealt to Scaaalll [Ad Kh]
Scaaalll: raises $0.04 to $0.06
NecromiconP: folds 
HubertFroh: folds 
zbixxx: folds 
ARTMVSLV: folds 
Finkey99: folds 
Uncalled bet ($0.04) returned to Scaaalll
Scaaalll collected $0.05 from pot
Scaaalll: doesn't show hand 
*** SUMMARY ***
Total pot $0.05 | Rake $0 
Seat 1: zbixxx (button) folded before Flop (didn't bet)
Seat 2: ARTMVSLV (small blind) folded before Flop
Seat 3: Finkey99 (big blind) folded before Flop
Seat 4: Scaaalll collected ($0.05)
Seat 5: NecromiconP folded before Flop (didn't bet)
Seat 6: HubertFroh folded before Flop (didn't bet)



PokerStars Zoom Hand #229231012912:  Hold'em No Limit ($0.01/$0.02) - 2021/08/21 21:57:54 CET [2021/08/21 15:57:54 ET]
Table 'Halley' 6-max Seat #1 is the button
Seat 1: Allexii ($2 in chips) 
Seat 2: Aho1337 ($3.77 in chips) 
Seat 3: Kreodont1987 ($5.19 in chips) 
Seat 4: maurivispa10 ($1.46 in chips) 
Seat 5: Scaaalll ($2.32 in chips) 
Seat 6: IgorFaria33 ($1.06 in chips) 
Aho1337: posts small blind $0.01
Kreodont1987: posts big blind $0.02
*** HOLE CARDS ***
Dealt to Scaaalll [6s 2c]
Allexii is disconnected 
maurivispa10: folds 
Scaaalll: folds 
IgorFaria33: calls $0.02
Allexii: folds 
Aho1337: folds 
Kreodont1987: raises $0.06 to $0.08
IgorFaria33: calls $0.06
*** FLOP *** [Qh Ah 7s]
Kreodont1987: bets $0.12
IgorFaria33: folds 
Uncalled bet ($0.12) returned to Kreodont1987
Kreodont1987 collected $0.16 from pot
Kreodont1987: doesn't show hand 
*** SUMMARY ***
Total pot $0.17 | Rake $0.01 
Board [Qh Ah 7s]
Seat 1: Allexii (button) folded before Flop (didn't bet)
Seat 2: Aho1337 (small blind) folded before Flop
Seat 3: Kreodont1987 (big blind) collected ($0.16)
Seat 4: maurivispa10 folded before Flop (didn't bet)
Seat 5: Scaaalll folded before Flop (didn't bet)
Seat 6: IgorFaria33 folded on the Flop



PokerStars Zoom Hand #229231020214:  Hold'em No Limit ($0.01/$0.02) - 2021/08/21 21:58:17 CET [2021/08/21 15:58:17 ET]
Table 'Halley' 6-max Seat #1 is the button
Seat 1: IWMTW ($0.68 in chips) 
Seat 2: lucksuckdonk ($4.35 in chips) 
Seat 3: Scaaalll ($2.31 in chips) 
Seat 4: smileakafray ($2.68 in chips) 
Seat 5: Blofeld197 ($3.27 in chips) 
Seat 6: arturtsutsaev ($1.33 in chips) 
lucksuckdonk: posts small blind $0.01
Scaaalll: posts big blind $0.02
*** HOLE CARDS ***
Dealt to Scaaalll [Qc 5d]
smileakafray: raises $0.04 to $0.06
arturtsutsaev is disconnected 
Blofeld197: folds 
arturtsutsaev: folds 
IWMTW: folds 
lucksuckdonk: folds 
Blofeld197 is disconnected 
Scaaalll: folds 
Uncalled bet ($0.04) returned to smileakafray
smileakafray collected $0.05 from pot
smileakafray: doesn't show hand 
*** SUMMARY ***
Total pot $0.05 | Rake $0 
Seat 1: IWMTW (button) folded before Flop (didn't bet)
Seat 2: lucksuckdonk (small blind) folded before Flop
Seat 3: Scaaalll (big blind) folded before Flop
Seat 4: smileakafray collected ($0.05)
Seat 5: Blofeld197 folded before Flop (didn't bet)
Seat 6: arturtsutsaev folded before Flop (didn't bet)



PokerStars Zoom Hand #229231016707:  Hold'em No Limit ($0.01/$0.02) - 2021/08/21 21:58:06 CET [2021/08/21 15:58:06 ET]
Table 'Halley' 6-max Seat #1 is the button
Seat 1: thekidisnuts ($1.91 in chips) 
Seat 2: pipecmolodec ($2 in chips) 
Seat 3: H0mmer99 ($3.25 in chips) 
Seat 4: lucksuckdonk ($4.35 in chips) 
Seat 5: Murileus ($2.30 in chips) 
Seat 6: Scaaalll ($2.31 in chips) 
pipecmolodec: posts small blind $0.01
H0mmer99: posts big blind $0.02
*** HOLE CARDS ***
Dealt to Scaaalll [8h Kc]
lucksuckdonk: folds 
Murileus: folds 
Scaaalll: folds 
thekidisnuts: raises $0.04 to $0.06
pipecmolodec: raises $0.14 to $0.20
H0mmer99: folds 
thekidisnuts: calls $0.14
*** FLOP *** [Ts 4d 4c]
pipecmolodec: bets $0.13
thekidisnuts: raises $0.34 to $0.47
pipecmolodec: folds 
Uncalled bet ($0.34) returned to thekidisnuts
thekidisnuts collected $0.66 from pot
thekidisnuts: doesn't show hand 
*** SUMMARY ***
Total pot $0.68 | Rake $0.02 
Board [Ts 4d 4c]
Seat 1: thekidisnuts (button) collected ($0.66)
Seat 2: pipecmolodec (small blind) folded on the Flop
Seat 3: H0mmer99 (big blind) folded before Flop
Seat 4: lucksuckdonk folded before Flop (didn't bet)
Seat 5: Murileus folded before Flop (didn't bet)
Seat 6: Scaaalll folded before Flop (didn't bet)



PokerStars Zoom Hand #229231014537:  Hold'em No Limit ($0.01/$0.02) - 2021/08/21 21:57:59 CET [2021/08/21 15:57:59 ET]
Table 'Halley' 6-max Seat #1 is the button
Seat 1: lexus00174 ($2 in chips) 
Seat 2: Scaaalll ($2.32 in chips) 
Seat 3: queen830 ($3.42 in chips) 
Seat 4: boa juice ($2.08 in chips) 
Seat 5: kahzura ($2 in chips) 
Seat 6: Baksit79 ($1.37 in chips) 
Scaaalll: posts small blind $0.01
queen830: posts big blind $0.02
*** HOLE CARDS ***
Dealt to Scaaalll [2c 8d]
boa juice: folds 
boa juice is disconnected 
kahzura: raises $0.04 to $0.06
Baksit79: raises $0.06 to $0.12
lexus00174: raises $0.33 to $0.45
Scaaalll: folds 
queen830: folds 
kahzura: folds 
Baksit79 has timed out
Baksit79: folds 
Uncalled bet ($0.33) returned to lexus00174
lexus00174 collected $0.33 from pot
lexus00174: doesn't show hand 
Baksit79 is disconnected 
*** SUMMARY ***
Total pot $0.33 | Rake $0 
Seat 1: lexus00174 (button) collected ($0.33)
Seat 2: Scaaalll (small blind) folded before Flop
Seat 3: queen830 (big blind) folded before Flop
Seat 4: boa juice folded before Flop (didn't bet)
Seat 5: kahzura folded before Flop
Seat 6: Baksit79 folded before Flop



PokerStars Zoom Hand #229231026234:  Hold'em No Limit ($0.01/$0.02) - 2021/08/21 21:58:36 CET [2021/08/21 15:58:36 ET]
Table 'Halley' 6-max Seat #1 is the button
Seat 1: auxy89 ($2.11 in chips) 
Seat 2: LuckyCheewey ($6.96 in chips) 
Seat 3: HellNative ($3.18 in chips) 
Seat 4: bossquaid ($2.20 in chips) 
Seat 5: sg.32rus ($1.36 in chips) 
Seat 6: Scaaalll ($2.29 in chips) 
LuckyCheewey: posts small blind $0.01
HellNative: posts big blind $0.02
*** HOLE CARDS ***
Dealt to Scaaalll [Td 7c]
bossquaid: folds 
sg.32rus: folds 
Scaaalll: folds 
auxy89: folds 
auxy89 is disconnected 
LuckyCheewey: raises $0.04 to $0.06
HellNative: folds 
Uncalled bet ($0.04) returned to LuckyCheewey
LuckyCheewey collected $0.04 from pot
LuckyCheewey: doesn't show hand 
*** SUMMARY ***
Total pot $0.04 | Rake $0 
Seat 1: auxy89 (button) folded before Flop (didn't bet)
Seat 2: LuckyCheewey (small blind) collected ($0.04)
Seat 3: HellNative (big blind) folded before Flop
Seat 4: bossquaid folded before Flop (didn't bet)
Seat 5: sg.32rus folded before Flop (didn't bet)
Seat 6: Scaaalll folded before Flop (didn't bet)



PokerStars Zoom Hand #229231033398:  Hold'em No Limit ($0.01/$0.02) - 2021/08/21 21:58:59 CET [2021/08/21 15:58:59 ET]
Table 'Halley' 6-max Seat #1 is the button
Seat 1: AlexGTPS ($1.87 in chips) 
Seat 2: Scaaalll ($2.29 in chips) 
Seat 3: Gullsnyta ($1 in chips) 
Seat 4: SIGREX ($2.02 in chips) 
Seat 5: BIITRU ($3.58 in chips) 
Seat 6: SKV_1985 ($2.42 in chips) 
Scaaalll: posts small blind $0.01
Gullsnyta: posts big blind $0.02
*** HOLE CARDS ***
Dealt to Scaaalll [9c 8d]
SIGREX: raises $0.02 to $0.04
BIITRU: folds 
SKV_1985: folds 
AlexGTPS: folds 
Scaaalll: folds 
Gullsnyta: folds 
Uncalled bet ($0.02) returned to SIGREX
SIGREX collected $0.05 from pot
SIGREX: doesn't show hand 
*** SUMMARY ***
Total pot $0.05 | Rake $0 
Seat 1: AlexGTPS (button) folded before Flop (didn't bet)
Seat 2: Scaaalll (small blind) folded before Flop
Seat 3: Gullsnyta (big blind) folded before Flop
Seat 4: SIGREX collected ($0.05)
Seat 5: BIITRU folded before Flop (didn't bet)
Seat 6: SKV_1985 folded before Flop (didn't bet)



PokerStars Zoom Hand #229231029336:  Hold'em No Limit ($0.01/$0.02) - 2021/08/21 21:58:46 CET [2021/08/21 15:58:46 ET]
Table 'Halley' 6-max Seat #1 is the button
Seat 1: Scaaalll ($2.29 in chips) 
Seat 2: Iwanb4 ($1.77 in chips) 
Seat 3: Dimon90x ($0.50 in chips) 
Seat 4: shingo594 ($2.24 in chips) 
Seat 5: PapiMik3 ($2.65 in chips) 
Seat 6: auxy89 ($2.11 in chips) 
Iwanb4: posts small blind $0.01
Dimon90x: posts big blind $0.02
*** HOLE CARDS ***
Dealt to Scaaalll [2s Ad]
shingo594: folds 
PapiMik3: folds 
shingo594 is disconnected 
auxy89: raises $0.04 to $0.06
Scaaalll: folds 
Iwanb4: folds 
Dimon90x: calls $0.04
*** FLOP *** [3h 7c Ks]
Dimon90x: checks 
auxy89: checks 
*** TURN *** [3h 7c Ks] [5s]
Dimon90x: checks 
auxy89: checks 
*** RIVER *** [3h 7c Ks 5s] [Td]
Dimon90x: checks 
auxy89: checks 
*** SHOW DOWN ***
Dimon90x: shows [6d 8c] (high card King)
auxy89: shows [Qs Ac] (high card Ace)
auxy89 collected $0.13 from pot
*** SUMMARY ***
Total pot $0.13 | Rake $0 
Board [3h 7c Ks 5s Td]
Seat 1: Scaaalll (button) folded before Flop (didn't bet)
Seat 2: Iwanb4 (small blind) folded before Flop
Seat 3: Dimon90x (big blind) showed [6d 8c] and lost with high card King
Seat 4: shingo594 folded before Flop (didn't bet)
Seat 5: PapiMik3 folded before Flop (didn't bet)
Seat 6: auxy89 showed [Qs Ac] and won ($0.13) with high card Ace



PokerStars Zoom Hand #229231034660:  Hold'em No Limit ($0.01/$0.02) - 2021/08/21 21:59:03 CET [2021/08/21 15:59:03 ET]
Table 'Halley' 6-max Seat #1 is the button
Seat 1: ARTMVSLV ($6.42 in chips) 
Seat 2: KIBA7660 ($0.99 in chips) 
Seat 3: zielony ($2.59 in chips) 
Seat 4: Scaaalll ($2.28 in chips) 
Seat 5: Reipinguimm ($3.49 in chips) 
Seat 6: queen830 ($4.08 in chips) 
KIBA7660: posts small blind $0.01
zielony: posts big blind $0.02
*** HOLE CARDS ***
Dealt to Scaaalll [As Ks]
Scaaalll: raises $0.04 to $0.06
Reipinguimm: folds 
queen830: folds 
ARTMVSLV: folds 
KIBA7660: calls $0.05
zielony: folds 
*** FLOP *** [9c 6s 3h]
KIBA7660: checks 
Scaaalll: checks 
*** TURN *** [9c 6s 3h] [7h]
KIBA7660: checks 
Scaaalll: checks 
*** RIVER *** [9c 6s 3h 7h] [Kc]
KIBA7660: bets $0.14
Scaaalll: raises $0.20 to $0.34
KIBA7660: folds 
Uncalled bet ($0.20) returned to Scaaalll
Scaaalll collected $0.41 from pot
Scaaalll: doesn't show hand 
KIBA7660 is disconnected 
*** SUMMARY ***
Total pot $0.42 | Rake $0.01 
Board [9c 6s 3h 7h Kc]
Seat 1: ARTMVSLV (button) folded before Flop (didn't bet)
Seat 2: KIBA7660 (small blind) folded on the River
Seat 3: zielony (big blind) folded before Flop
Seat 4: Scaaalll collected ($0.41)
Seat 5: Reipinguimm folded before Flop (didn't bet)
Seat 6: queen830 folded before Flop (didn't bet)



PokerStars Zoom Hand #229231049914:  Hold'em No Limit ($0.01/$0.02) - 2021/08/21 21:59:52 CET [2021/08/21 15:59:52 ET]
Table 'Halley' 6-max Seat #1 is the button
Seat 1: fenobarbital1 ($1.81 in chips) 
Seat 2: MIT_PKR ($2.61 in chips) 
Seat 3: BARDICHExSIN ($1.86 in chips) 
Seat 4: wstanula ($2.67 in chips) 
Seat 5: Scaaalll ($2.49 in chips) 
Seat 6: HDYD18 ($3.23 in chips) 
MIT_PKR: posts small blind $0.01
BARDICHExSIN: posts big blind $0.02
*** HOLE CARDS ***
Dealt to Scaaalll [9h 9c]
wstanula: folds 
Scaaalll: raises $0.04 to $0.06
HDYD18: folds 
fenobarbital1: folds 
MIT_PKR: folds 
BARDICHExSIN: folds 
Uncalled bet ($0.04) returned to Scaaalll
Scaaalll collected $0.05 from pot
Scaaalll: doesn't show hand 
BARDICHExSIN is disconnected 
*** SUMMARY ***
Total pot $0.05 | Rake $0 
Seat 1: fenobarbital1 (button) folded before Flop (didn't bet)
Seat 2: MIT_PKR (small blind) folded before Flop
Seat 3: BARDICHExSIN (big blind) folded before Flop
Seat 4: wstanula folded before Flop (didn't bet)
Seat 5: Scaaalll collected ($0.05)
Seat 6: HDYD18 folded before Flop (didn't bet)



PokerStars Zoom Hand #229231053804:  Hold'em No Limit ($0.01/$0.02) - 2021/08/21 22:00:04 CET [2021/08/21 16:00:04 ET]
Table 'Halley' 6-max Seat #1 is the button
Seat 1: Iluvatar922 ($9.24 in chips) 
Seat 2: maliniak75 ($2.14 in chips) 
Seat 3: Scaaalll ($2.52 in chips) 
Seat 4: ximik D V ($2.33 in chips) 
Seat 5: RonilsonCosta ($2.38 in chips) 
Seat 6: VITALIONICH626 ($2.92 in chips) 
maliniak75: posts small blind $0.01
Scaaalll: posts big blind $0.02
*** HOLE CARDS ***
Dealt to Scaaalll [2d 5d]
ximik D V: folds 
VITALIONICH626 is disconnected 
RonilsonCosta: folds 
VITALIONICH626: folds 
Iluvatar922: raises $0.03 to $0.05
maliniak75: folds 
Scaaalll: folds 
Uncalled bet ($0.03) returned to Iluvatar922
Iluvatar922 collected $0.05 from pot
Iluvatar922: doesn't show hand 
*** SUMMARY ***
Total pot $0.05 | Rake $0 
Seat 1: Iluvatar922 (button) collected ($0.05)
Seat 2: maliniak75 (small blind) folded before Flop
Seat 3: Scaaalll (big blind) folded before Flop
Seat 4: ximik D V folded before Flop (didn't bet)
Seat 5: RonilsonCosta folded before Flop (didn't bet)
Seat 6: VITALIONICH626 folded before Flop (didn't bet)



PokerStars Zoom Hand #229231060259:  Hold'em No Limit ($0.01/$0.02) - 2021/08/21 22:00:23 CET [2021/08/21 16:00:23 ET]
Table 'Halley' 6-max Seat #1 is the button
Seat 1: CROVOSOS-1978 ($2.09 in chips) 
Seat 2: Scaaalll ($2.50 in chips) 
Seat 3: Agno$tic ($2.03 in chips) 
Seat 4: zbixxx ($5.66 in chips) 
Seat 5: oberstreu ($2.22 in chips) 
Seat 6: Aho1337 ($2.51 in chips) 
Scaaalll: posts small blind $0.01
Agno$tic: posts big blind $0.02
*** HOLE CARDS ***
Dealt to Scaaalll [Qs Ac]
zbixxx: folds 
oberstreu: raises $0.04 to $0.06
Aho1337: folds 
CROVOSOS-1978: raises $0.15 to $0.21
Scaaalll: folds 
Agno$tic: folds 
oberstreu: folds 
Uncalled bet ($0.15) returned to CROVOSOS-1978
CROVOSOS-1978 collected $0.15 from pot
CROVOSOS-1978: doesn't show hand 
*** SUMMARY ***
Total pot $0.15 | Rake $0 
Seat 1: CROVOSOS-1978 (button) collected ($0.15)
Seat 2: Scaaalll (small blind) folded before Flop
Seat 3: Agno$tic (big blind) folded before Flop
Seat 4: zbixxx folded before Flop (didn't bet)
Seat 5: oberstreu folded before Flop
Seat 6: Aho1337 folded before Flop (didn't bet)



PokerStars Zoom Hand #229231067717:  Hold'em No Limit ($0.01/$0.02) - 2021/08/21 22:00:44 CET [2021/08/21 16:00:44 ET]
Table 'Halley' 6-max Seat #1 is the button
Seat 1: arturtsutsaev ($1.21 in chips) 
Seat 2: wopl ($1.39 in chips) 
Seat 3: pipecmolodec ($2.10 in chips) 
Seat 4: Scaaalll ($2.49 in chips) 
Seat 5: Mikeloko182 ($2.15 in chips) 
Seat 6: KIraMan ($7.01 in chips) 
wopl: posts small blind $0.01
pipecmolodec: posts big blind $0.02
*** HOLE CARDS ***
Dealt to Scaaalll [Qc 6h]
Scaaalll: folds 
Mikeloko182: folds 
KIraMan: folds 
arturtsutsaev: folds 
wopl: folds 
Uncalled bet ($0.01) returned to pipecmolodec
arturtsutsaev is disconnected 
pipecmolodec collected $0.02 from pot
pipecmolodec: doesn't show hand 
*** SUMMARY ***
Total pot $0.02 | Rake $0 
Seat 1: arturtsutsaev (button) folded before Flop (didn't bet)
Seat 2: wopl (small blind) folded before Flop
Seat 3: pipecmolodec (big blind) collected ($0.02)
Seat 4: Scaaalll folded before Flop (didn't bet)
Seat 5: Mikeloko182 folded before Flop (didn't bet)
Seat 6: KIraMan folded before Flop (didn't bet)



PokerStars Zoom Hand #229231069273:  Hold'em No Limit ($0.01/$0.02) - 2021/08/21 22:00:48 CET [2021/08/21 16:00:48 ET]
Table 'Halley' 6-max Seat #1 is the button
Seat 1: lucksuckdonk ($3.98 in chips) 
Seat 2: IceTdannyB ($2.13 in chips) 
Seat 3: Hantsirg ($0.66 in chips) 
Seat 4: Scaaalll ($2.49 in chips) 
Seat 5: z3317111711 ($4.64 in chips) 
Seat 6: JannikSPoker ($2.19 in chips) 
IceTdannyB: posts small blind $0.01
Hantsirg: posts big blind $0.02
*** HOLE CARDS ***
Dealt to Scaaalll [Qh Th]
JannikSPoker is disconnected 
Scaaalll: raises $0.04 to $0.06
z3317111711: folds 
JannikSPoker: folds 
lucksuckdonk: folds 
Hantsirg is disconnected 
IceTdannyB: folds 
Hantsirg: folds 
Uncalled bet ($0.04) returned to Scaaalll
IceTdannyB is disconnected 
Scaaalll collected $0.05 from pot
Scaaalll: doesn't show hand 
*** SUMMARY ***
Total pot $0.05 | Rake $0 
Seat 1: lucksuckdonk (button) folded before Flop (didn't bet)
Seat 2: IceTdannyB (small blind) folded before Flop
Seat 3: Hantsirg (big blind) folded before Flop
Seat 4: Scaaalll collected ($0.05)
Seat 5: z3317111711 folded before Flop (didn't bet)
Seat 6: JannikSPoker folded before Flop (didn't bet)



PokerStars Zoom Hand #229231058612:  Hold'em No Limit ($0.01/$0.02) - 2021/08/21 22:00:18 CET [2021/08/21 16:00:18 ET]
Table 'Halley' 6-max Seat #1 is the button
Seat 1: Scaaalll ($2.50 in chips) 
Seat 2: twiti174 ($3.62 in chips) 
Seat 3: caiolima99 ($5.66 in chips) 
Seat 4: 365p2eva ($2.06 in chips) 
Seat 5: Emilmoller1 ($1.92 in chips) 
Seat 6: Red Sky 15 ($5.44 in chips) 
twiti174: posts small blind $0.01
caiolima99: posts big blind $0.02
*** HOLE CARDS ***
Dealt to Scaaalll [5h Tc]
365p2eva: folds 
Emilmoller1: folds 
Red Sky 15: folds 
Scaaalll: folds 
Red Sky 15 is disconnected 
twiti174: raises $0.02 to $0.04
caiolima99: calls $0.02
*** FLOP *** [Qd As 8s]
twiti174: checks 
caiolima99: checks 
*** TURN *** [Qd As 8s] [5c]
twiti174: checks 
caiolima99: bets $0.05
twiti174: folds 
Uncalled bet ($0.05) returned to caiolima99
caiolima99 collected $0.08 from pot
caiolima99: doesn't show hand 
twiti174 is disconnected 
*** SUMMARY ***
Total pot $0.08 | Rake $0 
Board [Qd As 8s 5c]
Seat 1: Scaaalll (button) folded before Flop (didn't bet)
Seat 2: twiti174 (small blind) folded on the Turn
Seat 3: caiolima99 (big blind) collected ($0.08)
Seat 4: 365p2eva folded before Flop (didn't bet)
Seat 5: Emilmoller1 folded before Flop (didn't bet)
Seat 6: Red Sky 15 folded before Flop (didn't bet)



PokerStars Zoom Hand #229231065929:  Hold'em No Limit ($0.01/$0.02) - 2021/08/21 22:00:39 CET [2021/08/21 16:00:39 ET]
Table 'Halley' 6-max Seat #1 is the button
Seat 1: EevAA190 ($3.14 in chips) 
Seat 2: le_vlimeux ($2.05 in chips) 
Seat 3: RonilsonCosta ($2.37 in chips) 
Seat 4: Bufre ($4.07 in chips) 
Seat 5: Koldun 2636 ($2.34 in chips) 
Seat 6: Scaaalll ($2.49 in chips) 
le_vlimeux: posts small blind $0.01
RonilsonCosta: posts big blind $0.02
*** HOLE CARDS ***
Dealt to Scaaalll [8d Jc]
Bufre: folds 
Koldun 2636: folds 
Scaaalll: folds 
EevAA190: folds 
le_vlimeux: raises $0.03 to $0.05
RonilsonCosta: calls $0.03
*** FLOP *** [5h 2h Kc]
le_vlimeux: bets $0.03
RonilsonCosta: folds 
Uncalled bet ($0.03) returned to le_vlimeux
le_vlimeux collected $0.10 from pot
le_vlimeux: doesn't show hand 
*** SUMMARY ***
Total pot $0.10 | Rake $0 
Board [5h 2h Kc]
Seat 1: EevAA190 (button) folded before Flop (didn't bet)
Seat 2: le_vlimeux (small blind) collected ($0.10)
Seat 3: RonilsonCosta (big blind) folded on the Flop
Seat 4: Bufre folded before Flop (didn't bet)
Seat 5: Koldun 2636 folded before Flop (didn't bet)
Seat 6: Scaaalll folded before Flop (didn't bet)



PokerStars Zoom Hand #229231073089:  Hold'em No Limit ($0.01/$0.02) - 2021/08/21 22:00:58 CET [2021/08/21 16:00:58 ET]
Table 'Halley' 6-max Seat #1 is the button
Seat 1: satti1337 ($2.09 in chips) 
Seat 2: LuckyCheewey ($7.57 in chips) 
Seat 3: so0love ($2.02 in chips) 
Seat 4: Nihility77 ($2.04 in chips) 
Seat 5: VovaSerega ($1.22 in chips) 
Seat 6: Scaaalll ($2.52 in chips) 
LuckyCheewey: posts small blind $0.01
so0love: posts big blind $0.02
*** HOLE CARDS ***
Dealt to Scaaalll [2d 6h]
Nihility77: folds 
VovaSerega: folds 
Scaaalll: folds 
satti1337: folds 
LuckyCheewey: folds 
Uncalled bet ($0.01) returned to so0love
so0love collected $0.02 from pot
so0love: doesn't show hand 
*** SUMMARY ***
Total pot $0.02 | Rake $0 
Seat 1: satti1337 (button) folded before Flop (didn't bet)
Seat 2: LuckyCheewey (small blind) folded before Flop
Seat 3: so0love (big blind) collected ($0.02)
Seat 4: Nihility77 folded before Flop (didn't bet)
Seat 5: VovaSerega folded before Flop (didn't bet)
Seat 6: Scaaalll folded before Flop (didn't bet)



PokerStars Zoom Hand #229231074591:  Hold'em No Limit ($0.01/$0.02) - 2021/08/21 22:01:02 CET [2021/08/21 16:01:02 ET]
Table 'Halley' 6-max Seat #1 is the button
Seat 1: EmperorKurr ($2.46 in chips) 
Seat 2: Loto70 ($2.21 in chips) 
Seat 3: Scaaalll ($2.52 in chips) 
Seat 4: HellNative ($2.20 in chips) 
Seat 5: BriceDo1917 ($2.76 in chips) 
Seat 6: djMegagirl ($0.70 in chips) 
Loto70: posts small blind $0.01
Scaaalll: posts big blind $0.02
*** HOLE CARDS ***
Dealt to Scaaalll [2d Js]
BriceDo1917 is disconnected 
HellNative: folds 
BriceDo1917: folds 
djMegagirl: folds 
EmperorKurr: folds 
Loto70: raises $0.03 to $0.05
Scaaalll: folds 
Uncalled bet ($0.03) returned to Loto70
Loto70 collected $0.04 from pot
Loto70: doesn't show hand 
*** SUMMARY ***
Total pot $0.04 | Rake $0 
Seat 1: EmperorKurr (button) folded before Flop (didn't bet)
Seat 2: Loto70 (small blind) collected ($0.04)
Seat 3: Scaaalll (big blind) folded before Flop
Seat 4: HellNative folded before Flop (didn't bet)
Seat 5: BriceDo1917 folded before Flop (didn't bet)
Seat 6: djMegagirl folded before Flop (didn't bet)



PokerStars Zoom Hand #229231085718:  Hold'em No Limit ($0.01/$0.02) - 2021/08/21 22:01:22 CET [2021/08/21 16:01:22 ET]
Table 'Halley' 6-max Seat #1 is the button
Seat 1: Scaaalll ($2.50 in chips) 
Seat 2: jftd123 ($3.50 in chips) 
Seat 3: Tomiclashgolf ($1.71 in chips) 
Seat 4: olcham7 ($2.01 in chips) 
Seat 5: Gamer577 ($3.89 in chips) 
Seat 6: Nihility77 ($4.77 in chips) 
jftd123: posts small blind $0.01
Tomiclashgolf: posts big blind $0.02
*** HOLE CARDS ***
Dealt to Scaaalll [5h 4c]
olcham7: folds 
Gamer577: folds 
Nihility77: folds 
Scaaalll: folds 
jftd123: folds 
Uncalled bet ($0.01) returned to Tomiclashgolf
Tomiclashgolf collected $0.02 from pot
Tomiclashgolf: doesn't show hand 
*** SUMMARY ***
Total pot $0.02 | Rake $0 
Seat 1: Scaaalll (button) folded before Flop (didn't bet)
Seat 2: jftd123 (small blind) folded before Flop
Seat 3: Tomiclashgolf (big blind) collected ($0.02)
Seat 4: olcham7 folded before Flop (didn't bet)
Seat 5: Gamer577 folded before Flop (didn't bet)
Seat 6: Nihility77 folded before Flop (didn't bet)



PokerStars Zoom Hand #229231089071:  Hold'em No Limit ($0.01/$0.02) - 2021/08/21 22:01:30 CET [2021/08/21 16:01:30 ET]
Table 'Halley' 6-max Seat #1 is the button
Seat 1: Loto70 ($2.23 in chips) 
Seat 2: Scaaalll ($2.50 in chips) 
Seat 3: lexus00174 ($1.95 in chips) 
Seat 4: ARS_POLI13 ($2 in chips) 
Seat 5: Laonikos ($8.49 in chips) 
Seat 6: EevAA190 ($2 in chips) 
Scaaalll: posts small blind $0.01
lexus00174: posts big blind $0.02
*** HOLE CARDS ***
Dealt to Scaaalll [Kc Jc]
ARS_POLI13: folds 
Laonikos: raises $0.03 to $0.05
EevAA190: folds 
Loto70: folds 
Scaaalll: calls $0.04
lexus00174: calls $0.03
*** FLOP *** [3c Qc Ac]
Scaaalll: checks 
lexus00174: checks 
Laonikos: checks 
*** TURN *** [3c Qc Ac] [6h]
Scaaalll: bets $0.10
lexus00174: folds 
Laonikos: folds 
Uncalled bet ($0.10) returned to Scaaalll
Scaaalll collected $0.14 from pot
Scaaalll: doesn't show hand 
*** SUMMARY ***
Total pot $0.15 | Rake $0.01 
Board [3c Qc Ac 6h]
Seat 1: Loto70 (button) folded before Flop (didn't bet)
Seat 2: Scaaalll (small blind) collected ($0.14)
Seat 3: lexus00174 (big blind) folded on the Turn
Seat 4: ARS_POLI13 folded before Flop (didn't bet)
Seat 5: Laonikos folded on the Turn
Seat 6: EevAA190 folded before Flop (didn't bet)



PokerStars Zoom Hand #229231109907:  Hold'em No Limit ($0.01/$0.02) - 2021/08/21 22:02:18 CET [2021/08/21 16:02:18 ET]
Table 'Halley' 6-max Seat #1 is the button
Seat 1: EevAA190 ($2.79 in chips) 
Seat 2: tolstii906 ($3.57 in chips) 
Seat 3: kboskov123 ($2.91 in chips) 
Seat 4: le_vlimeux ($2.28 in chips) 
Seat 5: Scaaalll ($2.59 in chips) 
Seat 6: Player XVII ($1.94 in chips) 
tolstii906: posts small blind $0.01
kboskov123: posts big blind $0.02
*** HOLE CARDS ***
Dealt to Scaaalll [8h 8d]
le_vlimeux: folds 
Scaaalll: raises $0.04 to $0.06
Player XVII: folds 
EevAA190: folds 
tolstii906: calls $0.05
kboskov123: folds 
*** FLOP *** [Tc Kh Qs]
tolstii906: checks 
Scaaalll: checks 
*** TURN *** [Tc Kh Qs] [Jd]
tolstii906: bets $0.07
Scaaalll: folds 
Uncalled bet ($0.07) returned to tolstii906
tolstii906 collected $0.14 from pot
tolstii906: doesn't show hand 
*** SUMMARY ***
Total pot $0.14 | Rake $0 
Board [Tc Kh Qs Jd]
Seat 1: EevAA190 (button) folded before Flop (didn't bet)
Seat 2: tolstii906 (small blind) collected ($0.14)
Seat 3: kboskov123 (big blind) folded before Flop
Seat 4: le_vlimeux folded before Flop (didn't bet)
Seat 5: Scaaalll folded on the Turn
Seat 6: Player XVII folded before Flop (didn't bet)



PokerStars Zoom Hand #229231122297:  Hold'em No Limit ($0.01/$0.02) - 2021/08/21 22:02:47 CET [2021/08/21 16:02:47 ET]
Table 'Halley' 6-max Seat #1 is the button
Seat 1: Scaaalll ($2.53 in chips) 
Seat 2: olliejaydee ($3.51 in chips) 
Seat 3: felipeciji ($2 in chips) 
Seat 4: arrow17 ($2.19 in chips) 
Seat 5: basyan111 ($3.08 in chips) 
Seat 6: ash1448 ($10.77 in chips) 
olliejaydee: posts small blind $0.01
felipeciji: posts big blind $0.02
*** HOLE CARDS ***
Dealt to Scaaalll [4h 8c]
arrow17: folds 
basyan111: folds 
basyan111 is disconnected 
ash1448: folds 
Scaaalll: folds 
olliejaydee: raises $0.03 to $0.05
felipeciji: folds 
Uncalled bet ($0.03) returned to olliejaydee
olliejaydee collected $0.04 from pot
olliejaydee: doesn't show hand 
*** SUMMARY ***
Total pot $0.04 | Rake $0 
Seat 1: Scaaalll (button) folded before Flop (didn't bet)
Seat 2: olliejaydee (small blind) collected ($0.04)
Seat 3: felipeciji (big blind) folded before Flop
Seat 4: arrow17 folded before Flop (didn't bet)
Seat 5: basyan111 folded before Flop (didn't bet)
Seat 6: ash1448 folded before Flop (didn't bet)



PokerStars Zoom Hand #229231125709:  Hold'em No Limit ($0.01/$0.02) - 2021/08/21 22:02:55 CET [2021/08/21 16:02:55 ET]
Table 'Halley' 6-max Seat #1 is the button
Seat 1: NecromiconP ($2.73 in chips) 
Seat 2: davidalejag ($2.22 in chips) 
Seat 3: chinex_sba ($2 in chips) 
Seat 4: nV6TR ($5.44 in chips) 
Seat 5: Scaaalll ($2.53 in chips) 
Seat 6: MIT_PKR ($2.43 in chips) 
davidalejag: posts small blind $0.01
chinex_sba: posts big blind $0.02
*** HOLE CARDS ***
Dealt to Scaaalll [7c 8c]
nV6TR: raises $0.02 to $0.04
Scaaalll: calls $0.04
MIT_PKR: raises $0.15 to $0.19
NecromiconP: folds 
davidalejag: folds 
chinex_sba: folds 
nV6TR: folds 
Scaaalll: folds 
Uncalled bet ($0.15) returned to MIT_PKR
MIT_PKR collected $0.15 from pot
MIT_PKR: doesn't show hand 
*** SUMMARY ***
Total pot $0.15 | Rake $0 
Seat 1: NecromiconP (button) folded before Flop (didn't bet)
Seat 2: davidalejag (small blind) folded before Flop
Seat 3: chinex_sba (big blind) folded before Flop
Seat 4: nV6TR folded before Flop
Seat 5: Scaaalll folded before Flop
Seat 6: MIT_PKR collected ($0.15)



PokerStars Zoom Hand #229231133978:  Hold'em No Limit ($0.01/$0.02) - 2021/08/21 22:03:13 CET [2021/08/21 16:03:13 ET]
Table 'Halley' 6-max Seat #1 is the button
Seat 1: ricske68 ($3.13 in chips) 
Seat 2: rpycmbEM ($2.28 in chips) 
Seat 3: Scaaalll ($2.49 in chips) 
Seat 4: gds2003 ($1.57 in chips) 
Seat 5: FabOliveira9 ($2.01 in chips) 
Seat 6: KoAlRy ($2.29 in chips) 
rpycmbEM: posts small blind $0.01
Scaaalll: posts big blind $0.02
*** HOLE CARDS ***
Dealt to Scaaalll [As Th]
gds2003: folds 
FabOliveira9: folds 
KoAlRy: folds 
ricske68: folds 
rpycmbEM: raises $0.03 to $0.05
Scaaalll: raises $0.11 to $0.16
rpycmbEM: calls $0.11
*** FLOP *** [7d Ac 4d]
rpycmbEM: checks 
Scaaalll: bets $0.20
rpycmbEM: calls $0.20
*** TURN *** [7d Ac 4d] [Qc]
rpycmbEM: checks 
Scaaalll: bets $0.36
rpycmbEM: calls $0.36
*** RIVER *** [7d Ac 4d Qc] [Jd]
rpycmbEM: checks 
Scaaalll: checks 
*** SHOW DOWN ***
rpycmbEM: shows [Ah 7h] (two pair, Aces and Sevens)
Scaaalll: mucks hand 
rpycmbEM collected $1.39 from pot
*** SUMMARY ***
Total pot $1.44 | Rake $0.05 
Board [7d Ac 4d Qc Jd]
Seat 1: ricske68 (button) folded before Flop (didn't bet)
Seat 2: rpycmbEM (small blind) showed [Ah 7h] and won ($1.39) with two pair, Aces and Sevens
Seat 3: Scaaalll (big blind) mucked [As Th]
Seat 4: gds2003 folded before Flop (didn't bet)
Seat 5: FabOliveira9 folded before Flop (didn't bet)
Seat 6: KoAlRy folded before Flop (didn't bet)



PokerStars Zoom Hand #229231162643:  Hold'em No Limit ($0.01/$0.02) - 2021/08/21 22:04:18 CET [2021/08/21 16:04:18 ET]
Table 'Halley' 6-max Seat #1 is the button
Seat 1: usenovm ($3.90 in chips) 
Seat 2: LijanaV ($2.43 in chips) 
Seat 3: Jujiluju ($2.03 in chips) 
Seat 4: SIGREX ($2.42 in chips) 
Seat 5: Scaaalll ($2 in chips) 
Seat 6: Mad_Clock ($3.86 in chips) 
LijanaV: posts small blind $0.01
Jujiluju: posts big blind $0.02
*** HOLE CARDS ***
Dealt to Scaaalll [3s 9s]
SIGREX: folds 
Scaaalll: folds 
Mad_Clock: folds 
LijanaV is disconnected 
usenovm: raises $0.02 to $0.04
LijanaV: folds 
Jujiluju: folds 
Uncalled bet ($0.02) returned to usenovm
usenovm collected $0.05 from pot
usenovm: doesn't show hand 
*** SUMMARY ***
Total pot $0.05 | Rake $0 
Seat 1: usenovm (button) collected ($0.05)
Seat 2: LijanaV (small blind) folded before Flop
Seat 3: Jujiluju (big blind) folded before Flop
Seat 4: SIGREX folded before Flop (didn't bet)
Seat 5: Scaaalll folded before Flop (didn't bet)
Seat 6: Mad_Clock folded before Flop (didn't bet)



PokerStars Zoom Hand #229231160874:  Hold'em No Limit ($0.01/$0.02) - 2021/08/21 22:04:14 CET [2021/08/21 16:04:14 ET]
Table 'Halley' 6-max Seat #1 is the button
Seat 1: ugi-dugi ($2.09 in chips) 
Seat 2: ChowMangao ($6.12 in chips) 
Seat 3: LyahovIvan ($0.26 in chips) 
Seat 4: Scaaalll ($2 in chips) 
Seat 5: Chupacabra G ($1.79 in chips) 
Seat 6: ARTMVSLV ($4.64 in chips) 
ChowMangao: posts small blind $0.01
LyahovIvan: posts big blind $0.02
*** HOLE CARDS ***
Dealt to Scaaalll [Ts Ah]
Scaaalll: folds 
Chupacabra G: folds 
ARTMVSLV: folds 
ugi-dugi: folds 
ChowMangao: raises $0.04 to $0.06
LyahovIvan: folds 
Uncalled bet ($0.04) returned to ChowMangao
ChowMangao collected $0.04 from pot
ChowMangao: doesn't show hand 
*** SUMMARY ***
Total pot $0.04 | Rake $0 
Seat 1: ugi-dugi (button) folded before Flop (didn't bet)
Seat 2: ChowMangao (small blind) collected ($0.04)
Seat 3: LyahovIvan (big blind) folded before Flop
Seat 4: Scaaalll folded before Flop (didn't bet)
Seat 5: Chupacabra G folded before Flop (didn't bet)
Seat 6: ARTMVSLV folded before Flop (didn't bet)



PokerStars Zoom Hand #229231164423:  Hold'em No Limit ($0.01/$0.02) - 2021/08/21 22:04:22 CET [2021/08/21 16:04:22 ET]
Table 'Halley' 6-max Seat #1 is the button
Seat 1: diamonds410 ($0.34 in chips) 
Seat 2: Scaaalll ($2 in chips) 
Seat 3: feybys ($2 in chips) 
Seat 4: RoughRafff ($2.78 in chips) 
Seat 5: Gerar NB ($3.43 in chips) 
Seat 6: Blaackie ($2.81 in chips) 
Scaaalll: posts small blind $0.01
feybys: posts big blind $0.02
*** HOLE CARDS ***
Dealt to Scaaalll [Qd 7d]
RoughRafff: raises $0.04 to $0.06
Gerar NB: folds 
Blaackie: folds 
diamonds410: calls $0.06
Scaaalll: folds 
feybys: folds 
*** FLOP *** [8s Ad Ah]
RoughRafff: bets $0.12
diamonds410: folds 
Uncalled bet ($0.12) returned to RoughRafff
RoughRafff collected $0.14 from pot
RoughRafff: doesn't show hand 
diamonds410 is disconnected 
*** SUMMARY ***
Total pot $0.15 | Rake $0.01 
Board [8s Ad Ah]
Seat 1: diamonds410 (button) folded on the Flop
Seat 2: Scaaalll (small blind) folded before Flop
Seat 3: feybys (big blind) folded before Flop
Seat 4: RoughRafff collected ($0.14)
Seat 5: Gerar NB folded before Flop (didn't bet)
Seat 6: Blaackie folded before Flop (didn't bet)



PokerStars Zoom Hand #229231168885:  Hold'em No Limit ($0.01/$0.02) - 2021/08/21 22:04:32 CET [2021/08/21 16:04:32 ET]
Table 'Halley' 6-max Seat #1 is the button
Seat 1: rekopo203 ($2.17 in chips) 
Seat 2: HellNative ($2.12 in chips) 
Seat 3: PapiMik3 ($2.99 in chips) 
Seat 4: Finkey99 ($6.76 in chips) 
Seat 5: pipecmolodec ($2 in chips) 
Seat 6: Scaaalll ($2 in chips) 
HellNative: posts small blind $0.01
PapiMik3: posts big blind $0.02
*** HOLE CARDS ***
Dealt to Scaaalll [6h 8s]
Finkey99: folds 
pipecmolodec: folds 
Scaaalll: folds 
rekopo203: folds 
HellNative: folds 
Uncalled bet ($0.01) returned to PapiMik3
PapiMik3 collected $0.02 from pot
PapiMik3: doesn't show hand 
*** SUMMARY ***
Total pot $0.02 | Rake $0 
Seat 1: rekopo203 (button) folded before Flop (didn't bet)
Seat 2: HellNative (small blind) folded before Flop
Seat 3: PapiMik3 (big blind) collected ($0.02)
Seat 4: Finkey99 folded before Flop (didn't bet)
Seat 5: pipecmolodec folded before Flop (didn't bet)
Seat 6: Scaaalll folded before Flop (didn't bet)



PokerStars Zoom Hand #229231178501:  Hold'em No Limit ($0.01/$0.02) - 2021/08/21 22:04:54 CET [2021/08/21 16:04:54 ET]
Table 'Halley' 6-max Seat #1 is the button
Seat 1: arrow17 ($2.46 in chips) 
Seat 2: Gyapszi958 ($1.68 in chips) 
Seat 3: Scaaalll ($2 in chips) 
Seat 4: meikoz ($4.85 in chips) 
Seat 5: Sinad1302 ($2.62 in chips) 
Seat 6: AlexGTPS ($2.23 in chips) 
Gyapszi958: posts small blind $0.01
Scaaalll: posts big blind $0.02
*** HOLE CARDS ***
Dealt to Scaaalll [7c 3h]
meikoz: folds 
Sinad1302: folds 
AlexGTPS: folds 
Sinad1302 is disconnected 
arrow17: folds 
Gyapszi958: raises $0.02 to $0.04
Scaaalll: folds 
Uncalled bet ($0.02) returned to Gyapszi958
Gyapszi958 collected $0.04 from pot
Gyapszi958: doesn't show hand 
*** SUMMARY ***
Total pot $0.04 | Rake $0 
Seat 1: arrow17 (button) folded before Flop (didn't bet)
Seat 2: Gyapszi958 (small blind) collected ($0.04)
Seat 3: Scaaalll (big blind) folded before Flop
Seat 4: meikoz folded before Flop (didn't bet)
Seat 5: Sinad1302 folded before Flop (didn't bet)
Seat 6: AlexGTPS folded before Flop (didn't bet)



PokerStars Zoom Hand #229231173714:  Hold'em No Limit ($0.01/$0.02) - 2021/08/21 22:04:43 CET [2021/08/21 16:04:43 ET]
Table 'Halley' 6-max Seat #1 is the button
Seat 1: Slirey ($2.90 in chips) 
Seat 2: smileakafray ($4.44 in chips) 
Seat 3: guntren.ps ($2 in chips) 
Seat 4: Scaaalll ($2 in chips) 
Seat 5: Mikeloko182 ($2 in chips) 
Seat 6: XHerrTUMNUSX ($8.10 in chips) 
smileakafray: posts small blind $0.01
guntren.ps: posts big blind $0.02
*** HOLE CARDS ***
Dealt to Scaaalll [Ad Th]
Slirey is disconnected 
Scaaalll: folds 
Mikeloko182: folds 
XHerrTUMNUSX: raises $0.03 to $0.05
Slirey: folds 
smileakafray: folds 
guntren.ps: calls $0.03
*** FLOP *** [Qc 4c Jh]
guntren.ps: checks 
XHerrTUMNUSX: bets $0.08
guntren.ps: folds 
Uncalled bet ($0.08) returned to XHerrTUMNUSX
XHerrTUMNUSX collected $0.11 from pot
XHerrTUMNUSX: doesn't show hand 
*** SUMMARY ***
Total pot $0.11 | Rake $0 
Board [Qc 4c Jh]
Seat 1: Slirey (button) folded before Flop (didn't bet)
Seat 2: smileakafray (small blind) folded before Flop
Seat 3: guntren.ps (big blind) folded on the Flop
Seat 4: Scaaalll folded before Flop (didn't bet)
Seat 5: Mikeloko182 folded before Flop (didn't bet)
Seat 6: XHerrTUMNUSX collected ($0.11)



PokerStars Zoom Hand #229231186588:  Hold'em No Limit ($0.01/$0.02) - 2021/08/21 22:05:12 CET [2021/08/21 16:05:12 ET]
Table 'Halley' 6-max Seat #1 is the button
Seat 1: Scaaalll ($2 in chips) 
Seat 2: DaBaDaBaDooo ($2.04 in chips) 
Seat 3: FicheroQuit ($3.24 in chips) 
Seat 4: H0mmer99 ($2.75 in chips) 
Seat 5: Chapaev136 ($3.92 in chips) 
Seat 6: lucksuckdonk ($2.29 in chips) 
DaBaDaBaDooo: posts small blind $0.01
FicheroQuit: posts big blind $0.02
*** HOLE CARDS ***
Dealt to Scaaalll [Jd Tc]
H0mmer99: folds 
Chapaev136: folds 
lucksuckdonk: folds 
Scaaalll: raises $0.02 to $0.04
DaBaDaBaDooo: raises $0.12 to $0.16
FicheroQuit: folds 
Scaaalll: folds 
Uncalled bet ($0.12) returned to DaBaDaBaDooo
DaBaDaBaDooo collected $0.10 from pot
DaBaDaBaDooo: doesn't show hand 
*** SUMMARY ***
Total pot $0.10 | Rake $0 
Seat 1: Scaaalll (button) folded before Flop
Seat 2: DaBaDaBaDooo (small blind) collected ($0.10)
Seat 3: FicheroQuit (big blind) folded before Flop
Seat 4: H0mmer99 folded before Flop (didn't bet)
Seat 5: Chapaev136 folded before Flop (didn't bet)
Seat 6: lucksuckdonk folded before Flop (didn't bet)



PokerStars Zoom Hand #229231196261:  Hold'em No Limit ($0.01/$0.02) - 2021/08/21 22:05:34 CET [2021/08/21 16:05:34 ET]
Table 'Halley' 6-max Seat #1 is the button
Seat 1: nabro03 ($1.20 in chips) 
Seat 2: Blaackie ($2.24 in chips) 
Seat 3: Mikeloko182 ($2.08 in chips) 
Seat 4: maliniak75 ($0.90 in chips) 
Seat 5: zergmiky ($2.02 in chips) 
Seat 6: Scaaalll ($2 in chips) 
Blaackie: posts small blind $0.01
Mikeloko182: posts big blind $0.02
*** HOLE CARDS ***
Dealt to Scaaalll [Ah 6s]
maliniak75: folds 
zergmiky: folds 
Scaaalll: folds 
nabro03: raises $0.05 to $0.07
Blaackie: folds 
Mikeloko182: folds 
Uncalled bet ($0.05) returned to nabro03
nabro03 collected $0.05 from pot
nabro03: doesn't show hand 
*** SUMMARY ***
Total pot $0.05 | Rake $0 
Seat 1: nabro03 (button) collected ($0.05)
Seat 2: Blaackie (small blind) folded before Flop
Seat 3: Mikeloko182 (big blind) folded before Flop
Seat 4: maliniak75 folded before Flop (didn't bet)
Seat 5: zergmiky folded before Flop (didn't bet)
Seat 6: Scaaalll folded before Flop (didn't bet)



PokerStars Zoom Hand #229231201157:  Hold'em No Limit ($0.01/$0.02) - 2021/08/21 22:05:45 CET [2021/08/21 16:05:45 ET]
Table 'Halley' 6-max Seat #1 is the button
Seat 1: Matias Jesus N ($0.80 in chips) 
Seat 2: Scaaalll ($2 in chips) 
Seat 3: usenovm ($1.15 in chips) 
Seat 4: japoneis mt ($2.47 in chips) 
Seat 5: mrfastflow ($2.04 in chips) 
Seat 6: blillad ($2 in chips) 
Scaaalll: posts small blind $0.01
usenovm: posts big blind $0.02
*** HOLE CARDS ***
Dealt to Scaaalll [7c 6h]
japoneis mt: raises $0.02 to $0.04
mrfastflow: folds 
blillad: calls $0.04
Matias Jesus N: raises $0.76 to $0.80 and is all-in
Scaaalll: folds 
usenovm: folds 
japoneis mt: folds 
japoneis mt is disconnected 
blillad: folds 
Uncalled bet ($0.76) returned to Matias Jesus N
Matias Jesus N collected $0.15 from pot
Matias Jesus N: doesn't show hand 
*** SUMMARY ***
Total pot $0.15 | Rake $0 
Seat 1: Matias Jesus N (button) collected ($0.15)
Seat 2: Scaaalll (small blind) folded before Flop
Seat 3: usenovm (big blind) folded before Flop
Seat 4: japoneis mt folded before Flop
Seat 5: mrfastflow folded before Flop (didn't bet)
Seat 6: blillad folded before Flop



PokerStars Zoom Hand #229231202926:  Hold'em No Limit ($0.01/$0.02) - 2021/08/21 22:05:49 CET [2021/08/21 16:05:49 ET]
Table 'Halley' 6-max Seat #1 is the button
Seat 1: EevAA190 ($2.57 in chips) 
Seat 2: nV6TR ($1.19 in chips) 
Seat 3: EmperorKurr ($2.22 in chips) 
Seat 4: Treadero ($1.94 in chips) 
Seat 5: Scaaalll ($2 in chips) 
Seat 6: zbixxx ($3.31 in chips) 
nV6TR: posts small blind $0.01
EmperorKurr: posts big blind $0.02
*** HOLE CARDS ***
Dealt to Scaaalll [Ah 6h]
Treadero: raises $0.02 to $0.04
Scaaalll: folds 
zbixxx: folds 
EevAA190: folds 
nV6TR: calls $0.03
EmperorKurr: folds 
*** FLOP *** [Kh 2d 2c]
nV6TR: checks 
Treadero: bets $0.05
nV6TR: folds 
Uncalled bet ($0.05) returned to Treadero
Treadero collected $0.10 from pot
Treadero: doesn't show hand 
*** SUMMARY ***
Total pot $0.10 | Rake $0 
Board [Kh 2d 2c]
Seat 1: EevAA190 (button) folded before Flop (didn't bet)
Seat 2: nV6TR (small blind) folded on the Flop
Seat 3: EmperorKurr (big blind) folded before Flop
Seat 4: Treadero collected ($0.10)
Seat 5: Scaaalll folded before Flop (didn't bet)
Seat 6: zbixxx folded before Flop (didn't bet)



PokerStars Zoom Hand #229231218546:  Hold'em No Limit ($0.01/$0.02) - 2021/08/21 22:06:24 CET [2021/08/21 16:06:24 ET]
Table 'Halley' 6-max Seat #1 is the button
Seat 1: Scaaalll ($2 in chips) 
Seat 2: Koldun 2636 ($2.89 in chips) 
Seat 3: hubertott ($1.99 in chips) 
Seat 4: ash1448 ($3.50 in chips) 
Seat 5: ADWish ($1.43 in chips) 
Seat 6: so0love ($2.01 in chips) 
Koldun 2636: posts small blind $0.01
hubertott: posts big blind $0.02
*** HOLE CARDS ***
Dealt to Scaaalll [Ts 7s]
ash1448: folds 
ADWish: folds 
so0love: folds 
Scaaalll: raises $0.02 to $0.04
Koldun 2636: folds 
hubertott: folds 
Uncalled bet ($0.02) returned to Scaaalll
Scaaalll collected $0.05 from pot
Scaaalll: doesn't show hand 
*** SUMMARY ***
Total pot $0.05 | Rake $0 
Seat 1: Scaaalll (button) collected ($0.05)
Seat 2: Koldun 2636 (small blind) folded before Flop
Seat 3: hubertott (big blind) folded before Flop
Seat 4: ash1448 folded before Flop (didn't bet)
Seat 5: ADWish folded before Flop (didn't bet)
Seat 6: so0love folded before Flop (didn't bet)



PokerStars Zoom Hand #229231206025:  Hold'em No Limit ($0.01/$0.02) - 2021/08/21 22:05:56 CET [2021/08/21 16:05:56 ET]
Table 'Halley' 6-max Seat #1 is the button
Seat 1: ser313131 ($2.03 in chips) 
Seat 2: Nihility77 ($5.12 in chips) 
Seat 3: Scaaalll ($2 in chips) 
Seat 4: emyliver ($1.91 in chips) 
Seat 5: lucksuckdonk ($3.35 in chips) 
Seat 6: SaRCh_Ale ($2.20 in chips) 
Nihility77: posts small blind $0.01
Scaaalll: posts big blind $0.02
*** HOLE CARDS ***
Dealt to Scaaalll [5s 7s]
emyliver: raises $0.02 to $0.04
lucksuckdonk: folds 
SaRCh_Ale: folds 
ser313131: calls $0.04
Nihility77: folds 
Scaaalll: calls $0.02
*** FLOP *** [8c 3s 8d]
Scaaalll: checks 
emyliver: bets $0.02
ser313131: calls $0.02
Scaaalll: folds 
*** TURN *** [8c 3s 8d] [Qd]
emyliver: bets $0.02
ser313131: calls $0.02
*** RIVER *** [8c 3s 8d Qd] [3d]
emyliver: bets $0.10
ser313131: folds 
Uncalled bet ($0.10) returned to emyliver
emyliver collected $0.20 from pot
emyliver: doesn't show hand 
*** SUMMARY ***
Total pot $0.21 | Rake $0.01 
Board [8c 3s 8d Qd 3d]
Seat 1: ser313131 (button) folded on the River
Seat 2: Nihility77 (small blind) folded before Flop
Seat 3: Scaaalll (big blind) folded on the Flop
Seat 4: emyliver collected ($0.20)
Seat 5: lucksuckdonk folded before Flop (didn't bet)
Seat 6: SaRCh_Ale folded before Flop (didn't bet)



PokerStars Zoom Hand #229231226149:  Hold'em No Limit ($0.01/$0.02) - 2021/08/21 22:06:41 CET [2021/08/21 16:06:41 ET]
Table 'Halley' 6-max Seat #1 is the button
Seat 1: Koldun 2636 ($2.35 in chips) 
Seat 2: Oprichnick90 ($4.19 in chips) 
Seat 3: byakuda ($4.28 in chips) 
Seat 4: LyahovIvan ($0.44 in chips) 
Seat 5: caiolima99 ($5.40 in chips) 
Seat 6: Scaaalll ($2.03 in chips) 
Oprichnick90: posts small blind $0.01
byakuda: posts big blind $0.02
*** HOLE CARDS ***
Dealt to Scaaalll [8c Kc]
LyahovIvan: folds 
caiolima99: raises $0.04 to $0.06
Scaaalll: folds 
Koldun 2636: folds 
Oprichnick90: folds 
byakuda: folds 
Uncalled bet ($0.04) returned to caiolima99
caiolima99 collected $0.05 from pot
caiolima99: doesn't show hand 
*** SUMMARY ***
Total pot $0.05 | Rake $0 
Seat 1: Koldun 2636 (button) folded before Flop (didn't bet)
Seat 2: Oprichnick90 (small blind) folded before Flop
Seat 3: byakuda (big blind) folded before Flop
Seat 4: LyahovIvan folded before Flop (didn't bet)
Seat 5: caiolima99 collected ($0.05)
Seat 6: Scaaalll folded before Flop (didn't bet)



PokerStars Zoom Hand #229231232250:  Hold'em No Limit ($0.01/$0.02) - 2021/08/21 22:06:55 CET [2021/08/21 16:06:55 ET]
Table 'Halley' 6-max Seat #1 is the button
Seat 1: Kb013497 ($1.89 in chips) 
Seat 2: Scaaalll ($2.03 in chips) 
Seat 3: Alfmasterrr ($2 in chips) 
Seat 4: BlackhawKK's ($3.05 in chips) 
Seat 5: VasquezSancho96 ($4.91 in chips) 
Seat 6: Quad Jacks21 ($4.99 in chips) 
Scaaalll: posts small blind $0.01
Alfmasterrr: posts big blind $0.02
*** HOLE CARDS ***
Dealt to Scaaalll [Jd Td]
BlackhawKK's: folds 
VasquezSancho96: folds 
Quad Jacks21: folds 
Kb013497: folds 
Scaaalll: raises $0.04 to $0.06
Alfmasterrr: folds 
Uncalled bet ($0.04) returned to Scaaalll
Scaaalll collected $0.04 from pot
Scaaalll: doesn't show hand 
*** SUMMARY ***
Total pot $0.04 | Rake $0 
Seat 1: Kb013497 (button) folded before Flop (didn't bet)
Seat 2: Scaaalll (small blind) collected ($0.04)
Seat 3: Alfmasterrr (big blind) folded before Flop
Seat 4: BlackhawKK's folded before Flop (didn't bet)
Seat 5: VasquezSancho96 folded before Flop (didn't bet)
Seat 6: Quad Jacks21 folded before Flop (didn't bet)



PokerStars Zoom Hand #229231224349:  Hold'em No Limit ($0.01/$0.02) - 2021/08/21 22:06:37 CET [2021/08/21 16:06:37 ET]
Table 'Halley' 6-max Seat #1 is the button
Seat 1: PokemonK5 ($0.97 in chips) 
Seat 2: Shcherbak252 ($1.73 in chips) 
Seat 3: davidalejag ($2.25 in chips) 
Seat 4: Scaaalll ($2.03 in chips) 
Seat 5: jjjj135 ($1.03 in chips) 
Seat 6: bober2702 ($3.72 in chips) 
Shcherbak252: posts small blind $0.01
davidalejag: posts big blind $0.02
*** HOLE CARDS ***
Dealt to Scaaalll [8c 2c]
Scaaalll: folds 
jjjj135: raises $0.02 to $0.04
bober2702: folds 
PokemonK5: folds 
PokemonK5 is disconnected 
Shcherbak252: calls $0.03
davidalejag: folds 
*** FLOP *** [7d 2h 7c]
Shcherbak252: checks 
jjjj135: bets $0.10
Shcherbak252: raises $0.10 to $0.20
jjjj135: folds 
Uncalled bet ($0.10) returned to Shcherbak252
Shcherbak252 collected $0.29 from pot
Shcherbak252: doesn't show hand 
*** SUMMARY ***
Total pot $0.30 | Rake $0.01 
Board [7d 2h 7c]
Seat 1: PokemonK5 (button) folded before Flop (didn't bet)
Seat 2: Shcherbak252 (small blind) collected ($0.29)
Seat 3: davidalejag (big blind) folded before Flop
Seat 4: Scaaalll folded before Flop (didn't bet)
Seat 5: jjjj135 folded on the Flop
Seat 6: bober2702 folded before Flop (didn't bet)



PokerStars Zoom Hand #229231239805:  Hold'em No Limit ($0.01/$0.02) - 2021/08/21 22:07:12 CET [2021/08/21 16:07:12 ET]
Table 'Halley' 6-max Seat #1 is the button
Seat 1: meikoz ($4.76 in chips) 
Seat 2: Chupacabra G ($1.88 in chips) 
Seat 3: MsMars777 ($2.03 in chips) 
Seat 4: Scaaalll ($2.05 in chips) 
Seat 5: IamFixxed ($2.44 in chips) 
Seat 6: strigoii7777 ($2.03 in chips) 
Chupacabra G: posts small blind $0.01
MsMars777: posts big blind $0.02
*** HOLE CARDS ***
Dealt to Scaaalll [Kd Qs]
Scaaalll: raises $0.04 to $0.06
IamFixxed: folds 
strigoii7777: raises $1.97 to $2.03 and is all-in
meikoz: folds 
Chupacabra G: folds 
MsMars777: folds 
Scaaalll: folds 
Uncalled bet ($1.97) returned to strigoii7777
strigoii7777 collected $0.15 from pot
strigoii7777: doesn't show hand 
*** SUMMARY ***
Total pot $0.15 | Rake $0 
Seat 1: meikoz (button) folded before Flop (didn't bet)
Seat 2: Chupacabra G (small blind) folded before Flop
Seat 3: MsMars777 (big blind) folded before Flop
Seat 4: Scaaalll folded before Flop
Seat 5: IamFixxed folded before Flop (didn't bet)
Seat 6: strigoii7777 collected ($0.15)



PokerStars Zoom Hand #229231248217:  Hold'em No Limit ($0.01/$0.02) - 2021/08/21 22:07:31 CET [2021/08/21 16:07:31 ET]
Table 'Halley' 6-max Seat #1 is the button
Seat 1: pokershevela ($1.94 in chips) 
Seat 2: BriceDo1917 ($1.72 in chips) 
Seat 3: tazar34_777 ($2.26 in chips) 
Seat 4: bananAAbandit ($4.03 in chips) 
Seat 5: Plmax94 ($0.98 in chips) 
Seat 6: Scaaalll ($2 in chips) 
BriceDo1917: posts small blind $0.01
tazar34_777: posts big blind $0.02
*** HOLE CARDS ***
Dealt to Scaaalll [9d 8d]
bananAAbandit: folds 
BriceDo1917 is disconnected 
pokershevela is disconnected 
Plmax94: raises $0.04 to $0.06
Scaaalll: calls $0.06
pokershevela: folds 
BriceDo1917: folds 
tazar34_777: folds 
*** FLOP *** [2c 4c Js]
Plmax94: bets $0.11
Scaaalll: folds 
Uncalled bet ($0.11) returned to Plmax94
Plmax94 collected $0.14 from pot
Plmax94: doesn't show hand 
*** SUMMARY ***
Total pot $0.15 | Rake $0.01 
Board [2c 4c Js]
Seat 1: pokershevela (button) folded before Flop (didn't bet)
Seat 2: BriceDo1917 (small blind) folded before Flop
Seat 3: tazar34_777 (big blind) folded before Flop
Seat 4: bananAAbandit folded before Flop (didn't bet)
Seat 5: Plmax94 collected ($0.14)
Seat 6: Scaaalll folded on the Flop



PokerStars Zoom Hand #229231266808:  Hold'em No Limit ($0.01/$0.02) - 2021/08/21 22:08:13 CET [2021/08/21 16:08:13 ET]
Table 'Halley' 6-max Seat #1 is the button
Seat 1: Ramirres ($2.42 in chips) 
Seat 2: Plmax94 ($1.07 in chips) 
Seat 3: olcham7 ($3.32 in chips) 
Seat 4: HellNative ($2.05 in chips) 
Seat 5: Scaaalll ($2 in chips) 
Seat 6: py100ta ($16.10 in chips) 
Plmax94: posts small blind $0.01
olcham7: posts big blind $0.02
*** HOLE CARDS ***
Dealt to Scaaalll [Jc Qd]
HellNative: folds 
Scaaalll: raises $0.04 to $0.06
py100ta: folds 
Ramirres: folds 
Plmax94: calls $0.05
olcham7: folds 
*** FLOP *** [Ah 7h 2s]
Plmax94: checks 
Scaaalll: bets $0.08
Plmax94: folds 
Uncalled bet ($0.08) returned to Scaaalll
Scaaalll collected $0.14 from pot
Scaaalll: doesn't show hand 
*** SUMMARY ***
Total pot $0.14 | Rake $0 
Board [Ah 7h 2s]
Seat 1: Ramirres (button) folded before Flop (didn't bet)
Seat 2: Plmax94 (small blind) folded on the Flop
Seat 3: olcham7 (big blind) folded before Flop
Seat 4: HellNative folded before Flop (didn't bet)
Seat 5: Scaaalll collected ($0.14)
Seat 6: py100ta folded before Flop (didn't bet)



PokerStars Zoom Hand #229231265036:  Hold'em No Limit ($0.01/$0.02) - 2021/08/21 22:08:09 CET [2021/08/21 16:08:09 ET]
Table 'Halley' 6-max Seat #1 is the button
Seat 1: Scaaalll ($2 in chips) 
Seat 2: pipecmolodec ($2.05 in chips) 
Seat 3: meikoz ($2.08 in chips) 
Seat 4: amario89 ($5.58 in chips) 
Seat 5: dinoVIEIRA ($2.66 in chips) 
Seat 6: Mikalai M. ($0.22 in chips) 
pipecmolodec: posts small blind $0.01
meikoz: posts big blind $0.02
*** HOLE CARDS ***
Dealt to Scaaalll [Kd 2h]
amario89: folds 
dinoVIEIRA: folds 
Mikalai M.: calls $0.02
Scaaalll: folds 
pipecmolodec: raises $0.07 to $0.09
meikoz: folds 
Mikalai M.: calls $0.07
*** FLOP *** [4d 3c 7c]
pipecmolodec: bets $0.17
Mikalai M.: calls $0.13 and is all-in
Uncalled bet ($0.04) returned to pipecmolodec
*** TURN *** [4d 3c 7c] [Ks]
*** RIVER *** [4d 3c 7c Ks] [Jc]
*** SHOW DOWN ***
pipecmolodec: shows [Qh Ah] (high card Ace)
Mikalai M.: shows [Jh As] (a pair of Jacks)
Mikalai M. collected $0.44 from pot
*** SUMMARY ***
Total pot $0.46 | Rake $0.02 
Board [4d 3c 7c Ks Jc]
Seat 1: Scaaalll (button) folded before Flop (didn't bet)
Seat 2: pipecmolodec (small blind) showed [Qh Ah] and lost with high card Ace
Seat 3: meikoz (big blind) folded before Flop
Seat 4: amario89 folded before Flop (didn't bet)
Seat 5: dinoVIEIRA folded before Flop (didn't bet)
Seat 6: Mikalai M. showed [Jh As] and won ($0.44) with a pair of Jacks



PokerStars Zoom Hand #229231255753:  Hold'em No Limit ($0.01/$0.02) - 2021/08/21 22:07:48 CET [2021/08/21 16:07:48 ET]
Table 'Halley' 6-max Seat #1 is the button
Seat 1: tomsa01 ($1.85 in chips) 
Seat 2: feybys ($3.27 in chips) 
Seat 3: Scaaalll ($2 in chips) 
Seat 4: brasilroger ($0.49 in chips) 
Seat 5: XHerrTUMNUSX ($8 in chips) 
Seat 6: Player XVII ($1.94 in chips) 
feybys: posts small blind $0.01
Scaaalll: posts big blind $0.02
*** HOLE CARDS ***
Dealt to Scaaalll [Ts 5s]
tomsa01 is disconnected 
brasilroger: raises $0.02 to $0.04
XHerrTUMNUSX: calls $0.04
Player XVII: folds 
tomsa01: folds 
feybys: raises $0.18 to $0.22
Scaaalll: folds 
brasilroger: calls $0.18
XHerrTUMNUSX: calls $0.18
*** FLOP *** [Jh 7c 5d]
feybys: checks 
brasilroger: checks 
XHerrTUMNUSX: checks 
*** TURN *** [Jh 7c 5d] [Kc]
feybys: checks 
brasilroger: bets $0.27 and is all-in
XHerrTUMNUSX: calls $0.27
feybys: folds 
*** RIVER *** [Jh 7c 5d Kc] [Js]
*** SHOW DOWN ***
brasilroger: shows [6c 8c] (a pair of Jacks)
XHerrTUMNUSX: shows [Kh Qc] (two pair, Kings and Jacks)
XHerrTUMNUSX cashed out the hand for $0.79 | Cash Out Fee $0.01
*** SUMMARY ***
Total pot $1.22 | Rake $0.04 
Board [Jh 7c 5d Kc Js]
Seat 1: tomsa01 (button) folded before Flop (didn't bet)
Seat 2: feybys (small blind) folded on the Turn
Seat 3: Scaaalll (big blind) folded before Flop
Seat 4: brasilroger showed [6c 8c] and lost with a pair of Jacks
Seat 5: XHerrTUMNUSX showed [Kh Qc] and won ($1.18) with two pair, Kings and Jacks (pot not awarded as player cashed out)
Seat 6: Player XVII folded before Flop (didn't bet)



PokerStars Zoom Hand #229231286629:  Hold'em No Limit ($0.01/$0.02) - 2021/08/21 22:08:58 CET [2021/08/21 16:08:58 ET]
Table 'Halley' 6-max Seat #1 is the button
Seat 1: Iwanb4 ($2.01 in chips) 
Seat 2: usenovm ($1 in chips) 
Seat 3: Tacojesuscrisp ($2 in chips) 
Seat 4: le_vlimeux ($2.58 in chips) 
Seat 5: FabOliveira9 ($5.03 in chips) 
Seat 6: Scaaalll ($2.07 in chips) 
usenovm: posts small blind $0.01
Tacojesuscrisp: posts big blind $0.02
*** HOLE CARDS ***
Dealt to Scaaalll [Th 7h]
le_vlimeux: folds 
FabOliveira9: folds 
Scaaalll: folds 
Iwanb4: folds 
usenovm: folds 
Uncalled bet ($0.01) returned to Tacojesuscrisp
Tacojesuscrisp collected $0.02 from pot
Tacojesuscrisp: doesn't show hand 
*** SUMMARY ***
Total pot $0.02 | Rake $0 
Seat 1: Iwanb4 (button) folded before Flop (didn't bet)
Seat 2: usenovm (small blind) folded before Flop
Seat 3: Tacojesuscrisp (big blind) collected ($0.02)
Seat 4: le_vlimeux folded before Flop (didn't bet)
Seat 5: FabOliveira9 folded before Flop (didn't bet)
Seat 6: Scaaalll folded before Flop (didn't bet)



PokerStars Zoom Hand #229231279657:  Hold'em No Limit ($0.01/$0.02) - 2021/08/21 22:08:42 CET [2021/08/21 16:08:42 ET]
Table 'Halley' 6-max Seat #1 is the button
Seat 1: NecromiconP ($4.11 in chips) 
Seat 2: Scaaalll ($2.08 in chips) 
Seat 3: sal_sagev41 ($2 in chips) 
Seat 4: ca$hmeoutsid ($3.50 in chips) 
Seat 5: gds2003 ($1.26 in chips) 
Seat 6: Tj741 ($2 in chips) 
Scaaalll: posts small blind $0.01
sal_sagev41: posts big blind $0.02
*** HOLE CARDS ***
Dealt to Scaaalll [2d Qd]
ca$hmeoutsid: folds 
gds2003: calls $0.02
Tj741: raises $0.02 to $0.04
NecromiconP: folds 
Scaaalll: folds 
sal_sagev41: folds 
gds2003: calls $0.02
*** FLOP *** [6d 9s 7s]
gds2003: checks 
Tj741: checks 
*** TURN *** [6d 9s 7s] [Kd]
gds2003: checks 
Tj741: bets $0.08
gds2003: calls $0.08
*** RIVER *** [6d 9s 7s Kd] [7c]
gds2003: checks 
Tj741: bets $0.18
gds2003: calls $0.18
*** SHOW DOWN ***
Tj741: shows [Ad Qs] (a pair of Sevens)
gds2003: shows [Kh Td] (two pair, Kings and Sevens)
gds2003 collected $0.61 from pot
*** SUMMARY ***
Total pot $0.63 | Rake $0.02 
Board [6d 9s 7s Kd 7c]
Seat 1: NecromiconP (button) folded before Flop (didn't bet)
Seat 2: Scaaalll (small blind) folded before Flop
Seat 3: sal_sagev41 (big blind) folded before Flop
Seat 4: ca$hmeoutsid folded before Flop (didn't bet)
Seat 5: gds2003 showed [Kh Td] and won ($0.61) with two pair, Kings and Sevens
Seat 6: Tj741 showed [Ad Qs] and lost with a pair of Sevens



PokerStars Zoom Hand #229231282666:  Hold'em No Limit ($0.01/$0.02) - 2021/08/21 22:08:49 CET [2021/08/21 16:08:49 ET]
Table 'Halley' 6-max Seat #1 is the button
Seat 1: mrfastflow ($2.51 in chips) 
Seat 2: Diegor1924 ($2.18 in chips) 
Seat 3: Fanatspartak ($0.94 in chips) 
Seat 4: tcl4l ($0.98 in chips) 
Seat 5: Scaaalll ($2.07 in chips) 
Seat 6: rodrigoasor ($1.08 in chips) 
Diegor1924: posts small blind $0.01
Fanatspartak: posts big blind $0.02
*** HOLE CARDS ***
Dealt to Scaaalll [8d 7s]
tcl4l: calls $0.02
Scaaalll: folds 
rodrigoasor: folds 
mrfastflow: folds 
Diegor1924: raises $0.03 to $0.05
Fanatspartak: folds 
tcl4l: calls $0.03
*** FLOP *** [Kd Kc 6h]
Diegor1924: bets $0.04
tcl4l: folds 
Uncalled bet ($0.04) returned to Diegor1924
Diegor1924 collected $0.12 from pot
Diegor1924: doesn't show hand 
tcl4l is disconnected 
*** SUMMARY ***
Total pot $0.12 | Rake $0 
Board [Kd Kc 6h]
Seat 1: mrfastflow (button) folded before Flop (didn't bet)
Seat 2: Diegor1924 (small blind) collected ($0.12)
Seat 3: Fanatspartak (big blind) folded before Flop
Seat 4: tcl4l folded on the Flop
Seat 5: Scaaalll folded before Flop (didn't bet)
Seat 6: rodrigoasor folded before Flop (didn't bet)



PokerStars Zoom Hand #229231284847:  Hold'em No Limit ($0.01/$0.02) - 2021/08/21 22:08:54 CET [2021/08/21 16:08:54 ET]
Table 'Halley' 6-max Seat #1 is the button
Seat 1: bober2702 ($3.70 in chips) 
Seat 2: Han_Solo_71 ($1.36 in chips) 
Seat 3: RaulacateFolds ($2.19 in chips) 
Seat 4: Scaaalll ($2.07 in chips) 
Seat 5: EstiBan18 ($2.17 in chips) 
Seat 6: Vanekakqj ($1.09 in chips) 
Han_Solo_71: posts small blind $0.01
RaulacateFolds: posts big blind $0.02
*** HOLE CARDS ***
Dealt to Scaaalll [Qc 5c]
Scaaalll: folds 
EstiBan18: folds 
Vanekakqj: folds 
bober2702: folds 
Han_Solo_71: calls $0.01
RaulacateFolds: checks 
*** FLOP *** [4c Qh 2d]
Han_Solo_71: checks 
RaulacateFolds: checks 
*** TURN *** [4c Qh 2d] [9s]
Han_Solo_71: bets $0.02
RaulacateFolds: folds 
Uncalled bet ($0.02) returned to Han_Solo_71
Han_Solo_71 collected $0.04 from pot
Han_Solo_71: doesn't show hand 
*** SUMMARY ***
Total pot $0.04 | Rake $0 
Board [4c Qh 2d 9s]
Seat 1: bober2702 (button) folded before Flop (didn't bet)
Seat 2: Han_Solo_71 (small blind) collected ($0.04)
Seat 3: RaulacateFolds (big blind) folded on the Turn
Seat 4: Scaaalll folded before Flop (didn't bet)
Seat 5: EstiBan18 folded before Flop (didn't bet)
Seat 6: Vanekakqj folded before Flop (didn't bet)



PokerStars Zoom Hand #229231294845:  Hold'em No Limit ($0.01/$0.02) - 2021/08/21 22:09:17 CET [2021/08/21 16:09:17 ET]
Table 'Halley' 6-max Seat #1 is the button
Seat 1: Scaaalll ($2.05 in chips) 
Seat 2: Healthys07 ($5.04 in chips) 
Seat 3: Kb013497 ($6.59 in chips) 
Seat 4: py100ta ($16.19 in chips) 
Seat 5: ZunderSS ($3.64 in chips) 
Seat 6: Ne0net ($2.55 in chips) 
Healthys07: posts small blind $0.01
Kb013497: posts big blind $0.02
*** HOLE CARDS ***
Dealt to Scaaalll [9d 5d]
py100ta: raises $0.04 to $0.06
ZunderSS: raises $0.15 to $0.21
Ne0net: folds 
Scaaalll: folds 
Healthys07: folds 
Kb013497: folds 
py100ta: calls $0.15
*** FLOP *** [Th Qs 4c]
py100ta: checks 
ZunderSS: bets $0.22
py100ta: folds 
Uncalled bet ($0.22) returned to ZunderSS
ZunderSS collected $0.43 from pot
ZunderSS: doesn't show hand 
*** SUMMARY ***
Total pot $0.45 | Rake $0.02 
Board [Th Qs 4c]
Seat 1: Scaaalll (button) folded before Flop (didn't bet)
Seat 2: Healthys07 (small blind) folded before Flop
Seat 3: Kb013497 (big blind) folded before Flop
Seat 4: py100ta folded on the Flop
Seat 5: ZunderSS collected ($0.43)
Seat 6: Ne0net folded before Flop (didn't bet)



PokerStars Zoom Hand #229231301112:  Hold'em No Limit ($0.01/$0.02) - 2021/08/21 22:09:31 CET [2021/08/21 16:09:31 ET]
Table 'Halley' 6-max Seat #1 is the button
Seat 1: amario89 ($2.35 in chips) 
Seat 2: Sergant20081 ($3.47 in chips) 
Seat 3: skitai555 ($1.93 in chips) 
Seat 4: Scaaalll ($2.05 in chips) 
Seat 5: meikoz ($2 in chips) 
Seat 6: Jujiluju ($1.19 in chips) 
Sergant20081: posts small blind $0.01
skitai555: posts big blind $0.02
*** HOLE CARDS ***
Dealt to Scaaalll [4c 3s]
Scaaalll: folds 
meikoz: folds 
Jujiluju: folds 
amario89: folds 
Sergant20081: folds 
Uncalled bet ($0.01) returned to skitai555
skitai555 collected $0.02 from pot
skitai555: doesn't show hand 
*** SUMMARY ***
Total pot $0.02 | Rake $0 
Seat 1: amario89 (button) folded before Flop (didn't bet)
Seat 2: Sergant20081 (small blind) folded before Flop
Seat 3: skitai555 (big blind) collected ($0.02)
Seat 4: Scaaalll folded before Flop (didn't bet)
Seat 5: meikoz folded before Flop (didn't bet)
Seat 6: Jujiluju folded before Flop (didn't bet)



PokerStars Zoom Hand #229231288771:  Hold'em No Limit ($0.01/$0.02) - 2021/08/21 22:09:03 CET [2021/08/21 16:09:03 ET]
Table 'Halley' 6-max Seat #1 is the button
Seat 1: Baksit79 ($0.16 in chips) 
Seat 2: KatedratiK ($1.95 in chips) 
Seat 3: Scaaalll ($2.07 in chips) 
Seat 4: Padde68 ($3.25 in chips) 
Seat 5: ADWish ($1.35 in chips) 
Seat 6: AlexGTPS ($3.30 in chips) 
KatedratiK: posts small blind $0.01
Scaaalll: posts big blind $0.02
*** HOLE CARDS ***
Dealt to Scaaalll [Qs 6d]
Padde68: calls $0.02
ADWish: folds 
AlexGTPS: raises $0.07 to $0.09
Baksit79 has timed out
Baksit79: folds 
KatedratiK: folds 
Scaaalll: folds 
Baksit79 is disconnected 
Padde68: calls $0.07
*** FLOP *** [4d Ac 8h]
Padde68: checks 
AlexGTPS: bets $0.10
Padde68: folds 
Uncalled bet ($0.10) returned to AlexGTPS
AlexGTPS collected $0.20 from pot
AlexGTPS: doesn't show hand 
Padde68 is disconnected 
*** SUMMARY ***
Total pot $0.21 | Rake $0.01 
Board [4d Ac 8h]
Seat 1: Baksit79 (button) folded before Flop (didn't bet)
Seat 2: KatedratiK (small blind) folded before Flop
Seat 3: Scaaalll (big blind) folded before Flop
Seat 4: Padde68 folded on the Flop
Seat 5: ADWish folded before Flop (didn't bet)
Seat 6: AlexGTPS collected ($0.20)



PokerStars Zoom Hand #229231302827:  Hold'em No Limit ($0.01/$0.02) - 2021/08/21 22:09:35 CET [2021/08/21 16:09:35 ET]
Table 'Halley' 6-max Seat #1 is the button
Seat 1: FabOliveira9 ($3.50 in chips) 
Seat 2: Allexii ($2.24 in chips) 
Seat 3: Manager2414 ($1.64 in chips) 
Seat 4: LucasG155 ($2.56 in chips) 
Seat 5: Scaaalll ($2.05 in chips) 
Seat 6: bananAAbandit ($2.74 in chips) 
Allexii: posts small blind $0.01
Manager2414: posts big blind $0.02
*** HOLE CARDS ***
Dealt to Scaaalll [2s 5h]
LucasG155: folds 
Scaaalll: folds 
bananAAbandit: folds 
FabOliveira9: raises $0.03 to $0.05
Allexii: calls $0.04
Manager2414: folds 
*** FLOP *** [Qc 7s 3s]
Allexii: checks 
FabOliveira9: bets $0.06
Allexii: folds 
Uncalled bet ($0.06) returned to FabOliveira9
FabOliveira9 collected $0.12 from pot
FabOliveira9: doesn't show hand 
Allexii is disconnected 
*** SUMMARY ***
Total pot $0.12 | Rake $0 
Board [Qc 7s 3s]
Seat 1: FabOliveira9 (button) collected ($0.12)
Seat 2: Allexii (small blind) folded on the Flop
Seat 3: Manager2414 (big blind) folded before Flop
Seat 4: LucasG155 folded before Flop (didn't bet)
Seat 5: Scaaalll folded before Flop (didn't bet)
Seat 6: bananAAbandit folded before Flop (didn't bet)



PokerStars Zoom Hand #229231305947:  Hold'em No Limit ($0.01/$0.02) - 2021/08/21 22:09:42 CET [2021/08/21 16:09:42 ET]
Table 'Halley' 6-max Seat #1 is the button
Seat 1: IceTdannyB ($2.35 in chips) 
Seat 2: Scaaalll ($2.05 in chips) 
Seat 3: CowboyNicky ($1.93 in chips) 
Seat 4: Kb013497 ($6.57 in chips) 
Seat 5: teutonknight ($3.80 in chips) 
Seat 6: LuckyCheewey ($2.42 in chips) 
Scaaalll: posts small blind $0.01
CowboyNicky: posts big blind $0.02
*** HOLE CARDS ***
Dealt to Scaaalll [Jh Kd]
IceTdannyB is disconnected 
Kb013497: folds 
teutonknight: calls $0.02
LuckyCheewey: folds 
IceTdannyB: folds 
Scaaalll: calls $0.01
CowboyNicky: checks 
*** FLOP *** [Tc 4h Ad]
Scaaalll: checks 
CowboyNicky: checks 
teutonknight: checks 
*** TURN *** [Tc 4h Ad] [Qs]
Scaaalll: bets $0.06
CowboyNicky: folds 
CowboyNicky is disconnected 
teutonknight: folds 
Uncalled bet ($0.06) returned to Scaaalll
Scaaalll collected $0.06 from pot
Scaaalll: doesn't show hand 
*** SUMMARY ***
Total pot $0.06 | Rake $0 
Board [Tc 4h Ad Qs]
Seat 1: IceTdannyB (button) folded before Flop (didn't bet)
Seat 2: Scaaalll (small blind) collected ($0.06)
Seat 3: CowboyNicky (big blind) folded on the Turn
Seat 4: Kb013497 folded before Flop (didn't bet)
Seat 5: teutonknight folded on the Turn
Seat 6: LuckyCheewey folded before Flop (didn't bet)



PokerStars Zoom Hand #229231320529:  Hold'em No Limit ($0.01/$0.02) - 2021/08/21 22:10:15 CET [2021/08/21 16:10:15 ET]
Table 'Halley' 6-max Seat #1 is the button
Seat 1: HellNative ($3.74 in chips) 
Seat 2: le_vlimeux ($2.61 in chips) 
Seat 3: EevAA190 ($2 in chips) 
Seat 4: malandro733 ($2.11 in chips) 
Seat 5: GiordanoBrn ($2.25 in chips) 
Seat 6: Scaaalll ($2.09 in chips) 
le_vlimeux: posts small blind $0.01
EevAA190: posts big blind $0.02
*** HOLE CARDS ***
Dealt to Scaaalll [3c 3h]
GiordanoBrn is disconnected 
malandro733: folds 
GiordanoBrn: folds 
Scaaalll: raises $0.04 to $0.06
HellNative: folds 
le_vlimeux: folds 
EevAA190: folds 
Uncalled bet ($0.04) returned to Scaaalll
Scaaalll collected $0.05 from pot
Scaaalll: doesn't show hand 
*** SUMMARY ***
Total pot $0.05 | Rake $0 
Seat 1: HellNative (button) folded before Flop (didn't bet)
Seat 2: le_vlimeux (small blind) folded before Flop
Seat 3: EevAA190 (big blind) folded before Flop
Seat 4: malandro733 folded before Flop (didn't bet)
Seat 5: GiordanoBrn folded before Flop (didn't bet)
Seat 6: Scaaalll collected ($0.05)



PokerStars Zoom Hand #229231332905:  Hold'em No Limit ($0.01/$0.02) - 2021/08/21 22:10:43 CET [2021/08/21 16:10:43 ET]
Table 'Halley' 6-max Seat #1 is the button
Seat 1: Scaaalll ($2.10 in chips) 
Seat 2: Nihility77 ($5.97 in chips) 
Seat 3: Saint_ANBU ($4.02 in chips) 
Seat 4: rekopo203 ($1.98 in chips) 
Seat 5: HellNative ($2 in chips) 
Seat 6: Kreodont1987 ($2.35 in chips) 
Nihility77: posts small blind $0.01
Saint_ANBU: posts big blind $0.02
*** HOLE CARDS ***
Dealt to Scaaalll [2d 6c]
rekopo203: folds 
HellNative: raises $0.02 to $0.04
Kreodont1987: folds 
Scaaalll: folds 
Nihility77: folds 
Saint_ANBU: folds 
Uncalled bet ($0.02) returned to HellNative
HellNative collected $0.05 from pot
HellNative: doesn't show hand 
*** SUMMARY ***
Total pot $0.05 | Rake $0 
Seat 1: Scaaalll (button) folded before Flop (didn't bet)
Seat 2: Nihility77 (small blind) folded before Flop
Seat 3: Saint_ANBU (big blind) folded before Flop
Seat 4: rekopo203 folded before Flop (didn't bet)
Seat 5: HellNative collected ($0.05)
Seat 6: Kreodont1987 folded before Flop (didn't bet)



PokerStars Zoom Hand #229231334704:  Hold'em No Limit ($0.01/$0.02) - 2021/08/21 22:10:47 CET [2021/08/21 16:10:47 ET]
Table 'Halley' 6-max Seat #1 is the button
Seat 1: F_oksi(BLR) ($2.38 in chips) 
Seat 2: 888lifeIS ($2.01 in chips) 
Seat 3: Sergant20081 ($2.38 in chips) 
Seat 4: zergmiky ($2.40 in chips) 
Seat 5: Scaaalll ($2.10 in chips) 
Seat 6: DaBaDaBaDooo ($2.05 in chips) 
888lifeIS: posts small blind $0.01
Sergant20081: posts big blind $0.02
*** HOLE CARDS ***
Dealt to Scaaalll [5h Jc]
zergmiky: folds 
Scaaalll: folds 
DaBaDaBaDooo: folds 
F_oksi(BLR): raises $0.02 to $0.04
888lifeIS: folds 
Sergant20081: folds 
Uncalled bet ($0.02) returned to F_oksi(BLR)
F_oksi(BLR) collected $0.05 from pot
F_oksi(BLR): doesn't show hand 
*** SUMMARY ***
Total pot $0.05 | Rake $0 
Seat 1: F_oksi(BLR) (button) collected ($0.05)
Seat 2: 888lifeIS (small blind) folded before Flop
Seat 3: Sergant20081 (big blind) folded before Flop
Seat 4: zergmiky folded before Flop (didn't bet)
Seat 5: Scaaalll folded before Flop (didn't bet)
Seat 6: DaBaDaBaDooo folded before Flop (didn't bet)



PokerStars Zoom Hand #229231336911:  Hold'em No Limit ($0.01/$0.02) - 2021/08/21 22:10:52 CET [2021/08/21 16:10:52 ET]
Table 'Halley' 6-max Seat #1 is the button
Seat 1: zbixxx ($2.12 in chips) 
Seat 2: Scaaalll ($2.10 in chips) 
Seat 3: nemat_g ($2.04 in chips) 
Seat 4: robokop358 ($0.97 in chips) 
Seat 5: Kreodont1987 ($5.62 in chips) 
Seat 6: Murileus ($2 in chips) 
Scaaalll: posts small blind $0.01
nemat_g: posts big blind $0.02
*** HOLE CARDS ***
Dealt to Scaaalll [Qs Kc]
robokop358: folds 
Kreodont1987: folds 
Murileus: folds 
zbixxx: folds 
Scaaalll: raises $0.04 to $0.06
nemat_g: calls $0.04
*** FLOP *** [9s 2d 6c]
Scaaalll: bets $0.07
nemat_g: calls $0.07
*** TURN *** [9s 2d 6c] [4s]
Scaaalll: checks 
nemat_g: bets $0.13
Scaaalll: folds 
Uncalled bet ($0.13) returned to nemat_g
nemat_g collected $0.25 from pot
nemat_g: doesn't show hand 
*** SUMMARY ***
Total pot $0.26 | Rake $0.01 
Board [9s 2d 6c 4s]
Seat 1: zbixxx (button) folded before Flop (didn't bet)
Seat 2: Scaaalll (small blind) folded on the Turn
Seat 3: nemat_g (big blind) collected ($0.25)
Seat 4: robokop358 folded before Flop (didn't bet)
Seat 5: Kreodont1987 folded before Flop (didn't bet)
Seat 6: Murileus folded before Flop (didn't bet)



PokerStars Zoom Hand #229231327647:  Hold'em No Limit ($0.01/$0.02) - 2021/08/21 22:10:31 CET [2021/08/21 16:10:31 ET]
Table 'Halley' 6-max Seat #1 is the button
Seat 1: sewq55 ($0.84 in chips) 
Seat 2: dinoVIEIRA ($2.61 in chips) 
Seat 3: Scaaalll ($2.12 in chips) 
Seat 4: EDJF1999 ($0.94 in chips) 
Seat 5: MATIdf365 ($1.99 in chips) 
Seat 6: bananAAbandit ($6.59 in chips) 
dinoVIEIRA: posts small blind $0.01
Scaaalll: posts big blind $0.02
*** HOLE CARDS ***
Dealt to Scaaalll [5d Ac]
EDJF1999: raises $0.02 to $0.04
MATIdf365: folds 
bananAAbandit: folds 
sewq55: calls $0.04
dinoVIEIRA: folds 
Scaaalll: folds 
*** FLOP *** [6h Tc 5h]
EDJF1999: checks 
sewq55: checks 
*** TURN *** [6h Tc 5h] [8h]
EDJF1999: checks 
sewq55: checks 
*** RIVER *** [6h Tc 5h 8h] [6c]
EDJF1999: checks 
sewq55: checks 
*** SHOW DOWN ***
EDJF1999: shows [7s 2s] (a pair of Sixes)
sewq55: shows [Kd Jc] (a pair of Sixes - King kicker)
sewq55 collected $0.11 from pot
*** SUMMARY ***
Total pot $0.11 | Rake $0 
Board [6h Tc 5h 8h 6c]
Seat 1: sewq55 (button) showed [Kd Jc] and won ($0.11) with a pair of Sixes
Seat 2: dinoVIEIRA (small blind) folded before Flop
Seat 3: Scaaalll (big blind) folded before Flop
Seat 4: EDJF1999 showed [7s 2s] and lost with a pair of Sixes
Seat 5: MATIdf365 folded before Flop (didn't bet)
Seat 6: bananAAbandit folded before Flop (didn't bet)



PokerStars Zoom Hand #229231350627:  Hold'em No Limit ($0.01/$0.02) - 2021/08/21 22:11:23 CET [2021/08/21 16:11:23 ET]
Table 'Halley' 6-max Seat #1 is the button
Seat 1: slipknot956 ($2 in chips) 
Seat 2: Thaleshs ($2 in chips) 
Seat 3: BigTestIcicle ($0.90 in chips) 
Seat 4: Scaaalll ($2 in chips) 
Seat 5: fishh_play ($5.24 in chips) 
Seat 6: ppluiaule ($2.14 in chips) 
Thaleshs: posts small blind $0.01
BigTestIcicle: posts big blind $0.02
*** HOLE CARDS ***
Dealt to Scaaalll [Ts Qh]
Scaaalll: folds 
fishh_play: folds 
ppluiaule: folds 
slipknot956: raises $0.04 to $0.06
Thaleshs: folds 
BigTestIcicle: folds 
Uncalled bet ($0.04) returned to slipknot956
slipknot956 collected $0.05 from pot
slipknot956: doesn't show hand 
*** SUMMARY ***
Total pot $0.05 | Rake $0 
Seat 1: slipknot956 (button) collected ($0.05)
Seat 2: Thaleshs (small blind) folded before Flop
Seat 3: BigTestIcicle (big blind) folded before Flop
Seat 4: Scaaalll folded before Flop (didn't bet)
Seat 5: fishh_play folded before Flop (didn't bet)
Seat 6: ppluiaule folded before Flop (didn't bet)



PokerStars Zoom Hand #229231352371:  Hold'em No Limit ($0.01/$0.02) - 2021/08/21 22:11:27 CET [2021/08/21 16:11:27 ET]
Table 'Halley' 6-max Seat #1 is the button
Seat 1: WellWell57 ($1.55 in chips) 
Seat 2: Allexii ($2.12 in chips) 
Seat 3: Scaaalll ($2 in chips) 
Seat 4: Djalmethedj ($2.34 in chips) 
Seat 5: Clavis Noa ($3.16 in chips) 
Seat 6: Thaleshs ($2 in chips) 
Allexii: posts small blind $0.01
Scaaalll: posts big blind $0.02
*** HOLE CARDS ***
Dealt to Scaaalll [9s 3d]
Djalmethedj: folds 
Allexii is disconnected 
Clavis Noa: raises $0.04 to $0.06
Thaleshs: folds 
WellWell57: folds 
Allexii: folds 
Scaaalll: folds 
Uncalled bet ($0.04) returned to Clavis Noa
Clavis Noa collected $0.05 from pot
Clavis Noa: doesn't show hand 
*** SUMMARY ***
Total pot $0.05 | Rake $0 
Seat 1: WellWell57 (button) folded before Flop (didn't bet)
Seat 2: Allexii (small blind) folded before Flop
Seat 3: Scaaalll (big blind) folded before Flop
Seat 4: Djalmethedj folded before Flop (didn't bet)
Seat 5: Clavis Noa collected ($0.05)
Seat 6: Thaleshs folded before Flop (didn't bet)



PokerStars Zoom Hand #229231358119:  Hold'em No Limit ($0.01/$0.02) - 2021/08/21 22:11:40 CET [2021/08/21 16:11:40 ET]
Table 'Halley' 6-max Seat #1 is the button
Seat 1: Mikalai M. ($0.46 in chips) 
Seat 2: SICKDIRTY416 ($6.31 in chips) 
Seat 3: 13Mohican ($2.03 in chips) 
Seat 4: Scaaalll ($2 in chips) 
Seat 5: rpycmbEM ($4.66 in chips) 
Seat 6: hubertott ($3.25 in chips) 
SICKDIRTY416: posts small blind $0.01
13Mohican: posts big blind $0.02
*** HOLE CARDS ***
Dealt to Scaaalll [9c 6s]
Scaaalll: folds 
rpycmbEM: folds 
hubertott: folds 
Mikalai M.: calls $0.02
SICKDIRTY416: calls $0.01
13Mohican: checks 
*** FLOP *** [Jh 7h Ah]
SICKDIRTY416: bets $0.02
13Mohican: folds 
Mikalai M.: folds 
Uncalled bet ($0.02) returned to SICKDIRTY416
SICKDIRTY416 collected $0.06 from pot
SICKDIRTY416: doesn't show hand 
Mikalai M. is disconnected 
*** SUMMARY ***
Total pot $0.06 | Rake $0 
Board [Jh 7h Ah]
Seat 1: Mikalai M. (button) folded on the Flop
Seat 2: SICKDIRTY416 (small blind) collected ($0.06)
Seat 3: 13Mohican (big blind) folded on the Flop
Seat 4: Scaaalll folded before Flop (didn't bet)
Seat 5: rpycmbEM folded before Flop (didn't bet)
Seat 6: hubertott folded before Flop (didn't bet)



PokerStars Zoom Hand #229231360329:  Hold'em No Limit ($0.01/$0.02) - 2021/08/21 22:11:45 CET [2021/08/21 16:11:45 ET]
Table 'Halley' 6-max Seat #1 is the button
Seat 1: Scaaalll ($2 in chips) 
Seat 2: Jujiluju ($2.18 in chips) 
Seat 3: Aho1337 ($3.11 in chips) 
Seat 4: pphit ($2.53 in chips) 
Seat 5: LyahovIvan ($0.17 in chips) 
Seat 6: PapiMik3 ($2.94 in chips) 
Jujiluju: posts small blind $0.01
Aho1337: posts big blind $0.02
*** HOLE CARDS ***
Dealt to Scaaalll [3h 7d]
pphit: raises $0.03 to $0.05
LyahovIvan: folds 
PapiMik3: folds 
Scaaalll: folds 
Jujiluju: calls $0.04
Aho1337: calls $0.03
*** FLOP *** [5h 2s Qd]
Jujiluju: bets $0.14
Aho1337: folds 
pphit: folds 
Uncalled bet ($0.14) returned to Jujiluju
Jujiluju collected $0.14 from pot
Jujiluju: doesn't show hand 
*** SUMMARY ***
Total pot $0.15 | Rake $0.01 
Board [5h 2s Qd]
Seat 1: Scaaalll (button) folded before Flop (didn't bet)
Seat 2: Jujiluju (small blind) collected ($0.14)
Seat 3: Aho1337 (big blind) folded on the Flop
Seat 4: pphit folded on the Flop
Seat 5: LyahovIvan folded before Flop (didn't bet)
Seat 6: PapiMik3 folded before Flop (didn't bet)



PokerStars Zoom Hand #229231363905:  Hold'em No Limit ($0.01/$0.02) - 2021/08/21 22:11:53 CET [2021/08/21 16:11:53 ET]
Table 'Halley' 6-max Seat #1 is the button
Seat 1: 13Mohican ($2.01 in chips) 
Seat 2: Hug0Flavi0 ($1.64 in chips) 
Seat 3: LuckyCheewey ($8.31 in chips) 
Seat 4: Scaaalll ($2 in chips) 
Seat 5: Nihility77 ($5.99 in chips) 
Seat 6: sewq55 ($0.72 in chips) 
Hug0Flavi0: posts small blind $0.01
LuckyCheewey: posts big blind $0.02
*** HOLE CARDS ***
Dealt to Scaaalll [4s Ad]
Scaaalll: folds 
Nihility77: folds 
sewq55: folds 
13Mohican: folds 
Hug0Flavi0: calls $0.01
LuckyCheewey: checks 
*** FLOP *** [8s 6c As]
Hug0Flavi0: bets $0.02
LuckyCheewey: folds 
Uncalled bet ($0.02) returned to Hug0Flavi0
Hug0Flavi0 collected $0.04 from pot
Hug0Flavi0: doesn't show hand 
*** SUMMARY ***
Total pot $0.04 | Rake $0 
Board [8s 6c As]
Seat 1: 13Mohican (button) folded before Flop (didn't bet)
Seat 2: Hug0Flavi0 (small blind) collected ($0.04)
Seat 3: LuckyCheewey (big blind) folded on the Flop
Seat 4: Scaaalll folded before Flop (didn't bet)
Seat 5: Nihility77 folded before Flop (didn't bet)
Seat 6: sewq55 folded before Flop (didn't bet)



PokerStars Zoom Hand #229231355937:  Hold'em No Limit ($0.01/$0.02) - 2021/08/21 22:11:35 CET [2021/08/21 16:11:35 ET]
Table 'Halley' 6-max Seat #1 is the button
Seat 1: RomiSex ($2.02 in chips) 
Seat 2: EstiBan18 ($2.09 in chips) 
Seat 3: EevAA190 ($2.53 in chips) 
Seat 4: Shcherbak252 ($1.63 in chips) 
Seat 5: py100ta ($15.89 in chips) 
Seat 6: Scaaalll ($2 in chips) 
EstiBan18: posts small blind $0.01
EevAA190: posts big blind $0.02
*** HOLE CARDS ***
Dealt to Scaaalll [4c 2c]
Shcherbak252: raises $0.05 to $0.07
py100ta: folds 
Scaaalll: folds 
RomiSex: calls $0.07
EstiBan18: folds 
EevAA190: folds 
*** FLOP *** [2h 5h 7d]
Shcherbak252: checks 
RomiSex: checks 
*** TURN *** [2h 5h 7d] [9h]
Shcherbak252: checks 
RomiSex: checks 
*** RIVER *** [2h 5h 7d 9h] [Qc]
Shcherbak252: checks 
RomiSex: checks 
*** SHOW DOWN ***
Shcherbak252: shows [8s Ah] (high card Ace)
RomiSex: shows [Jh As] (high card Ace - Queen+Jack kicker)
RomiSex collected $0.16 from pot
*** SUMMARY ***
Total pot $0.17 | Rake $0.01 
Board [2h 5h 7d 9h Qc]
Seat 1: RomiSex (button) showed [Jh As] and won ($0.16) with high card Ace
Seat 2: EstiBan18 (small blind) folded before Flop
Seat 3: EevAA190 (big blind) folded before Flop
Seat 4: Shcherbak252 showed [8s Ah] and lost with high card Ace
Seat 5: py100ta folded before Flop (didn't bet)
Seat 6: Scaaalll folded before Flop (didn't bet)



PokerStars Zoom Hand #229231370043:  Hold'em No Limit ($0.01/$0.02) - 2021/08/21 22:12:07 CET [2021/08/21 16:12:07 ET]
Table 'Halley' 6-max Seat #1 is the button
Seat 1: ADWish ($2.01 in chips) 
Seat 2: Scaaalll ($2 in chips) 
Seat 3: amario89 ($5.49 in chips) 
Seat 4: RoughRafff ($2 in chips) 
Seat 5: zbixxx ($6.95 in chips) 
Seat 6: LegendaryLRS ($2 in chips) 
Scaaalll: posts small blind $0.01
amario89: posts big blind $0.02
*** HOLE CARDS ***
Dealt to Scaaalll [Tc Kc]
RoughRafff: folds 
zbixxx: folds 
LegendaryLRS: raises $0.03 to $0.05
ADWish: raises $0.11 to $0.16
Scaaalll: folds 
amario89: folds 
LegendaryLRS: calls $0.11
*** FLOP *** [9d 6d 3s]
LegendaryLRS: checks 
ADWish: checks 
*** TURN *** [9d 6d 3s] [Qd]
LegendaryLRS: checks 
ADWish: checks 
*** RIVER *** [9d 6d 3s Qd] [2d]
LegendaryLRS: checks 
ADWish: checks 
*** SHOW DOWN ***
LegendaryLRS: shows [Ks Jh] (high card King)
ADWish: shows [Qs Ac] (a pair of Queens)
ADWish collected $0.34 from pot
*** SUMMARY ***
Total pot $0.35 | Rake $0.01 
Board [9d 6d 3s Qd 2d]
Seat 1: ADWish (button) showed [Qs Ac] and won ($0.34) with a pair of Queens
Seat 2: Scaaalll (small blind) folded before Flop
Seat 3: amario89 (big blind) folded before Flop
Seat 4: RoughRafff folded before Flop (didn't bet)
Seat 5: zbixxx folded before Flop (didn't bet)
Seat 6: LegendaryLRS showed [Ks Jh] and lost with high card King



PokerStars Zoom Hand #229231365640:  Hold'em No Limit ($0.01/$0.02) - 2021/08/21 22:11:57 CET [2021/08/21 16:11:57 ET]
Table 'Halley' 6-max Seat #1 is the button
Seat 1: jerl22 ($3.79 in chips) 
Seat 2: Koldun 2636 ($2.86 in chips) 
Seat 3: Scaaalll ($2 in chips) 
Seat 4: IIDARKROBOTII ($1.55 in chips) 
Seat 5: SICKDIRTY416 ($6.35 in chips) 
Seat 6: Blaackie ($3.28 in chips) 
Koldun 2636: posts small blind $0.01
Scaaalll: posts big blind $0.02
*** HOLE CARDS ***
Dealt to Scaaalll [5h Th]
IIDARKROBOTII: folds 
IIDARKROBOTII is disconnected 
SICKDIRTY416: raises $0.02 to $0.04
Blaackie: folds 
jerl22: calls $0.04
Koldun 2636: raises $0.14 to $0.18
Scaaalll: folds 
SICKDIRTY416: calls $0.14
jerl22: calls $0.14
*** FLOP *** [Js Ks 3s]
Koldun 2636: bets $0.22
SICKDIRTY416: folds 
SICKDIRTY416 is disconnected 
jerl22: folds 
Uncalled bet ($0.22) returned to Koldun 2636
Koldun 2636 collected $0.54 from pot
Koldun 2636: doesn't show hand 
jerl22 is disconnected 
*** SUMMARY ***
Total pot $0.56 | Rake $0.02 
Board [Js Ks 3s]
Seat 1: jerl22 (button) folded on the Flop
Seat 2: Koldun 2636 (small blind) collected ($0.54)
Seat 3: Scaaalll (big blind) folded before Flop
Seat 4: IIDARKROBOTII folded before Flop (didn't bet)
Seat 5: SICKDIRTY416 folded on the Flop
Seat 6: Blaackie folded before Flop (didn't bet)



PokerStars Zoom Hand #229231383329:  Hold'em No Limit ($0.01/$0.02) - 2021/08/21 22:12:37 CET [2021/08/21 16:12:37 ET]
Table 'Halley' 6-max Seat #1 is the button
Seat 1: boa juice ($1.64 in chips) 
Seat 2: Scaaalll ($2 in chips) 
Seat 3: ZorroZoltan ($1.68 in chips) 
Seat 4: EmperorKurr ($2.06 in chips) 
Seat 5: smileakafray ($2.03 in chips) 
Seat 6: RichJImen89 ($2 in chips) 
Scaaalll: posts small blind $0.01
ZorroZoltan: posts big blind $0.02
*** HOLE CARDS ***
Dealt to Scaaalll [4s 6d]
EmperorKurr: folds 
smileakafray: raises $0.04 to $0.06
boa juice is disconnected 
RichJImen89: folds 
boa juice: folds 
Scaaalll: folds 
ZorroZoltan: folds 
Uncalled bet ($0.04) returned to smileakafray
smileakafray collected $0.05 from pot
smileakafray: doesn't show hand 
*** SUMMARY ***
Total pot $0.05 | Rake $0 
Seat 1: boa juice (button) folded before Flop (didn't bet)
Seat 2: Scaaalll (small blind) folded before Flop
Seat 3: ZorroZoltan (big blind) folded before Flop
Seat 4: EmperorKurr folded before Flop (didn't bet)
Seat 5: smileakafray collected ($0.05)
Seat 6: RichJImen89 folded before Flop (didn't bet)



PokerStars Zoom Hand #229231390417:  Hold'em No Limit ($0.01/$0.02) - 2021/08/21 22:12:53 CET [2021/08/21 16:12:53 ET]
Table 'Halley' 6-max Seat #1 is the button
Seat 1: Scaaalll ($2 in chips) 
Seat 2: RoughRafff ($4.13 in chips) 
Seat 3: ARTMVSLV ($7.16 in chips) 
Seat 4: NoLuckLeck ($2.04 in chips) 
Seat 5: DaBaDaBaDooo ($2 in chips) 
Seat 6: Mikeloko182 ($2.04 in chips) 
RoughRafff: posts small blind $0.01
ARTMVSLV: posts big blind $0.02
*** HOLE CARDS ***
Dealt to Scaaalll [7c 8s]
NoLuckLeck: raises $0.03 to $0.05
DaBaDaBaDooo: folds 
Mikeloko182: folds 
Scaaalll: folds 
RoughRafff: folds 
ARTMVSLV: folds 
Uncalled bet ($0.03) returned to NoLuckLeck
NoLuckLeck collected $0.05 from pot
NoLuckLeck: doesn't show hand 
*** SUMMARY ***
Total pot $0.05 | Rake $0 
Seat 1: Scaaalll (button) folded before Flop (didn't bet)
Seat 2: RoughRafff (small blind) folded before Flop
Seat 3: ARTMVSLV (big blind) folded before Flop
Seat 4: NoLuckLeck collected ($0.05)
Seat 5: DaBaDaBaDooo folded before Flop (didn't bet)
Seat 6: Mikeloko182 folded before Flop (didn't bet)



PokerStars Zoom Hand #229231380243:  Hold'em No Limit ($0.01/$0.02) - 2021/08/21 22:12:30 CET [2021/08/21 16:12:30 ET]
Table 'Halley' 6-max Seat #1 is the button
Seat 1: HubertFroh ($2.45 in chips) 
Seat 2: tragedy1986 ($2.04 in chips) 
Seat 3: LuckyCheewey ($7.32 in chips) 
Seat 4: Gerar NB ($2.45 in chips) 
Seat 5: Scaaalll ($2 in chips) 
Seat 6: sal_sagev41 ($2 in chips) 
tragedy1986: posts small blind $0.01
LuckyCheewey: posts big blind $0.02
*** HOLE CARDS ***
Dealt to Scaaalll [Jd 5s]
Gerar NB: folds 
Scaaalll: folds 
sal_sagev41: raises $0.03 to $0.05
HubertFroh: folds 
tragedy1986: calls $0.04
LuckyCheewey: folds 
*** FLOP *** [2h 2d 8c]
tragedy1986: checks 
sal_sagev41: bets $0.04
tragedy1986: raises $0.10 to $0.14
sal_sagev41: folds 
Uncalled bet ($0.10) returned to tragedy1986
tragedy1986 collected $0.19 from pot
tragedy1986: doesn't show hand 
*** SUMMARY ***
Total pot $0.20 | Rake $0.01 
Board [2h 2d 8c]
Seat 1: HubertFroh (button) folded before Flop (didn't bet)
Seat 2: tragedy1986 (small blind) collected ($0.19)
Seat 3: LuckyCheewey (big blind) folded before Flop
Seat 4: Gerar NB folded before Flop (didn't bet)
Seat 5: Scaaalll folded before Flop (didn't bet)
Seat 6: sal_sagev41 folded on the Flop



PokerStars Zoom Hand #229231394413:  Hold'em No Limit ($0.01/$0.02) - 2021/08/21 22:13:02 CET [2021/08/21 16:13:02 ET]
Table 'Halley' 6-max Seat #1 is the button
Seat 1: meikoz ($2.13 in chips) 
Seat 2: tcl4l ($1.25 in chips) 
Seat 3: Hantsirg ($0.50 in chips) 
Seat 4: OFSHOR ($2.15 in chips) 
Seat 5: djewlz ($1.73 in chips) 
Seat 6: Scaaalll ($2 in chips) 
tcl4l: posts small blind $0.01
Hantsirg: posts big blind $0.02
*** HOLE CARDS ***
Dealt to Scaaalll [3d 6s]
OFSHOR: folds 
djewlz: folds 
Scaaalll: folds 
meikoz: raises $0.03 to $0.05
Hantsirg is disconnected 
tcl4l: calls $0.04
Hantsirg: folds 
*** FLOP *** [5d Td 2d]
tcl4l: checks 
meikoz: bets $0.06
tcl4l: folds 
Uncalled bet ($0.06) returned to meikoz
meikoz collected $0.12 from pot
meikoz: doesn't show hand 
tcl4l is disconnected 
*** SUMMARY ***
Total pot $0.12 | Rake $0 
Board [5d Td 2d]
Seat 1: meikoz (button) collected ($0.12)
Seat 2: tcl4l (small blind) folded on the Flop
Seat 3: Hantsirg (big blind) folded before Flop
Seat 4: OFSHOR folded before Flop (didn't bet)
Seat 5: djewlz folded before Flop (didn't bet)
Seat 6: Scaaalll folded before Flop (didn't bet)



PokerStars Zoom Hand #229231398337:  Hold'em No Limit ($0.01/$0.02) - 2021/08/21 22:13:11 CET [2021/08/21 16:13:11 ET]
Table 'Halley' 6-max Seat #1 is the button
Seat 1: KRITAYA ($1.13 in chips) 
Seat 2: nemat_g ($2.16 in chips) 
Seat 3: RrriotGrrrl ($5.05 in chips) 
Seat 4: pushpas ($1.84 in chips) 
Seat 5: Scaaalll ($2 in chips) 
Seat 6: xxRoseIloveu ($8.15 in chips) 
nemat_g: posts small blind $0.01
RrriotGrrrl: posts big blind $0.02
*** HOLE CARDS ***
Dealt to Scaaalll [8h Kd]
pushpas: folds 
Scaaalll: folds 
xxRoseIloveu: folds 
KRITAYA: raises $0.03 to $0.05
nemat_g: calls $0.04
RrriotGrrrl: folds 
*** FLOP *** [Kh 7c 3h]
nemat_g: bets $0.06
KRITAYA: folds 
Uncalled bet ($0.06) returned to nemat_g
nemat_g collected $0.12 from pot
nemat_g: doesn't show hand 
*** SUMMARY ***
Total pot $0.12 | Rake $0 
Board [Kh 7c 3h]
Seat 1: KRITAYA (button) folded on the Flop
Seat 2: nemat_g (small blind) collected ($0.12)
Seat 3: RrriotGrrrl (big blind) folded before Flop
Seat 4: pushpas folded before Flop (didn't bet)
Seat 5: Scaaalll folded before Flop (didn't bet)
Seat 6: xxRoseIloveu folded before Flop (didn't bet)



PokerStars Zoom Hand #229231376748:  Hold'em No Limit ($0.01/$0.02) - 2021/08/21 22:12:22 CET [2021/08/21 16:12:22 ET]
Table 'Halley' 6-max Seat #1 is the button
Seat 1: 888lifeIS ($2 in chips) 
Seat 2: malandro733 ($7.35 in chips) 
Seat 3: 13Mohican ($2.03 in chips) 
Seat 4: MATIdf365 ($2.30 in chips) 
Seat 5: estelionat171 ($0.59 in chips) 
Seat 6: Scaaalll ($2 in chips) 
malandro733: posts small blind $0.01
13Mohican: posts big blind $0.02
*** HOLE CARDS ***
Dealt to Scaaalll [4d 9h]
MATIdf365: folds 
estelionat171: folds 
Scaaalll: folds 
888lifeIS: folds 
malandro733: raises $0.04 to $0.06
13Mohican: calls $0.04
*** FLOP *** [5c Qh 7c]
malandro733: checks 
13Mohican: checks 
*** TURN *** [5c Qh 7c] [9d]
malandro733: checks 
13Mohican: checks 
*** RIVER *** [5c Qh 7c 9d] [8h]
malandro733: checks 
13Mohican: checks 
*** SHOW DOWN ***
malandro733: shows [Ah Kc] (high card Ace)
13Mohican: shows [5h Kh] (a pair of Fives)
13Mohican collected $0.12 from pot
*** SUMMARY ***
Total pot $0.12 | Rake $0 
Board [5c Qh 7c 9d 8h]
Seat 1: 888lifeIS (button) folded before Flop (didn't bet)
Seat 2: malandro733 (small blind) showed [Ah Kc] and lost with high card Ace
Seat 3: 13Mohican (big blind) showed [5h Kh] and won ($0.12) with a pair of Fives
Seat 4: MATIdf365 folded before Flop (didn't bet)
Seat 5: estelionat171 folded before Flop (didn't bet)
Seat 6: Scaaalll folded before Flop (didn't bet)



PokerStars Zoom Hand #229231400099:  Hold'em No Limit ($0.01/$0.02) - 2021/08/21 22:13:15 CET [2021/08/21 16:13:15 ET]
Table 'Halley' 6-max Seat #1 is the button
Seat 1: rodrigocvx ($2.09 in chips) 
Seat 2: RaulacateFolds ($2 in chips) 
Seat 3: Scaaalll ($2 in chips) 
Seat 4: ash1448 ($9.98 in chips) 
Seat 5: zerohorabr ($0.82 in chips) 
Seat 6: lucksuckdonk ($4.87 in chips) 
RaulacateFolds: posts small blind $0.01
Scaaalll: posts big blind $0.02
*** HOLE CARDS ***
Dealt to Scaaalll [2c 8h]
ash1448: folds 
zerohorabr: folds 
lucksuckdonk: folds 
rodrigocvx: folds 
RaulacateFolds: raises $0.04 to $0.06
Scaaalll: folds 
Uncalled bet ($0.04) returned to RaulacateFolds
RaulacateFolds collected $0.04 from pot
RaulacateFolds: doesn't show hand 
*** SUMMARY ***
Total pot $0.04 | Rake $0 
Seat 1: rodrigocvx (button) folded before Flop (didn't bet)
Seat 2: RaulacateFolds (small blind) collected ($0.04)
Seat 3: Scaaalll (big blind) folded before Flop
Seat 4: ash1448 folded before Flop (didn't bet)
Seat 5: zerohorabr folded before Flop (didn't bet)
Seat 6: lucksuckdonk folded before Flop (didn't bet)



PokerStars Zoom Hand #229231409343:  Hold'em No Limit ($0.01/$0.02) - 2021/08/21 22:13:36 CET [2021/08/21 16:13:36 ET]
Table 'Halley' 6-max Seat #1 is the button
Seat 1: Scaaalll ($2 in chips) 
Seat 2: SKV_1985 ($2.70 in chips) 
Seat 3: FicheroQuit ($3.59 in chips) 
Seat 4: ca$hmeoutsid ($2.27 in chips) 
Seat 5: Treadero ($2.48 in chips) 
Seat 6: RoughRafff ($4.07 in chips) 
SKV_1985: posts small blind $0.01
FicheroQuit: posts big blind $0.02
*** HOLE CARDS ***
Dealt to Scaaalll [6c 8d]
ca$hmeoutsid: folds 
Treadero: folds 
RoughRafff: folds 
Scaaalll: folds 
SKV_1985: folds 
Uncalled bet ($0.01) returned to FicheroQuit
FicheroQuit collected $0.02 from pot
FicheroQuit: doesn't show hand 
*** SUMMARY ***
Total pot $0.02 | Rake $0 
Seat 1: Scaaalll (button) folded before Flop (didn't bet)
Seat 2: SKV_1985 (small blind) folded before Flop
Seat 3: FicheroQuit (big blind) collected ($0.02)
Seat 4: ca$hmeoutsid folded before Flop (didn't bet)
Seat 5: Treadero folded before Flop (didn't bet)
Seat 6: RoughRafff folded before Flop (didn't bet)



PokerStars Zoom Hand #229231415052:  Hold'em No Limit ($0.01/$0.02) - 2021/08/21 22:13:49 CET [2021/08/21 16:13:49 ET]
Table 'Halley' 6-max Seat #1 is the button
Seat 1: willmorel ($2.29 in chips) 
Seat 2: Scaaalll ($2 in chips) 
Seat 3: usenovm ($3.66 in chips) 
Seat 4: uniicecube ($2.63 in chips) 
Seat 5: AlexGTPS ($4.37 in chips) 
Seat 6: keb1981 ($2 in chips) 
Scaaalll: posts small blind $0.01
usenovm: posts big blind $0.02
*** HOLE CARDS ***
Dealt to Scaaalll [Kc Kd]
uniicecube: folds 
AlexGTPS: raises $0.03 to $0.05
keb1981: folds 
willmorel: folds 
Scaaalll: raises $0.13 to $0.18
usenovm: folds 
AlexGTPS: folds 
Uncalled bet ($0.13) returned to Scaaalll
Scaaalll collected $0.12 from pot
Scaaalll: doesn't show hand 
*** SUMMARY ***
Total pot $0.12 | Rake $0 
Seat 1: willmorel (button) folded before Flop (didn't bet)
Seat 2: Scaaalll (small blind) collected ($0.12)
Seat 3: usenovm (big blind) folded before Flop
Seat 4: uniicecube folded before Flop (didn't bet)
Seat 5: AlexGTPS folded before Flop
Seat 6: keb1981 folded before Flop (didn't bet)



PokerStars Zoom Hand #229231425130:  Hold'em No Limit ($0.01/$0.02) - 2021/08/21 22:14:12 CET [2021/08/21 16:14:12 ET]
Table 'Halley' 6-max Seat #1 is the button
Seat 1: LuckyCheewey ($8.69 in chips) 
Seat 2: DaporteWins ($2.01 in chips) 
Seat 3: AtZ3899 ($1.13 in chips) 
Seat 4: Scaaalll ($2.07 in chips) 
Seat 5: Djalmethedj ($1.83 in chips) 
Seat 6: SIGREX ($2.85 in chips) 
DaporteWins: posts small blind $0.01
AtZ3899: posts big blind $0.02
*** HOLE CARDS ***
Dealt to Scaaalll [6s 8c]
Scaaalll: folds 
Djalmethedj: folds 
SIGREX: folds 
LuckyCheewey: folds 
DaporteWins: folds 
Uncalled bet ($0.01) returned to AtZ3899
AtZ3899 collected $0.02 from pot
AtZ3899: doesn't show hand 
*** SUMMARY ***
Total pot $0.02 | Rake $0 
Seat 1: LuckyCheewey (button) folded before Flop (didn't bet)
Seat 2: DaporteWins (small blind) folded before Flop
Seat 3: AtZ3899 (big blind) collected ($0.02)
Seat 4: Scaaalll folded before Flop (didn't bet)
Seat 5: Djalmethedj folded before Flop (didn't bet)
Seat 6: SIGREX folded before Flop (didn't bet)



PokerStars Zoom Hand #229231413277:  Hold'em No Limit ($0.01/$0.02) - 2021/08/21 22:13:45 CET [2021/08/21 16:13:45 ET]
Table 'Halley' 6-max Seat #1 is the button
Seat 1: plmanuelpl ($0.79 in chips) 
Seat 2: Thaleshs ($2 in chips) 
Seat 3: KoAlRy ($2 in chips) 
Seat 4: Clavis Noa ($3.09 in chips) 
Seat 5: Scaaalll ($2 in chips) 
Seat 6: VasquezSancho96 ($4.23 in chips) 
Thaleshs: posts small blind $0.01
KoAlRy: posts big blind $0.02
*** HOLE CARDS ***
Dealt to Scaaalll [6h 3s]
Clavis Noa: raises $0.04 to $0.06
Scaaalll: folds 
VasquezSancho96: folds 
plmanuelpl: raises $0.73 to $0.79 and is all-in
Thaleshs: folds 
KoAlRy: folds 
Clavis Noa: calls $0.73
*** FLOP *** [9h 8h 9c]
*** TURN *** [9h 8h 9c] [Ah]
*** RIVER *** [9h 8h 9c Ah] [Qh]
*** SHOW DOWN ***
Clavis Noa: shows [Qc Qs] (a full house, Queens full of Nines)
plmanuelpl: shows [As Ac] (a full house, Aces full of Nines)
plmanuelpl cashed out the hand for $1.26 | Cash Out Fee $0.01
*** SUMMARY ***
Total pot $1.61 | Rake $0.06 
Board [9h 8h 9c Ah Qh]
Seat 1: plmanuelpl (button) showed [As Ac] and won ($1.55) with a full house, Aces full of Nines (pot not awarded as player cashed out)
Seat 2: Thaleshs (small blind) folded before Flop
Seat 3: KoAlRy (big blind) folded before Flop
Seat 4: Clavis Noa showed [Qc Qs] and lost with a full house, Queens full of Nines
Seat 5: Scaaalll folded before Flop (didn't bet)
Seat 6: VasquezSancho96 folded before Flop (didn't bet)



PokerStars Zoom Hand #229231441310:  Hold'em No Limit ($0.01/$0.02) - 2021/08/21 22:14:20 CET [2021/08/21 16:14:20 ET]
Table 'Halley' 6-max Seat #1 is the button
Seat 1: Scaaalll ($2.07 in chips) 
Seat 2: KonopDima ($2 in chips) 
Seat 3: Luben_76 ($2 in chips) 
Seat 4: DPQQ335 ($3.31 in chips) 
Seat 5: Allekccc ($1.80 in chips) 
Seat 6: carlomagno ($1.58 in chips) 
KonopDima: posts small blind $0.01
Luben_76: posts big blind $0.02
*** HOLE CARDS ***
Dealt to Scaaalll [Jh Tc]
DPQQ335: folds 
Allekccc: folds 
carlomagno: folds 
Scaaalll: raises $0.02 to $0.04
KonopDima: folds 
Luben_76: raises $0.20 to $0.24
Scaaalll: folds 
Uncalled bet ($0.20) returned to Luben_76
Luben_76 collected $0.09 from pot
Luben_76: doesn't show hand 
*** SUMMARY ***
Total pot $0.09 | Rake $0 
Seat 1: Scaaalll (button) folded before Flop
Seat 2: KonopDima (small blind) folded before Flop
Seat 3: Luben_76 (big blind) collected ($0.09)
Seat 4: DPQQ335 folded before Flop (didn't bet)
Seat 5: Allekccc folded before Flop (didn't bet)
Seat 6: carlomagno folded before Flop (didn't bet)



PokerStars Zoom Hand #229231451485:  Hold'em No Limit ($0.01/$0.02) - 2021/08/21 22:14:43 CET [2021/08/21 16:14:43 ET]
Table 'Halley' 6-max Seat #1 is the button
Seat 1: KRITAYA ($1.05 in chips) 
Seat 2: Healthys07 ($5.35 in chips) 
Seat 3: Scaaalll ($2.03 in chips) 
Seat 4: alecha11 ($2 in chips) 
Seat 5: HellNative ($3.75 in chips) 
Seat 6: 13Mohican ($2 in chips) 
Healthys07: posts small blind $0.01
Scaaalll: posts big blind $0.02
*** HOLE CARDS ***
Dealt to Scaaalll [Qs Jh]
alecha11: folds 
HellNative: folds 
13Mohican: folds 
KRITAYA: folds 
Healthys07: folds 
Uncalled bet ($0.01) returned to Scaaalll
Scaaalll collected $0.02 from pot
Scaaalll: doesn't show hand 
*** SUMMARY ***
Total pot $0.02 | Rake $0 
Seat 1: KRITAYA (button) folded before Flop (didn't bet)
Seat 2: Healthys07 (small blind) folded before Flop
Seat 3: Scaaalll (big blind) collected ($0.02)
Seat 4: alecha11 folded before Flop (didn't bet)
Seat 5: HellNative folded before Flop (didn't bet)
Seat 6: 13Mohican folded before Flop (didn't bet)



PokerStars Zoom Hand #229231430052:  Hold'em No Limit ($0.01/$0.02) - 2021/08/21 22:14:16 CET [2021/08/21 16:14:16 ET]
Table 'Halley' 6-max Seat #1 is the button
Seat 1: bananAAbandit ($3.12 in chips) 
Seat 2: ser313131 ($2.03 in chips) 
Seat 3: Blaackie ($3.88 in chips) 
Seat 4: Nihility77 ($5.22 in chips) 
Seat 5: kahzura ($2.23 in chips) 
Seat 6: Scaaalll ($2.07 in chips) 
ser313131: posts small blind $0.01
Blaackie: posts big blind $0.02
*** HOLE CARDS ***
Dealt to Scaaalll [9c Jd]
Nihility77: folds 
kahzura: folds 
Scaaalll: folds 
bananAAbandit: raises $0.04 to $0.06
ser313131: raises $0.14 to $0.20
Blaackie: folds 
bananAAbandit: calls $0.14
*** FLOP *** [7c Th Td]
ser313131: checks 
bananAAbandit: bets $0.21
ser313131: folds 
Uncalled bet ($0.21) returned to bananAAbandit
bananAAbandit collected $0.41 from pot
bananAAbandit: doesn't show hand 
*** SUMMARY ***
Total pot $0.42 | Rake $0.01 
Board [7c Th Td]
Seat 1: bananAAbandit (button) collected ($0.41)
Seat 2: ser313131 (small blind) folded on the Flop
Seat 3: Blaackie (big blind) folded before Flop
Seat 4: Nihility77 folded before Flop (didn't bet)
Seat 5: kahzura folded before Flop (didn't bet)
Seat 6: Scaaalll folded before Flop (didn't bet)



PokerStars Zoom Hand #229231456726:  Hold'em No Limit ($0.01/$0.02) - 2021/08/21 22:14:55 CET [2021/08/21 16:14:55 ET]
Table 'Halley' 6-max Seat #1 is the button
Seat 1: ugi-dugi ($2.07 in chips) 
Seat 2: feybys ($2.04 in chips) 
Seat 3: HellNative ($2.31 in chips) 
Seat 4: IIDARKROBOTII ($1.45 in chips) 
Seat 5: Scaaalll ($2.04 in chips) 
Seat 6: dkno77 ($2.79 in chips) 
feybys: posts small blind $0.01
HellNative: posts big blind $0.02
*** HOLE CARDS ***
Dealt to Scaaalll [5c Ah]
IIDARKROBOTII: raises $0.05 to $0.07
Scaaalll: folds 
dkno77: folds 
ugi-dugi: folds 
feybys: folds 
HellNative: folds 
Uncalled bet ($0.05) returned to IIDARKROBOTII
IIDARKROBOTII collected $0.05 from pot
IIDARKROBOTII: doesn't show hand 
*** SUMMARY ***
Total pot $0.05 | Rake $0 
Seat 1: ugi-dugi (button) folded before Flop (didn't bet)
Seat 2: feybys (small blind) folded before Flop
Seat 3: HellNative (big blind) folded before Flop
Seat 4: IIDARKROBOTII collected ($0.05)
Seat 5: Scaaalll folded before Flop (didn't bet)
Seat 6: dkno77 folded before Flop (didn't bet)



PokerStars Zoom Hand #229231459785:  Hold'em No Limit ($0.01/$0.02) - 2021/08/21 22:15:02 CET [2021/08/21 16:15:02 ET]
Table 'Halley' 6-max Seat #1 is the button
Seat 1: rodrigocvx ($1.88 in chips) 
Seat 2: Scaaalll ($2.04 in chips) 
Seat 3: bananAAbandit ($3.33 in chips) 
Seat 4: ChuckGaylordIII ($2 in chips) 
Seat 5: Tacojesuscrisp ($2.30 in chips) 
Seat 6: MSD2006 ($2.31 in chips) 
Scaaalll: posts small blind $0.01
bananAAbandit: posts big blind $0.02
*** HOLE CARDS ***
Dealt to Scaaalll [Jh 6c]
ChuckGaylordIII: folds 
ChuckGaylordIII is disconnected 
Tacojesuscrisp: raises $0.03 to $0.05
MSD2006: raises $0.08 to $0.13
rodrigocvx: folds 
Scaaalll: folds 
bananAAbandit: folds 
Tacojesuscrisp: raises $0.23 to $0.36
MSD2006: folds 
Uncalled bet ($0.23) returned to Tacojesuscrisp
Tacojesuscrisp collected $0.29 from pot
Tacojesuscrisp: doesn't show hand 
*** SUMMARY ***
Total pot $0.29 | Rake $0 
Seat 1: rodrigocvx (button) folded before Flop (didn't bet)
Seat 2: Scaaalll (small blind) folded before Flop
Seat 3: bananAAbandit (big blind) folded before Flop
Seat 4: ChuckGaylordIII folded before Flop (didn't bet)
Seat 5: Tacojesuscrisp collected ($0.29)
Seat 6: MSD2006 folded before Flop



PokerStars Zoom Hand #229231470427:  Hold'em No Limit ($0.01/$0.02) - 2021/08/21 22:15:25 CET [2021/08/21 16:15:25 ET]
Table 'Halley' 6-max Seat #1 is the button
Seat 1: Red Sky 15 ($9.89 in chips) 
Seat 2: zergmiky ($2.26 in chips) 
Seat 3: satti1337 ($6 in chips) 
Seat 4: Scaaalll ($2.03 in chips) 
Seat 5: Feliciano16 ($4.17 in chips) 
Seat 6: Koldun 2636 ($2.94 in chips) 
zergmiky: posts small blind $0.01
satti1337: posts big blind $0.02
*** HOLE CARDS ***
Dealt to Scaaalll [2d Jh]
Scaaalll: folds 
Feliciano16: folds 
Koldun 2636: folds 
Red Sky 15: raises $0.04 to $0.06
zergmiky: folds 
satti1337: calls $0.04
*** FLOP *** [3h 3c As]
satti1337: checks 
Red Sky 15: bets $0.08
satti1337: folds 
Uncalled bet ($0.08) returned to Red Sky 15
Red Sky 15 collected $0.13 from pot
Red Sky 15: doesn't show hand 
*** SUMMARY ***
Total pot $0.13 | Rake $0 
Board [3h 3c As]
Seat 1: Red Sky 15 (button) collected ($0.13)
Seat 2: zergmiky (small blind) folded before Flop
Seat 3: satti1337 (big blind) folded on the Flop
Seat 4: Scaaalll folded before Flop (didn't bet)
Seat 5: Feliciano16 folded before Flop (didn't bet)
Seat 6: Koldun 2636 folded before Flop (didn't bet)



PokerStars Zoom Hand #229231472737:  Hold'em No Limit ($0.01/$0.02) - 2021/08/21 22:15:30 CET [2021/08/21 16:15:30 ET]
Table 'Halley' 6-max Seat #1 is the button
Seat 1: malandro733 ($2 in chips) 
Seat 2: usenovm ($4.63 in chips) 
Seat 3: SIGREX ($2.94 in chips) 
Seat 4: Scaaalll ($2.03 in chips) 
Seat 5: Tibelloni ($0.79 in chips) 
Seat 6: parrotman991 ($1.75 in chips) 
usenovm: posts small blind $0.01
SIGREX: posts big blind $0.02
*** HOLE CARDS ***
Dealt to Scaaalll [3c Ac]
Tibelloni is disconnected 
Scaaalll has timed out
Scaaalll: folds 
Tibelloni: folds 
parrotman991: calls $0.02
malandro733: folds 
usenovm: folds 
SIGREX: raises $0.07 to $0.09
parrotman991: folds 
Uncalled bet ($0.07) returned to SIGREX
SIGREX collected $0.05 from pot
SIGREX: doesn't show hand 
*** SUMMARY ***
Total pot $0.05 | Rake $0 
Seat 1: malandro733 (button) folded before Flop (didn't bet)
Seat 2: usenovm (small blind) folded before Flop
Seat 3: SIGREX (big blind) collected ($0.05)
Seat 4: Scaaalll folded before Flop (didn't bet)
Seat 5: Tibelloni folded before Flop (didn't bet)
Seat 6: parrotman991 folded before Flop



PokerStars Zoom Hand #229231480003:  Hold'em No Limit ($0.01/$0.02) - 2021/08/21 22:15:46 CET [2021/08/21 16:15:46 ET]
Table 'Halley' 6-max Seat #1 is the button
Seat 1: Henry Chinasky ($6.66 in chips) 
Seat 2: JDGGrinder ($3.22 in chips) 
Seat 3: Realmadridfan ($2 in chips) 
Seat 4: Tacojesuscrisp ($3.49 in chips) 
Seat 5: Scaaalll ($2.03 in chips) 
Seat 6: WithMyWalker ($2.54 in chips) 
JDGGrinder: posts small blind $0.01
Realmadridfan: posts big blind $0.02
*** HOLE CARDS ***
Dealt to Scaaalll [3d 8c]
Tacojesuscrisp: folds 
Scaaalll: folds 
WithMyWalker: folds 
Henry Chinasky: folds 
JDGGrinder: folds 
Uncalled bet ($0.01) returned to Realmadridfan
Realmadridfan collected $0.02 from pot
Realmadridfan: doesn't show hand 
*** SUMMARY ***
Total pot $0.02 | Rake $0 
Seat 1: Henry Chinasky (button) folded before Flop (didn't bet)
Seat 2: JDGGrinder (small blind) folded before Flop
Seat 3: Realmadridfan (big blind) collected ($0.02)
Seat 4: Tacojesuscrisp folded before Flop (didn't bet)
Seat 5: Scaaalll folded before Flop (didn't bet)
Seat 6: WithMyWalker folded before Flop (didn't bet)



PokerStars Zoom Hand #229231481803:  Hold'em No Limit ($0.01/$0.02) - 2021/08/21 22:15:50 CET [2021/08/21 16:15:50 ET]
Table 'Halley' 6-max Seat #1 is the button
Seat 1: Scaaalll ($2.03 in chips) 
Seat 2: sewq55 ($1.21 in chips) 
Seat 3: BigTestIcicle ($1.99 in chips) 
Seat 4: Chapaev136 ($3.43 in chips) 
Seat 5: artur9124 ($2.23 in chips) 
Seat 6: polymorhp ($2.66 in chips) 
sewq55: posts small blind $0.01
BigTestIcicle: posts big blind $0.02
*** HOLE CARDS ***
Dealt to Scaaalll [7d 7c]
Chapaev136: folds 
artur9124 has timed out while disconnected
artur9124: folds 
polymorhp: raises $0.04 to $0.06
Scaaalll: calls $0.06
sewq55: folds 
BigTestIcicle: calls $0.04
*** FLOP *** [2s Kc Qh]
BigTestIcicle: checks 
polymorhp: checks 
Scaaalll: checks 
*** TURN *** [2s Kc Qh] [Ad]
BigTestIcicle: checks 
polymorhp: checks 
Scaaalll: checks 
*** RIVER *** [2s Kc Qh Ad] [8c]
BigTestIcicle: checks 
polymorhp: checks 
Scaaalll: checks 
*** SHOW DOWN ***
BigTestIcicle: shows [4d 5d] (high card Ace)
polymorhp: shows [7h 7s] (a pair of Sevens)
Scaaalll: shows [7d 7c] (a pair of Sevens)
polymorhp collected $0.09 from pot
Scaaalll collected $0.09 from pot
*** SUMMARY ***
Total pot $0.19 | Rake $0.01 
Board [2s Kc Qh Ad 8c]
Seat 1: Scaaalll (button) showed [7d 7c] and won ($0.09) with a pair of Sevens
Seat 2: sewq55 (small blind) folded before Flop
Seat 3: BigTestIcicle (big blind) showed [4d 5d] and lost with high card Ace
Seat 4: Chapaev136 folded before Flop (didn't bet)
Seat 5: artur9124 folded before Flop (didn't bet)
Seat 6: polymorhp showed [7h 7s] and won ($0.09) with a pair of Sevens



PokerStars Zoom Hand #229231510631:  Hold'em No Limit ($0.01/$0.02) - 2021/08/21 22:16:53 CET [2021/08/21 16:16:53 ET]
Table 'Halley' 6-max Seat #1 is the button
Seat 1: WithMyWalker ($2.50 in chips) 
Seat 2: Dipod1991 ($2.15 in chips) 
Seat 3: Scaaalll ($2.06 in chips) 
Seat 4: Kuzmich_2502 ($4.85 in chips) 
Seat 5: rekopo203 ($6.40 in chips) 
Seat 6: Phoenixxxxxxxx ($2.08 in chips) 
Dipod1991: posts small blind $0.01
Scaaalll: posts big blind $0.02
*** HOLE CARDS ***
Dealt to Scaaalll [4h 2s]
Kuzmich_2502: folds 
rekopo203: folds 
Phoenixxxxxxxx: folds 
WithMyWalker: folds 
Dipod1991: raises $0.04 to $0.06
Scaaalll: folds 
Uncalled bet ($0.04) returned to Dipod1991
Dipod1991 collected $0.04 from pot
Dipod1991: doesn't show hand 
*** SUMMARY ***
Total pot $0.04 | Rake $0 
Seat 1: WithMyWalker (button) folded before Flop (didn't bet)
Seat 2: Dipod1991 (small blind) collected ($0.04)
Seat 3: Scaaalll (big blind) folded before Flop
Seat 4: Kuzmich_2502 folded before Flop (didn't bet)
Seat 5: rekopo203 folded before Flop (didn't bet)
Seat 6: Phoenixxxxxxxx folded before Flop (didn't bet)



PokerStars Zoom Hand #229231521256:  Hold'em No Limit ($0.01/$0.02) - 2021/08/21 22:17:16 CET [2021/08/21 16:17:16 ET]
Table 'Halley' 6-max Seat #1 is the button
Seat 1: zielony ($2.50 in chips) 
Seat 2: Kergie ($15.30 in chips) 
Seat 3: HellNative ($2.03 in chips) 
Seat 4: Ne0net ($2.22 in chips) 
Seat 5: KonopDima ($2.13 in chips) 
Seat 6: Scaaalll ($2.04 in chips) 
Kergie: posts small blind $0.01
HellNative: posts big blind $0.02
*** HOLE CARDS ***
Dealt to Scaaalll [4h Ac]
Ne0net: folds 
KonopDima: folds 
Scaaalll: folds 
zielony: raises $0.03 to $0.05
Kergie: folds 
HellNative: raises $0.21 to $0.26
zielony: folds 
Uncalled bet ($0.21) returned to HellNative
HellNative collected $0.11 from pot
HellNative: doesn't show hand 
*** SUMMARY ***
Total pot $0.11 | Rake $0 
Seat 1: zielony (button) folded before Flop
Seat 2: Kergie (small blind) folded before Flop
Seat 3: HellNative (big blind) collected ($0.11)
Seat 4: Ne0net folded before Flop (didn't bet)
Seat 5: KonopDima folded before Flop (didn't bet)
Seat 6: Scaaalll folded before Flop (didn't bet)



PokerStars Zoom Hand #229231524023:  Hold'em No Limit ($0.01/$0.02) - 2021/08/21 22:17:22 CET [2021/08/21 16:17:22 ET]
Table 'Halley' 6-max Seat #1 is the button
Seat 1: Scaaalll ($2.04 in chips) 
Seat 2: polymorhp ($2.29 in chips) 
Seat 3: HellNative ($3.62 in chips) 
Seat 4: Sergant20081 ($2.08 in chips) 
Seat 5: Russian MA ($1.81 in chips) 
Seat 6: causavera ($4.10 in chips) 
polymorhp: posts small blind $0.01
HellNative: posts big blind $0.02
*** HOLE CARDS ***
Dealt to Scaaalll [3d 7h]
Russian MA is disconnected 
Sergant20081: folds 
Russian MA: folds 
causavera: folds 
Scaaalll: folds 
polymorhp: folds 
Uncalled bet ($0.01) returned to HellNative
HellNative collected $0.02 from pot
HellNative: doesn't show hand 
*** SUMMARY ***
Total pot $0.02 | Rake $0 
Seat 1: Scaaalll (button) folded before Flop (didn't bet)
Seat 2: polymorhp (small blind) folded before Flop
Seat 3: HellNative (big blind) collected ($0.02)
Seat 4: Sergant20081 folded before Flop (didn't bet)
Seat 5: Russian MA folded before Flop (didn't bet)
Seat 6: causavera folded before Flop (didn't bet)



PokerStars Zoom Hand #229231525834:  Hold'em No Limit ($0.01/$0.02) - 2021/08/21 22:17:26 CET [2021/08/21 16:17:26 ET]
Table 'Halley' 6-max Seat #1 is the button
Seat 1: skitai555 ($1.71 in chips) 
Seat 2: Scaaalll ($2.04 in chips) 
Seat 3: MirkoV224 ($1.24 in chips) 
Seat 4: so0love ($6.89 in chips) 
Seat 5: Ne0net ($2.43 in chips) 
Seat 6: sg.32rus ($0.64 in chips) 
Scaaalll: posts small blind $0.01
MirkoV224: posts big blind $0.02
*** HOLE CARDS ***
Dealt to Scaaalll [9s Th]
so0love: folds 
Ne0net: folds 
sg.32rus: calls $0.02
skitai555: folds 
Scaaalll: calls $0.01
MirkoV224: checks 
*** FLOP *** [Js 7h Jd]
Scaaalll: checks 
MirkoV224: bets $0.06
sg.32rus: folds 
Scaaalll: folds 
Uncalled bet ($0.06) returned to MirkoV224
MirkoV224 collected $0.06 from pot
MirkoV224: doesn't show hand 
*** SUMMARY ***
Total pot $0.06 | Rake $0 
Board [Js 7h Jd]
Seat 1: skitai555 (button) folded before Flop (didn't bet)
Seat 2: Scaaalll (small blind) folded on the Flop
Seat 3: MirkoV224 (big blind) collected ($0.06)
Seat 4: so0love folded before Flop (didn't bet)
Seat 5: Ne0net folded before Flop (didn't bet)
Seat 6: sg.32rus folded on the Flop



PokerStars Zoom Hand #229231540060:  Hold'em No Limit ($0.01/$0.02) - 2021/08/21 22:17:57 CET [2021/08/21 16:17:57 ET]
Table 'Halley' 6-max Seat #1 is the button
Seat 1: RaulacateFolds ($2.29 in chips) 
Seat 2: AtZ3899 ($0.61 in chips) 
Seat 3: Koldun 2636 ($3.05 in chips) 
Seat 4: estelionat171 ($0.91 in chips) 
Seat 5: EevAA190 ($2.23 in chips) 
Seat 6: Scaaalll ($2.02 in chips) 
AtZ3899: posts small blind $0.01
Koldun 2636: posts big blind $0.02
*** HOLE CARDS ***
Dealt to Scaaalll [4s 4h]
estelionat171: folds 
EevAA190: folds 
Scaaalll: raises $0.04 to $0.06
RaulacateFolds: folds 
AtZ3899: calls $0.05
Koldun 2636: folds 
*** FLOP *** [8c 7s 3h]
AtZ3899: checks 
Scaaalll: bets $0.07
AtZ3899: folds 
Uncalled bet ($0.07) returned to Scaaalll
Scaaalll collected $0.14 from pot
Scaaalll: doesn't show hand 
*** SUMMARY ***
Total pot $0.14 | Rake $0 
Board [8c 7s 3h]
Seat 1: RaulacateFolds (button) folded before Flop (didn't bet)
Seat 2: AtZ3899 (small blind) folded on the Flop
Seat 3: Koldun 2636 (big blind) folded before Flop
Seat 4: estelionat171 folded before Flop (didn't bet)
Seat 5: EevAA190 folded before Flop (didn't bet)
Seat 6: Scaaalll collected ($0.14)



PokerStars Zoom Hand #229231555704:  Hold'em No Limit ($0.01/$0.02) - 2021/08/21 22:18:31 CET [2021/08/21 16:18:31 ET]
Table 'Halley' 6-max Seat #1 is the button
Seat 1: Chapaev136 ($3.63 in chips) 
Seat 2: Tabitaji ($2.68 in chips) 
Seat 3: Scaaalll ($2.10 in chips) 
Seat 4: 48159348 ($2.27 in chips) 
Seat 5: mheronmagno ($2.48 in chips) 
Seat 6: Koldun 2636 ($4.11 in chips) 
Tabitaji: posts small blind $0.01
Scaaalll: posts big blind $0.02
*** HOLE CARDS ***
Dealt to Scaaalll [Ks Qd]
48159348: folds 
mheronmagno: raises $0.02 to $0.04
Koldun 2636: folds 
Chapaev136: folds 
Tabitaji: folds 
Scaaalll: calls $0.02
*** FLOP *** [Td 6h 7d]
Scaaalll: checks 
mheronmagno: bets $0.02
Scaaalll: calls $0.02
*** TURN *** [Td 6h 7d] [Qh]
Scaaalll: bets $0.07
mheronmagno: calls $0.07
*** RIVER *** [Td 6h 7d Qh] [3s]
Scaaalll: bets $0.15
mheronmagno: calls $0.15
*** SHOW DOWN ***
Scaaalll: shows [Ks Qd] (a pair of Queens)
mheronmagno: mucks hand 
Scaaalll collected $0.55 from pot
*** SUMMARY ***
Total pot $0.57 | Rake $0.02 
Board [Td 6h 7d Qh 3s]
Seat 1: Chapaev136 (button) folded before Flop (didn't bet)
Seat 2: Tabitaji (small blind) folded before Flop
Seat 3: Scaaalll (big blind) showed [Ks Qd] and won ($0.55) with a pair of Queens
Seat 4: 48159348 folded before Flop (didn't bet)
Seat 5: mheronmagno mucked [Ts Kd]
Seat 6: Koldun 2636 folded before Flop (didn't bet)



PokerStars Zoom Hand #229231572899:  Hold'em No Limit ($0.01/$0.02) - 2021/08/21 22:19:08 CET [2021/08/21 16:19:08 ET]
Table 'Halley' 6-max Seat #1 is the button
Seat 1: Tixon777 ($1.21 in chips) 
Seat 2: arturtsutsaev ($1.06 in chips) 
Seat 3: alecha11 ($2.07 in chips) 
Seat 4: dcd113 ($2.92 in chips) 
Seat 5: Scaaalll ($2.37 in chips) 
Seat 6: Mikeloko182 ($2.01 in chips) 
arturtsutsaev: posts small blind $0.01
alecha11: posts big blind $0.02
*** HOLE CARDS ***
Dealt to Scaaalll [5d 5s]
dcd113: folds 
arturtsutsaev is disconnected 
Scaaalll: raises $0.04 to $0.06
Mikeloko182: folds 
Tixon777: folds 
arturtsutsaev: folds 
alecha11: folds 
Uncalled bet ($0.04) returned to Scaaalll
Scaaalll collected $0.05 from pot
Scaaalll: doesn't show hand 
*** SUMMARY ***
Total pot $0.05 | Rake $0 
Seat 1: Tixon777 (button) folded before Flop (didn't bet)
Seat 2: arturtsutsaev (small blind) folded before Flop
Seat 3: alecha11 (big blind) folded before Flop
Seat 4: dcd113 folded before Flop (didn't bet)
Seat 5: Scaaalll collected ($0.05)
Seat 6: Mikeloko182 folded before Flop (didn't bet)



PokerStars Zoom Hand #229231582119:  Hold'em No Limit ($0.01/$0.02) - 2021/08/21 22:19:28 CET [2021/08/21 16:19:28 ET]
Table 'Halley' 6-max Seat #1 is the button
Seat 1: benzzo420 ($1.08 in chips) 
Seat 2: Scaaalll ($2.40 in chips) 
Seat 3: Ramirres ($2.18 in chips) 
Seat 4: boa juice ($1.80 in chips) 
Seat 5: lexus00174 ($2 in chips) 
Seat 6: RrriotGrrrl ($9.27 in chips) 
Scaaalll: posts small blind $0.01
Ramirres: posts big blind $0.02
*** HOLE CARDS ***
Dealt to Scaaalll [7d 5c]
boa juice: folds 
boa juice is disconnected 
lexus00174: folds 
RrriotGrrrl: raises $0.03 to $0.05
benzzo420: folds 
Scaaalll: folds 
Ramirres: folds 
Uncalled bet ($0.03) returned to RrriotGrrrl
RrriotGrrrl collected $0.05 from pot
RrriotGrrrl: doesn't show hand 
*** SUMMARY ***
Total pot $0.05 | Rake $0 
Seat 1: benzzo420 (button) folded before Flop (didn't bet)
Seat 2: Scaaalll (small blind) folded before Flop
Seat 3: Ramirres (big blind) folded before Flop
Seat 4: boa juice folded before Flop (didn't bet)
Seat 5: lexus00174 folded before Flop (didn't bet)
Seat 6: RrriotGrrrl collected ($0.05)



PokerStars Zoom Hand #229231587113:  Hold'em No Limit ($0.01/$0.02) - 2021/08/21 22:19:39 CET [2021/08/21 16:19:39 ET]
Table 'Halley' 6-max Seat #1 is the button
Seat 1: Scaaalll ($2.39 in chips) 
Seat 2: IceTdannyB ($3.36 in chips) 
Seat 3: JackNineRules ($2 in chips) 
Seat 4: NOLUWDtC ($2.04 in chips) 
Seat 5: snowy_96 ($2 in chips) 
Seat 6: 888lifeIS ($2.01 in chips) 
IceTdannyB: posts small blind $0.01
JackNineRules: posts big blind $0.02
*** HOLE CARDS ***
Dealt to Scaaalll [5h 8d]
NOLUWDtC: folds 
snowy_96: folds 
888lifeIS: folds 
NOLUWDtC is disconnected 
Scaaalll: folds 
IceTdannyB: folds 
Uncalled bet ($0.01) returned to JackNineRules
JackNineRules collected $0.02 from pot
JackNineRules: doesn't show hand 
IceTdannyB is disconnected 
*** SUMMARY ***
Total pot $0.02 | Rake $0 
Seat 1: Scaaalll (button) folded before Flop (didn't bet)
Seat 2: IceTdannyB (small blind) folded before Flop
Seat 3: JackNineRules (big blind) collected ($0.02)
Seat 4: NOLUWDtC folded before Flop (didn't bet)
Seat 5: snowy_96 folded before Flop (didn't bet)
Seat 6: 888lifeIS folded before Flop (didn't bet)



PokerStars Zoom Hand #229231589845:  Hold'em No Limit ($0.01/$0.02) - 2021/08/21 22:19:45 CET [2021/08/21 16:19:45 ET]
Table 'Halley' 6-max Seat #1 is the button
Seat 1: BenOKopen ($2 in chips) 
Seat 2: jamal514 ($2 in chips) 
Seat 3: ARTMVSLV ($4.21 in chips) 
Seat 4: Scaaalll ($2.39 in chips) 
Seat 5: AtZ3899 ($1.89 in chips) 
Seat 6: sg.32rus ($0.99 in chips) 
jamal514: posts small blind $0.01
ARTMVSLV: posts big blind $0.02
*** HOLE CARDS ***
Dealt to Scaaalll [Jc Ac]
Scaaalll: raises $0.04 to $0.06
AtZ3899: calls $0.06
sg.32rus: folds 
BenOKopen: folds 
jamal514: folds 
ARTMVSLV: folds 
*** FLOP *** [8s 9s 7c]
Scaaalll: bets $0.09
AtZ3899: calls $0.09
*** TURN *** [8s 9s 7c] [Ks]
Scaaalll: checks 
AtZ3899: checks 
*** RIVER *** [8s 9s 7c Ks] [8c]
Scaaalll: checks 
AtZ3899: checks 
*** SHOW DOWN ***
Scaaalll: shows [Jc Ac] (a pair of Eights)
AtZ3899: shows [Ad 9d] (two pair, Nines and Eights)
AtZ3899 collected $0.32 from pot
*** SUMMARY ***
Total pot $0.33 | Rake $0.01 
Board [8s 9s 7c Ks 8c]
Seat 1: BenOKopen (button) folded before Flop (didn't bet)
Seat 2: jamal514 (small blind) folded before Flop
Seat 3: ARTMVSLV (big blind) folded before Flop
Seat 4: Scaaalll showed [Jc Ac] and lost with a pair of Eights
Seat 5: AtZ3899 showed [Ad 9d] and won ($0.32) with two pair, Nines and Eights
Seat 6: sg.32rus folded before Flop (didn't bet)



PokerStars Zoom Hand #229231614135:  Hold'em No Limit ($0.01/$0.02) - 2021/08/21 22:20:38 CET [2021/08/21 16:20:38 ET]
Table 'Halley' 6-max Seat #1 is the button
Seat 1: estelionat171 ($1.12 in chips) 
Seat 2: ADWish ($1.67 in chips) 
Seat 3: Scaaalll ($2.24 in chips) 
Seat 4: pipecmolodec ($2.36 in chips) 
Seat 5: Dr.stromg ($2 in chips) 
Seat 6: vovo4kapooh ($2.29 in chips) 
ADWish: posts small blind $0.01
Scaaalll: posts big blind $0.02
*** HOLE CARDS ***
Dealt to Scaaalll [8d Jh]
pipecmolodec: folds 
Dr.stromg: folds 
vovo4kapooh: folds 
estelionat171: folds 
ADWish: folds 
Uncalled bet ($0.01) returned to Scaaalll
Scaaalll collected $0.02 from pot
Scaaalll: doesn't show hand 
*** SUMMARY ***
Total pot $0.02 | Rake $0 
Seat 1: estelionat171 (button) folded before Flop (didn't bet)
Seat 2: ADWish (small blind) folded before Flop
Seat 3: Scaaalll (big blind) collected ($0.02)
Seat 4: pipecmolodec folded before Flop (didn't bet)
Seat 5: Dr.stromg folded before Flop (didn't bet)
Seat 6: vovo4kapooh folded before Flop (didn't bet)



PokerStars Zoom Hand #229231610091:  Hold'em No Limit ($0.01/$0.02) - 2021/08/21 22:20:29 CET [2021/08/21 16:20:29 ET]
Table 'Halley' 6-max Seat #1 is the button
Seat 1: ugi-dugi ($2.73 in chips) 
Seat 2: innexplus ($2.12 in chips) 
Seat 3: Vov4ik071 ($1.72 in chips) 
Seat 4: Pechorin.G ($2.01 in chips) 
Seat 5: ARTMVSLV ($3.99 in chips) 
Seat 6: Scaaalll ($2.24 in chips) 
innexplus: posts small blind $0.01
Vov4ik071: posts big blind $0.02
*** HOLE CARDS ***
Dealt to Scaaalll [2s 3c]
Pechorin.G: folds 
ARTMVSLV: folds 
Scaaalll: folds 
ugi-dugi: folds 
innexplus: raises $0.03 to $0.05
Vov4ik071: calls $0.03
*** FLOP *** [5h Td 3h]
innexplus: bets $0.03
Vov4ik071: raises $1.64 to $1.67 and is all-in
innexplus: calls $1.64
*** TURN *** [5h Td 3h] [3s]
*** RIVER *** [5h Td 3h 3s] [Kd]
*** SHOW DOWN ***
innexplus: shows [Js Jh] (two pair, Jacks and Threes)
Vov4ik071: shows [Qh Ts] (two pair, Tens and Threes)
innexplus cashed out the hand for $2.53 | Cash Out Fee $0.03
*** SUMMARY ***
Total pot $3.44 | Rake $0.12 
Board [5h Td 3h 3s Kd]
Seat 1: ugi-dugi (button) folded before Flop (didn't bet)
Seat 2: innexplus (small blind) showed [Js Jh] and won ($3.32) with two pair, Jacks and Threes (pot not awarded as player cashed out)
Seat 3: Vov4ik071 (big blind) showed [Qh Ts] and lost with two pair, Tens and Threes
Seat 4: Pechorin.G folded before Flop (didn't bet)
Seat 5: ARTMVSLV folded before Flop (didn't bet)
Seat 6: Scaaalll folded before Flop (didn't bet)



PokerStars Zoom Hand #229231624607:  Hold'em No Limit ($0.01/$0.02) - 2021/08/21 22:21:01 CET [2021/08/21 16:21:01 ET]
Table 'Halley' 6-max Seat #1 is the button
Seat 1: PapiMik3 ($2 in chips) 
Seat 2: olcham7 ($3.06 in chips) 
Seat 3: CordiPS ($4.99 in chips) 
Seat 4: AlexGTPS ($3.81 in chips) 
Seat 5: shingo594 ($3.65 in chips) 
Seat 6: Scaaalll ($2.24 in chips) 
olcham7: posts small blind $0.01
CordiPS: posts big blind $0.02
*** HOLE CARDS ***
Dealt to Scaaalll [4d 3h]
AlexGTPS: folds 
shingo594: folds 
Scaaalll: folds 
PapiMik3: folds 
olcham7: folds 
Uncalled bet ($0.01) returned to CordiPS
shingo594 is disconnected 
CordiPS collected $0.02 from pot
CordiPS: doesn't show hand 
*** SUMMARY ***
Total pot $0.02 | Rake $0 
Seat 1: PapiMik3 (button) folded before Flop (didn't bet)
Seat 2: olcham7 (small blind) folded before Flop
Seat 3: CordiPS (big blind) collected ($0.02)
Seat 4: AlexGTPS folded before Flop (didn't bet)
Seat 5: shingo594 folded before Flop (didn't bet)
Seat 6: Scaaalll folded before Flop (didn't bet)



PokerStars Zoom Hand #229231618741:  Hold'em No Limit ($0.01/$0.02) - 2021/08/21 22:20:48 CET [2021/08/21 16:20:48 ET]
Table 'Halley' 6-max Seat #1 is the button
Seat 1: dinoVIEIRA ($3.11 in chips) 
Seat 2: NoEff0rt2w1n ($2.38 in chips) 
Seat 3: EdwardF95 ($2 in chips) 
Seat 4: Dulli007 ($5.24 in chips) 
Seat 5: Scaaalll ($2.25 in chips) 
Seat 6: PapiMik3 ($2.80 in chips) 
NoEff0rt2w1n: posts small blind $0.01
EdwardF95: posts big blind $0.02
*** HOLE CARDS ***
Dealt to Scaaalll [2c Js]
Dulli007: folds 
Scaaalll: folds 
PapiMik3: raises $0.04 to $0.06
dinoVIEIRA: folds 
NoEff0rt2w1n: folds 
EdwardF95: folds 
Uncalled bet ($0.04) returned to PapiMik3
PapiMik3 collected $0.05 from pot
PapiMik3: doesn't show hand 
*** SUMMARY ***
Total pot $0.05 | Rake $0 
Seat 1: dinoVIEIRA (button) folded before Flop (didn't bet)
Seat 2: NoEff0rt2w1n (small blind) folded before Flop
Seat 3: EdwardF95 (big blind) folded before Flop
Seat 4: Dulli007 folded before Flop (didn't bet)
Seat 5: Scaaalll folded before Flop (didn't bet)
Seat 6: PapiMik3 collected ($0.05)



PokerStars Zoom Hand #229231620514:  Hold'em No Limit ($0.01/$0.02) - 2021/08/21 22:20:52 CET [2021/08/21 16:20:52 ET]
Table 'Halley' 6-max Seat #1 is the button
Seat 1: Dipod1991 ($2.10 in chips) 
Seat 2: z3317111711 ($4.18 in chips) 
Seat 3: olga3021221 ($5.03 in chips) 
Seat 4: Scaaalll ($2.25 in chips) 
Seat 5: Tony-Broke ($2 in chips) 
Seat 6: Dulli007 ($5.24 in chips) 
z3317111711: posts small blind $0.01
olga3021221: posts big blind $0.02
*** HOLE CARDS ***
Dealt to Scaaalll [6s 8h]
Scaaalll: folds 
Tony-Broke: raises $0.04 to $0.06
Dulli007: calls $0.06
Dipod1991: folds 
z3317111711: folds 
olga3021221: folds 
*** FLOP *** [Td 4c 8s]
Tony-Broke: bets $0.09
Dulli007: folds 
Uncalled bet ($0.09) returned to Tony-Broke
Tony-Broke collected $0.14 from pot
Tony-Broke: doesn't show hand 
*** SUMMARY ***
Total pot $0.15 | Rake $0.01 
Board [Td 4c 8s]
Seat 1: Dipod1991 (button) folded before Flop (didn't bet)
Seat 2: z3317111711 (small blind) folded before Flop
Seat 3: olga3021221 (big blind) folded before Flop
Seat 4: Scaaalll folded before Flop (didn't bet)
Seat 5: Tony-Broke collected ($0.14)
Seat 6: Dulli007 folded on the Flop



PokerStars Zoom Hand #229231622314:  Hold'em No Limit ($0.01/$0.02) - 2021/08/21 22:20:56 CET [2021/08/21 16:20:56 ET]
Table 'Halley' 6-max Seat #1 is the button
Seat 1: rancing87 ($2.01 in chips) 
Seat 2: Scaaalll ($2.25 in chips) 
Seat 3: Axel201388 ($1 in chips) 
Seat 4: LucasG155 ($3.21 in chips) 
Seat 5: Tony-Broke ($2 in chips) 
Seat 6: Fanatspartak ($1.50 in chips) 
Scaaalll: posts small blind $0.01
Axel201388: posts big blind $0.02
*** HOLE CARDS ***
Dealt to Scaaalll [2s Th]
LucasG155: folds 
Tony-Broke: folds 
Fanatspartak: raises $0.04 to $0.06
rancing87: folds 
Scaaalll: folds 
Axel201388: folds 
Uncalled bet ($0.04) returned to Fanatspartak
Fanatspartak collected $0.05 from pot
Fanatspartak: doesn't show hand 
*** SUMMARY ***
Total pot $0.05 | Rake $0 
Seat 1: rancing87 (button) folded before Flop (didn't bet)
Seat 2: Scaaalll (small blind) folded before Flop
Seat 3: Axel201388 (big blind) folded before Flop
Seat 4: LucasG155 folded before Flop (didn't bet)
Seat 5: Tony-Broke folded before Flop (didn't bet)
Seat 6: Fanatspartak collected ($0.05)



PokerStars Zoom Hand #229231626930:  Hold'em No Limit ($0.01/$0.02) - 2021/08/21 22:21:06 CET [2021/08/21 16:21:06 ET]
Table 'Halley' 6-max Seat #1 is the button
Seat 1: Scaaalll ($2.24 in chips) 
Seat 2: vovo4kapooh ($2.01 in chips) 
Seat 3: bananAAbandit ($6.58 in chips) 
Seat 4: 888lifeIS ($2.03 in chips) 
Seat 5: lexus00174 ($1.78 in chips) 
Seat 6: Hantsirg ($0.71 in chips) 
vovo4kapooh: posts small blind $0.01
bananAAbandit: posts big blind $0.02
*** HOLE CARDS ***
Dealt to Scaaalll [3c Ah]
888lifeIS: folds 
Hantsirg is disconnected 
lexus00174: folds 
Hantsirg: folds 
Scaaalll: raises $0.02 to $0.04
vovo4kapooh: calls $0.03
bananAAbandit: calls $0.02
*** FLOP *** [4c 6d Kd]
vovo4kapooh: checks 
bananAAbandit: checks 
Scaaalll: bets $0.08
vovo4kapooh: folds 
bananAAbandit: folds 
Uncalled bet ($0.08) returned to Scaaalll
Scaaalll collected $0.12 from pot
Scaaalll: doesn't show hand 
*** SUMMARY ***
Total pot $0.12 | Rake $0 
Board [4c 6d Kd]
Seat 1: Scaaalll (button) collected ($0.12)
Seat 2: vovo4kapooh (small blind) folded on the Flop
Seat 3: bananAAbandit (big blind) folded on the Flop
Seat 4: 888lifeIS folded before Flop (didn't bet)
Seat 5: lexus00174 folded before Flop (didn't bet)
Seat 6: Hantsirg folded before Flop (didn't bet)



PokerStars Zoom Hand #229231648779:  Hold'em No Limit ($0.01/$0.02) - 2021/08/21 22:21:54 CET [2021/08/21 16:21:54 ET]
Table 'Halley' 6-max Seat #1 is the button
Seat 1: Clavis Noa ($2.60 in chips) 
Seat 2: ARTMVSLV ($5.78 in chips) 
Seat 3: SKV_1985 ($2.19 in chips) 
Seat 4: Scaaalll ($2.32 in chips) 
Seat 5: Finderra ($2.39 in chips) 
Seat 6: Maradonna663 ($2.18 in chips) 
ARTMVSLV: posts small blind $0.01
SKV_1985: posts big blind $0.02
*** HOLE CARDS ***
Dealt to Scaaalll [8c 4c]
Scaaalll: folds 
Finderra: raises $0.04 to $0.06
Maradonna663: raises $0.14 to $0.20
Clavis Noa: folds 
ARTMVSLV: folds 
SKV_1985: folds 
Finderra: folds 
Uncalled bet ($0.14) returned to Maradonna663
Maradonna663 collected $0.15 from pot
Maradonna663: doesn't show hand 
*** SUMMARY ***
Total pot $0.15 | Rake $0 
Seat 1: Clavis Noa (button) folded before Flop (didn't bet)
Seat 2: ARTMVSLV (small blind) folded before Flop
Seat 3: SKV_1985 (big blind) folded before Flop
Seat 4: Scaaalll folded before Flop (didn't bet)
Seat 5: Finderra folded before Flop
Seat 6: Maradonna663 collected ($0.15)



PokerStars Zoom Hand #229231652490:  Hold'em No Limit ($0.01/$0.02) - 2021/08/21 22:22:02 CET [2021/08/21 16:22:02 ET]
Table 'Halley' 6-max Seat #1 is the button
Seat 1: KonopDima ($2.08 in chips) 
Seat 2: Alex19942211 ($1 in chips) 
Seat 3: Scaaalll ($2.32 in chips) 
Seat 4: RrriotGrrrl ($9.32 in chips) 
Seat 5: Tixon777 ($1.18 in chips) 
Seat 6: maurivispa10 ($3.22 in chips) 
Alex19942211: posts small blind $0.01
Scaaalll: posts big blind $0.02
*** HOLE CARDS ***
Dealt to Scaaalll [Ad 6h]
RrriotGrrrl: folds 
Tixon777: folds 
Alex19942211 is disconnected 
maurivispa10: raises $0.03 to $0.05
KonopDima: raises $0.13 to $0.18
Alex19942211: folds 
Scaaalll: folds 
maurivispa10: calls $0.13
*** FLOP *** [3d Jc Qd]
maurivispa10: checks 
KonopDima: bets $0.19
maurivispa10: folds 
Uncalled bet ($0.19) returned to KonopDima
KonopDima collected $0.38 from pot
KonopDima: doesn't show hand 
*** SUMMARY ***
Total pot $0.39 | Rake $0.01 
Board [3d Jc Qd]
Seat 1: KonopDima (button) collected ($0.38)
Seat 2: Alex19942211 (small blind) folded before Flop
Seat 3: Scaaalll (big blind) folded before Flop
Seat 4: RrriotGrrrl folded before Flop (didn't bet)
Seat 5: Tixon777 folded before Flop (didn't bet)
Seat 6: maurivispa10 folded on the Flop



PokerStars Zoom Hand #229231662511:  Hold'em No Limit ($0.01/$0.02) - 2021/08/21 22:22:24 CET [2021/08/21 16:22:24 ET]
Table 'Halley' 6-max Seat #1 is the button
Seat 1: Gullsnyta ($5.33 in chips) 
Seat 2: BlackhawKK's ($3.39 in chips) 
Seat 3: Tony-Broke ($2.08 in chips) 
Seat 4: Scaaalll ($2.30 in chips) 
Seat 5: Enoffllescini ($2.16 in chips) 
Seat 6: 365p2eva ($3.75 in chips) 
BlackhawKK's: posts small blind $0.01
Tony-Broke: posts big blind $0.02
*** HOLE CARDS ***
Dealt to Scaaalll [Qh Td]
Scaaalll: folds 
Enoffllescini: folds 
365p2eva: folds 
Gullsnyta: calls $0.02
BlackhawKK's: folds 
Tony-Broke: checks 
*** FLOP *** [Js 4h 8c]
Tony-Broke: checks 
Gullsnyta: checks 
*** TURN *** [Js 4h 8c] [4s]
Tony-Broke: checks 
Gullsnyta: checks 
*** RIVER *** [Js 4h 8c 4s] [As]
Tony-Broke: checks 
Gullsnyta: checks 
*** SHOW DOWN ***
Tony-Broke: shows [7h Jd] (two pair, Jacks and Fours)
Gullsnyta: mucks hand 
Tony-Broke collected $0.05 from pot
*** SUMMARY ***
Total pot $0.05 | Rake $0 
Board [Js 4h 8c 4s As]
Seat 1: Gullsnyta (button) mucked [5c 6c]
Seat 2: BlackhawKK's (small blind) folded before Flop
Seat 3: Tony-Broke (big blind) showed [7h Jd] and won ($0.05) with two pair, Jacks and Fours
Seat 4: Scaaalll folded before Flop (didn't bet)
Seat 5: Enoffllescini folded before Flop (didn't bet)
Seat 6: 365p2eva folded before Flop (didn't bet)



PokerStars Zoom Hand #229231669890:  Hold'em No Limit ($0.01/$0.02) - 2021/08/21 22:22:40 CET [2021/08/21 16:22:40 ET]
Table 'Halley' 6-max Seat #1 is the button
Seat 1: EevAA190 ($2.03 in chips) 
Seat 2: Iwanb4 ($2.05 in chips) 
Seat 3: HellNative ($2.32 in chips) 
Seat 4: dkno77 ($5.49 in chips) 
Seat 5: vovo4kapooh ($2.26 in chips) 
Seat 6: Scaaalll ($2.29 in chips) 
Iwanb4: posts small blind $0.01
HellNative: posts big blind $0.02
*** HOLE CARDS ***
Dealt to Scaaalll [3c Ac]
dkno77: folds 
vovo4kapooh: folds 
Scaaalll: raises $0.04 to $0.06
EevAA190: folds 
Iwanb4: folds 
HellNative: folds 
Uncalled bet ($0.04) returned to Scaaalll
Scaaalll collected $0.05 from pot
Scaaalll: doesn't show hand 
*** SUMMARY ***
Total pot $0.05 | Rake $0 
Seat 1: EevAA190 (button) folded before Flop (didn't bet)
Seat 2: Iwanb4 (small blind) folded before Flop
Seat 3: HellNative (big blind) folded before Flop
Seat 4: dkno77 folded before Flop (didn't bet)
Seat 5: vovo4kapooh folded before Flop (didn't bet)
Seat 6: Scaaalll collected ($0.05)



PokerStars Zoom Hand #229231658393:  Hold'em No Limit ($0.01/$0.02) - 2021/08/21 22:22:15 CET [2021/08/21 16:22:15 ET]
Table 'Halley' 6-max Seat #1 is the button
Seat 1: viktor2935 ($1 in chips) 
Seat 2: kahzura ($2 in chips) 
Seat 3: KoAlRy ($2 in chips) 
Seat 4: trickywizard64 ($2.36 in chips) 
Seat 5: Scaaalll ($2.30 in chips) 
Seat 6: kotpigav ($1.18 in chips) 
kahzura: posts small blind $0.01
KoAlRy: posts big blind $0.02
*** HOLE CARDS ***
Dealt to Scaaalll [9c Th]
kotpigav is disconnected 
trickywizard64: folds 
Scaaalll: folds 
kotpigav: folds 
viktor2935: calls $0.02
kahzura: folds 
KoAlRy: checks 
*** FLOP *** [2h Qs 8d]
KoAlRy: checks 
viktor2935: checks 
*** TURN *** [2h Qs 8d] [Js]
KoAlRy: checks 
viktor2935: checks 
*** RIVER *** [2h Qs 8d Js] [6d]
KoAlRy: checks 
viktor2935: checks 
*** SHOW DOWN ***
KoAlRy: shows [Kd 8c] (a pair of Eights)
viktor2935: mucks hand 
KoAlRy collected $0.05 from pot
*** SUMMARY ***
Total pot $0.05 | Rake $0 
Board [2h Qs 8d Js 6d]
Seat 1: viktor2935 (button) mucked [7s Ac]
Seat 2: kahzura (small blind) folded before Flop
Seat 3: KoAlRy (big blind) showed [Kd 8c] and won ($0.05) with a pair of Eights
Seat 4: trickywizard64 folded before Flop (didn't bet)
Seat 5: Scaaalll folded before Flop (didn't bet)
Seat 6: kotpigav folded before Flop (didn't bet)



PokerStars Zoom Hand #229231664305:  Hold'em No Limit ($0.01/$0.02) - 2021/08/21 22:22:28 CET [2021/08/21 16:22:28 ET]
Table 'Halley' 6-max Seat #1 is the button
Seat 1: pavlo8855 ($2.21 in chips) 
Seat 2: Scaaalll ($2.30 in chips) 
Seat 3: GVMELLO ($1.99 in chips) 
Seat 4: kgatihertzavis ($1.25 in chips) 
Seat 5: Ne0net ($2.12 in chips) 
Seat 6: felipeciji ($2 in chips) 
Scaaalll: posts small blind $0.01
GVMELLO: posts big blind $0.02
*** HOLE CARDS ***
Dealt to Scaaalll [4c Ks]
kgatihertzavis: folds 
kgatihertzavis is disconnected 
Ne0net: folds 
felipeciji: raises $0.03 to $0.05
pavlo8855: folds 
Scaaalll: folds 
GVMELLO: raises $0.17 to $0.22
felipeciji: calls $0.17
*** FLOP *** [6h 2c 3h]
GVMELLO: bets $0.14
felipeciji: folds 
Uncalled bet ($0.14) returned to GVMELLO
GVMELLO collected $0.43 from pot
GVMELLO: doesn't show hand 
*** SUMMARY ***
Total pot $0.45 | Rake $0.02 
Board [6h 2c 3h]
Seat 1: pavlo8855 (button) folded before Flop (didn't bet)
Seat 2: Scaaalll (small blind) folded before Flop
Seat 3: GVMELLO (big blind) collected ($0.43)
Seat 4: kgatihertzavis folded before Flop (didn't bet)
Seat 5: Ne0net folded before Flop (didn't bet)
Seat 6: felipeciji folded on the Flop



PokerStars Zoom Hand #229231678658:  Hold'em No Limit ($0.01/$0.02) - 2021/08/21 22:22:59 CET [2021/08/21 16:22:59 ET]
Table 'Halley' 6-max Seat #1 is the button
Seat 1: DaBaDaBaDooo ($2.49 in chips) 
Seat 2: Henry Chinasky ($1.98 in chips) 
Seat 3: Scaaalll ($2.32 in chips) 
Seat 4: Wegezin ($2.15 in chips) 
Seat 5: Feliciano16 ($3.63 in chips) 
Seat 6: rpycmbEM ($4.31 in chips) 
Henry Chinasky: posts small blind $0.01
Scaaalll: posts big blind $0.02
*** HOLE CARDS ***
Dealt to Scaaalll [9d 9s]
Wegezin: folds 
Feliciano16: folds 
rpycmbEM: folds 
DaBaDaBaDooo: folds 
Henry Chinasky: raises $0.04 to $0.06
Scaaalll: calls $0.04
*** FLOP *** [6d Th 3h]
Henry Chinasky: bets $0.05
Scaaalll: calls $0.05
*** TURN *** [6d Th 3h] [9h]
Henry Chinasky: checks 
Scaaalll: bets $0.14
Henry Chinasky: folds 
Uncalled bet ($0.14) returned to Scaaalll
Scaaalll collected $0.21 from pot
Scaaalll: doesn't show hand 
*** SUMMARY ***
Total pot $0.22 | Rake $0.01 
Board [6d Th 3h 9h]
Seat 1: DaBaDaBaDooo (button) folded before Flop (didn't bet)
Seat 2: Henry Chinasky (small blind) folded on the Turn
Seat 3: Scaaalll (big blind) collected ($0.21)
Seat 4: Wegezin folded before Flop (didn't bet)
Seat 5: Feliciano16 folded before Flop (didn't bet)
Seat 6: rpycmbEM folded before Flop (didn't bet)



PokerStars Zoom Hand #229231719627:  Hold'em No Limit ($0.01/$0.02) - 2021/08/21 22:24:29 CET [2021/08/21 16:24:29 ET]
Table 'Halley' 6-max Seat #1 is the button
Seat 1: Jacon2905 ($2.02 in chips) 
Seat 2: FabOliveira9 ($2.14 in chips) 
Seat 3: feybys ($3.43 in chips) 
Seat 4: Scaaalll ($2.42 in chips) 
Seat 5: Tibelloni ($0.74 in chips) 
Seat 6: Mad_Clock ($2.20 in chips) 
FabOliveira9: posts small blind $0.01
feybys: posts big blind $0.02
*** HOLE CARDS ***
Dealt to Scaaalll [Ts 3d]
Scaaalll: folds 
Tibelloni: folds 
Tibelloni is disconnected 
Mad_Clock: raises $0.05 to $0.07
Jacon2905: folds 
FabOliveira9: folds 
feybys: folds 
Uncalled bet ($0.05) returned to Mad_Clock
Mad_Clock collected $0.05 from pot
Mad_Clock: doesn't show hand 
*** SUMMARY ***
Total pot $0.05 | Rake $0 
Seat 1: Jacon2905 (button) folded before Flop (didn't bet)
Seat 2: FabOliveira9 (small blind) folded before Flop
Seat 3: feybys (big blind) folded before Flop
Seat 4: Scaaalll folded before Flop (didn't bet)
Seat 5: Tibelloni folded before Flop (didn't bet)
Seat 6: Mad_Clock collected ($0.05)



PokerStars Zoom Hand #229231712296:  Hold'em No Limit ($0.01/$0.02) - 2021/08/21 22:24:13 CET [2021/08/21 16:24:13 ET]
Table 'Halley' 6-max Seat #1 is the button
Seat 1: Clavis Noa ($2.49 in chips) 
Seat 2: BriceDo1917 ($2.15 in chips) 
Seat 3: layschan ($3.12 in chips) 
Seat 4: ChowMangao ($5.76 in chips) 
Seat 5: Scaaalll ($2.42 in chips) 
Seat 6: Lamro50 ($10.22 in chips) 
BriceDo1917: posts small blind $0.01
layschan: posts big blind $0.02
*** HOLE CARDS ***
Dealt to Scaaalll [4h Qh]
BriceDo1917 is disconnected 
ChowMangao: folds 
Scaaalll: folds 
Lamro50: calls $0.02
Clavis Noa: raises $0.07 to $0.09
BriceDo1917: folds 
layschan: raises $0.21 to $0.30
Lamro50: folds 
Clavis Noa: calls $0.21
*** FLOP *** [8s 8c 7c]
layschan: bets $0.31
Clavis Noa: calls $0.31
*** TURN *** [8s 8c 7c] [Td]
layschan: checks 
Clavis Noa: checks 
*** RIVER *** [8s 8c 7c Td] [3d]
layschan: bets $2.51 and is all-in
Clavis Noa: folds 
Uncalled bet ($2.51) returned to layschan
layschan collected $1.21 from pot
layschan: doesn't show hand 
*** SUMMARY ***
Total pot $1.25 | Rake $0.04 
Board [8s 8c 7c Td 3d]
Seat 1: Clavis Noa (button) folded on the River
Seat 2: BriceDo1917 (small blind) folded before Flop
Seat 3: layschan (big blind) collected ($1.21)
Seat 4: ChowMangao folded before Flop (didn't bet)
Seat 5: Scaaalll folded before Flop (didn't bet)
Seat 6: Lamro50 folded before Flop



PokerStars Zoom Hand #229231725965:  Hold'em No Limit ($0.01/$0.02) - 2021/08/21 22:24:43 CET [2021/08/21 16:24:43 ET]
Table 'Halley' 6-max Seat #1 is the button
Seat 1: Scaaalll ($2.41 in chips) 
Seat 2: F_oksi(BLR) ($1.71 in chips) 
Seat 3: kahzura ($2 in chips) 
Seat 4: csmall14 ($2 in chips) 
Seat 5: Daino G ($2.17 in chips) 
Seat 6: PapiMik3 ($2.75 in chips) 
F_oksi(BLR): posts small blind $0.01
kahzura: posts big blind $0.02
*** HOLE CARDS ***
Dealt to Scaaalll [8h 6s]
csmall14: folds 
Daino G: folds 
PapiMik3: folds 
Scaaalll: folds 
F_oksi(BLR): raises $0.04 to $0.06
kahzura: folds 
Uncalled bet ($0.04) returned to F_oksi(BLR)
F_oksi(BLR) collected $0.04 from pot
F_oksi(BLR): doesn't show hand 
*** SUMMARY ***
Total pot $0.04 | Rake $0 
Seat 1: Scaaalll (button) folded before Flop (didn't bet)
Seat 2: F_oksi(BLR) (small blind) collected ($0.04)
Seat 3: kahzura (big blind) folded before Flop
Seat 4: csmall14 folded before Flop (didn't bet)
Seat 5: Daino G folded before Flop (didn't bet)
Seat 6: PapiMik3 folded before Flop (didn't bet)



PokerStars Zoom Hand #229231721446:  Hold'em No Limit ($0.01/$0.02) - 2021/08/21 22:24:33 CET [2021/08/21 16:24:33 ET]
Table 'Halley' 6-max Seat #1 is the button
Seat 1: rodrigoasor ($0.37 in chips) 
Seat 2: Scaaalll ($2.42 in chips) 
Seat 3: SKV_1985 ($2.52 in chips) 
Seat 4: KoAlRy ($2.08 in chips) 
Seat 5: tazar34_777 ($1.98 in chips) 
Seat 6: Luk Hander ($1.99 in chips) 
Scaaalll: posts small blind $0.01
SKV_1985: posts big blind $0.02
*** HOLE CARDS ***
Dealt to Scaaalll [6d Kc]
KoAlRy: folds 
tazar34_777: folds 
Luk Hander: raises $0.03 to $0.05
rodrigoasor: folds 
Scaaalll: folds 
SKV_1985: calls $0.03
*** FLOP *** [6c As 5h]
SKV_1985: checks 
Luk Hander: bets $0.03
SKV_1985: folds 
Uncalled bet ($0.03) returned to Luk Hander
Luk Hander collected $0.11 from pot
Luk Hander: doesn't show hand 
*** SUMMARY ***
Total pot $0.11 | Rake $0 
Board [6c As 5h]
Seat 1: rodrigoasor (button) folded before Flop (didn't bet)
Seat 2: Scaaalll (small blind) folded before Flop
Seat 3: SKV_1985 (big blind) folded on the Flop
Seat 4: KoAlRy folded before Flop (didn't bet)
Seat 5: tazar34_777 folded before Flop (didn't bet)
Seat 6: Luk Hander collected ($0.11)



PokerStars Zoom Hand #229231714084:  Hold'em No Limit ($0.01/$0.02) - 2021/08/21 22:24:17 CET [2021/08/21 16:24:17 ET]
Table 'Halley' 6-max Seat #1 is the button
Seat 1: Scaaalll ($2.42 in chips) 
Seat 2: zbixxx ($3.28 in chips) 
Seat 3: Maradonna663 ($1.83 in chips) 
Seat 4: HWalshy ($2.55 in chips) 
Seat 5: marcoshig864 ($3.21 in chips) 
Seat 6: vovo4kapooh ($3.64 in chips) 
zbixxx: posts small blind $0.01
Maradonna663: posts big blind $0.02
*** HOLE CARDS ***
Dealt to Scaaalll [Ts 9h]
HWalshy: raises $0.02 to $0.04
marcoshig864: folds 
vovo4kapooh: calls $0.04
Scaaalll: folds 
zbixxx: folds 
Maradonna663: calls $0.02
*** FLOP *** [Tc 5s 3c]
Maradonna663: checks 
HWalshy: bets $0.11
Maradonna663 is disconnected 
vovo4kapooh: raises $0.26 to $0.37
Maradonna663: folds 
HWalshy: calls $0.26
*** TURN *** [Tc 5s 3c] [7h]
HWalshy: checks 
vovo4kapooh: bets $0.84
HWalshy: calls $0.84
*** RIVER *** [Tc 5s 3c 7h] [3d]
HWalshy: checks 
vovo4kapooh: bets $2.39 and is all-in
HWalshy: folds 
Uncalled bet ($2.39) returned to vovo4kapooh
vovo4kapooh collected $2.46 from pot
vovo4kapooh: doesn't show hand 
*** SUMMARY ***
Total pot $2.55 | Rake $0.09 
Board [Tc 5s 3c 7h 3d]
Seat 1: Scaaalll (button) folded before Flop (didn't bet)
Seat 2: zbixxx (small blind) folded before Flop
Seat 3: Maradonna663 (big blind) folded on the Flop
Seat 4: HWalshy folded on the River
Seat 5: marcoshig864 folded before Flop (didn't bet)
Seat 6: vovo4kapooh collected ($2.46)



PokerStars Zoom Hand #229231731069:  Hold'em No Limit ($0.01/$0.02) - 2021/08/21 22:24:54 CET [2021/08/21 16:24:54 ET]
Table 'Halley' 6-max Seat #1 is the button
Seat 1: ChowMangao ($5.73 in chips) 
Seat 2: pipecmolodec ($2 in chips) 
Seat 3: jejmcclu ($2.64 in chips) 
Seat 4: Scaaalll ($2.41 in chips) 
Seat 5: wallaharto ($1.97 in chips) 
Seat 6: IceTdannyB ($2.43 in chips) 
pipecmolodec: posts small blind $0.01
jejmcclu: posts big blind $0.02
*** HOLE CARDS ***
Dealt to Scaaalll [2s 5c]
IceTdannyB is disconnected 
Scaaalll: folds 
wallaharto: folds 
IceTdannyB: folds 
ChowMangao: raises $0.02 to $0.04
pipecmolodec: raises $0.14 to $0.18
jejmcclu: folds 
ChowMangao: folds 
Uncalled bet ($0.14) returned to pipecmolodec
pipecmolodec collected $0.10 from pot
pipecmolodec: doesn't show hand 
*** SUMMARY ***
Total pot $0.10 | Rake $0 
Seat 1: ChowMangao (button) folded before Flop
Seat 2: pipecmolodec (small blind) collected ($0.10)
Seat 3: jejmcclu (big blind) folded before Flop
Seat 4: Scaaalll folded before Flop (didn't bet)
Seat 5: wallaharto folded before Flop (didn't bet)
Seat 6: IceTdannyB folded before Flop (didn't bet)



PokerStars Zoom Hand #229231728255:  Hold'em No Limit ($0.01/$0.02) - 2021/08/21 22:24:48 CET [2021/08/21 16:24:48 ET]
Table 'Halley' 6-max Seat #1 is the button
Seat 1: plmanuelpl ($0.10 in chips) 
Seat 2: marcoshig864 ($3.34 in chips) 
Seat 3: gasmar_29 ($2 in chips) 
Seat 4: juraa14 ($1.69 in chips) 
Seat 5: LuckyCheewey ($11.87 in chips) 
Seat 6: Scaaalll ($2.41 in chips) 
marcoshig864: posts small blind $0.01
gasmar_29: posts big blind $0.02
*** HOLE CARDS ***
Dealt to Scaaalll [Td 6h]
juraa14: folds 
LuckyCheewey: folds 
Scaaalll: folds 
plmanuelpl: calls $0.02
marcoshig864: folds 
gasmar_29: checks 
*** FLOP *** [2s Kd Jc]
gasmar_29: checks 
plmanuelpl: checks 
*** TURN *** [2s Kd Jc] [3d]
gasmar_29: checks 
plmanuelpl: checks 
*** RIVER *** [2s Kd Jc 3d] [4c]
gasmar_29: checks 
plmanuelpl: checks 
*** SHOW DOWN ***
gasmar_29: shows [7s 2c] (a pair of Deuces)
plmanuelpl: mucks hand 
gasmar_29 collected $0.05 from pot
*** SUMMARY ***
Total pot $0.05 | Rake $0 
Board [2s Kd Jc 3d 4c]
Seat 1: plmanuelpl (button) mucked [Ah 9h]
Seat 2: marcoshig864 (small blind) folded before Flop
Seat 3: gasmar_29 (big blind) showed [7s 2c] and won ($0.05) with a pair of Deuces
Seat 4: juraa14 folded before Flop (didn't bet)
Seat 5: LuckyCheewey folded before Flop (didn't bet)
Seat 6: Scaaalll folded before Flop (didn't bet)



PokerStars Zoom Hand #229231740556:  Hold'em No Limit ($0.01/$0.02) - 2021/08/21 22:25:15 CET [2021/08/21 16:25:15 ET]
Table 'Halley' 6-max Seat #1 is the button
Seat 1: Tabitaji ($3.04 in chips) 
Seat 2: rpycmbEM ($3.50 in chips) 
Seat 3: Iwanb4 ($2.27 in chips) 
Seat 4: keldh ($2.05 in chips) 
Seat 5: 365p2eva ($3.79 in chips) 
Seat 6: Scaaalll ($2.39 in chips) 
rpycmbEM: posts small blind $0.01
Iwanb4: posts big blind $0.02
*** HOLE CARDS ***
Dealt to Scaaalll [Jd 9c]
keldh: folds 
365p2eva: folds 
Scaaalll: folds 
Tabitaji: folds 
rpycmbEM: folds 
Uncalled bet ($0.01) returned to Iwanb4
Iwanb4 collected $0.02 from pot
Iwanb4: doesn't show hand 
*** SUMMARY ***
Total pot $0.02 | Rake $0 
Seat 1: Tabitaji (button) folded before Flop (didn't bet)
Seat 2: rpycmbEM (small blind) folded before Flop
Seat 3: Iwanb4 (big blind) collected ($0.02)
Seat 4: keldh folded before Flop (didn't bet)
Seat 5: 365p2eva folded before Flop (didn't bet)
Seat 6: Scaaalll folded before Flop (didn't bet)



PokerStars Zoom Hand #229231745979:  Hold'em No Limit ($0.01/$0.02) - 2021/08/21 22:25:27 CET [2021/08/21 16:25:27 ET]
Table 'Halley' 6-max Seat #1 is the button
Seat 1: Scaaalll ($2.38 in chips) 
Seat 2: Lacitoo ($2.50 in chips) 
Seat 3: HubertFroh ($4.40 in chips) 
Seat 4: HellNative ($2.38 in chips) 
Seat 5: Russian MA ($1.82 in chips) 
Seat 6: boa juice ($2.04 in chips) 
Lacitoo: posts small blind $0.01
HubertFroh: posts big blind $0.02
*** HOLE CARDS ***
Dealt to Scaaalll [Qd Kc]
HellNative: folds 
Lacitoo is disconnected 
Russian MA: folds 
boa juice: folds 
boa juice is disconnected 
Russian MA is disconnected 
Scaaalll: raises $0.02 to $0.04
Lacitoo: folds 
HubertFroh: folds 
Uncalled bet ($0.02) returned to Scaaalll
Scaaalll collected $0.05 from pot
Scaaalll: doesn't show hand 
*** SUMMARY ***
Total pot $0.05 | Rake $0 
Seat 1: Scaaalll (button) collected ($0.05)
Seat 2: Lacitoo (small blind) folded before Flop
Seat 3: HubertFroh (big blind) folded before Flop
Seat 4: HellNative folded before Flop (didn't bet)
Seat 5: Russian MA folded before Flop (didn't bet)
Seat 6: boa juice folded before Flop (didn't bet)



PokerStars Zoom Hand #229231734222:  Hold'em No Limit ($0.01/$0.02) - 2021/08/21 22:25:01 CET [2021/08/21 16:25:01 ET]
Table 'Halley' 6-max Seat #1 is the button
Seat 1: RoughRafff ($3.81 in chips) 
Seat 2: feybys ($3.41 in chips) 
Seat 3: Scaaalll ($2.41 in chips) 
Seat 4: SGALINAE ($1.91 in chips) 
Seat 5: SKV_1985 ($2.07 in chips) 
Seat 6: innexplus ($3.02 in chips) 
feybys: posts small blind $0.01
Scaaalll: posts big blind $0.02
*** HOLE CARDS ***
Dealt to Scaaalll [3h 9c]
SGALINAE: calls $0.02
SKV_1985: folds 
innexplus: raises $0.05 to $0.07
RoughRafff: folds 
feybys: calls $0.06
Scaaalll: folds 
SGALINAE: calls $0.05
*** FLOP *** [6d 2d Td]
feybys: checks 
SGALINAE: checks 
innexplus: checks 
*** TURN *** [6d 2d Td] [Qh]
feybys: checks 
SGALINAE: checks 
innexplus: bets $0.11
feybys: folds 
SGALINAE: calls $0.11
*** RIVER *** [6d 2d Td Qh] [4s]
SGALINAE: checks 
innexplus: bets $0.34
SGALINAE: folds 
Uncalled bet ($0.34) returned to innexplus
innexplus collected $0.43 from pot
innexplus: doesn't show hand 
*** SUMMARY ***
Total pot $0.45 | Rake $0.02 
Board [6d 2d Td Qh 4s]
Seat 1: RoughRafff (button) folded before Flop (didn't bet)
Seat 2: feybys (small blind) folded on the Turn
Seat 3: Scaaalll (big blind) folded before Flop
Seat 4: SGALINAE folded on the River
Seat 5: SKV_1985 folded before Flop (didn't bet)
Seat 6: innexplus collected ($0.43)



PokerStars Zoom Hand #229231751026:  Hold'em No Limit ($0.01/$0.02) - 2021/08/21 22:25:38 CET [2021/08/21 16:25:38 ET]
Table 'Halley' 6-max Seat #1 is the button
Seat 1: NoEff0rt2w1n ($2.76 in chips) 
Seat 2: A.luckebeggr ($3.07 in chips) 
Seat 3: SGALINAE ($1.73 in chips) 
Seat 4: RoughRafff ($4.43 in chips) 
Seat 5: Scaaalll ($2.41 in chips) 
Seat 6: satti1337 ($2 in chips) 
A.luckebeggr: posts small blind $0.01
SGALINAE: posts big blind $0.02
*** HOLE CARDS ***
Dealt to Scaaalll [Kh As]
RoughRafff: folds 
Scaaalll: raises $0.04 to $0.06
satti1337: folds 
NoEff0rt2w1n: folds 
A.luckebeggr: folds 
SGALINAE: calls $0.04
*** FLOP *** [Qh 4c 2h]
SGALINAE: checks 
Scaaalll: bets $0.08
SGALINAE: folds 
Uncalled bet ($0.08) returned to Scaaalll
Scaaalll collected $0.13 from pot
Scaaalll: doesn't show hand 
*** SUMMARY ***
Total pot $0.13 | Rake $0 
Board [Qh 4c 2h]
Seat 1: NoEff0rt2w1n (button) folded before Flop (didn't bet)
Seat 2: A.luckebeggr (small blind) folded before Flop
Seat 3: SGALINAE (big blind) folded on the Flop
Seat 4: RoughRafff folded before Flop (didn't bet)
Seat 5: Scaaalll collected ($0.13)
Seat 6: satti1337 folded before Flop (didn't bet)



PokerStars Zoom Hand #229231743675:  Hold'em No Limit ($0.01/$0.02) - 2021/08/21 22:25:22 CET [2021/08/21 16:25:22 ET]
Table 'Halley' 6-max Seat #1 is the button
Seat 1: so0love ($4.27 in chips) 
Seat 2: Scaaalll ($2.39 in chips) 
Seat 3: BezVariantov957 ($1.53 in chips) 
Seat 4: Alex Koshva1 ($2.64 in chips) 
Seat 5: RonilsonCosta ($2.30 in chips) 
Seat 6: 4umi4ev ($2.22 in chips) 
Scaaalll: posts small blind $0.01
BezVariantov957: posts big blind $0.02
*** HOLE CARDS ***
Dealt to Scaaalll [Ts 9h]
4umi4ev is disconnected 
Alex Koshva1: calls $0.02
RonilsonCosta: folds 
4umi4ev: folds 
so0love: folds 
Scaaalll: folds 
BezVariantov957: checks 
*** FLOP *** [7d As 9c]
BezVariantov957: checks 
Alex Koshva1: checks 
*** TURN *** [7d As 9c] [9s]
BezVariantov957: bets $0.03
Alex Koshva1: calls $0.03
*** RIVER *** [7d As 9c 9s] [7h]
BezVariantov957: bets $0.08
Alex Koshva1: folds 
Uncalled bet ($0.08) returned to BezVariantov957
BezVariantov957 collected $0.11 from pot
BezVariantov957: doesn't show hand 
*** SUMMARY ***
Total pot $0.11 | Rake $0 
Board [7d As 9c 9s 7h]
Seat 1: so0love (button) folded before Flop (didn't bet)
Seat 2: Scaaalll (small blind) folded before Flop
Seat 3: BezVariantov957 (big blind) collected ($0.11)
Seat 4: Alex Koshva1 folded on the River
Seat 5: RonilsonCosta folded before Flop (didn't bet)
Seat 6: 4umi4ev folded before Flop (didn't bet)



PokerStars Zoom Hand #229231761762:  Hold'em No Limit ($0.01/$0.02) - 2021/08/21 22:26:02 CET [2021/08/21 16:26:02 ET]
Table 'Halley' 6-max Seat #1 is the button
Seat 1: Fanatspartak ($1.18 in chips) 
Seat 2: LuckyCheewey ($2.02 in chips) 
Seat 3: Ramirres ($2 in chips) 
Seat 4: kahzura ($2.09 in chips) 
Seat 5: Scaaalll ($2.48 in chips) 
Seat 6: IamFixxed ($8.52 in chips) 
LuckyCheewey: posts small blind $0.01
Ramirres: posts big blind $0.02
*** HOLE CARDS ***
Dealt to Scaaalll [Qd 2h]
kahzura: folds 
Scaaalll: folds 
IamFixxed: raises $0.03 to $0.05
Fanatspartak: folds 
LuckyCheewey: folds 
Ramirres: folds 
Uncalled bet ($0.03) returned to IamFixxed
IamFixxed collected $0.05 from pot
IamFixxed: doesn't show hand 
*** SUMMARY ***
Total pot $0.05 | Rake $0 
Seat 1: Fanatspartak (button) folded before Flop (didn't bet)
Seat 2: LuckyCheewey (small blind) folded before Flop
Seat 3: Ramirres (big blind) folded before Flop
Seat 4: kahzura folded before Flop (didn't bet)
Seat 5: Scaaalll folded before Flop (didn't bet)
Seat 6: IamFixxed collected ($0.05)



PokerStars Zoom Hand #229231767337:  Hold'em No Limit ($0.01/$0.02) - 2021/08/21 22:26:14 CET [2021/08/21 16:26:14 ET]
Table 'Halley' 6-max Seat #1 is the button
Seat 1: ryokun@tps ($1.60 in chips) 
Seat 2: NoEff0rt2w1n ($2.01 in chips) 
Seat 3: Scaaalll ($2.48 in chips) 
Seat 4: DTracker13 ($1.45 in chips) 
Seat 5: Kreodont1987 ($2.10 in chips) 
Seat 6: BriceDo1917 ($2.41 in chips) 
NoEff0rt2w1n: posts small blind $0.01
Scaaalll: posts big blind $0.02
*** HOLE CARDS ***
Dealt to Scaaalll [8h 6c]
DTracker13: folds 
Kreodont1987: folds 
BriceDo1917: raises $0.04 to $0.06
ryokun@tps: folds 
NoEff0rt2w1n: folds 
Scaaalll: folds 
Uncalled bet ($0.04) returned to BriceDo1917
BriceDo1917 collected $0.05 from pot
BriceDo1917: doesn't show hand 
*** SUMMARY ***
Total pot $0.05 | Rake $0 
Seat 1: ryokun@tps (button) folded before Flop (didn't bet)
Seat 2: NoEff0rt2w1n (small blind) folded before Flop
Seat 3: Scaaalll (big blind) folded before Flop
Seat 4: DTracker13 folded before Flop (didn't bet)
Seat 5: Kreodont1987 folded before Flop (didn't bet)
Seat 6: BriceDo1917 collected ($0.05)



PokerStars Zoom Hand #229231773258:  Hold'em No Limit ($0.01/$0.02) - 2021/08/21 22:26:27 CET [2021/08/21 16:26:27 ET]
Table 'Halley' 6-max Seat #1 is the button
Seat 1: NNGun ($1.71 in chips) 
Seat 2: Scaaalll ($2.46 in chips) 
Seat 3: byakuda ($2.03 in chips) 
Seat 4: NoEff0rt2w1n ($2 in chips) 
Seat 5: xxRoseIloveu ($8.45 in chips) 
Seat 6: pavlo8855 ($2.03 in chips) 
Scaaalll: posts small blind $0.01
byakuda: posts big blind $0.02
*** HOLE CARDS ***
Dealt to Scaaalll [Qs 5h]
NoEff0rt2w1n: folds 
xxRoseIloveu: folds 
pavlo8855: folds 
NNGun: raises $0.04 to $0.06
Scaaalll: folds 
byakuda: folds 
Uncalled bet ($0.04) returned to NNGun
NNGun collected $0.05 from pot
NNGun: doesn't show hand 
*** SUMMARY ***
Total pot $0.05 | Rake $0 
Seat 1: NNGun (button) collected ($0.05)
Seat 2: Scaaalll (small blind) folded before Flop
Seat 3: byakuda (big blind) folded before Flop
Seat 4: NoEff0rt2w1n folded before Flop (didn't bet)
Seat 5: xxRoseIloveu folded before Flop (didn't bet)
Seat 6: pavlo8855 folded before Flop (didn't bet)



PokerStars Zoom Hand #229231775503:  Hold'em No Limit ($0.01/$0.02) - 2021/08/21 22:26:32 CET [2021/08/21 16:26:32 ET]
Table 'Halley' 6-max Seat #1 is the button
Seat 1: KonopDima ($2.04 in chips) 
Seat 2: Kreodont1987 ($5.63 in chips) 
Seat 3: krezq3 ($1.82 in chips) 
Seat 4: Scaaalll ($2.45 in chips) 
Seat 5: SchinkenToni ($2.33 in chips) 
Seat 6: roukoun1984 ($1.42 in chips) 
Kreodont1987: posts small blind $0.01
krezq3: posts big blind $0.02
*** HOLE CARDS ***
Dealt to Scaaalll [Qs Tc]
Scaaalll: folds 
SchinkenToni: raises $0.05 to $0.07
roukoun1984: folds 
roukoun1984 is disconnected 
krezq3 is disconnected 
KonopDima: folds 
Kreodont1987: folds 
krezq3: folds 
Uncalled bet ($0.05) returned to SchinkenToni
SchinkenToni collected $0.05 from pot
SchinkenToni: doesn't show hand 
*** SUMMARY ***
Total pot $0.05 | Rake $0 
Seat 1: KonopDima (button) folded before Flop (didn't bet)
Seat 2: Kreodont1987 (small blind) folded before Flop
Seat 3: krezq3 (big blind) folded before Flop
Seat 4: Scaaalll folded before Flop (didn't bet)
Seat 5: SchinkenToni collected ($0.05)
Seat 6: roukoun1984 folded before Flop (didn't bet)



PokerStars Zoom Hand #229231763592:  Hold'em No Limit ($0.01/$0.02) - 2021/08/21 22:26:06 CET [2021/08/21 16:26:06 ET]
Table 'Halley' 6-max Seat #1 is the button
Seat 1: Scaaalll ($2.48 in chips) 
Seat 2: Espartacus5222 ($3.59 in chips) 
Seat 3: happyboom80 ($2.68 in chips) 
Seat 4: Smirandal ($2.62 in chips) 
Seat 5: Ebbelwoiexp ($2 in chips) 
Seat 6: Zero_sdk ($2.26 in chips) 
Espartacus5222: posts small blind $0.01
happyboom80: posts big blind $0.02
*** HOLE CARDS ***
Dealt to Scaaalll [9s 4s]
Ebbelwoiexp is disconnected 
Smirandal has timed out
Smirandal: folds 
Ebbelwoiexp: folds 
Zero_sdk: raises $0.06 to $0.08
Scaaalll: folds 
Espartacus5222: folds 
happyboom80: calls $0.06
*** FLOP *** [Ks 5h 8s]
happyboom80: checks 
Zero_sdk: bets $0.16
happyboom80: folds 
Uncalled bet ($0.16) returned to Zero_sdk
Zero_sdk collected $0.16 from pot
Zero_sdk: doesn't show hand 
*** SUMMARY ***
Total pot $0.17 | Rake $0.01 
Board [Ks 5h 8s]
Seat 1: Scaaalll (button) folded before Flop (didn't bet)
Seat 2: Espartacus5222 (small blind) folded before Flop
Seat 3: happyboom80 (big blind) folded on the Flop
Seat 4: Smirandal folded before Flop (didn't bet)
Seat 5: Ebbelwoiexp folded before Flop (didn't bet)
Seat 6: Zero_sdk collected ($0.16)



PokerStars Zoom Hand #229231777303:  Hold'em No Limit ($0.01/$0.02) - 2021/08/21 22:26:36 CET [2021/08/21 16:26:36 ET]
Table 'Halley' 6-max Seat #1 is the button
Seat 1: dinoVIEIRA ($3.41 in chips) 
Seat 2: Soh0sold ($2.34 in chips) 
Seat 3: felipeciji ($2.37 in chips) 
Seat 4: rancing87 ($2.05 in chips) 
Seat 5: FabOliveira9 ($2 in chips) 
Seat 6: Scaaalll ($2.45 in chips) 
Soh0sold: posts small blind $0.01
felipeciji: posts big blind $0.02
*** HOLE CARDS ***
Dealt to Scaaalll [3h 7h]
rancing87: folds 
FabOliveira9: folds 
Scaaalll: folds 
dinoVIEIRA: folds 
Soh0sold: raises $0.04 to $0.06
felipeciji: folds 
Uncalled bet ($0.04) returned to Soh0sold
Soh0sold collected $0.04 from pot
Soh0sold: doesn't show hand 
*** SUMMARY ***
Total pot $0.04 | Rake $0 
Seat 1: dinoVIEIRA (button) folded before Flop (didn't bet)
Seat 2: Soh0sold (small blind) collected ($0.04)
Seat 3: felipeciji (big blind) folded before Flop
Seat 4: rancing87 folded before Flop (didn't bet)
Seat 5: FabOliveira9 folded before Flop (didn't bet)
Seat 6: Scaaalll folded before Flop (didn't bet)



PokerStars Zoom Hand #229231779549:  Hold'em No Limit ($0.01/$0.02) - 2021/08/21 22:26:41 CET [2021/08/21 16:26:41 ET]
Table 'Halley' 6-max Seat #1 is the button
Seat 1: EevAA190 ($2.32 in chips) 
Seat 2: Andnet ($2 in chips) 
Seat 3: Scaaalll ($2.45 in chips) 
Seat 4: Feliciano16 ($3.64 in chips) 
Seat 5: Kb013497 ($1.63 in chips) 
Seat 6: dinoVIEIRA ($3.41 in chips) 
Andnet: posts small blind $0.01
Scaaalll: posts big blind $0.02
*** HOLE CARDS ***
Dealt to Scaaalll [8c 7d]
Feliciano16: raises $0.04 to $0.06
Kb013497: folds 
dinoVIEIRA: folds 
EevAA190: folds 
Andnet: folds 
Scaaalll: folds 
Uncalled bet ($0.04) returned to Feliciano16
Feliciano16 collected $0.05 from pot
Feliciano16: doesn't show hand 
*** SUMMARY ***
Total pot $0.05 | Rake $0 
Seat 1: EevAA190 (button) folded before Flop (didn't bet)
Seat 2: Andnet (small blind) folded before Flop
Seat 3: Scaaalll (big blind) folded before Flop
Seat 4: Feliciano16 collected ($0.05)
Seat 5: Kb013497 folded before Flop (didn't bet)
Seat 6: dinoVIEIRA folded before Flop (didn't bet)



PokerStars Zoom Hand #229231781342:  Hold'em No Limit ($0.01/$0.02) - 2021/08/21 22:26:45 CET [2021/08/21 16:26:45 ET]
Table 'Halley' 6-max Seat #1 is the button
Seat 1: Agno$tic ($2.22 in chips) 
Seat 2: le_vlimeux ($2.74 in chips) 
Seat 3: PapiMik3 ($2 in chips) 
Seat 4: LuckyCheewey ($11.72 in chips) 
Seat 5: Scaaalll ($2.43 in chips) 
Seat 6: VovaU164 ($1.50 in chips) 
le_vlimeux: posts small blind $0.01
PapiMik3: posts big blind $0.02
*** HOLE CARDS ***
Dealt to Scaaalll [Ks 5h]
LuckyCheewey: raises $0.05 to $0.07
Scaaalll: folds 
VovaU164: folds 
VovaU164 is disconnected 
Agno$tic: folds 
le_vlimeux: folds 
PapiMik3: folds 
Uncalled bet ($0.05) returned to LuckyCheewey
LuckyCheewey collected $0.05 from pot
LuckyCheewey: doesn't show hand 
*** SUMMARY ***
Total pot $0.05 | Rake $0 
Seat 1: Agno$tic (button) folded before Flop (didn't bet)
Seat 2: le_vlimeux (small blind) folded before Flop
Seat 3: PapiMik3 (big blind) folded before Flop
Seat 4: LuckyCheewey collected ($0.05)
Seat 5: Scaaalll folded before Flop (didn't bet)
Seat 6: VovaU164 folded before Flop (didn't bet)



PokerStars Zoom Hand #229231783609:  Hold'em No Limit ($0.01/$0.02) - 2021/08/21 22:26:50 CET [2021/08/21 16:26:50 ET]
Table 'Halley' 6-max Seat #1 is the button
Seat 1: gy67 ($1.88 in chips) 
Seat 2: polymorhp ($0.80 in chips) 
Seat 3: Finderra ($1.88 in chips) 
Seat 4: Scaaalll ($2.43 in chips) 
Seat 5: BadBeat Bert ($2.02 in chips) 
Seat 6: BendixSenior ($1.24 in chips) 
polymorhp: posts small blind $0.01
Finderra: posts big blind $0.02
*** HOLE CARDS ***
Dealt to Scaaalll [7c 9d]
Scaaalll: folds 
BadBeat Bert: calls $0.02
BendixSenior: calls $0.02
gy67: calls $0.02
polymorhp: raises $0.10 to $0.12
Finderra: folds 
BadBeat Bert: folds 
BendixSenior: calls $0.10
gy67: folds 
*** FLOP *** [As Qc 8d]
polymorhp: bets $0.12
BendixSenior: calls $0.12
*** TURN *** [As Qc 8d] [Ah]
polymorhp: checks 
BendixSenior: checks 
*** RIVER *** [As Qc 8d Ah] [4d]
polymorhp: bets $0.26
BendixSenior: calls $0.26
*** SHOW DOWN ***
polymorhp: shows [Kh Qh] (two pair, Aces and Queens)
BendixSenior: mucks hand 
polymorhp collected $1.02 from pot
*** SUMMARY ***
Total pot $1.06 | Rake $0.04 
Board [As Qc 8d Ah 4d]
Seat 1: gy67 (button) folded before Flop
Seat 2: polymorhp (small blind) showed [Kh Qh] and won ($1.02) with two pair, Aces and Queens
Seat 3: Finderra (big blind) folded before Flop
Seat 4: Scaaalll folded before Flop (didn't bet)
Seat 5: BadBeat Bert folded before Flop
Seat 6: BendixSenior mucked [8s 5d]



PokerStars Zoom Hand #229231785955:  Hold'em No Limit ($0.01/$0.02) - 2021/08/21 22:26:55 CET [2021/08/21 16:26:55 ET]
Table 'Halley' 6-max Seat #1 is the button
Seat 1: ded serch ($2 in chips) 
Seat 2: Scaaalll ($2.43 in chips) 
Seat 3: Allexii ($2.22 in chips) 
Seat 4: kboskov123 ($1.92 in chips) 
Seat 5: NOLUWDtC ($2.30 in chips) 
Seat 6: wallaharto ($1.17 in chips) 
Scaaalll: posts small blind $0.01
Allexii: posts big blind $0.02
*** HOLE CARDS ***
Dealt to Scaaalll [Ac 9s]
kboskov123: calls $0.02
NOLUWDtC: folds 
wallaharto: folds 
NOLUWDtC is disconnected 
ded serch: calls $0.02
Scaaalll: calls $0.01
Allexii: checks 
*** FLOP *** [Ah Ad Tc]
Scaaalll: checks 
Allexii: checks 
kboskov123: checks 
ded serch: checks 
*** TURN *** [Ah Ad Tc] [Qs]
Scaaalll: bets $0.04
Allexii: folds 
Allexii is disconnected 
kboskov123: folds 
ded serch: folds 
Uncalled bet ($0.04) returned to Scaaalll
Scaaalll collected $0.08 from pot
Scaaalll: doesn't show hand 
*** SUMMARY ***
Total pot $0.08 | Rake $0 
Board [Ah Ad Tc Qs]
Seat 1: ded serch (button) folded on the Turn
Seat 2: Scaaalll (small blind) collected ($0.08)
Seat 3: Allexii (big blind) folded on the Turn
Seat 4: kboskov123 folded on the Turn
Seat 5: NOLUWDtC folded before Flop (didn't bet)
Seat 6: wallaharto folded before Flop (didn't bet)



PokerStars Zoom Hand #229231802739:  Hold'em No Limit ($0.01/$0.02) - 2021/08/21 22:27:24 CET [2021/08/21 16:27:24 ET]
Table 'Halley' 6-max Seat #1 is the button
Seat 1: Scaaalll ($2.49 in chips) 
Seat 2: caiolima99 ($3.08 in chips) 
Seat 3: TomoKondo ($2.08 in chips) 
Seat 4: lexus00174 ($3.50 in chips) 
Seat 5: sal_sagev41 ($2.28 in chips) 
Seat 6: polymorhp ($3.57 in chips) 
caiolima99: posts small blind $0.01
TomoKondo: posts big blind $0.02
*** HOLE CARDS ***
Dealt to Scaaalll [3c As]
lexus00174: folds 
sal_sagev41: raises $0.03 to $0.05
polymorhp: folds 
Scaaalll: folds 
caiolima99: folds 
TomoKondo: folds 
Uncalled bet ($0.03) returned to sal_sagev41
sal_sagev41 collected $0.05 from pot
sal_sagev41: doesn't show hand 
*** SUMMARY ***
Total pot $0.05 | Rake $0 
Seat 1: Scaaalll (button) folded before Flop (didn't bet)
Seat 2: caiolima99 (small blind) folded before Flop
Seat 3: TomoKondo (big blind) folded before Flop
Seat 4: lexus00174 folded before Flop (didn't bet)
Seat 5: sal_sagev41 collected ($0.05)
Seat 6: polymorhp folded before Flop (didn't bet)



PokerStars Zoom Hand #229231813669:  Hold'em No Limit ($0.01/$0.02) - 2021/08/21 22:27:48 CET [2021/08/21 16:27:48 ET]
Table 'Halley' 6-max Seat #1 is the button
Seat 1: 78joniboy ($2.05 in chips) 
Seat 2: Luben_76 ($1.79 in chips) 
Seat 3: Map4ik ($1 in chips) 
Seat 4: dcd113 ($0.84 in chips) 
Seat 5: BenOKopen ($2 in chips) 
Seat 6: Scaaalll ($2.49 in chips) 
Luben_76: posts small blind $0.01
Map4ik: posts big blind $0.02
*** HOLE CARDS ***
Dealt to Scaaalll [Qd 2d]
dcd113: raises $0.06 to $0.08
BenOKopen: folds 
Scaaalll: folds 
78joniboy: folds 
Luben_76: folds 
Map4ik: folds 
Uncalled bet ($0.06) returned to dcd113
dcd113 collected $0.05 from pot
dcd113: doesn't show hand 
*** SUMMARY ***
Total pot $0.05 | Rake $0 
Seat 1: 78joniboy (button) folded before Flop (didn't bet)
Seat 2: Luben_76 (small blind) folded before Flop
Seat 3: Map4ik (big blind) folded before Flop
Seat 4: dcd113 collected ($0.05)
Seat 5: BenOKopen folded before Flop (didn't bet)
Seat 6: Scaaalll folded before Flop (didn't bet)



PokerStars Zoom Hand #229231815429:  Hold'em No Limit ($0.01/$0.02) - 2021/08/21 22:27:52 CET [2021/08/21 16:27:52 ET]
Table 'Halley' 6-max Seat #1 is the button
Seat 1: balalaikaRUS47 ($1.66 in chips) 
Seat 2: FabOliveira9 ($2.01 in chips) 
Seat 3: vovo4kapooh ($2.61 in chips) 
Seat 4: satti1337 ($2.17 in chips) 
Seat 5: Scaaalll ($2.49 in chips) 
Seat 6: Kreodont1987 ($5.59 in chips) 
FabOliveira9: posts small blind $0.01
vovo4kapooh: posts big blind $0.02
*** HOLE CARDS ***
Dealt to Scaaalll [Ad Js]
satti1337: folds 
balalaikaRUS47 is disconnected 
Scaaalll: raises $0.04 to $0.06
Kreodont1987: folds 
balalaikaRUS47: folds 
FabOliveira9: folds 
vovo4kapooh: folds 
Uncalled bet ($0.04) returned to Scaaalll
Scaaalll collected $0.05 from pot
Scaaalll: doesn't show hand 
*** SUMMARY ***
Total pot $0.05 | Rake $0 
Seat 1: balalaikaRUS47 (button) folded before Flop (didn't bet)
Seat 2: FabOliveira9 (small blind) folded before Flop
Seat 3: vovo4kapooh (big blind) folded before Flop
Seat 4: satti1337 folded before Flop (didn't bet)
Seat 5: Scaaalll collected ($0.05)
Seat 6: Kreodont1987 folded before Flop (didn't bet)



PokerStars Zoom Hand #229231825499:  Hold'em No Limit ($0.01/$0.02) - 2021/08/21 22:28:14 CET [2021/08/21 16:28:14 ET]
Table 'Halley' 6-max Seat #1 is the button
Seat 1: LUCHOPWNZ ($2.30 in chips) 
Seat 2: AlexGTPS ($3.18 in chips) 
Seat 3: Scaaalll ($2.52 in chips) 
Seat 4: Enoffllescini ($2.18 in chips) 
Seat 5: KonopDima ($2.01 in chips) 
Seat 6: MATIdf365 ($2.15 in chips) 
AlexGTPS: posts small blind $0.01
Scaaalll: posts big blind $0.02
*** HOLE CARDS ***
Dealt to Scaaalll [As 8h]
Enoffllescini: folds 
KonopDima: folds 
MATIdf365: folds 
LUCHOPWNZ: raises $0.04 to $0.06
AlexGTPS: raises $0.14 to $0.20
Scaaalll: folds 
LUCHOPWNZ: folds 
Uncalled bet ($0.14) returned to AlexGTPS
AlexGTPS collected $0.14 from pot
AlexGTPS: doesn't show hand 
*** SUMMARY ***
Total pot $0.14 | Rake $0 
Seat 1: LUCHOPWNZ (button) folded before Flop
Seat 2: AlexGTPS (small blind) collected ($0.14)
Seat 3: Scaaalll (big blind) folded before Flop
Seat 4: Enoffllescini folded before Flop (didn't bet)
Seat 5: KonopDima folded before Flop (didn't bet)
Seat 6: MATIdf365 folded before Flop (didn't bet)



PokerStars Zoom Hand #229231832666:  Hold'em No Limit ($0.01/$0.02) - 2021/08/21 22:28:30 CET [2021/08/21 16:28:30 ET]
Table 'Halley' 6-max Seat #1 is the button
Seat 1: Scaaalll ($2.50 in chips) 
Seat 2: marios199922 ($1.98 in chips) 
Seat 3: CordiPS ($2.30 in chips) 
Seat 4: jowecheck ($0.35 in chips) 
Seat 5: Ne0net ($2 in chips) 
Seat 6: PapiMik3 ($2.92 in chips) 
marios199922: posts small blind $0.01
CordiPS: posts big blind $0.02
*** HOLE CARDS ***
Dealt to Scaaalll [Jd 9d]
jowecheck: folds 
Ne0net: folds 
PapiMik3: folds 
Scaaalll: raises $0.02 to $0.04
marios199922: folds 
CordiPS: folds 
Uncalled bet ($0.02) returned to Scaaalll
Scaaalll collected $0.05 from pot
Scaaalll: doesn't show hand 
*** SUMMARY ***
Total pot $0.05 | Rake $0 
Seat 1: Scaaalll (button) collected ($0.05)
Seat 2: marios199922 (small blind) folded before Flop
Seat 3: CordiPS (big blind) folded before Flop
Seat 4: jowecheck folded before Flop (didn't bet)
Seat 5: Ne0net folded before Flop (didn't bet)
Seat 6: PapiMik3 folded before Flop (didn't bet)



PokerStars Zoom Hand #229231822728:  Hold'em No Limit ($0.01/$0.02) - 2021/08/21 22:28:08 CET [2021/08/21 16:28:08 ET]
Table 'Halley' 6-max Seat #1 is the button
Seat 1: juraa14 ($1.89 in chips) 
Seat 2: NNGun ($1.82 in chips) 
Seat 3: Axel201388 ($0.81 in chips) 
Seat 4: Scaaalll ($2.52 in chips) 
Seat 5: CordiPS ($2.28 in chips) 
Seat 6: felipeciji ($2.55 in chips) 
NNGun: posts small blind $0.01
Axel201388: posts big blind $0.02
*** HOLE CARDS ***
Dealt to Scaaalll [7h 4d]
Scaaalll: folds 
CordiPS: folds 
felipeciji: raises $0.03 to $0.05
juraa14: folds 
NNGun: folds 
Axel201388: calls $0.03
*** FLOP *** [Ts 7d 9s]
Axel201388: checks 
felipeciji: checks 
*** TURN *** [Ts 7d 9s] [Ac]
Axel201388: bets $0.04
felipeciji: raises $0.13 to $0.17
Axel201388: folds 
Uncalled bet ($0.13) returned to felipeciji
felipeciji collected $0.18 from pot
felipeciji: doesn't show hand 
*** SUMMARY ***
Total pot $0.19 | Rake $0.01 
Board [Ts 7d 9s Ac]
Seat 1: juraa14 (button) folded before Flop (didn't bet)
Seat 2: NNGun (small blind) folded before Flop
Seat 3: Axel201388 (big blind) folded on the Turn
Seat 4: Scaaalll folded before Flop (didn't bet)
Seat 5: CordiPS folded before Flop (didn't bet)
Seat 6: felipeciji collected ($0.18)



PokerStars Zoom Hand #229231838968:  Hold'em No Limit ($0.01/$0.02) - 2021/08/21 22:28:44 CET [2021/08/21 16:28:44 ET]
Table 'Halley' 6-max Seat #1 is the button
Seat 1: Diegor1924 ($2.44 in chips) 
Seat 2: Scaaalll ($2.53 in chips) 
Seat 3: juraa14 ($1.88 in chips) 
Seat 4: Tabitaji ($3.38 in chips) 
Seat 5: Agno$tic ($2.02 in chips) 
Seat 6: pokershevela ($2.50 in chips) 
Scaaalll: posts small blind $0.01
juraa14: posts big blind $0.02
*** HOLE CARDS ***
Dealt to Scaaalll [Ad Ac]
pokershevela is disconnected 
Tabitaji: folds 
Agno$tic: folds 
pokershevela: folds 
Diegor1924: folds 
Scaaalll: raises $0.04 to $0.06
juraa14: calls $0.04
*** FLOP *** [3h 8c 9c]
Scaaalll: bets $0.08
juraa14: calls $0.08
*** TURN *** [3h 8c 9c] [8s]
Scaaalll: bets $0.18
juraa14: folds 
Uncalled bet ($0.18) returned to Scaaalll
Scaaalll collected $0.27 from pot
Scaaalll: doesn't show hand 
*** SUMMARY ***
Total pot $0.28 | Rake $0.01 
Board [3h 8c 9c 8s]
Seat 1: Diegor1924 (button) folded before Flop (didn't bet)
Seat 2: Scaaalll (small blind) collected ($0.27)
Seat 3: juraa14 (big blind) folded on the Turn
Seat 4: Tabitaji folded before Flop (didn't bet)
Seat 5: Agno$tic folded before Flop (didn't bet)
Seat 6: pokershevela folded before Flop (didn't bet)



PokerStars Zoom Hand #229231852838:  Hold'em No Limit ($0.01/$0.02) - 2021/08/21 22:29:15 CET [2021/08/21 16:29:15 ET]
Table 'Halley' 6-max Seat #1 is the button
Seat 1: LucasG155 ($3.10 in chips) 
Seat 2: CyrilBro ($2.22 in chips) 
Seat 3: keldh ($2.30 in chips) 
Seat 4: maurivispa10 ($3.62 in chips) 
Seat 5: Scaaalll ($2.66 in chips) 
Seat 6: RrriotGrrrl ($9.31 in chips) 
CyrilBro: posts small blind $0.01
keldh: posts big blind $0.02
*** HOLE CARDS ***
Dealt to Scaaalll [6h 7h]
maurivispa10: folds 
Scaaalll: raises $0.04 to $0.06
RrriotGrrrl: folds 
LucasG155: folds 
CyrilBro: folds 
CyrilBro is disconnected 
keldh: folds 
Uncalled bet ($0.04) returned to Scaaalll
Scaaalll collected $0.05 from pot
Scaaalll: doesn't show hand 
*** SUMMARY ***
Total pot $0.05 | Rake $0 
Seat 1: LucasG155 (button) folded before Flop (didn't bet)
Seat 2: CyrilBro (small blind) folded before Flop
Seat 3: keldh (big blind) folded before Flop
Seat 4: maurivispa10 folded before Flop (didn't bet)
Seat 5: Scaaalll collected ($0.05)
Seat 6: RrriotGrrrl folded before Flop (didn't bet)



PokerStars Zoom Hand #229231858974:  Hold'em No Limit ($0.01/$0.02) - 2021/08/21 22:29:29 CET [2021/08/21 16:29:29 ET]
Table 'Halley' 6-max Seat #1 is the button
Seat 1: hubertott ($2.96 in chips) 
Seat 2: MSD2006 ($1.92 in chips) 
Seat 3: Lamazflush ($1.78 in chips) 
Seat 4: Vanekakqj ($0.68 in chips) 
Seat 5: sg.32rus ($1 in chips) 
Seat 6: Scaaalll ($2.69 in chips) 
MSD2006: posts small blind $0.01
Lamazflush: posts big blind $0.02
*** HOLE CARDS ***
Dealt to Scaaalll [Ks Ad]
Vanekakqj: folds 
sg.32rus: calls $0.02
Scaaalll: raises $0.06 to $0.08
Lamazflush is disconnected 
hubertott: folds 
MSD2006: folds 
Lamazflush: folds 
sg.32rus: calls $0.06
*** FLOP *** [Qs 4s Kh]
sg.32rus: checks 
Scaaalll: bets $0.12
sg.32rus: raises $0.12 to $0.24
Scaaalll: calls $0.12
*** TURN *** [Qs 4s Kh] [7d]
sg.32rus: bets $0.10
Scaaalll: raises $2.27 to $2.37 and is all-in
sg.32rus: calls $0.58 and is all-in
Uncalled bet ($1.69) returned to Scaaalll
*** RIVER *** [Qs 4s Kh 7d] [5s]
*** SHOW DOWN ***
sg.32rus: shows [Th Qc] (a pair of Queens)
Scaaalll: shows [Ks Ad] (a pair of Kings)
Scaaalll collected $1.94 from pot
sg.32rus cashed out the hand for $0.23
*** SUMMARY ***
Total pot $2.03 | Rake $0.09 
Board [Qs 4s Kh 7d 5s]
Seat 1: hubertott (button) folded before Flop (didn't bet)
Seat 2: MSD2006 (small blind) folded before Flop
Seat 3: Lamazflush (big blind) folded before Flop
Seat 4: Vanekakqj folded before Flop (didn't bet)
Seat 5: sg.32rus showed [Th Qc] and lost with a pair of Queens (cashed out).
Seat 6: Scaaalll showed [Ks Ad] and won ($1.94) with a pair of Kings



PokerStars Zoom Hand #229231880953:  Hold'em No Limit ($0.01/$0.02) - 2021/08/21 22:30:17 CET [2021/08/21 16:30:17 ET]
Table 'Halley' 6-max Seat #1 is the button
Seat 1: GVMELLO ($1.99 in chips) 
Seat 2: LUCHOPWNZ ($2.27 in chips) 
Seat 3: Scaaalll ($3.63 in chips) 
Seat 4: Daiting1 ($2.25 in chips) 
Seat 5: KRITAYA ($1.64 in chips) 
Seat 6: maria west side ($1.97 in chips) 
LUCHOPWNZ: posts small blind $0.01
Scaaalll: posts big blind $0.02
*** HOLE CARDS ***
Dealt to Scaaalll [4d 8h]
Daiting1: folds 
KRITAYA: folds 
maria west side: raises $0.04 to $0.06
GVMELLO: folds 
LUCHOPWNZ: folds 
Scaaalll: folds 
Uncalled bet ($0.04) returned to maria west side
maria west side collected $0.05 from pot
maria west side: doesn't show hand 
*** SUMMARY ***
Total pot $0.05 | Rake $0 
Seat 1: GVMELLO (button) folded before Flop (didn't bet)
Seat 2: LUCHOPWNZ (small blind) folded before Flop
Seat 3: Scaaalll (big blind) folded before Flop
Seat 4: Daiting1 folded before Flop (didn't bet)
Seat 5: KRITAYA folded before Flop (didn't bet)
Seat 6: maria west side collected ($0.05)



PokerStars Zoom Hand #229231888992:  Hold'em No Limit ($0.01/$0.02) - 2021/08/21 22:30:35 CET [2021/08/21 16:30:35 ET]
Table 'Halley' 6-max Seat #1 is the button
Seat 1: Axel201388 ($0.80 in chips) 
Seat 2: Scaaalll ($3.61 in chips) 
Seat 3: uniicecube ($2.98 in chips) 
Seat 4: SKV_1985 ($2.83 in chips) 
Seat 5: Leonpy92 ($2 in chips) 
Seat 6: Haraldo550 ($5.09 in chips) 
Scaaalll: posts small blind $0.01
uniicecube: posts big blind $0.02
*** HOLE CARDS ***
Dealt to Scaaalll [Jh 9c]
SKV_1985: folds 
Leonpy92: raises $0.04 to $0.06
Haraldo550: folds 
Axel201388: folds 
Haraldo550 is disconnected 
Scaaalll: folds 
uniicecube: folds 
Uncalled bet ($0.04) returned to Leonpy92
Leonpy92 collected $0.05 from pot
Leonpy92: doesn't show hand 
*** SUMMARY ***
Total pot $0.05 | Rake $0 
Seat 1: Axel201388 (button) folded before Flop (didn't bet)
Seat 2: Scaaalll (small blind) folded before Flop
Seat 3: uniicecube (big blind) folded before Flop
Seat 4: SKV_1985 folded before Flop (didn't bet)
Seat 5: Leonpy92 collected ($0.05)
Seat 6: Haraldo550 folded before Flop (didn't bet)



PokerStars Zoom Hand #229231895276:  Hold'em No Limit ($0.01/$0.02) - 2021/08/21 22:30:49 CET [2021/08/21 16:30:49 ET]
Table 'Halley' 6-max Seat #1 is the button
Seat 1: Scaaalll ($3.60 in chips) 
Seat 2: Busya777 ($1.66 in chips) 
Seat 3: Fanatspartak ($0.84 in chips) 
Seat 4: EevAA190 ($2.94 in chips) 
Seat 5: ZunderSS ($2 in chips) 
Seat 6: Tacojesuscrisp ($2.59 in chips) 
Busya777: posts small blind $0.01
Fanatspartak: posts big blind $0.02
*** HOLE CARDS ***
Dealt to Scaaalll [9c Ks]
Busya777 is disconnected 
EevAA190: raises $0.04 to $0.06
ZunderSS: folds 
Tacojesuscrisp: folds 
Scaaalll: folds 
Busya777: folds 
Fanatspartak: folds 
Uncalled bet ($0.04) returned to EevAA190
EevAA190 collected $0.05 from pot
EevAA190: doesn't show hand 
*** SUMMARY ***
Total pot $0.05 | Rake $0 
Seat 1: Scaaalll (button) folded before Flop (didn't bet)
Seat 2: Busya777 (small blind) folded before Flop
Seat 3: Fanatspartak (big blind) folded before Flop
Seat 4: EevAA190 collected ($0.05)
Seat 5: ZunderSS folded before Flop (didn't bet)
Seat 6: Tacojesuscrisp folded before Flop (didn't bet)



PokerStars Zoom Hand #229231887243:  Hold'em No Limit ($0.01/$0.02) - 2021/08/21 22:30:31 CET [2021/08/21 16:30:31 ET]
Table 'Halley' 6-max Seat #1 is the button
Seat 1: El Chicha.CL ($2 in chips) 
Seat 2: PapiMik3 ($5.74 in chips) 
Seat 3: nathann1995 ($1.22 in chips) 
Seat 4: Scaaalll ($3.61 in chips) 
Seat 5: Colby1771 ($2.05 in chips) 
Seat 6: Larí ($2.09 in chips) 
PapiMik3: posts small blind $0.01
nathann1995: posts big blind $0.02
*** HOLE CARDS ***
Dealt to Scaaalll [5d 6s]
Scaaalll: folds 
Colby1771: folds 
Larí: folds 
El Chicha.CL: folds 
PapiMik3: raises $0.04 to $0.06
nathann1995: raises $0.10 to $0.16
PapiMik3: folds 
Uncalled bet ($0.10) returned to nathann1995
nathann1995 collected $0.12 from pot
nathann1995: doesn't show hand 
*** SUMMARY ***
Total pot $0.12 | Rake $0 
Seat 1: El Chicha.CL (button) folded before Flop (didn't bet)
Seat 2: PapiMik3 (small blind) folded before Flop
Seat 3: nathann1995 (big blind) collected ($0.12)
Seat 4: Scaaalll folded before Flop (didn't bet)
Seat 5: Colby1771 folded before Flop (didn't bet)
Seat 6: Larí folded before Flop (didn't bet)



PokerStars Zoom Hand #229231899771:  Hold'em No Limit ($0.01/$0.02) - 2021/08/21 22:30:59 CET [2021/08/21 16:30:59 ET]
Table 'Halley' 6-max Seat #1 is the button
Seat 1: olcham7 ($2.84 in chips) 
Seat 2: willmorel ($2 in chips) 
Seat 3: Scaaalll ($3.60 in chips) 
Seat 4: pescador2 ($0.90 in chips) 
Seat 5: Zierfisch84 ($7.37 in chips) 
Seat 6: ryokun@tps ($1.30 in chips) 
willmorel: posts small blind $0.01
Scaaalll: posts big blind $0.02
*** HOLE CARDS ***
Dealt to Scaaalll [4h Jh]
Zierfisch84 is disconnected 
pescador2: folds 
Zierfisch84: folds 
pescador2 is disconnected 
ryokun@tps: raises $0.02 to $0.04
olcham7: folds 
willmorel: folds 
Scaaalll: folds 
Uncalled bet ($0.02) returned to ryokun@tps
ryokun@tps collected $0.05 from pot
ryokun@tps: doesn't show hand 
*** SUMMARY ***
Total pot $0.05 | Rake $0 
Seat 1: olcham7 (button) folded before Flop (didn't bet)
Seat 2: willmorel (small blind) folded before Flop
Seat 3: Scaaalll (big blind) folded before Flop
Seat 4: pescador2 folded before Flop (didn't bet)
Seat 5: Zierfisch84 folded before Flop (didn't bet)
Seat 6: ryokun@tps collected ($0.05)



PokerStars Zoom Hand #229231885434:  Hold'em No Limit ($0.01/$0.02) - 2021/08/21 22:30:27 CET [2021/08/21 16:30:27 ET]
Table 'Halley' 6-max Seat #1 is the button
Seat 1: satti1337 ($7.99 in chips) 
Seat 2: nippurkaunas ($0.86 in chips) 
Seat 3: EevAA190 ($2.97 in chips) 
Seat 4: Scaaalll ($3.61 in chips) 
Seat 5: van Alien ($1.47 in chips) 
Seat 6: Red Sky 15 ($8.65 in chips) 
nippurkaunas: posts small blind $0.01
EevAA190: posts big blind $0.02
*** HOLE CARDS ***
Dealt to Scaaalll [Th 7c]
Scaaalll: folds 
van Alien: folds 
Red Sky 15: raises $0.04 to $0.06
satti1337: folds 
nippurkaunas: calls $0.05
EevAA190: folds 
*** FLOP *** [3d 2c 2h]
nippurkaunas: checks 
Red Sky 15: bets $0.07
nippurkaunas: calls $0.07
*** TURN *** [3d 2c 2h] [8d]
nippurkaunas: checks 
Red Sky 15: bets $0.13
nippurkaunas: raises $0.13 to $0.26
Red Sky 15: calls $0.13
*** RIVER *** [3d 2c 2h 8d] [7s]
nippurkaunas: checks 
Red Sky 15: checks 
*** SHOW DOWN ***
nippurkaunas: shows [Qc Kh] (a pair of Deuces)
Red Sky 15: mucks hand 
nippurkaunas collected $0.77 from pot
*** SUMMARY ***
Total pot $0.80 | Rake $0.03 
Board [3d 2c 2h 8d 7s]
Seat 1: satti1337 (button) folded before Flop (didn't bet)
Seat 2: nippurkaunas (small blind) showed [Qc Kh] and won ($0.77) with a pair of Deuces
Seat 3: EevAA190 (big blind) folded before Flop
Seat 4: Scaaalll folded before Flop (didn't bet)
Seat 5: van Alien folded before Flop (didn't bet)
Seat 6: Red Sky 15 mucked [5h 6s]



PokerStars Zoom Hand #229231906437:  Hold'em No Limit ($0.01/$0.02) - 2021/08/21 22:31:14 CET [2021/08/21 16:31:14 ET]
Table 'Halley' 6-max Seat #1 is the button
Seat 1: Scaaalll ($3.58 in chips) 
Seat 2: Laonikos ($8.26 in chips) 
Seat 3: basyan111 ($4.19 in chips) 
Seat 4: keldh ($2.15 in chips) 
Seat 5: Tibelloni ($1.36 in chips) 
Seat 6: XHerrTUMNUSX ($8.98 in chips) 
Laonikos: posts small blind $0.01
basyan111: posts big blind $0.02
*** HOLE CARDS ***
Dealt to Scaaalll [3s Ac]
keldh: folds 
Tibelloni: folds 
XHerrTUMNUSX: folds 
Tibelloni is disconnected 
Scaaalll: raises $0.02 to $0.04
basyan111 is disconnected 
Laonikos: folds 
basyan111: folds 
Uncalled bet ($0.02) returned to Scaaalll
Scaaalll collected $0.05 from pot
Scaaalll: doesn't show hand 
*** SUMMARY ***
Total pot $0.05 | Rake $0 
Seat 1: Scaaalll (button) collected ($0.05)
Seat 2: Laonikos (small blind) folded before Flop
Seat 3: basyan111 (big blind) folded before Flop
Seat 4: keldh folded before Flop (didn't bet)
Seat 5: Tibelloni folded before Flop (didn't bet)
Seat 6: XHerrTUMNUSX folded before Flop (didn't bet)



PokerStars Zoom Hand #229231913639:  Hold'em No Limit ($0.01/$0.02) - 2021/08/21 22:31:30 CET [2021/08/21 16:31:30 ET]
Table 'Halley' 6-max Seat #1 is the button
Seat 1: WellWell57 ($3.63 in chips) 
Seat 2: WITKOW_AV ($2 in chips) 
Seat 3: MATIdf365 ($2.47 in chips) 
Seat 4: Colby1771 ($2.14 in chips) 
Seat 5: ash1448 ($4.48 in chips) 
Seat 6: Scaaalll ($3.61 in chips) 
WITKOW_AV: posts small blind $0.01
MATIdf365: posts big blind $0.02
*** HOLE CARDS ***
Dealt to Scaaalll [Qs 3c]
Colby1771: folds 
ash1448: folds 
Scaaalll: folds 
WellWell57: folds 
WITKOW_AV: folds 
Uncalled bet ($0.01) returned to MATIdf365
MATIdf365 collected $0.02 from pot
MATIdf365: doesn't show hand 
*** SUMMARY ***
Total pot $0.02 | Rake $0 
Seat 1: WellWell57 (button) folded before Flop (didn't bet)
Seat 2: WITKOW_AV (small blind) folded before Flop
Seat 3: MATIdf365 (big blind) collected ($0.02)
Seat 4: Colby1771 folded before Flop (didn't bet)
Seat 5: ash1448 folded before Flop (didn't bet)
Seat 6: Scaaalll folded before Flop (didn't bet)



PokerStars Zoom Hand #229231918053:  Hold'em No Limit ($0.01/$0.02) - 2021/08/21 22:31:40 CET [2021/08/21 16:31:40 ET]
Table 'Halley' 6-max Seat #1 is the button
Seat 1: 888lifeIS ($2 in chips) 
Seat 2: Scaaalll ($3.61 in chips) 
Seat 3: PapiMik3 ($5.71 in chips) 
Seat 4: Simon190713 ($6.84 in chips) 
Seat 5: FabOliveira9 ($2 in chips) 
Seat 6: juraa14 ($2.37 in chips) 
Scaaalll: posts small blind $0.01
PapiMik3: posts big blind $0.02
*** HOLE CARDS ***
Dealt to Scaaalll [5c 5s]
Simon190713: folds 
Simon190713 is disconnected 
FabOliveira9: folds 
juraa14: folds 
888lifeIS: raises $0.02 to $0.04
Scaaalll: calls $0.03
PapiMik3: calls $0.02
*** FLOP *** [Ah 9s 7c]
Scaaalll: checks 
PapiMik3: checks 
888lifeIS: checks 
*** TURN *** [Ah 9s 7c] [6h]
Scaaalll: checks 
PapiMik3: checks 
888lifeIS: bets $0.08
Scaaalll: folds 
PapiMik3: calls $0.08
*** RIVER *** [Ah 9s 7c 6h] [6s]
PapiMik3: checks 
888lifeIS: bets $0.18
PapiMik3: folds 
Uncalled bet ($0.18) returned to 888lifeIS
888lifeIS collected $0.27 from pot
888lifeIS: doesn't show hand 
*** SUMMARY ***
Total pot $0.28 | Rake $0.01 
Board [Ah 9s 7c 6h 6s]
Seat 1: 888lifeIS (button) collected ($0.27)
Seat 2: Scaaalll (small blind) folded on the Turn
Seat 3: PapiMik3 (big blind) folded on the River
Seat 4: Simon190713 folded before Flop (didn't bet)
Seat 5: FabOliveira9 folded before Flop (didn't bet)
Seat 6: juraa14 folded before Flop (didn't bet)



PokerStars Zoom Hand #229231935724:  Hold'em No Limit ($0.01/$0.02) - 2021/08/21 22:32:19 CET [2021/08/21 16:32:19 ET]
Table 'Halley' 6-max Seat #1 is the button
Seat 1: Pechorin.G ($2 in chips) 
Seat 2: GVMELLO ($1.98 in chips) 
Seat 3: kboskov123 ($2.05 in chips) 
Seat 4: Scaaalll ($3.57 in chips) 
Seat 5: Stryda00 ($2.37 in chips) 
Seat 6: xxRoseIloveu ($8.43 in chips) 
GVMELLO: posts small blind $0.01
kboskov123: posts big blind $0.02
*** HOLE CARDS ***
Dealt to Scaaalll [Tc Ad]
Scaaalll: raises $0.04 to $0.06
Stryda00: folds 
xxRoseIloveu: raises $0.15 to $0.21
Pechorin.G: folds 
GVMELLO: folds 
kboskov123: folds 
Scaaalll: folds 
Uncalled bet ($0.15) returned to xxRoseIloveu
xxRoseIloveu collected $0.15 from pot
xxRoseIloveu: doesn't show hand 
*** SUMMARY ***
Total pot $0.15 | Rake $0 
Seat 1: Pechorin.G (button) folded before Flop (didn't bet)
Seat 2: GVMELLO (small blind) folded before Flop
Seat 3: kboskov123 (big blind) folded before Flop
Seat 4: Scaaalll folded before Flop
Seat 5: Stryda00 folded before Flop (didn't bet)
Seat 6: xxRoseIloveu collected ($0.15)



PokerStars Zoom Hand #229231941577:  Hold'em No Limit ($0.01/$0.02) - 2021/08/21 22:32:32 CET [2021/08/21 16:32:32 ET]
Table 'Halley' 6-max Seat #1 is the button
Seat 1: Tn 939 ($2.38 in chips) 
Seat 2: Reipinguimm ($2.27 in chips) 
Seat 3: RichJImen89 ($2 in chips) 
Seat 4: Dr.stromg ($2.03 in chips) 
Seat 5: Axel201388 ($1.29 in chips) 
Seat 6: Scaaalll ($3.51 in chips) 
Reipinguimm: posts small blind $0.01
RichJImen89: posts big blind $0.02
*** HOLE CARDS ***
Dealt to Scaaalll [Jh Kd]
Dr.stromg: folds 
Axel201388: folds 
Scaaalll: raises $0.04 to $0.06
Tn 939: folds 
Reipinguimm: folds 
RichJImen89: folds 
Uncalled bet ($0.04) returned to Scaaalll
Scaaalll collected $0.05 from pot
Scaaalll: doesn't show hand 
*** SUMMARY ***
Total pot $0.05 | Rake $0 
Seat 1: Tn 939 (button) folded before Flop (didn't bet)
Seat 2: Reipinguimm (small blind) folded before Flop
Seat 3: RichJImen89 (big blind) folded before Flop
Seat 4: Dr.stromg folded before Flop (didn't bet)
Seat 5: Axel201388 folded before Flop (didn't bet)
Seat 6: Scaaalll collected ($0.05)



PokerStars Zoom Hand #229231915380:  Hold'em No Limit ($0.01/$0.02) - 2021/08/21 22:31:34 CET [2021/08/21 16:31:34 ET]
Table 'Halley' 6-max Seat #1 is the button
Seat 1: PEDACIT0 ($2.44 in chips) 
Seat 2: HubertFroh ($2.65 in chips) 
Seat 3: Zero_sdk ($2.65 in chips) 
Seat 4: Koldun 2636 ($3.33 in chips) 
Seat 5: Scaaalll ($3.61 in chips) 
Seat 6: willmorel ($2 in chips) 
HubertFroh: posts small blind $0.01
Zero_sdk: posts big blind $0.02
*** HOLE CARDS ***
Dealt to Scaaalll [Th 6c]
Koldun 2636: folds 
Scaaalll: folds 
willmorel: raises $0.04 to $0.06
PEDACIT0: folds 
HubertFroh: folds 
Zero_sdk: calls $0.04
*** FLOP *** [2h 6s 9d]
Zero_sdk: checks 
willmorel: checks 
*** TURN *** [2h 6s 9d] [7s]
Zero_sdk: bets $0.08
willmorel: calls $0.08
*** RIVER *** [2h 6s 9d 7s] [4h]
Zero_sdk: bets $0.18
willmorel: calls $0.18
*** SHOW DOWN ***
Zero_sdk: shows [6d Qd] (a pair of Sixes)
willmorel: mucks hand 
Zero_sdk collected $0.63 from pot
*** SUMMARY ***
Total pot $0.65 | Rake $0.02 
Board [2h 6s 9d 7s 4h]
Seat 1: PEDACIT0 (button) folded before Flop (didn't bet)
Seat 2: HubertFroh (small blind) folded before Flop
Seat 3: Zero_sdk (big blind) showed [6d Qd] and won ($0.63) with a pair of Sixes
Seat 4: Koldun 2636 folded before Flop (didn't bet)
Seat 5: Scaaalll folded before Flop (didn't bet)
Seat 6: willmorel mucked [Qc Ah]



PokerStars Zoom Hand #229231949685:  Hold'em No Limit ($0.01/$0.02) - 2021/08/21 22:32:50 CET [2021/08/21 16:32:50 ET]
Table 'Halley' 6-max Seat #1 is the button
Seat 1: Stryda00 ($2.36 in chips) 
Seat 2: znak312 ($2 in chips) 
Seat 3: Scaaalll ($3.54 in chips) 
Seat 4: slipknot956 ($3.01 in chips) 
Seat 5: Spo1LT ($1.61 in chips) 
Seat 6: dcd113 ($0.87 in chips) 
znak312: posts small blind $0.01
Scaaalll: posts big blind $0.02
*** HOLE CARDS ***
Dealt to Scaaalll [Ad 3h]
slipknot956: folds 
Spo1LT: folds 
dcd113: folds 
Stryda00: folds 
znak312: raises $0.03 to $0.05
Scaaalll: raises $0.11 to $0.16
znak312: folds 
Uncalled bet ($0.11) returned to Scaaalll
Scaaalll collected $0.10 from pot
Scaaalll: doesn't show hand 
*** SUMMARY ***
Total pot $0.10 | Rake $0 
Seat 1: Stryda00 (button) folded before Flop (didn't bet)
Seat 2: znak312 (small blind) folded before Flop
Seat 3: Scaaalll (big blind) collected ($0.10)
Seat 4: slipknot956 folded before Flop (didn't bet)
Seat 5: Spo1LT folded before Flop (didn't bet)
Seat 6: dcd113 folded before Flop (didn't bet)



PokerStars Zoom Hand #229231964087:  Hold'em No Limit ($0.01/$0.02) - 2021/08/21 22:33:22 CET [2021/08/21 16:33:22 ET]
Table 'Halley' 6-max Seat #1 is the button
Seat 1: Enoffllescini ($2 in chips) 
Seat 2: Yangyang1407 ($2.03 in chips) 
Seat 3: Flatergl ($1.59 in chips) 
Seat 4: pavlo8855 ($2 in chips) 
Seat 5: Scaaalll ($3.59 in chips) 
Seat 6: Vad-Gadov ($1.83 in chips) 
Yangyang1407: posts small blind $0.01
Flatergl: posts big blind $0.02
*** HOLE CARDS ***
Dealt to Scaaalll [Jd Jc]
pavlo8855: folds 
Vad-Gadov is disconnected 
Scaaalll: raises $0.04 to $0.06
Vad-Gadov: folds 
Enoffllescini: folds 
Yangyang1407: folds 
Flatergl: calls $0.04
*** FLOP *** [4c 3s 3h]
Flatergl: bets $0.13
Scaaalll: calls $0.13
*** TURN *** [4c 3s 3h] [Qh]
Flatergl: checks 
Scaaalll: bets $0.23
Flatergl: folds 
Uncalled bet ($0.23) returned to Scaaalll
Scaaalll collected $0.38 from pot
Scaaalll: doesn't show hand 
Flatergl is disconnected 
*** SUMMARY ***
Total pot $0.39 | Rake $0.01 
Board [4c 3s 3h Qh]
Seat 1: Enoffllescini (button) folded before Flop (didn't bet)
Seat 2: Yangyang1407 (small blind) folded before Flop
Seat 3: Flatergl (big blind) folded on the Turn
Seat 4: pavlo8855 folded before Flop (didn't bet)
Seat 5: Scaaalll collected ($0.38)
Seat 6: Vad-Gadov folded before Flop (didn't bet)



PokerStars Zoom Hand #229232001377:  Hold'em No Limit ($0.01/$0.02) - 2021/08/21 22:34:45 CET [2021/08/21 16:34:45 ET]
Table 'Halley' 6-max Seat #1 is the button
Seat 1: parrotman991 ($2.31 in chips) 
Seat 2: zaharoff74 ($2.85 in chips) 
Seat 3: FabOliveira9 ($2.41 in chips) 
Seat 4: Haraldo550 ($6.12 in chips) 
Seat 5: ded serch ($2 in chips) 
Seat 6: Scaaalll ($3.74 in chips) 
zaharoff74: posts small blind $0.01
FabOliveira9: posts big blind $0.02
*** HOLE CARDS ***
Dealt to Scaaalll [Tc 4h]
Haraldo550: folds 
ded serch: folds 
Haraldo550 is disconnected 
Scaaalll: folds 
parrotman991: folds 
zaharoff74: folds 
Uncalled bet ($0.01) returned to FabOliveira9
FabOliveira9 collected $0.02 from pot
FabOliveira9: doesn't show hand 
*** SUMMARY ***
Total pot $0.02 | Rake $0 
Seat 1: parrotman991 (button) folded before Flop (didn't bet)
Seat 2: zaharoff74 (small blind) folded before Flop
Seat 3: FabOliveira9 (big blind) collected ($0.02)
Seat 4: Haraldo550 folded before Flop (didn't bet)
Seat 5: ded serch folded before Flop (didn't bet)
Seat 6: Scaaalll folded before Flop (didn't bet)



PokerStars Zoom Hand #229231986292:  Hold'em No Limit ($0.01/$0.02) - 2021/08/21 22:34:11 CET [2021/08/21 16:34:11 ET]
Table 'Halley' 6-max Seat #1 is the button
Seat 1: boa juice ($1.85 in chips) 
Seat 2: Scaaalll ($3.78 in chips) 
Seat 3: EdwardF95 ($2.13 in chips) 
Seat 4: anes.v. ($2 in chips) 
Seat 5: Akrobat94 ($2.67 in chips) 
Seat 6: smileakafray ($2.48 in chips) 
Scaaalll: posts small blind $0.01
EdwardF95: posts big blind $0.02
*** HOLE CARDS ***
Dealt to Scaaalll [Ad 2d]
anes.v.: raises $0.02 to $0.04
Akrobat94: calls $0.04
smileakafray: folds 
boa juice: folds 
boa juice is disconnected 
Scaaalll: calls $0.03
EdwardF95: folds 
*** FLOP *** [9c 8h 7s]
Scaaalll: checks 
anes.v.: checks 
Akrobat94: checks 
*** TURN *** [9c 8h 7s] [6c]
Scaaalll: checks 
anes.v.: checks 
Akrobat94: bets $0.02
Scaaalll: folds 
anes.v.: calls $0.02
*** RIVER *** [9c 8h 7s 6c] [Tc]
anes.v.: checks 
Akrobat94: bets $0.23
anes.v.: folds 
Uncalled bet ($0.23) returned to Akrobat94
Akrobat94 collected $0.17 from pot
Akrobat94: doesn't show hand 
*** SUMMARY ***
Total pot $0.18 | Rake $0.01 
Board [9c 8h 7s 6c Tc]
Seat 1: boa juice (button) folded before Flop (didn't bet)
Seat 2: Scaaalll (small blind) folded on the Turn
Seat 3: EdwardF95 (big blind) folded before Flop
Seat 4: anes.v. folded on the River
Seat 5: Akrobat94 collected ($0.17)
Seat 6: smileakafray folded before Flop (didn't bet)



PokerStars Zoom Hand #229232004531:  Hold'em No Limit ($0.01/$0.02) - 2021/08/21 22:34:52 CET [2021/08/21 16:34:52 ET]
Table 'Halley' 6-max Seat #1 is the button
Seat 1: Scaaalll ($3.74 in chips) 
Seat 2: gilberto98 ($1.87 in chips) 
Seat 3: Agno$tic ($2.33 in chips) 
Seat 4: Map4ik ($1.12 in chips) 
Seat 5: zbixxx ($2.89 in chips) 
Seat 6: PapiMik3 ($2.06 in chips) 
gilberto98: posts small blind $0.01
Agno$tic: posts big blind $0.02
*** HOLE CARDS ***
Dealt to Scaaalll [8d Kh]
Map4ik: folds 
zbixxx: folds 
PapiMik3: folds 
Scaaalll: raises $0.02 to $0.04
gilberto98: folds 
Agno$tic: folds 
Uncalled bet ($0.02) returned to Scaaalll
Scaaalll collected $0.05 from pot
Scaaalll: doesn't show hand 
*** SUMMARY ***
Total pot $0.05 | Rake $0 
Seat 1: Scaaalll (button) collected ($0.05)
Seat 2: gilberto98 (small blind) folded before Flop
Seat 3: Agno$tic (big blind) folded before Flop
Seat 4: Map4ik folded before Flop (didn't bet)
Seat 5: zbixxx folded before Flop (didn't bet)
Seat 6: PapiMik3 folded before Flop (didn't bet)



PokerStars Zoom Hand #229232020127:  Hold'em No Limit ($0.01/$0.02) - 2021/08/21 22:35:27 CET [2021/08/21 16:35:27 ET]
Table 'Halley' 6-max Seat #1 is the button
Seat 1: Allexii ($1.93 in chips) 
Seat 2: guntren.ps ($3.39 in chips) 
Seat 3: estelionat171 ($1.13 in chips) 
Seat 4: Scaaalll ($3.77 in chips) 
Seat 5: bananAAbandit ($4.17 in chips) 
Seat 6: LuckyCheewey ($8.40 in chips) 
guntren.ps: posts small blind $0.01
estelionat171: posts big blind $0.02
*** HOLE CARDS ***
Dealt to Scaaalll [2h 9d]
Scaaalll: folds 
bananAAbandit: folds 
Allexii is disconnected 
LuckyCheewey: folds 
Allexii: folds 
guntren.ps: raises $0.04 to $0.06
estelionat171: folds 
Uncalled bet ($0.04) returned to guntren.ps
guntren.ps collected $0.04 from pot
guntren.ps: doesn't show hand 
*** SUMMARY ***
Total pot $0.04 | Rake $0 
Seat 1: Allexii (button) folded before Flop (didn't bet)
Seat 2: guntren.ps (small blind) collected ($0.04)
Seat 3: estelionat171 (big blind) folded before Flop
Seat 4: Scaaalll folded before Flop (didn't bet)
Seat 5: bananAAbandit folded before Flop (didn't bet)
Seat 6: LuckyCheewey folded before Flop (didn't bet)



PokerStars Zoom Hand #229232012500:  Hold'em No Limit ($0.01/$0.02) - 2021/08/21 22:35:10 CET [2021/08/21 16:35:10 ET]
Table 'Halley' 6-max Seat #1 is the button
Seat 1: GUN118 ($1.92 in chips) 
Seat 2: PapiMik3 ($5.86 in chips) 
Seat 3: sewq55 ($0.64 in chips) 
Seat 4: RomiSex ($4.34 in chips) 
Seat 5: Scaaalll ($3.77 in chips) 
Seat 6: fishh_play ($2.88 in chips) 
PapiMik3: posts small blind $0.01
sewq55: posts big blind $0.02
*** HOLE CARDS ***
Dealt to Scaaalll [Kd Th]
RomiSex: folds 
Scaaalll has timed out
Scaaalll: folds 
fishh_play: raises $0.03 to $0.05
GUN118: calls $0.05
PapiMik3: folds 
sewq55: folds 
*** FLOP *** [6h 2c Kc]
fishh_play: bets $0.08
GUN118: folds 
Uncalled bet ($0.08) returned to fishh_play
fishh_play collected $0.13 from pot
fishh_play: doesn't show hand 
*** SUMMARY ***
Total pot $0.13 | Rake $0 
Board [6h 2c Kc]
Seat 1: GUN118 (button) folded on the Flop
Seat 2: PapiMik3 (small blind) folded before Flop
Seat 3: sewq55 (big blind) folded before Flop
Seat 4: RomiSex folded before Flop (didn't bet)
Seat 5: Scaaalll folded before Flop (didn't bet)
Seat 6: fishh_play collected ($0.13)



PokerStars Zoom Hand #229232022784:  Hold'em No Limit ($0.01/$0.02) - 2021/08/21 22:35:33 CET [2021/08/21 16:35:33 ET]
Table 'Halley' 6-max Seat #1 is the button
Seat 1: Healthys07 ($5.14 in chips) 
Seat 2: trickywizard64 ($1.86 in chips) 
Seat 3: Scaaalll ($3.77 in chips) 
Seat 4: rancing87 ($2 in chips) 
Seat 5: maria west side ($1.69 in chips) 
Seat 6: kboskov123 ($2.48 in chips) 
trickywizard64: posts small blind $0.01
Scaaalll: posts big blind $0.02
*** HOLE CARDS ***
Dealt to Scaaalll [3d 9h]
rancing87: folds 
maria west side: folds 
maria west side is disconnected 
kboskov123: folds 
Healthys07: raises $0.03 to $0.05
trickywizard64: folds 
Scaaalll: folds 
Uncalled bet ($0.03) returned to Healthys07
Healthys07 collected $0.05 from pot
Healthys07: doesn't show hand 
*** SUMMARY ***
Total pot $0.05 | Rake $0 
Seat 1: Healthys07 (button) collected ($0.05)
Seat 2: trickywizard64 (small blind) folded before Flop
Seat 3: Scaaalll (big blind) folded before Flop
Seat 4: rancing87 folded before Flop (didn't bet)
Seat 5: maria west side folded before Flop (didn't bet)
Seat 6: kboskov123 folded before Flop (didn't bet)



PokerStars Zoom Hand #229232032201:  Hold'em No Limit ($0.01/$0.02) - 2021/08/21 22:35:54 CET [2021/08/21 16:35:54 ET]
Table 'Halley' 6-max Seat #1 is the button
Seat 1: Jellycube ($1.89 in chips) 
Seat 2: Scaaalll ($3.75 in chips) 
Seat 3: bananAAbandit ($2.01 in chips) 
Seat 4: gasmar_29 ($2.47 in chips) 
Seat 5: PEDACIT0 ($2.48 in chips) 
Seat 6: Fanatspartak ($1.47 in chips) 
Scaaalll: posts small blind $0.01
bananAAbandit: posts big blind $0.02
*** HOLE CARDS ***
Dealt to Scaaalll [Jd 6h]
gasmar_29: folds 
PEDACIT0: folds 
Fanatspartak: folds 
Jellycube: folds 
Scaaalll: folds 
Uncalled bet ($0.01) returned to bananAAbandit
bananAAbandit collected $0.02 from pot
bananAAbandit: doesn't show hand 
*** SUMMARY ***
Total pot $0.02 | Rake $0 
Seat 1: Jellycube (button) folded before Flop (didn't bet)
Seat 2: Scaaalll (small blind) folded before Flop
Seat 3: bananAAbandit (big blind) collected ($0.02)
Seat 4: gasmar_29 folded before Flop (didn't bet)
Seat 5: PEDACIT0 folded before Flop (didn't bet)
Seat 6: Fanatspartak folded before Flop (didn't bet)



PokerStars Zoom Hand #229232038873:  Hold'em No Limit ($0.01/$0.02) - 2021/08/21 22:36:09 CET [2021/08/21 16:36:09 ET]
Table 'Halley' 6-max Seat #1 is the button
Seat 1: EmperorKurr ($3.05 in chips) 
Seat 2: 78joniboy ($2.55 in chips) 
Seat 3: rodrigoasor ($0.38 in chips) 
Seat 4: GVMELLO ($2.32 in chips) 
Seat 5: Yangyang1407 ($2 in chips) 
Seat 6: Scaaalll ($3.74 in chips) 
78joniboy: posts small blind $0.01
rodrigoasor: posts big blind $0.02
*** HOLE CARDS ***
Dealt to Scaaalll [2h Ks]
GVMELLO: folds 
Yangyang1407: folds 
Scaaalll: folds 
EmperorKurr: folds 
78joniboy: folds 
Uncalled bet ($0.01) returned to rodrigoasor
rodrigoasor collected $0.02 from pot
rodrigoasor: doesn't show hand 
*** SUMMARY ***
Total pot $0.02 | Rake $0 
Seat 1: EmperorKurr (button) folded before Flop (didn't bet)
Seat 2: 78joniboy (small blind) folded before Flop
Seat 3: rodrigoasor (big blind) collected ($0.02)
Seat 4: GVMELLO folded before Flop (didn't bet)
Seat 5: Yangyang1407 folded before Flop (didn't bet)
Seat 6: Scaaalll folded before Flop (didn't bet)



PokerStars Zoom Hand #229232041126:  Hold'em No Limit ($0.01/$0.02) - 2021/08/21 22:36:14 CET [2021/08/21 16:36:14 ET]
Table 'Halley' 6-max Seat #1 is the button
Seat 1: Scaaalll ($3.74 in chips) 
Seat 2: sergeyl01 ($0.48 in chips) 
Seat 3: kboskov123 ($0.92 in chips) 
Seat 4: queen830 ($8.85 in chips) 
Seat 5: Jellycube ($4.64 in chips) 
Seat 6: RomiSex ($4.34 in chips) 
sergeyl01: posts small blind $0.01
kboskov123: posts big blind $0.02
*** HOLE CARDS ***
Dealt to Scaaalll [9h 7c]
queen830: folds 
Jellycube: raises $0.03 to $0.05
RomiSex: folds 
Scaaalll: folds 
sergeyl01: folds 
kboskov123: folds 
Uncalled bet ($0.03) returned to Jellycube
Jellycube collected $0.05 from pot
Jellycube: doesn't show hand 
*** SUMMARY ***
Total pot $0.05 | Rake $0 
Seat 1: Scaaalll (button) folded before Flop (didn't bet)
Seat 2: sergeyl01 (small blind) folded before Flop
Seat 3: kboskov123 (big blind) folded before Flop
Seat 4: queen830 folded before Flop (didn't bet)
Seat 5: Jellycube collected ($0.05)
Seat 6: RomiSex folded before Flop (didn't bet)



PokerStars Zoom Hand #229232045538:  Hold'em No Limit ($0.01/$0.02) - 2021/08/21 22:36:24 CET [2021/08/21 16:36:24 ET]
Table 'Halley' 6-max Seat #1 is the button
Seat 1: HellNative ($5.21 in chips) 
Seat 2: estelionat171 ($0.65 in chips) 
Seat 3: Fanatspartak ($0.96 in chips) 
Seat 4: jens 305 ($0.97 in chips) 
Seat 5: Scaaalll ($3.74 in chips) 
Seat 6: Ebbelwoiexp ($2.60 in chips) 
estelionat171: posts small blind $0.01
Fanatspartak: posts big blind $0.02
*** HOLE CARDS ***
Dealt to Scaaalll [As Ks]
jens 305: calls $0.02
Scaaalll: raises $0.06 to $0.08
Ebbelwoiexp: folds 
HellNative: folds 
estelionat171: folds 
Ebbelwoiexp is disconnected 
Fanatspartak: folds 
jens 305: calls $0.06
*** FLOP *** [8s Qs 8d]
jens 305: bets $0.06
Scaaalll: calls $0.06
*** TURN *** [8s Qs 8d] [Qc]
jens 305: checks 
Scaaalll: checks 
*** RIVER *** [8s Qs 8d Qc] [2d]
jens 305: checks 
Scaaalll: checks 
*** SHOW DOWN ***
jens 305: shows [5c 5d] (two pair, Queens and Eights)
Scaaalll: shows [As Ks] (two pair, Queens and Eights - Ace kicker)
Scaaalll collected $0.30 from pot
*** SUMMARY ***
Total pot $0.31 | Rake $0.01 
Board [8s Qs 8d Qc 2d]
Seat 1: HellNative (button) folded before Flop (didn't bet)
Seat 2: estelionat171 (small blind) folded before Flop
Seat 3: Fanatspartak (big blind) folded before Flop
Seat 4: jens 305 showed [5c 5d] and lost with two pair, Queens and Eights
Seat 5: Scaaalll showed [As Ks] and won ($0.30) with two pair, Queens and Eights
Seat 6: Ebbelwoiexp folded before Flop (didn't bet)



PokerStars Zoom Hand #229232076392:  Hold'em No Limit ($0.01/$0.02) - 2021/08/21 22:37:33 CET [2021/08/21 16:37:33 ET]
Table 'Halley' 6-max Seat #1 is the button
Seat 1: Chupacabra G ($2.06 in chips) 
Seat 2: wstanula ($1.25 in chips) 
Seat 3: pavlo8855 ($2.10 in chips) 
Seat 4: 888lifeIS ($2.43 in chips) 
Seat 5: didiclavi777 ($2.07 in chips) 
Seat 6: Scaaalll ($3.88 in chips) 
wstanula: posts small blind $0.01
pavlo8855: posts big blind $0.02
*** HOLE CARDS ***
Dealt to Scaaalll [Jd 2h]
888lifeIS: folds 
didiclavi777: folds 
Scaaalll: folds 
Chupacabra G: folds 
wstanula: folds 
Uncalled bet ($0.01) returned to pavlo8855
pavlo8855 collected $0.02 from pot
pavlo8855: doesn't show hand 
*** SUMMARY ***
Total pot $0.02 | Rake $0 
Seat 1: Chupacabra G (button) folded before Flop (didn't bet)
Seat 2: wstanula (small blind) folded before Flop
Seat 3: pavlo8855 (big blind) collected ($0.02)
Seat 4: 888lifeIS folded before Flop (didn't bet)
Seat 5: didiclavi777 folded before Flop (didn't bet)
Seat 6: Scaaalll folded before Flop (didn't bet)



PokerStars Zoom Hand #229232074687:  Hold'em No Limit ($0.01/$0.02) - 2021/08/21 22:37:29 CET [2021/08/21 16:37:29 ET]
Table 'Halley' 6-max Seat #1 is the button
Seat 1: BlackhawKK's ($2.05 in chips) 
Seat 2: leeroy818 ($2.31 in chips) 
Seat 3: AtZ3899 ($1.64 in chips) 
Seat 4: Scaaalll ($3.88 in chips) 
Seat 5: BendixSenior ($2.70 in chips) 
Seat 6: RzkPoker ($1.75 in chips) 
leeroy818: posts small blind $0.01
AtZ3899: posts big blind $0.02
*** HOLE CARDS ***
Dealt to Scaaalll [Qh 6s]
Scaaalll: folds 
BendixSenior: folds 
BendixSenior is disconnected 
RzkPoker: folds 
BlackhawKK's: folds 
leeroy818: raises $0.04 to $0.06
AtZ3899: folds 
Uncalled bet ($0.04) returned to leeroy818
leeroy818 collected $0.04 from pot
leeroy818: doesn't show hand 
*** SUMMARY ***
Total pot $0.04 | Rake $0 
Seat 1: BlackhawKK's (button) folded before Flop (didn't bet)
Seat 2: leeroy818 (small blind) collected ($0.04)
Seat 3: AtZ3899 (big blind) folded before Flop
Seat 4: Scaaalll folded before Flop (didn't bet)
Seat 5: BendixSenior folded before Flop (didn't bet)
Seat 6: RzkPoker folded before Flop (didn't bet)



PokerStars Zoom Hand #229232078604:  Hold'em No Limit ($0.01/$0.02) - 2021/08/21 22:37:38 CET [2021/08/21 16:37:38 ET]
Table 'Halley' 6-max Seat #1 is the button
Seat 1: Reipinguimm ($2.93 in chips) 
Seat 2: Scaaalll ($3.88 in chips) 
Seat 3: ADWish ($1.38 in chips) 
Seat 4: Pechorin.G ($2 in chips) 
Seat 5: Dron4uk UA ($2.19 in chips) 
Seat 6: ppluiaule ($3.56 in chips) 
Scaaalll: posts small blind $0.01
ADWish: posts big blind $0.02
*** HOLE CARDS ***
Dealt to Scaaalll [Ac 6c]
Pechorin.G: folds 
Dron4uk UA: folds 
ppluiaule: folds 
Reipinguimm: raises $0.02 to $0.04
Scaaalll: raises $0.12 to $0.16
ADWish: folds 
Reipinguimm: folds 
Uncalled bet ($0.12) returned to Scaaalll
Scaaalll collected $0.10 from pot
Scaaalll: doesn't show hand 
*** SUMMARY ***
Total pot $0.10 | Rake $0 
Seat 1: Reipinguimm (button) folded before Flop
Seat 2: Scaaalll (small blind) collected ($0.10)
Seat 3: ADWish (big blind) folded before Flop
Seat 4: Pechorin.G folded before Flop (didn't bet)
Seat 5: Dron4uk UA folded before Flop (didn't bet)
Seat 6: ppluiaule folded before Flop (didn't bet)



PokerStars Zoom Hand #229232090227:  Hold'em No Limit ($0.01/$0.02) - 2021/08/21 22:38:04 CET [2021/08/21 16:38:04 ET]
Table 'Halley' 6-max Seat #1 is the button
Seat 1: Scaaalll ($3.94 in chips) 
Seat 2: Finderra ($2.96 in chips) 
Seat 3: CRODeny ($2 in chips) 
Seat 4: mrsavagep ($0.83 in chips) 
Seat 5: EB-NetCafe ($1.47 in chips) 
Seat 6: storo98 ($16.67 in chips) 
Finderra: posts small blind $0.01
CRODeny: posts big blind $0.02
*** HOLE CARDS ***
Dealt to Scaaalll [As 9h]
mrsavagep: folds 
mrsavagep is disconnected 
EB-NetCafe: folds 
storo98: raises $0.03 to $0.05
Scaaalll: folds 
Finderra: folds 
CRODeny: folds 
Uncalled bet ($0.03) returned to storo98
storo98 collected $0.05 from pot
storo98: doesn't show hand 
*** SUMMARY ***
Total pot $0.05 | Rake $0 
Seat 1: Scaaalll (button) folded before Flop (didn't bet)
Seat 2: Finderra (small blind) folded before Flop
Seat 3: CRODeny (big blind) folded before Flop
Seat 4: mrsavagep folded before Flop (didn't bet)
Seat 5: EB-NetCafe folded before Flop (didn't bet)
Seat 6: storo98 collected ($0.05)



PokerStars Zoom Hand #229232068474:  Hold'em No Limit ($0.01/$0.02) - 2021/08/21 22:37:15 CET [2021/08/21 16:37:15 ET]
Table 'Halley' 6-max Seat #1 is the button
Seat 1: Ck@tih@ ($1.84 in chips) 
Seat 2: KRITAYA ($1.62 in chips) 
Seat 3: Scaaalll ($3.90 in chips) 
Seat 4: Ramirres ($2.05 in chips) 
Seat 5: zergmiky ($2.67 in chips) 
Seat 6: alphabeta1d ($2 in chips) 
KRITAYA: posts small blind $0.01
Scaaalll: posts big blind $0.02
*** HOLE CARDS ***
Dealt to Scaaalll [6h 5c]
Ramirres: folds 
zergmiky: raises $0.03 to $0.05
alphabeta1d: folds 
Ck@tih@: calls $0.05
KRITAYA: calls $0.04
Scaaalll: folds 
*** FLOP *** [7s Qd Ad]
KRITAYA: checks 
zergmiky: checks 
Ck@tih@: bets $0.08
KRITAYA: raises $0.16 to $0.24
zergmiky: folds 
Ck@tih@: calls $0.16
*** TURN *** [7s Qd Ad] [Ks]
KRITAYA: bets $0.47
Ck@tih@: calls $0.47
*** RIVER *** [7s Qd Ad Ks] [3s]
KRITAYA: bets $0.86 and is all-in
Ck@tih@: folds 
Uncalled bet ($0.86) returned to KRITAYA
KRITAYA collected $1.53 from pot
KRITAYA: doesn't show hand 
*** SUMMARY ***
Total pot $1.59 | Rake $0.06 
Board [7s Qd Ad Ks 3s]
Seat 1: Ck@tih@ (button) folded on the River
Seat 2: KRITAYA (small blind) collected ($1.53)
Seat 3: Scaaalll (big blind) folded before Flop
Seat 4: Ramirres folded before Flop (didn't bet)
Seat 5: zergmiky folded on the Flop
Seat 6: alphabeta1d folded before Flop (didn't bet)



PokerStars Zoom Hand #229232094081:  Hold'em No Limit ($0.01/$0.02) - 2021/08/21 22:38:12 CET [2021/08/21 16:38:12 ET]
Table 'Halley' 6-max Seat #1 is the button
Seat 1: alecha11 ($2.05 in chips) 
Seat 2: WellWell57 ($4.16 in chips) 
Seat 3: ded serch ($2 in chips) 
Seat 4: Scaaalll ($3.94 in chips) 
Seat 5: KochetovAN ($0.62 in chips) 
Seat 6: LijanaV ($5.82 in chips) 
WellWell57: posts small blind $0.01
ded serch: posts big blind $0.02
*** HOLE CARDS ***
Dealt to Scaaalll [Qc 4c]
LijanaV is disconnected 
Scaaalll: folds 
KochetovAN: raises $0.05 to $0.07
LijanaV: folds 
alecha11: folds 
WellWell57: folds 
ded serch: folds 
Uncalled bet ($0.05) returned to KochetovAN
KochetovAN collected $0.05 from pot
KochetovAN: doesn't show hand 
*** SUMMARY ***
Total pot $0.05 | Rake $0 
Seat 1: alecha11 (button) folded before Flop (didn't bet)
Seat 2: WellWell57 (small blind) folded before Flop
Seat 3: ded serch (big blind) folded before Flop
Seat 4: Scaaalll folded before Flop (didn't bet)
Seat 5: KochetovAN collected ($0.05)
Seat 6: LijanaV folded before Flop (didn't bet)



PokerStars Zoom Hand #229232096830:  Hold'em No Limit ($0.01/$0.02) - 2021/08/21 22:38:19 CET [2021/08/21 16:38:19 ET]
Table 'Halley' 6-max Seat #1 is the button
Seat 1: 888lifeIS ($2.30 in chips) 
Seat 2: bbarao ($2.59 in chips) 
Seat 3: Scaaalll ($3.94 in chips) 
Seat 4: F_oksi(BLR) ($2.26 in chips) 
Seat 5: balalaikaRUS47 ($1.70 in chips) 
Seat 6: zbixxx ($2.71 in chips) 
bbarao: posts small blind $0.01
Scaaalll: posts big blind $0.02
*** HOLE CARDS ***
Dealt to Scaaalll [Ah 2s]
F_oksi(BLR): folds 
balalaikaRUS47: calls $0.02
zbixxx: folds 
888lifeIS: folds 
bbarao: folds 
Scaaalll: checks 
*** FLOP *** [Tc 6d Jh]
Scaaalll: checks 
balalaikaRUS47: checks 
*** TURN *** [Tc 6d Jh] [3d]
Scaaalll: checks 
balalaikaRUS47: bets $0.05
Scaaalll: folds 
Uncalled bet ($0.05) returned to balalaikaRUS47
balalaikaRUS47 collected $0.05 from pot
balalaikaRUS47: doesn't show hand 
*** SUMMARY ***
Total pot $0.05 | Rake $0 
Board [Tc 6d Jh 3d]
Seat 1: 888lifeIS (button) folded before Flop (didn't bet)
Seat 2: bbarao (small blind) folded before Flop
Seat 3: Scaaalll (big blind) folded on the Turn
Seat 4: F_oksi(BLR) folded before Flop (didn't bet)
Seat 5: balalaikaRUS47 collected ($0.05)
Seat 6: zbixxx folded before Flop (didn't bet)



PokerStars Zoom Hand #229232113717:  Hold'em No Limit ($0.01/$0.02) - 2021/08/21 22:38:57 CET [2021/08/21 16:38:57 ET]
Table 'Halley' 6-max Seat #1 is the button
Seat 1: Treadero ($3.05 in chips) 
Seat 2: NickAlex18 ($2 in chips) 
Seat 3: Cid s2 ($3.64 in chips) 
Seat 4: keb1981 ($2.13 in chips) 
Seat 5: Scaaalll ($3.92 in chips) 
Seat 6: polymorhp ($2.75 in chips) 
NickAlex18: posts small blind $0.01
Cid s2: posts big blind $0.02
*** HOLE CARDS ***
Dealt to Scaaalll [3s Th]
keb1981: folds 
Scaaalll: folds 
polymorhp: folds 
Treadero: folds 
NickAlex18: folds 
Uncalled bet ($0.01) returned to Cid s2
Cid s2 collected $0.02 from pot
Cid s2: doesn't show hand 
*** SUMMARY ***
Total pot $0.02 | Rake $0 
Seat 1: Treadero (button) folded before Flop (didn't bet)
Seat 2: NickAlex18 (small blind) folded before Flop
Seat 3: Cid s2 (big blind) collected ($0.02)
Seat 4: keb1981 folded before Flop (didn't bet)
Seat 5: Scaaalll folded before Flop (didn't bet)
Seat 6: polymorhp folded before Flop (didn't bet)



PokerStars Zoom Hand #229232115456:  Hold'em No Limit ($0.01/$0.02) - 2021/08/21 22:39:01 CET [2021/08/21 16:39:01 ET]
Table 'Halley' 6-max Seat #1 is the button
Seat 1: LuckyCheewey ($5.28 in chips) 
Seat 2: Scaaalll ($3.92 in chips) 
Seat 3: HellNative ($3.46 in chips) 
Seat 4: Clavis Noa ($1.03 in chips) 
Seat 5: AtZ3899 ($1.85 in chips) 
Seat 6: Koldun 2636 ($3.72 in chips) 
Scaaalll: posts small blind $0.01
HellNative: posts big blind $0.02
*** HOLE CARDS ***
Dealt to Scaaalll [7h Ts]
Clavis Noa: folds 
AtZ3899: folds 
Koldun 2636: folds 
LuckyCheewey: raises $0.05 to $0.07
Scaaalll: folds 
HellNative: folds 
Uncalled bet ($0.05) returned to LuckyCheewey
LuckyCheewey collected $0.05 from pot
LuckyCheewey: doesn't show hand 
*** SUMMARY ***
Total pot $0.05 | Rake $0 
Seat 1: LuckyCheewey (button) collected ($0.05)
Seat 2: Scaaalll (small blind) folded before Flop
Seat 3: HellNative (big blind) folded before Flop
Seat 4: Clavis Noa folded before Flop (didn't bet)
Seat 5: AtZ3899 folded before Flop (didn't bet)
Seat 6: Koldun 2636 folded before Flop (didn't bet)



PokerStars Zoom Hand #229232110211:  Hold'em No Limit ($0.01/$0.02) - 2021/08/21 22:38:49 CET [2021/08/21 16:38:49 ET]
Table 'Halley' 6-max Seat #1 is the button
Seat 1: Daiting1 ($1.96 in chips) 
Seat 2: golfffffer ($1.48 in chips) 
Seat 3: ded serch ($2.04 in chips) 
Seat 4: homka45 ($1.02 in chips) 
Seat 5: TomoKondo ($2 in chips) 
Seat 6: Scaaalll ($3.92 in chips) 
golfffffer: posts small blind $0.01
ded serch: posts big blind $0.02
*** HOLE CARDS ***
Dealt to Scaaalll [3s 9h]
homka45: folds 
TomoKondo: folds 
Scaaalll: folds 
Daiting1: raises $0.04 to $0.06
golfffffer: raises $0.14 to $0.20
ded serch: folds 
Daiting1 has timed out
Daiting1: folds 
Uncalled bet ($0.14) returned to golfffffer
golfffffer collected $0.14 from pot
golfffffer: doesn't show hand 
*** SUMMARY ***
Total pot $0.14 | Rake $0 
Seat 1: Daiting1 (button) folded before Flop
Seat 2: golfffffer (small blind) collected ($0.14)
Seat 3: ded serch (big blind) folded before Flop
Seat 4: homka45 folded before Flop (didn't bet)
Seat 5: TomoKondo folded before Flop (didn't bet)
Seat 6: Scaaalll folded before Flop (didn't bet)



PokerStars Zoom Hand #229232120215:  Hold'em No Limit ($0.01/$0.02) - 2021/08/21 22:39:10 CET [2021/08/21 16:39:10 ET]
Table 'Halley' 6-max Seat #1 is the button
Seat 1: Emilmoller1 ($0.91 in chips) 
Seat 2: Koldun 2636 ($3.72 in chips) 
Seat 3: LSDenny ($1.82 in chips) 
Seat 4: Scaaalll ($3.91 in chips) 
Seat 5: gasmar_29 ($2.08 in chips) 
Seat 6: slipknot956 ($3.46 in chips) 
Koldun 2636: posts small blind $0.01
LSDenny: posts big blind $0.02
*** HOLE CARDS ***
Dealt to Scaaalll [Qd 7s]
Scaaalll: folds 
gasmar_29: folds 
slipknot956: folds 
Emilmoller1: folds 
Koldun 2636: folds 
Uncalled bet ($0.01) returned to LSDenny
LSDenny collected $0.02 from pot
LSDenny: doesn't show hand 
*** SUMMARY ***
Total pot $0.02 | Rake $0 
Seat 1: Emilmoller1 (button) folded before Flop (didn't bet)
Seat 2: Koldun 2636 (small blind) folded before Flop
Seat 3: LSDenny (big blind) collected ($0.02)
Seat 4: Scaaalll folded before Flop (didn't bet)
Seat 5: gasmar_29 folded before Flop (didn't bet)
Seat 6: slipknot956 folded before Flop (didn't bet)



PokerStars Zoom Hand #229232121957:  Hold'em No Limit ($0.01/$0.02) - 2021/08/21 22:39:14 CET [2021/08/21 16:39:14 ET]
Table 'Halley' 6-max Seat #1 is the button
Seat 1: Scaaalll ($3.91 in chips) 
Seat 2: RichJImen89 ($2.13 in chips) 
Seat 3: rekopo203 ($5.05 in chips) 
Seat 4: bbarao ($2.59 in chips) 
Seat 5: Artezito ($2.26 in chips) 
Seat 6: jowecheck ($1.93 in chips) 
RichJImen89: posts small blind $0.01
rekopo203: posts big blind $0.02
*** HOLE CARDS ***
Dealt to Scaaalll [6s Jc]
bbarao: folds 
Artezito: folds 
jowecheck: raises $0.02 to $0.04
Scaaalll: folds 
RichJImen89: folds 
rekopo203: folds 
Uncalled bet ($0.02) returned to jowecheck
jowecheck collected $0.05 from pot
jowecheck: doesn't show hand 
*** SUMMARY ***
Total pot $0.05 | Rake $0 
Seat 1: Scaaalll (button) folded before Flop (didn't bet)
Seat 2: RichJImen89 (small blind) folded before Flop
Seat 3: rekopo203 (big blind) folded before Flop
Seat 4: bbarao folded before Flop (didn't bet)
Seat 5: Artezito folded before Flop (didn't bet)
Seat 6: jowecheck collected ($0.05)



PokerStars Zoom Hand #229232125095:  Hold'em No Limit ($0.01/$0.02) - 2021/08/21 22:39:21 CET [2021/08/21 16:39:21 ET]
Table 'Halley' 6-max Seat #1 is the button
Seat 1: mheronmagno ($0.97 in chips) 
Seat 2: 888lifeIS ($2.01 in chips) 
Seat 3: Scaaalll ($3.91 in chips) 
Seat 4: anes.v. ($2.89 in chips) 
Seat 5: TomoKondo ($2.03 in chips) 
Seat 6: zbixxx ($2.62 in chips) 
888lifeIS: posts small blind $0.01
Scaaalll: posts big blind $0.02
*** HOLE CARDS ***
Dealt to Scaaalll [4h Kh]
anes.v.: folds 
TomoKondo: folds 
zbixxx: folds 
mheronmagno: folds 
888lifeIS: raises $0.02 to $0.04
Scaaalll: calls $0.02
*** FLOP *** [6c 5s Tc]
888lifeIS: checks 
Scaaalll: checks 
*** TURN *** [6c 5s Tc] [4c]
888lifeIS: bets $0.05
Scaaalll: folds 
Uncalled bet ($0.05) returned to 888lifeIS
888lifeIS collected $0.08 from pot
888lifeIS: doesn't show hand 
*** SUMMARY ***
Total pot $0.08 | Rake $0 
Board [6c 5s Tc 4c]
Seat 1: mheronmagno (button) folded before Flop (didn't bet)
Seat 2: 888lifeIS (small blind) collected ($0.08)
Seat 3: Scaaalll (big blind) folded on the Turn
Seat 4: anes.v. folded before Flop (didn't bet)
Seat 5: TomoKondo folded before Flop (didn't bet)
Seat 6: zbixxx folded before Flop (didn't bet)



PokerStars Zoom Hand #229232136973:  Hold'em No Limit ($0.01/$0.02) - 2021/08/21 22:39:48 CET [2021/08/21 16:39:48 ET]
Table 'Halley' 6-max Seat #1 is the button
Seat 1: dcd113 ($1.86 in chips) 
Seat 2: davidalejag ($3.46 in chips) 
Seat 3: SKV_1985 ($2.79 in chips) 
Seat 4: Ogni ($4.45 in chips) 
Seat 5: Scaaalll ($3.87 in chips) 
Seat 6: amand14 ($2.19 in chips) 
davidalejag: posts small blind $0.01
SKV_1985: posts big blind $0.02
*** HOLE CARDS ***
Dealt to Scaaalll [Tc Ts]
Ogni: folds 
Scaaalll: raises $0.04 to $0.06
amand14: folds 
dcd113: folds 
davidalejag: folds 
SKV_1985: folds 
Uncalled bet ($0.04) returned to Scaaalll
Scaaalll collected $0.05 from pot
Scaaalll: doesn't show hand 
*** SUMMARY ***
Total pot $0.05 | Rake $0 
Seat 1: dcd113 (button) folded before Flop (didn't bet)
Seat 2: davidalejag (small blind) folded before Flop
Seat 3: SKV_1985 (big blind) folded before Flop
Seat 4: Ogni folded before Flop (didn't bet)
Seat 5: Scaaalll collected ($0.05)
Seat 6: amand14 folded before Flop (didn't bet)



PokerStars Zoom Hand #229232158157:  Hold'em No Limit ($0.01/$0.02) - 2021/08/21 22:40:36 CET [2021/08/21 16:40:36 ET]
Table 'Halley' 6-max Seat #1 is the button
Seat 1: NoEff0rt2w1n ($2.65 in chips) 
Seat 2: LuckyCheewey ($8.94 in chips) 
Seat 3: ppluiaule ($3.44 in chips) 
Seat 4: Scaaalll ($3.89 in chips) 
Seat 5: Alex Koshva1 ($3.39 in chips) 
Seat 6: gilberto98 ($2.22 in chips) 
LuckyCheewey: posts small blind $0.01
ppluiaule: posts big blind $0.02
*** HOLE CARDS ***
Dealt to Scaaalll [3h Qc]
Scaaalll: folds 
Alex Koshva1: folds 
gilberto98: folds 
NoEff0rt2w1n: raises $0.03 to $0.05
LuckyCheewey: folds 
ppluiaule: folds 
Uncalled bet ($0.03) returned to NoEff0rt2w1n
NoEff0rt2w1n collected $0.05 from pot
NoEff0rt2w1n: doesn't show hand 
*** SUMMARY ***
Total pot $0.05 | Rake $0 
Seat 1: NoEff0rt2w1n (button) collected ($0.05)
Seat 2: LuckyCheewey (small blind) folded before Flop
Seat 3: ppluiaule (big blind) folded before Flop
Seat 4: Scaaalll folded before Flop (didn't bet)
Seat 5: Alex Koshva1 folded before Flop (didn't bet)
Seat 6: gilberto98 folded before Flop (didn't bet)



PokerStars Zoom Hand #229232151024:  Hold'em No Limit ($0.01/$0.02) - 2021/08/21 22:40:20 CET [2021/08/21 16:40:20 ET]
Table 'Halley' 6-max Seat #1 is the button
Seat 1: tittenholmes ($2.02 in chips) 
Seat 2: Scaaalll ($3.90 in chips) 
Seat 3: Spo1LT ($1.64 in chips) 
Seat 4: Kelingor ($2 in chips) 
Seat 5: yasinffm ($1.52 in chips) 
Seat 6: 888lifeIS ($2.05 in chips) 
Scaaalll: posts small blind $0.01
Spo1LT: posts big blind $0.02
*** HOLE CARDS ***
Dealt to Scaaalll [5s 8s]
Kelingor: folds 
yasinffm: calls $0.02
888lifeIS: raises $0.04 to $0.06
tittenholmes: folds 
Scaaalll: folds 
Spo1LT: folds 
yasinffm: calls $0.04
*** FLOP *** [9h Ts 4d]
yasinffm: bets $0.07
888lifeIS: calls $0.07
*** TURN *** [9h Ts 4d] [Kd]
yasinffm: checks 
888lifeIS: bets $0.14
yasinffm: folds 
Uncalled bet ($0.14) returned to 888lifeIS
888lifeIS collected $0.28 from pot
888lifeIS: doesn't show hand 
*** SUMMARY ***
Total pot $0.29 | Rake $0.01 
Board [9h Ts 4d Kd]
Seat 1: tittenholmes (button) folded before Flop (didn't bet)
Seat 2: Scaaalll (small blind) folded before Flop
Seat 3: Spo1LT (big blind) folded before Flop
Seat 4: Kelingor folded before Flop (didn't bet)
Seat 5: yasinffm folded on the Turn
Seat 6: 888lifeIS collected ($0.28)



PokerStars Zoom Hand #229232149234:  Hold'em No Limit ($0.01/$0.02) - 2021/08/21 22:40:16 CET [2021/08/21 16:40:16 ET]
Table 'Halley' 6-max Seat #1 is the button
Seat 1: loukon579 ($5.87 in chips) 
Seat 2: new face onl ($1.92 in chips) 
Seat 3: RChinenov ($2.02 in chips) 
Seat 4: FabOliveira9 ($2.03 in chips) 
Seat 5: sal_sagev41 ($2.21 in chips) 
Seat 6: Scaaalll ($3.90 in chips) 
new face onl: posts small blind $0.01
RChinenov: posts big blind $0.02
*** HOLE CARDS ***
Dealt to Scaaalll [4d 7s]
FabOliveira9: folds 
sal_sagev41: raises $0.03 to $0.05
Scaaalll: folds 
loukon579: calls $0.05
new face onl: folds 
RChinenov: folds 
*** FLOP *** [Qc Th Ah]
sal_sagev41: bets $0.04
loukon579: raises $0.88 to $0.92
sal_sagev41: folds 
Uncalled bet ($0.88) returned to loukon579
loukon579 collected $0.20 from pot
loukon579: doesn't show hand 
*** SUMMARY ***
Total pot $0.21 | Rake $0.01 
Board [Qc Th Ah]
Seat 1: loukon579 (button) collected ($0.20)
Seat 2: new face onl (small blind) folded before Flop
Seat 3: RChinenov (big blind) folded before Flop
Seat 4: FabOliveira9 folded before Flop (didn't bet)
Seat 5: sal_sagev41 folded on the Flop
Seat 6: Scaaalll folded before Flop (didn't bet)



PokerStars Zoom Hand #229232159875:  Hold'em No Limit ($0.01/$0.02) - 2021/08/21 22:40:40 CET [2021/08/21 16:40:40 ET]
Table 'Halley' 6-max Seat #1 is the button
Seat 1: Scaaalll ($3.89 in chips) 
Seat 2: CowboyNicky ($2.23 in chips) 
Seat 3: NecromiconP ($5.71 in chips) 
Seat 4: JBPY ($1.89 in chips) 
Seat 5: Pechorin.G ($2.03 in chips) 
Seat 6: z3317111711 ($6.04 in chips) 
CowboyNicky: posts small blind $0.01
NecromiconP: posts big blind $0.02
*** HOLE CARDS ***
Dealt to Scaaalll [3s Kh]
JBPY: folds 
Pechorin.G: folds 
z3317111711: raises $0.03 to $0.05
Scaaalll: folds 
CowboyNicky: folds 
CowboyNicky is disconnected 
NecromiconP: folds 
Uncalled bet ($0.03) returned to z3317111711
z3317111711 collected $0.05 from pot
z3317111711: doesn't show hand 
*** SUMMARY ***
Total pot $0.05 | Rake $0 
Seat 1: Scaaalll (button) folded before Flop (didn't bet)
Seat 2: CowboyNicky (small blind) folded before Flop
Seat 3: NecromiconP (big blind) folded before Flop
Seat 4: JBPY folded before Flop (didn't bet)
Seat 5: Pechorin.G folded before Flop (didn't bet)
Seat 6: z3317111711 collected ($0.05)



PokerStars Zoom Hand #229232170101:  Hold'em No Limit ($0.01/$0.02) - 2021/08/21 22:41:00 CET [2021/08/21 16:41:00 ET]
Table 'Halley' 6-max Seat #1 is the button
Seat 1: Wobblerking1979 ($1.07 in chips) 
Seat 2: felipeciji ($2.73 in chips) 
Seat 3: Scaaalll ($3.89 in chips) 
Seat 4: juan24655 ($1.28 in chips) 
Seat 5: Billy Beane1 ($2.11 in chips) 
Seat 6: CRODeny ($2 in chips) 
felipeciji: posts small blind $0.01
Scaaalll: posts big blind $0.02
*** HOLE CARDS ***
Dealt to Scaaalll [Ks Jd]
juan24655: folds 
Billy Beane1: folds 
CRODeny: folds 
Wobblerking1979: folds 
felipeciji: raises $0.04 to $0.06
Scaaalll: calls $0.04
*** FLOP *** [6s 2d 9h]
felipeciji: checks 
Scaaalll: checks 
*** TURN *** [6s 2d 9h] [3d]
felipeciji: bets $0.08
Scaaalll: folds 
Uncalled bet ($0.08) returned to felipeciji
felipeciji collected $0.12 from pot
felipeciji: doesn't show hand 
*** SUMMARY ***
Total pot $0.12 | Rake $0 
Board [6s 2d 9h 3d]
Seat 1: Wobblerking1979 (button) folded before Flop (didn't bet)
Seat 2: felipeciji (small blind) collected ($0.12)
Seat 3: Scaaalll (big blind) folded on the Turn
Seat 4: juan24655 folded before Flop (didn't bet)
Seat 5: Billy Beane1 folded before Flop (didn't bet)
Seat 6: CRODeny folded before Flop (didn't bet)



PokerStars Zoom Hand #229232187196:  Hold'em No Limit ($0.01/$0.02) - 2021/08/21 22:41:39 CET [2021/08/21 16:41:39 ET]
Table 'Halley' 6-max Seat #1 is the button
Seat 1: Ar xxx ($1.63 in chips) 
Seat 2: Healthys07 ($4.93 in chips) 
Seat 3: furgalik ($0.59 in chips) 
Seat 4: Dr.stromg ($2.56 in chips) 
Seat 5: Reipinguimm ($2 in chips) 
Seat 6: Scaaalll ($3.83 in chips) 
Healthys07: posts small blind $0.01
furgalik: posts big blind $0.02
*** HOLE CARDS ***
Dealt to Scaaalll [Jd Th]
Dr.stromg: folds 
Reipinguimm: folds 
Scaaalll: raises $0.04 to $0.06
Ar xxx: calls $0.06
Healthys07: folds 
furgalik: raises $0.53 to $0.59 and is all-in
Scaaalll: folds 
Ar xxx: folds 
Uncalled bet ($0.53) returned to furgalik
furgalik collected $0.19 from pot
furgalik: doesn't show hand 
*** SUMMARY ***
Total pot $0.19 | Rake $0 
Seat 1: Ar xxx (button) folded before Flop
Seat 2: Healthys07 (small blind) folded before Flop
Seat 3: furgalik (big blind) collected ($0.19)
Seat 4: Dr.stromg folded before Flop (didn't bet)
Seat 5: Reipinguimm folded before Flop (didn't bet)
Seat 6: Scaaalll folded before Flop



PokerStars Zoom Hand #229232209932:  Hold'em No Limit ($0.01/$0.02) - 2021/08/21 22:42:31 CET [2021/08/21 16:42:31 ET]
Table 'Halley' 6-max Seat #1 is the button
Seat 1: Ever10MZ ($1.20 in chips) 
Seat 2: NecromiconP ($2.70 in chips) 
Seat 3: Baldisback ($3.58 in chips) 
Seat 4: Pechorin.G ($2 in chips) 
Seat 5: Scaaalll ($3.76 in chips) 
Seat 6: MEZz828 ($2.04 in chips) 
NecromiconP: posts small blind $0.01
Baldisback: posts big blind $0.02
*** HOLE CARDS ***
Dealt to Scaaalll [2h 5h]
Pechorin.G: raises $0.04 to $0.06
Scaaalll: folds 
MEZz828: folds 
Ever10MZ: folds 
NecromiconP: raises $2.64 to $2.70 and is all-in
Baldisback: folds 
Pechorin.G: folds 
Uncalled bet ($2.64) returned to NecromiconP
NecromiconP collected $0.14 from pot
NecromiconP: doesn't show hand 
*** SUMMARY ***
Total pot $0.14 | Rake $0 
Seat 1: Ever10MZ (button) folded before Flop (didn't bet)
Seat 2: NecromiconP (small blind) collected ($0.14)
Seat 3: Baldisback (big blind) folded before Flop
Seat 4: Pechorin.G folded before Flop
Seat 5: Scaaalll folded before Flop (didn't bet)
Seat 6: MEZz828 folded before Flop (didn't bet)



PokerStars Zoom Hand #229232211684:  Hold'em No Limit ($0.01/$0.02) - 2021/08/21 22:42:35 CET [2021/08/21 16:42:35 ET]
Table 'Halley' 6-max Seat #1 is the button
Seat 1: Scaaalll ($3.76 in chips) 
Seat 2: thi_spe ($2 in chips) 
Seat 3: Rafa13brr ($0.99 in chips) 
Seat 4: The-End-snglr ($1.81 in chips) 
Seat 5: ricske68 ($2.74 in chips) 
Seat 6: XHerrTUMNUSX ($8.28 in chips) 
thi_spe: posts small blind $0.01
Rafa13brr: posts big blind $0.02
*** HOLE CARDS ***
Dealt to Scaaalll [Kc 5c]
The-End-snglr: folds 
ricske68: folds 
XHerrTUMNUSX: raises $0.03 to $0.05
Scaaalll: folds 
thi_spe: folds 
Rafa13brr: folds 
Uncalled bet ($0.03) returned to XHerrTUMNUSX
XHerrTUMNUSX collected $0.05 from pot
XHerrTUMNUSX: doesn't show hand 
*** SUMMARY ***
Total pot $0.05 | Rake $0 
Seat 1: Scaaalll (button) folded before Flop (didn't bet)
Seat 2: thi_spe (small blind) folded before Flop
Seat 3: Rafa13brr (big blind) folded before Flop
Seat 4: The-End-snglr folded before Flop (didn't bet)
Seat 5: ricske68 folded before Flop (didn't bet)
Seat 6: XHerrTUMNUSX collected ($0.05)



PokerStars Zoom Hand #229232216060:  Hold'em No Limit ($0.01/$0.02) - 2021/08/21 22:42:45 CET [2021/08/21 16:42:45 ET]
Table 'Halley' 6-max Seat #1 is the button
Seat 1: ladi59 ($2.05 in chips) 
Seat 2: Pechorin.G ($2 in chips) 
Seat 3: Simon190713 ($4.18 in chips) 
Seat 4: BlackhawKK's ($2.40 in chips) 
Seat 5: Jellycube ($4.27 in chips) 
Seat 6: Scaaalll ($3.76 in chips) 
Pechorin.G: posts small blind $0.01
Simon190713: posts big blind $0.02
*** HOLE CARDS ***
Dealt to Scaaalll [8c 6c]
BlackhawKK's: raises $0.02 to $0.04
ladi59 is disconnected 
Jellycube: folds 
Simon190713 is disconnected 
Scaaalll: folds 
ladi59: folds 
Pechorin.G: folds 
Simon190713: folds 
Uncalled bet ($0.02) returned to BlackhawKK's
BlackhawKK's collected $0.05 from pot
BlackhawKK's: doesn't show hand 
*** SUMMARY ***
Total pot $0.05 | Rake $0 
Seat 1: ladi59 (button) folded before Flop (didn't bet)
Seat 2: Pechorin.G (small blind) folded before Flop
Seat 3: Simon190713 (big blind) folded before Flop
Seat 4: BlackhawKK's collected ($0.05)
Seat 5: Jellycube folded before Flop (didn't bet)
Seat 6: Scaaalll folded before Flop (didn't bet)



PokerStars Zoom Hand #229232198947:  Hold'em No Limit ($0.01/$0.02) - 2021/08/21 22:42:06 CET [2021/08/21 16:42:06 ET]
Table 'Halley' 6-max Seat #1 is the button
Seat 1: Axel201388 ($2.64 in chips) 
Seat 2: Scaaalll ($3.77 in chips) 
Seat 3: Ar xxx ($1.57 in chips) 
Seat 4: new face onl ($2.93 in chips) 
Seat 5: Earl_greyPL ($2.43 in chips) 
Seat 6: mischail1974 ($0.91 in chips) 
Scaaalll: posts small blind $0.01
Ar xxx: posts big blind $0.02
*** HOLE CARDS ***
Dealt to Scaaalll [Jc Ts]
new face onl: folds 
Earl_greyPL: folds 
mischail1974: raises $0.02 to $0.04
Axel201388: folds 
Scaaalll: folds 
Ar xxx: calls $0.02
*** FLOP *** [Ks 8s 2s]
Ar xxx: bets $0.02
mischail1974: calls $0.02
*** TURN *** [Ks 8s 2s] [Qd]
Ar xxx: bets $0.02
mischail1974: raises $0.02 to $0.04
Ar xxx: calls $0.02
*** RIVER *** [Ks 8s 2s Qd] [3d]
Ar xxx: checks 
mischail1974: bets $0.20
Ar xxx: folds 
Uncalled bet ($0.20) returned to mischail1974
mischail1974 collected $0.20 from pot
mischail1974: doesn't show hand 
*** SUMMARY ***
Total pot $0.21 | Rake $0.01 
Board [Ks 8s 2s Qd 3d]
Seat 1: Axel201388 (button) folded before Flop (didn't bet)
Seat 2: Scaaalll (small blind) folded before Flop
Seat 3: Ar xxx (big blind) folded on the River
Seat 4: new face onl folded before Flop (didn't bet)
Seat 5: Earl_greyPL folded before Flop (didn't bet)
Seat 6: mischail1974 collected ($0.20)



PokerStars Zoom Hand #229232221620:  Hold'em No Limit ($0.01/$0.02) - 2021/08/21 22:42:58 CET [2021/08/21 16:42:58 ET]
Table 'Halley' 6-max Seat #1 is the button
Seat 1: FabOliveira9 ($2.51 in chips) 
Seat 2: Gabr Ribeiro ($1.88 in chips) 
Seat 3: Scaaalll ($3.76 in chips) 
Seat 4: sewq55 ($1.37 in chips) 
Seat 5: feybys ($1.95 in chips) 
Seat 6: Jackb9908 ($2.30 in chips) 
Gabr Ribeiro: posts small blind $0.01
Scaaalll: posts big blind $0.02
*** HOLE CARDS ***
Dealt to Scaaalll [Ad 9d]
sewq55: folds 
feybys: folds 
Jackb9908: folds 
FabOliveira9: folds 
Gabr Ribeiro: raises $0.03 to $0.05
Scaaalll: calls $0.03
*** FLOP *** [6c 2c 4h]
Gabr Ribeiro: bets $0.04
Scaaalll: calls $0.04
*** TURN *** [6c 2c 4h] [3d]
Gabr Ribeiro: bets $0.10
Scaaalll: folds 
Uncalled bet ($0.10) returned to Gabr Ribeiro
Gabr Ribeiro collected $0.17 from pot
Gabr Ribeiro: doesn't show hand 
*** SUMMARY ***
Total pot $0.18 | Rake $0.01 
Board [6c 2c 4h 3d]
Seat 1: FabOliveira9 (button) folded before Flop (didn't bet)
Seat 2: Gabr Ribeiro (small blind) collected ($0.17)
Seat 3: Scaaalll (big blind) folded on the Turn
Seat 4: sewq55 folded before Flop (didn't bet)
Seat 5: feybys folded before Flop (didn't bet)
Seat 6: Jackb9908 folded before Flop (didn't bet)



PokerStars Zoom Hand #229232241083:  Hold'em No Limit ($0.01/$0.02) - 2021/08/21 22:43:43 CET [2021/08/21 16:43:43 ET]
Table 'Halley' 6-max Seat #1 is the button
Seat 1: ppluiaule ($2.84 in chips) 
Seat 2: z3317111711 ($1.87 in chips) 
Seat 3: sewq55 ($0.78 in chips) 
Seat 4: VovaU164 ($0.66 in chips) 
Seat 5: Scaaalll ($3.67 in chips) 
Seat 6: Artezito ($2.51 in chips) 
z3317111711: posts small blind $0.01
sewq55: posts big blind $0.02
*** HOLE CARDS ***
Dealt to Scaaalll [2h 3c]
VovaU164: folds 
VovaU164 is disconnected 
Scaaalll: folds 
Artezito: folds 
ppluiaule: raises $0.02 to $0.04
z3317111711: folds 
sewq55: folds 
Uncalled bet ($0.02) returned to ppluiaule
ppluiaule collected $0.05 from pot
ppluiaule: doesn't show hand 
*** SUMMARY ***
Total pot $0.05 | Rake $0 
Seat 1: ppluiaule (button) collected ($0.05)
Seat 2: z3317111711 (small blind) folded before Flop
Seat 3: sewq55 (big blind) folded before Flop
Seat 4: VovaU164 folded before Flop (didn't bet)
Seat 5: Scaaalll folded before Flop (didn't bet)
Seat 6: Artezito folded before Flop (didn't bet)



PokerStars Zoom Hand #229232245296:  Hold'em No Limit ($0.01/$0.02) - 2021/08/21 22:43:53 CET [2021/08/21 16:43:53 ET]
Table 'Halley' 6-max Seat #1 is the button
Seat 1: NickAlex18 ($2.31 in chips) 
Seat 2: zergmiky ($2 in chips) 
Seat 3: kalina998 ($2 in chips) 
Seat 4: Scaaalll ($3.67 in chips) 
Seat 5: Clownyara ($2.36 in chips) 
Seat 6: fishh_play ($2.59 in chips) 
zergmiky: posts small blind $0.01
kalina998: posts big blind $0.02
*** HOLE CARDS ***
Dealt to Scaaalll [5d 6d]
Scaaalll: raises $0.04 to $0.06
Clownyara: folds 
fishh_play: folds 
NickAlex18: folds 
zergmiky: folds 
kalina998: raises $0.13 to $0.19
Scaaalll: calls $0.13
*** FLOP *** [8c Tc Ks]
kalina998: bets $0.38
Scaaalll: folds 
Uncalled bet ($0.38) returned to kalina998
kalina998 collected $0.38 from pot
kalina998: doesn't show hand 
*** SUMMARY ***
Total pot $0.39 | Rake $0.01 
Board [8c Tc Ks]
Seat 1: NickAlex18 (button) folded before Flop (didn't bet)
Seat 2: zergmiky (small blind) folded before Flop
Seat 3: kalina998 (big blind) collected ($0.38)
Seat 4: Scaaalll folded on the Flop
Seat 5: Clownyara folded before Flop (didn't bet)
Seat 6: fishh_play folded before Flop (didn't bet)



PokerStars Zoom Hand #229232264856:  Hold'em No Limit ($0.01/$0.02) - 2021/08/21 22:44:39 CET [2021/08/21 16:44:39 ET]
Table 'Halley' 6-max Seat #1 is the button
Seat 1: BlackhawKK's ($2.92 in chips) 
Seat 2: Stryda00 ($3.93 in chips) 
Seat 3: Scaaalll ($3.47 in chips) 
Seat 4: DiPchable ($0.84 in chips) 
Seat 5: Tn 939 ($2.38 in chips) 
Seat 6: davidalejag ($3.42 in chips) 
Stryda00: posts small blind $0.01
Scaaalll: posts big blind $0.02
*** HOLE CARDS ***
Dealt to Scaaalll [6h Ts]
DiPchable: folds 
DiPchable is disconnected 
Tn 939: folds 
davidalejag: folds 
BlackhawKK's: folds 
Stryda00: folds 
Uncalled bet ($0.01) returned to Scaaalll
Scaaalll collected $0.02 from pot
Scaaalll: doesn't show hand 
*** SUMMARY ***
Total pot $0.02 | Rake $0 
Seat 1: BlackhawKK's (button) folded before Flop (didn't bet)
Seat 2: Stryda00 (small blind) folded before Flop
Seat 3: Scaaalll (big blind) collected ($0.02)
Seat 4: DiPchable folded before Flop (didn't bet)
Seat 5: Tn 939 folded before Flop (didn't bet)
Seat 6: davidalejag folded before Flop (didn't bet)



PokerStars Zoom Hand #229232238460:  Hold'em No Limit ($0.01/$0.02) - 2021/08/21 22:43:37 CET [2021/08/21 16:43:37 ET]
Table 'Halley' 6-max Seat #1 is the button
Seat 1: sg.32rus ($1.23 in chips) 
Seat 2: sewq55 ($1.34 in chips) 
Seat 3: 09mexanik09 ($1.66 in chips) 
Seat 4: Scaaalll ($3.67 in chips) 
Seat 5: Akrobat94 ($0.75 in chips) 
Seat 6: polymorhp ($2.88 in chips) 
sewq55: posts small blind $0.01
09mexanik09: posts big blind $0.02
*** HOLE CARDS ***
Dealt to Scaaalll [6c 4h]
Scaaalll: folds 
Akrobat94: calls $0.02
polymorhp: calls $0.02
sg.32rus: folds 
sewq55: folds 
09mexanik09: checks 
*** FLOP *** [9s 3s 3h]
09mexanik09: bets $0.06
Akrobat94: raises $0.06 to $0.12
polymorhp: folds 
09mexanik09: calls $0.06
*** TURN *** [9s 3s 3h] [Js]
09mexanik09: checks 
Akrobat94: bets $0.30
09mexanik09: raises $0.32 to $0.62
Akrobat94: calls $0.31 and is all-in
Uncalled bet ($0.01) returned to 09mexanik09
*** RIVER *** [9s 3s 3h Js] [Kc]
*** SHOW DOWN ***
09mexanik09: shows [3d Ks] (a full house, Threes full of Kings)
Akrobat94: shows [Jh 9d] (two pair, Jacks and Nines)
09mexanik09 cashed out the hand for $1.34 | Cash Out Fee $0.01
*** SUMMARY ***
Total pot $1.53 | Rake $0.05 
Board [9s 3s 3h Js Kc]
Seat 1: sg.32rus (button) folded before Flop (didn't bet)
Seat 2: sewq55 (small blind) folded before Flop
Seat 3: 09mexanik09 (big blind) showed [3d Ks] and won ($1.48) with a full house, Threes full of Kings (pot not awarded as player cashed out)
Seat 4: Scaaalll folded before Flop (didn't bet)
Seat 5: Akrobat94 showed [Jh 9d] and lost with two pair, Jacks and Nines
Seat 6: polymorhp folded on the Flop



PokerStars Zoom Hand #229232259726:  Hold'em No Limit ($0.01/$0.02) - 2021/08/21 22:44:27 CET [2021/08/21 16:44:27 ET]
Table 'Halley' 6-max Seat #1 is the button
Seat 1: SIGREX ($3.51 in chips) 
Seat 2: Scaaalll ($3.48 in chips) 
Seat 3: egopi ($2 in chips) 
Seat 4: AlexGTPS ($2.33 in chips) 
Seat 5: Vitalyi1970 ($1.81 in chips) 
Seat 6: gasmar_29 ($4.22 in chips) 
Scaaalll: posts small blind $0.01
egopi: posts big blind $0.02
*** HOLE CARDS ***
Dealt to Scaaalll [Jh 2h]
AlexGTPS: folds 
Vitalyi1970: folds 
gasmar_29: raises $0.04 to $0.06
egopi is disconnected 
SIGREX: folds 
egopi is disconnected 
egopi is disconnected 
Scaaalll: folds 
egopi: calls $0.04
*** FLOP *** [Ah 7c 9d]
egopi: checks 
gasmar_29: bets $0.09
egopi: folds 
Uncalled bet ($0.09) returned to gasmar_29
gasmar_29 collected $0.13 from pot
gasmar_29: doesn't show hand 
egopi is disconnected 
*** SUMMARY ***
Total pot $0.13 | Rake $0 
Board [Ah 7c 9d]
Seat 1: SIGREX (button) folded before Flop (didn't bet)
Seat 2: Scaaalll (small blind) folded before Flop
Seat 3: egopi (big blind) folded on the Flop
Seat 4: AlexGTPS folded before Flop (didn't bet)
Seat 5: Vitalyi1970 folded before Flop (didn't bet)
Seat 6: gasmar_29 collected ($0.13)



PokerStars Zoom Hand #229232270368:  Hold'em No Limit ($0.01/$0.02) - 2021/08/21 22:44:52 CET [2021/08/21 16:44:52 ET]
Table 'Halley' 6-max Seat #1 is the button
Seat 1: Scaaalll ($3.48 in chips) 
Seat 2: Earl_greyPL ($1 in chips) 
Seat 3: WITKOW_AV ($2 in chips) 
Seat 4: Smailodon ($1.07 in chips) 
Seat 5: Koldun 2636 ($2.28 in chips) 
Seat 6: Gamer577 ($2.18 in chips) 
Earl_greyPL: posts small blind $0.01
WITKOW_AV: posts big blind $0.02
*** HOLE CARDS ***
Dealt to Scaaalll [7s 4d]
Smailodon: raises $0.04 to $0.06
Koldun 2636: folds 
Gamer577: folds 
Scaaalll: folds 
Earl_greyPL: folds 
WITKOW_AV: folds 
Uncalled bet ($0.04) returned to Smailodon
Smailodon collected $0.05 from pot
Smailodon: doesn't show hand 
*** SUMMARY ***
Total pot $0.05 | Rake $0 
Seat 1: Scaaalll (button) folded before Flop (didn't bet)
Seat 2: Earl_greyPL (small blind) folded before Flop
Seat 3: WITKOW_AV (big blind) folded before Flop
Seat 4: Smailodon collected ($0.05)
Seat 5: Koldun 2636 folded before Flop (didn't bet)
Seat 6: Gamer577 folded before Flop (didn't bet)



PokerStars Zoom Hand #229232275969:  Hold'em No Limit ($0.01/$0.02) - 2021/08/21 22:45:05 CET [2021/08/21 16:45:05 ET]
Table 'Halley' 6-max Seat #1 is the button
Seat 1: 888lifeIS ($2.60 in chips) 
Seat 2: Nolimit.208 ($2.79 in chips) 
Seat 3: RichJImen89 ($2.08 in chips) 
Seat 4: Umnik_M ($1.88 in chips) 
Seat 5: Kergie ($15.87 in chips) 
Seat 6: Scaaalll ($3.48 in chips) 
Nolimit.208: posts small blind $0.01
RichJImen89: posts big blind $0.02
*** HOLE CARDS ***
Dealt to Scaaalll [Jd 3d]
Umnik_M: folds 
Kergie: folds 
Scaaalll: folds 
888lifeIS: folds 
Nolimit.208: raises $0.02 to $0.04
RichJImen89: folds 
Uncalled bet ($0.02) returned to Nolimit.208
Nolimit.208 collected $0.04 from pot
Nolimit.208: doesn't show hand 
*** SUMMARY ***
Total pot $0.04 | Rake $0 
Seat 1: 888lifeIS (button) folded before Flop (didn't bet)
Seat 2: Nolimit.208 (small blind) collected ($0.04)
Seat 3: RichJImen89 (big blind) folded before Flop
Seat 4: Umnik_M folded before Flop (didn't bet)
Seat 5: Kergie folded before Flop (didn't bet)
Seat 6: Scaaalll folded before Flop (didn't bet)



PokerStars Zoom Hand #229232277851:  Hold'em No Limit ($0.01/$0.02) - 2021/08/21 22:45:09 CET [2021/08/21 16:45:09 ET]
Table 'Halley' 6-max Seat #1 is the button
Seat 1: Tobyellie ($3.99 in chips) 
Seat 2: Scaaalll ($3.48 in chips) 
Seat 3: rpycmbEM ($4.77 in chips) 
Seat 4: 78joniboy ($2.30 in chips) 
Seat 5: 888lifeIS ($2.60 in chips) 
Seat 6: teutonknight ($0.53 in chips) 
Scaaalll: posts small blind $0.01
rpycmbEM: posts big blind $0.02
*** HOLE CARDS ***
Dealt to Scaaalll [Ah As]
Tobyellie is disconnected 
78joniboy: folds 
888lifeIS: folds 
teutonknight: folds 
Tobyellie: folds 
Scaaalll: raises $0.04 to $0.06
rpycmbEM: calls $0.04
*** FLOP *** [3h Ks 9d]
Scaaalll: bets $0.08
rpycmbEM: calls $0.08
*** TURN *** [3h Ks 9d] [Ts]
Scaaalll: bets $0.17
rpycmbEM: folds 
Uncalled bet ($0.17) returned to Scaaalll
Scaaalll collected $0.27 from pot
Scaaalll: doesn't show hand 
*** SUMMARY ***
Total pot $0.28 | Rake $0.01 
Board [3h Ks 9d Ts]
Seat 1: Tobyellie (button) folded before Flop (didn't bet)
Seat 2: Scaaalll (small blind) collected ($0.27)
Seat 3: rpycmbEM (big blind) folded on the Turn
Seat 4: 78joniboy folded before Flop (didn't bet)
Seat 5: 888lifeIS folded before Flop (didn't bet)
Seat 6: teutonknight folded before Flop (didn't bet)



PokerStars Zoom Hand #229232310678:  Hold'em No Limit ($0.01/$0.02) - 2021/08/21 22:45:54 CET [2021/08/21 16:45:54 ET]
Table 'Halley' 6-max Seat #1 is the button
Seat 1: HDYD18 ($3.80 in chips) 
Seat 2: Artezito ($2.75 in chips) 
Seat 3: zbixxx ($10.07 in chips) 
Seat 4: EdwardF95 ($2 in chips) 
Seat 5: Scaaalll ($3.61 in chips) 
Seat 6: maliniak75 ($1.58 in chips) 
Artezito: posts small blind $0.01
zbixxx: posts big blind $0.02
*** HOLE CARDS ***
Dealt to Scaaalll [8h Kd]
EdwardF95: folds 
Scaaalll: folds 
maliniak75: folds 
HDYD18: folds 
Artezito: folds 
Uncalled bet ($0.01) returned to zbixxx
zbixxx collected $0.02 from pot
zbixxx: doesn't show hand 
*** SUMMARY ***
Total pot $0.02 | Rake $0 
Seat 1: HDYD18 (button) folded before Flop (didn't bet)
Seat 2: Artezito (small blind) folded before Flop
Seat 3: zbixxx (big blind) collected ($0.02)
Seat 4: EdwardF95 folded before Flop (didn't bet)
Seat 5: Scaaalll folded before Flop (didn't bet)
Seat 6: maliniak75 folded before Flop (didn't bet)



PokerStars Zoom Hand #229232312360:  Hold'em No Limit ($0.01/$0.02) - 2021/08/21 22:45:58 CET [2021/08/21 16:45:58 ET]
Table 'Halley' 6-max Seat #1 is the button
Seat 1: AlexGTPS ($2.04 in chips) 
Seat 2: MATIdf365 ($1.87 in chips) 
Seat 3: Chapaev136 ($5.17 in chips) 
Seat 4: Scaaalll ($3.61 in chips) 
Seat 5: py100ta ($20.70 in chips) 
Seat 6: golfffffer ($1.04 in chips) 
MATIdf365: posts small blind $0.01
Chapaev136: posts big blind $0.02
*** HOLE CARDS ***
Dealt to Scaaalll [5d 5h]
Scaaalll: raises $0.04 to $0.06
py100ta: folds 
golfffffer: folds 
golfffffer is disconnected 
AlexGTPS: folds 
MATIdf365: folds 
Chapaev136: folds 
Uncalled bet ($0.04) returned to Scaaalll
Scaaalll collected $0.05 from pot
Scaaalll: doesn't show hand 
*** SUMMARY ***
Total pot $0.05 | Rake $0 
Seat 1: AlexGTPS (button) folded before Flop (didn't bet)
Seat 2: MATIdf365 (small blind) folded before Flop
Seat 3: Chapaev136 (big blind) folded before Flop
Seat 4: Scaaalll collected ($0.05)
Seat 5: py100ta folded before Flop (didn't bet)
Seat 6: golfffffer folded before Flop (didn't bet)



PokerStars Zoom Hand #229232319407:  Hold'em No Limit ($0.01/$0.02) - 2021/08/21 22:46:14 CET [2021/08/21 16:46:14 ET]
Table 'Halley' 6-max Seat #1 is the button
Seat 1: rpycmbEM ($4.12 in chips) 
Seat 2: NickAlex18 ($2.05 in chips) 
Seat 3: Artezito ($2.63 in chips) 
Seat 4: new face onl ($3.11 in chips) 
Seat 5: Scaaalll ($3.64 in chips) 
Seat 6: boa juice ($2.11 in chips) 
NickAlex18: posts small blind $0.01
Artezito: posts big blind $0.02
*** HOLE CARDS ***
Dealt to Scaaalll [Kd Th]
new face onl: folds 
boa juice is disconnected 
Scaaalll: folds 
boa juice: folds 
rpycmbEM: folds 
NickAlex18: raises $0.03 to $0.05
Artezito: folds 
Uncalled bet ($0.03) returned to NickAlex18
NickAlex18 collected $0.04 from pot
NickAlex18: doesn't show hand 
*** SUMMARY ***
Total pot $0.04 | Rake $0 
Seat 1: rpycmbEM (button) folded before Flop (didn't bet)
Seat 2: NickAlex18 (small blind) collected ($0.04)
Seat 3: Artezito (big blind) folded before Flop
Seat 4: new face onl folded before Flop (didn't bet)
Seat 5: Scaaalll folded before Flop (didn't bet)
Seat 6: boa juice folded before Flop (didn't bet)



PokerStars Zoom Hand #229232322433:  Hold'em No Limit ($0.01/$0.02) - 2021/08/21 22:46:21 CET [2021/08/21 16:46:21 ET]
Table 'Halley' 6-max Seat #1 is the button
Seat 1: 01527368 ($4.23 in chips) 
Seat 2: RChinenov ($2.43 in chips) 
Seat 3: estelionat171 ($1 in chips) 
Seat 4: NecromiconP ($5.38 in chips) 
Seat 5: rpycmbEM ($3.05 in chips) 
Seat 6: Scaaalll ($3.64 in chips) 
RChinenov: posts small blind $0.01
estelionat171: posts big blind $0.02
*** HOLE CARDS ***
Dealt to Scaaalll [Th Qh]
NecromiconP: folds 
rpycmbEM: raises $0.02 to $0.04
Scaaalll: calls $0.04
01527368: calls $0.04
RChinenov: folds 
estelionat171: folds 
*** FLOP *** [7d 8d 8c]
rpycmbEM: checks 
Scaaalll: bets $0.09
01527368: calls $0.09
rpycmbEM: calls $0.09
*** TURN *** [7d 8d 8c] [4c]
rpycmbEM: checks 
Scaaalll: checks 
01527368: bets $0.40
rpycmbEM: folds 
Scaaalll: folds 
Uncalled bet ($0.40) returned to 01527368
01527368 collected $0.41 from pot
01527368: doesn't show hand 
*** SUMMARY ***
Total pot $0.42 | Rake $0.01 
Board [7d 8d 8c 4c]
Seat 1: 01527368 (button) collected ($0.41)
Seat 2: RChinenov (small blind) folded before Flop
Seat 3: estelionat171 (big blind) folded before Flop
Seat 4: NecromiconP folded before Flop (didn't bet)
Seat 5: rpycmbEM folded on the Turn
Seat 6: Scaaalll folded on the Turn



PokerStars Zoom Hand #229232351881:  Hold'em No Limit ($0.01/$0.02) - 2021/08/21 22:47:28 CET [2021/08/21 16:47:28 ET]
Table 'Halley' 6-max Seat #1 is the button
Seat 1: EdwardF95 ($2.05 in chips) 
Seat 2: Xlavariable ($2.04 in chips) 
Seat 3: Scaaalll ($3.51 in chips) 
Seat 4: dorro61966 ($1.41 in chips) 
Seat 5: Thaleshs ($2.19 in chips) 
Seat 6: pepope ($2 in chips) 
Xlavariable: posts small blind $0.01
Scaaalll: posts big blind $0.02
*** HOLE CARDS ***
Dealt to Scaaalll [7s 7d]
dorro61966: folds 
Thaleshs: folds 
pepope: folds 
EdwardF95: folds 
Xlavariable: raises $0.04 to $0.06
Scaaalll: calls $0.04
*** FLOP *** [Qc Qh 3d]
Xlavariable: bets $0.04
Scaaalll: calls $0.04
*** TURN *** [Qc Qh 3d] [8s]
Xlavariable: checks 
Scaaalll: bets $0.12
Xlavariable: folds 
Uncalled bet ($0.12) returned to Scaaalll
Scaaalll collected $0.19 from pot
Scaaalll: doesn't show hand 
*** SUMMARY ***
Total pot $0.20 | Rake $0.01 
Board [Qc Qh 3d 8s]
Seat 1: EdwardF95 (button) folded before Flop (didn't bet)
Seat 2: Xlavariable (small blind) folded on the Turn
Seat 3: Scaaalll (big blind) collected ($0.19)
Seat 4: dorro61966 folded before Flop (didn't bet)
Seat 5: Thaleshs folded before Flop (didn't bet)
Seat 6: pepope folded before Flop (didn't bet)



PokerStars Zoom Hand #229232376375:  Hold'em No Limit ($0.01/$0.02) - 2021/08/21 22:48:24 CET [2021/08/21 16:48:24 ET]
Table 'Halley' 6-max Seat #1 is the button
Seat 1: Scaaalll ($3.60 in chips) 
Seat 2: SKV_1985 ($3.35 in chips) 
Seat 3: leeroy818 ($3.54 in chips) 
Seat 4: zergmiky ($2.11 in chips) 
Seat 5: Gek77 ($5.48 in chips) 
Seat 6: pepope ($2 in chips) 
SKV_1985: posts small blind $0.01
leeroy818: posts big blind $0.02
*** HOLE CARDS ***
Dealt to Scaaalll [7c Ts]
zergmiky: raises $0.03 to $0.05
Gek77: folds 
pepope: folds 
Scaaalll: folds 
SKV_1985: folds 
leeroy818: folds 
Uncalled bet ($0.03) returned to zergmiky
zergmiky collected $0.05 from pot
zergmiky: doesn't show hand 
*** SUMMARY ***
Total pot $0.05 | Rake $0 
Seat 1: Scaaalll (button) folded before Flop (didn't bet)
Seat 2: SKV_1985 (small blind) folded before Flop
Seat 3: leeroy818 (big blind) folded before Flop
Seat 4: zergmiky collected ($0.05)
Seat 5: Gek77 folded before Flop (didn't bet)
Seat 6: pepope folded before Flop (didn't bet)



PokerStars Zoom Hand #229232378117:  Hold'em No Limit ($0.01/$0.02) - 2021/08/21 22:48:28 CET [2021/08/21 16:48:28 ET]
Table 'Halley' 6-max Seat #1 is the button
Seat 1: SKV_1985 ($3.34 in chips) 
Seat 2: Thaleshs ($3.19 in chips) 
Seat 3: medyza111 ($2 in chips) 
Seat 4: Scaaalll ($3.60 in chips) 
Seat 5: Yangyang1407 ($2.16 in chips) 
Seat 6: Busya777 ($1.81 in chips) 
Thaleshs: posts small blind $0.01
medyza111: posts big blind $0.02
*** HOLE CARDS ***
Dealt to Scaaalll [Kd 5h]
Busya777 is disconnected 
Scaaalll: folds 
Yangyang1407: raises $0.04 to $0.06
Busya777: folds 
SKV_1985: folds 
Thaleshs: folds 
medyza111: calls $0.04
*** FLOP *** [3h 2h Td]
medyza111: checks 
Yangyang1407: checks 
*** TURN *** [3h 2h Td] [Jd]
medyza111: bets $0.07
Yangyang1407: folds 
Uncalled bet ($0.07) returned to medyza111
medyza111 collected $0.13 from pot
medyza111: doesn't show hand 
*** SUMMARY ***
Total pot $0.13 | Rake $0 
Board [3h 2h Td Jd]
Seat 1: SKV_1985 (button) folded before Flop (didn't bet)
Seat 2: Thaleshs (small blind) folded before Flop
Seat 3: medyza111 (big blind) collected ($0.13)
Seat 4: Scaaalll folded before Flop (didn't bet)
Seat 5: Yangyang1407 folded on the Turn
Seat 6: Busya777 folded before Flop (didn't bet)



PokerStars Zoom Hand #229232381233:  Hold'em No Limit ($0.01/$0.02) - 2021/08/21 22:48:35 CET [2021/08/21 16:48:35 ET]
Table 'Halley' 6-max Seat #1 is the button
Seat 1: Tsopan77 ($1.43 in chips) 
Seat 2: Scaaalll ($3.60 in chips) 
Seat 3: olga3021221 ($2 in chips) 
Seat 4: gesaes ($1.56 in chips) 
Seat 5: BORODA-X ($2.20 in chips) 
Seat 6: dkno77 ($1.45 in chips) 
Scaaalll: posts small blind $0.01
olga3021221: posts big blind $0.02
*** HOLE CARDS ***
Dealt to Scaaalll [Qs 9c]
gesaes: folds 
BORODA-X: calls $0.02
dkno77: folds 
Tsopan77: raises $0.02 to $0.04
Scaaalll: folds 
olga3021221: folds 
BORODA-X: calls $0.02
*** FLOP *** [Js 4s Kc]
BORODA-X: checks 
Tsopan77: checks 
*** TURN *** [Js 4s Kc] [4d]
BORODA-X: checks 
Tsopan77: checks 
*** RIVER *** [Js 4s Kc 4d] [Ts]
BORODA-X: checks 
Tsopan77: checks 
*** SHOW DOWN ***
BORODA-X: shows [8h 9d] (a pair of Fours)
Tsopan77: shows [7c Ac] (a pair of Fours - Ace kicker)
Tsopan77 collected $0.11 from pot
*** SUMMARY ***
Total pot $0.11 | Rake $0 
Board [Js 4s Kc 4d Ts]
Seat 1: Tsopan77 (button) showed [7c Ac] and won ($0.11) with a pair of Fours
Seat 2: Scaaalll (small blind) folded before Flop
Seat 3: olga3021221 (big blind) folded before Flop
Seat 4: gesaes folded before Flop (didn't bet)
Seat 5: BORODA-X showed [8h 9d] and lost with a pair of Fours
Seat 6: dkno77 folded before Flop (didn't bet)



PokerStars Zoom Hand #229232388314:  Hold'em No Limit ($0.01/$0.02) - 2021/08/21 22:48:51 CET [2021/08/21 16:48:51 ET]
Table 'Halley' 6-max Seat #1 is the button
Seat 1: Scaaalll ($3.59 in chips) 
Seat 2: TRI MEDVEDYA ($1.84 in chips) 
Seat 3: pepope ($2.12 in chips) 
Seat 4: gasmar_29 ($2.68 in chips) 
Seat 5: CowboyNicky ($2.24 in chips) 
Seat 6: ser313131 ($10.34 in chips) 
TRI MEDVEDYA: posts small blind $0.01
pepope: posts big blind $0.02
*** HOLE CARDS ***
Dealt to Scaaalll [5s 9s]
CowboyNicky is disconnected 
gasmar_29: folds 
CowboyNicky: folds 
ser313131: raises $0.02 to $0.04
Scaaalll: folds 
TRI MEDVEDYA: folds 
TRI MEDVEDYA is disconnected 
pepope: folds 
Uncalled bet ($0.02) returned to ser313131
ser313131 collected $0.05 from pot
ser313131: doesn't show hand 
*** SUMMARY ***
Total pot $0.05 | Rake $0 
Seat 1: Scaaalll (button) folded before Flop (didn't bet)
Seat 2: TRI MEDVEDYA (small blind) folded before Flop
Seat 3: pepope (big blind) folded before Flop
Seat 4: gasmar_29 folded before Flop (didn't bet)
Seat 5: CowboyNicky folded before Flop (didn't bet)
Seat 6: ser313131 collected ($0.05)



PokerStars Zoom Hand #229232397127:  Hold'em No Limit ($0.01/$0.02) - 2021/08/21 22:49:11 CET [2021/08/21 16:49:11 ET]
Table 'Halley' 6-max Seat #1 is the button
Seat 1: egroj1700 ($2.05 in chips) 
Seat 2: Flo_Ned ($0.81 in chips) 
Seat 3: CrazyyParis ($2 in chips) 
Seat 4: DaBaDaBaDooo ($3.01 in chips) 
Seat 5: Mad_Clock ($3.53 in chips) 
Seat 6: Scaaalll ($3.59 in chips) 
Flo_Ned: posts small blind $0.01
CrazyyParis: posts big blind $0.02
*** HOLE CARDS ***
Dealt to Scaaalll [Jh Qc]
DaBaDaBaDooo: folds 
Mad_Clock: folds 
Scaaalll: raises $0.04 to $0.06
egroj1700: folds 
Flo_Ned: folds 
CrazyyParis: calls $0.04
*** FLOP *** [8s 5h Qs]
CrazyyParis: checks 
Scaaalll: bets $0.08
CrazyyParis: calls $0.08
*** TURN *** [8s 5h Qs] [7h]
CrazyyParis: checks 
Scaaalll: bets $0.18
CrazyyParis: calls $0.18
*** RIVER *** [8s 5h Qs 7h] [9h]
CrazyyParis: checks 
Scaaalll: checks 
*** SHOW DOWN ***
CrazyyParis: shows [9d Qd] (two pair, Queens and Nines)
Scaaalll: mucks hand 
CrazyyParis collected $0.63 from pot
*** SUMMARY ***
Total pot $0.65 | Rake $0.02 
Board [8s 5h Qs 7h 9h]
Seat 1: egroj1700 (button) folded before Flop (didn't bet)
Seat 2: Flo_Ned (small blind) folded before Flop
Seat 3: CrazyyParis (big blind) showed [9d Qd] and won ($0.63) with two pair, Queens and Nines
Seat 4: DaBaDaBaDooo folded before Flop (didn't bet)
Seat 5: Mad_Clock folded before Flop (didn't bet)
Seat 6: Scaaalll mucked [Jh Qc]



PokerStars Zoom Hand #229232418370:  Hold'em No Limit ($0.01/$0.02) - 2021/08/21 22:49:59 CET [2021/08/21 16:49:59 ET]
Table 'Halley' 6-max Seat #1 is the button
Seat 1: golfffffer ($1.01 in chips) 
Seat 2: JTbukowski ($3.89 in chips) 
Seat 3: Scaaalll ($3.27 in chips) 
Seat 4: Mad_Clock ($2.11 in chips) 
Seat 5: RrriotGrrrl ($4.54 in chips) 
Seat 6: NoEff0rt2w1n ($2.01 in chips) 
JTbukowski: posts small blind $0.01
Scaaalll: posts big blind $0.02
*** HOLE CARDS ***
Dealt to Scaaalll [Th Ts]
Mad_Clock: folds 
RrriotGrrrl: folds 
NoEff0rt2w1n: raises $0.03 to $0.05
golfffffer: raises $0.13 to $0.18
JTbukowski: folds 
Scaaalll: calls $0.16
NoEff0rt2w1n: raises $0.55 to $0.73
golfffffer: folds 
golfffffer is disconnected 
Scaaalll: folds 
Uncalled bet ($0.55) returned to NoEff0rt2w1n
NoEff0rt2w1n collected $0.55 from pot
NoEff0rt2w1n: doesn't show hand 
*** SUMMARY ***
Total pot $0.55 | Rake $0 
Seat 1: golfffffer (button) folded before Flop
Seat 2: JTbukowski (small blind) folded before Flop
Seat 3: Scaaalll (big blind) folded before Flop
Seat 4: Mad_Clock folded before Flop (didn't bet)
Seat 5: RrriotGrrrl folded before Flop (didn't bet)
Seat 6: NoEff0rt2w1n collected ($0.55)



PokerStars Zoom Hand #229232429860:  Hold'em No Limit ($0.01/$0.02) - 2021/08/21 22:50:25 CET [2021/08/21 16:50:25 ET]
Table 'Halley' 6-max Seat #1 is the button
Seat 1: Pechorin.G ($2 in chips) 
Seat 2: Scaaalll ($3.09 in chips) 
Seat 3: 888lifeIS ($2.08 in chips) 
Seat 4: WithMyWalker ($2.31 in chips) 
Seat 5: zergmiky ($2 in chips) 
Seat 6: ASAjr ($1.87 in chips) 
Scaaalll: posts small blind $0.01
888lifeIS: posts big blind $0.02
*** HOLE CARDS ***
Dealt to Scaaalll [Ac 8d]
WithMyWalker: folds 
zergmiky: folds 
ASAjr: folds 
Pechorin.G: folds 
Scaaalll: raises $0.04 to $0.06
888lifeIS: folds 
Uncalled bet ($0.04) returned to Scaaalll
Scaaalll collected $0.04 from pot
Scaaalll: doesn't show hand 
*** SUMMARY ***
Total pot $0.04 | Rake $0 
Seat 1: Pechorin.G (button) folded before Flop (didn't bet)
Seat 2: Scaaalll (small blind) collected ($0.04)
Seat 3: 888lifeIS (big blind) folded before Flop
Seat 4: WithMyWalker folded before Flop (didn't bet)
Seat 5: zergmiky folded before Flop (didn't bet)
Seat 6: ASAjr folded before Flop (didn't bet)



PokerStars Zoom Hand #229232438257:  Hold'em No Limit ($0.01/$0.02) - 2021/08/21 22:50:44 CET [2021/08/21 16:50:44 ET]
Table 'Halley' 6-max Seat #1 is the button
Seat 1: 365p2eva ($4.31 in chips) 
Seat 2: TomoKondo ($2.01 in chips) 
Seat 3: Kelingor ($2 in chips) 
Seat 4: egroj1700 ($2.13 in chips) 
Seat 5: Scaaalll ($3.11 in chips) 
Seat 6: HDYD18 ($5.78 in chips) 
TomoKondo: posts small blind $0.01
Kelingor: posts big blind $0.02
*** HOLE CARDS ***
Dealt to Scaaalll [Qs 4c]
egroj1700: folds 
Scaaalll: folds 
HDYD18: folds 
365p2eva: folds 
TomoKondo: folds 
Uncalled bet ($0.01) returned to Kelingor
Kelingor collected $0.02 from pot
Kelingor: doesn't show hand 
*** SUMMARY ***
Total pot $0.02 | Rake $0 
Seat 1: 365p2eva (button) folded before Flop (didn't bet)
Seat 2: TomoKondo (small blind) folded before Flop
Seat 3: Kelingor (big blind) collected ($0.02)
Seat 4: egroj1700 folded before Flop (didn't bet)
Seat 5: Scaaalll folded before Flop (didn't bet)
Seat 6: HDYD18 folded before Flop (didn't bet)



PokerStars Zoom Hand #229232440009:  Hold'em No Limit ($0.01/$0.02) - 2021/08/21 22:50:48 CET [2021/08/21 16:50:48 ET]
Table 'Halley' 6-max Seat #1 is the button
Seat 1: gasmar_29 ($2.07 in chips) 
Seat 2: VoidEclipse ($1.83 in chips) 
Seat 3: loukon579 ($5.05 in chips) 
Seat 4: Scaaalll ($3.11 in chips) 
Seat 5: luckybadoo ($1.46 in chips) 
Seat 6: RomiSex ($5.32 in chips) 
VoidEclipse: posts small blind $0.01
loukon579: posts big blind $0.02
*** HOLE CARDS ***
Dealt to Scaaalll [Kd Td]
Scaaalll: raises $0.04 to $0.06
loukon579 is disconnected 
luckybadoo: folds 
RomiSex: folds 
gasmar_29: folds 
VoidEclipse: folds 
loukon579: folds 
Uncalled bet ($0.04) returned to Scaaalll
Scaaalll collected $0.05 from pot
Scaaalll: doesn't show hand 
*** SUMMARY ***
Total pot $0.05 | Rake $0 
Seat 1: gasmar_29 (button) folded before Flop (didn't bet)
Seat 2: VoidEclipse (small blind) folded before Flop
Seat 3: loukon579 (big blind) folded before Flop
Seat 4: Scaaalll collected ($0.05)
Seat 5: luckybadoo folded before Flop (didn't bet)
Seat 6: RomiSex folded before Flop (didn't bet)



PokerStars Zoom Hand #229232447908:  Hold'em No Limit ($0.01/$0.02) - 2021/08/21 22:51:06 CET [2021/08/21 16:51:06 ET]
Table 'Halley' 6-max Seat #1 is the button
Seat 1: Scaaalll ($3.14 in chips) 
Seat 2: F_oksi(BLR) ($3.46 in chips) 
Seat 3: cr@sh test ($3.41 in chips) 
Seat 4: Pechorin.G ($2.24 in chips) 
Seat 5: Earl_greyPL ($2.03 in chips) 
Seat 6: smileakafray ($3.87 in chips) 
F_oksi(BLR): posts small blind $0.01
cr@sh test: posts big blind $0.02
*** HOLE CARDS ***
Dealt to Scaaalll [5s 2d]
Pechorin.G: raises $0.04 to $0.06
Earl_greyPL: folds 
smileakafray: folds 
Scaaalll: folds 
F_oksi(BLR): folds 
cr@sh test: folds 
Uncalled bet ($0.04) returned to Pechorin.G
Pechorin.G collected $0.05 from pot
Pechorin.G: doesn't show hand 
*** SUMMARY ***
Total pot $0.05 | Rake $0 
Seat 1: Scaaalll (button) folded before Flop (didn't bet)
Seat 2: F_oksi(BLR) (small blind) folded before Flop
Seat 3: cr@sh test (big blind) folded before Flop
Seat 4: Pechorin.G collected ($0.05)
Seat 5: Earl_greyPL folded before Flop (didn't bet)
Seat 6: smileakafray folded before Flop (didn't bet)



PokerStars Zoom Hand #229232458028:  Hold'em No Limit ($0.01/$0.02) - 2021/08/21 22:51:29 CET [2021/08/21 16:51:29 ET]
Table 'Halley' 6-max Seat #1 is the button
Seat 1: Lidion12 ($1.26 in chips) 
Seat 2: Baksit79 ($1.17 in chips) 
Seat 3: Scaaalll ($3.14 in chips) 
Seat 4: Koldun 2636 ($2.77 in chips) 
Seat 5: WithMyWalker ($2.05 in chips) 
Seat 6: PEDACIT0 ($3.16 in chips) 
Baksit79: posts small blind $0.01
Scaaalll: posts big blind $0.02
*** HOLE CARDS ***
Dealt to Scaaalll [Kh 4h]
Koldun 2636: folds 
Lidion12 is disconnected 
WithMyWalker: raises $0.03 to $0.05
PEDACIT0: folds 
Lidion12: folds 
Baksit79: folds 
Scaaalll: folds 
Uncalled bet ($0.03) returned to WithMyWalker
Baksit79 is disconnected 
WithMyWalker collected $0.05 from pot
WithMyWalker: doesn't show hand 
*** SUMMARY ***
Total pot $0.05 | Rake $0 
Seat 1: Lidion12 (button) folded before Flop (didn't bet)
Seat 2: Baksit79 (small blind) folded before Flop
Seat 3: Scaaalll (big blind) folded before Flop
Seat 4: Koldun 2636 folded before Flop (didn't bet)
Seat 5: WithMyWalker collected ($0.05)
Seat 6: PEDACIT0 folded before Flop (didn't bet)



PokerStars Zoom Hand #229232451381:  Hold'em No Limit ($0.01/$0.02) - 2021/08/21 22:51:14 CET [2021/08/21 16:51:14 ET]
Table 'Halley' 6-max Seat #1 is the button
Seat 1: ser313131 ($4.28 in chips) 
Seat 2: SaRCh_Ale ($2.17 in chips) 
Seat 3: BIITRU ($2.05 in chips) 
Seat 4: rodrigoasor ($2.70 in chips) 
Seat 5: Scaaalll ($3.14 in chips) 
Seat 6: TomoKondo ($2.87 in chips) 
SaRCh_Ale: posts small blind $0.01
BIITRU: posts big blind $0.02
*** HOLE CARDS ***
Dealt to Scaaalll [5d 8d]
rodrigoasor: raises $0.04 to $0.06
Scaaalll: folds 
TomoKondo: folds 
ser313131: folds 
SaRCh_Ale: folds 
BIITRU: folds 
Uncalled bet ($0.04) returned to rodrigoasor
rodrigoasor collected $0.05 from pot
rodrigoasor: doesn't show hand 
*** SUMMARY ***
Total pot $0.05 | Rake $0 
Seat 1: ser313131 (button) folded before Flop (didn't bet)
Seat 2: SaRCh_Ale (small blind) folded before Flop
Seat 3: BIITRU (big blind) folded before Flop
Seat 4: rodrigoasor collected ($0.05)
Seat 5: Scaaalll folded before Flop (didn't bet)
Seat 6: TomoKondo folded before Flop (didn't bet)



PokerStars Zoom Hand #229232461978:  Hold'em No Limit ($0.01/$0.02) - 2021/08/21 22:51:38 CET [2021/08/21 16:51:38 ET]
Table 'Halley' 6-max Seat #1 is the button
Seat 1: olga3021221 ($2 in chips) 
Seat 2: Kb013497 ($1.62 in chips) 
Seat 3: NoEff0rt2w1n ($6.55 in chips) 
Seat 4: Scaaalll ($3.12 in chips) 
Seat 5: uniicecube ($5.55 in chips) 
Seat 6: mcisaac05 ($4.94 in chips) 
Kb013497: posts small blind $0.01
NoEff0rt2w1n: posts big blind $0.02
*** HOLE CARDS ***
Dealt to Scaaalll [7d Ad]
Scaaalll: raises $0.04 to $0.06
uniicecube: calls $0.06
mcisaac05: raises $0.21 to $0.27
olga3021221: folds 
Kb013497: folds 
NoEff0rt2w1n: folds 
Scaaalll: folds 
uniicecube: folds 
Uncalled bet ($0.21) returned to mcisaac05
mcisaac05 collected $0.21 from pot
mcisaac05: doesn't show hand 
*** SUMMARY ***
Total pot $0.21 | Rake $0 
Seat 1: olga3021221 (button) folded before Flop (didn't bet)
Seat 2: Kb013497 (small blind) folded before Flop
Seat 3: NoEff0rt2w1n (big blind) folded before Flop
Seat 4: Scaaalll folded before Flop
Seat 5: uniicecube folded before Flop
Seat 6: mcisaac05 collected ($0.21)



PokerStars Zoom Hand #229232454045:  Hold'em No Limit ($0.01/$0.02) - 2021/08/21 22:51:20 CET [2021/08/21 16:51:20 ET]
Table 'Halley' 6-max Seat #1 is the button
Seat 1: Tabitaji ($2.45 in chips) 
Seat 2: trickywizard64 ($1.49 in chips) 
Seat 3: Habarovs18 ($2.50 in chips) 
Seat 4: zergmiky ($2.05 in chips) 
Seat 5: Earl_greyPL ($1.01 in chips) 
Seat 6: Scaaalll ($3.14 in chips) 
trickywizard64: posts small blind $0.01
Habarovs18: posts big blind $0.02
*** HOLE CARDS ***
Dealt to Scaaalll [Ts 6s]
zergmiky: folds 
Earl_greyPL: folds 
Scaaalll: folds 
Tabitaji: raises $0.03 to $0.05
trickywizard64: calls $0.04
Habarovs18: calls $0.03
*** FLOP *** [6c Kc Kh]
trickywizard64: checks 
Habarovs18: checks 
Tabitaji: bets $0.05
trickywizard64: folds 
Habarovs18: folds 
Uncalled bet ($0.05) returned to Tabitaji
Habarovs18 is disconnected 
Tabitaji collected $0.14 from pot
Tabitaji: doesn't show hand 
*** SUMMARY ***
Total pot $0.15 | Rake $0.01 
Board [6c Kc Kh]
Seat 1: Tabitaji (button) collected ($0.14)
Seat 2: trickywizard64 (small blind) folded on the Flop
Seat 3: Habarovs18 (big blind) folded on the Flop
Seat 4: zergmiky folded before Flop (didn't bet)
Seat 5: Earl_greyPL folded before Flop (didn't bet)
Seat 6: Scaaalll folded before Flop (didn't bet)



PokerStars Zoom Hand #229232477837:  Hold'em No Limit ($0.01/$0.02) - 2021/08/21 22:52:14 CET [2021/08/21 16:52:14 ET]
Table 'Halley' 6-max Seat #1 is the button
Seat 1: pavlo8855 ($2.25 in chips) 
Seat 2: Scaaalll ($3.06 in chips) 
Seat 3: smileakafray ($4.09 in chips) 
Seat 4: xxVanquishxx ($10.97 in chips) 
Seat 5: cr@sh test ($2.15 in chips) 
Seat 6: CordiPS ($4.93 in chips) 
Scaaalll: posts small blind $0.01
smileakafray: posts big blind $0.02
*** HOLE CARDS ***
Dealt to Scaaalll [7h 3s]
xxVanquishxx: folds 
cr@sh test: raises $0.04 to $0.06
CordiPS: folds 
pavlo8855: folds 
Scaaalll: folds 
smileakafray: folds 
Uncalled bet ($0.04) returned to cr@sh test
cr@sh test collected $0.05 from pot
cr@sh test: doesn't show hand 
*** SUMMARY ***
Total pot $0.05 | Rake $0 
Seat 1: pavlo8855 (button) folded before Flop (didn't bet)
Seat 2: Scaaalll (small blind) folded before Flop
Seat 3: smileakafray (big blind) folded before Flop
Seat 4: xxVanquishxx folded before Flop (didn't bet)
Seat 5: cr@sh test collected ($0.05)
Seat 6: CordiPS folded before Flop (didn't bet)



PokerStars Zoom Hand #229232482761:  Hold'em No Limit ($0.01/$0.02) - 2021/08/21 22:52:25 CET [2021/08/21 16:52:25 ET]
Table 'Halley' 6-max Seat #1 is the button
Seat 1: Tacojesuscrisp ($2.07 in chips) 
Seat 2: HDYD18 ($3.41 in chips) 
Seat 3: Scaaalll ($3.05 in chips) 
Seat 4: auxy89 ($2.20 in chips) 
Seat 5: Yangyang1407 ($2.01 in chips) 
Seat 6: castrosis ($3.13 in chips) 
HDYD18: posts small blind $0.01
Scaaalll: posts big blind $0.02
*** HOLE CARDS ***
Dealt to Scaaalll [Qs 2h]
auxy89: folds 
auxy89 is disconnected 
Yangyang1407: folds 
castrosis: raises $0.04 to $0.06
Tacojesuscrisp: folds 
HDYD18: folds 
Scaaalll: folds 
Uncalled bet ($0.04) returned to castrosis
castrosis collected $0.05 from pot
castrosis: doesn't show hand 
*** SUMMARY ***
Total pot $0.05 | Rake $0 
Seat 1: Tacojesuscrisp (button) folded before Flop (didn't bet)
Seat 2: HDYD18 (small blind) folded before Flop
Seat 3: Scaaalll (big blind) folded before Flop
Seat 4: auxy89 folded before Flop (didn't bet)
Seat 5: Yangyang1407 folded before Flop (didn't bet)
Seat 6: castrosis collected ($0.05)



PokerStars Zoom Hand #229232491196:  Hold'em No Limit ($0.01/$0.02) - 2021/08/21 22:52:44 CET [2021/08/21 16:52:44 ET]
Table 'Halley' 6-max Seat #1 is the button
Seat 1: NoEff0rt2w1n ($2.52 in chips) 
Seat 2: Keltu :D ($2 in chips) 
Seat 3: kahzura ($2 in chips) 
Seat 4: astapowitsch ($2.48 in chips) 
Seat 5: Scaaalll ($3.03 in chips) 
Seat 6: Astel88 ($2.30 in chips) 
Keltu :D: posts small blind $0.01
kahzura: posts big blind $0.02
*** HOLE CARDS ***
Dealt to Scaaalll [5c 6h]
astapowitsch: raises $0.04 to $0.06
Scaaalll: folds 
Astel88: folds 
NoEff0rt2w1n: folds 
Keltu :D: folds 
Astel88 is disconnected 
kahzura: calls $0.04
*** FLOP *** [Th 5d Jd]
kahzura: checks 
astapowitsch: checks 
*** TURN *** [Th 5d Jd] [6s]
kahzura: bets $0.10
astapowitsch: folds 
Uncalled bet ($0.10) returned to kahzura
kahzura collected $0.13 from pot
kahzura: doesn't show hand 
*** SUMMARY ***
Total pot $0.13 | Rake $0 
Board [Th 5d Jd 6s]
Seat 1: NoEff0rt2w1n (button) folded before Flop (didn't bet)
Seat 2: Keltu :D (small blind) folded before Flop
Seat 3: kahzura (big blind) collected ($0.13)
Seat 4: astapowitsch folded on the Turn
Seat 5: Scaaalll folded before Flop (didn't bet)
Seat 6: Astel88 folded before Flop (didn't bet)



PokerStars Zoom Hand #229232494258:  Hold'em No Limit ($0.01/$0.02) - 2021/08/21 22:52:51 CET [2021/08/21 16:52:51 ET]
Table 'Halley' 6-max Seat #1 is the button
Seat 1: SniperTano ($1.59 in chips) 
Seat 2: Scaaalll ($3.03 in chips) 
Seat 3: HubertFroh ($2 in chips) 
Seat 4: kukulagosleep ($2.03 in chips) 
Seat 5: kboskov123 ($1.39 in chips) 
Seat 6: MsSuffolk ($2.19 in chips) 
Scaaalll: posts small blind $0.01
HubertFroh: posts big blind $0.02
*** HOLE CARDS ***
Dealt to Scaaalll [8h Jh]
kukulagosleep: folds 
kboskov123: calls $0.02
MsSuffolk: folds 
SniperTano: folds 
Scaaalll: raises $0.08 to $0.10
HubertFroh: folds 
kboskov123: folds 
Uncalled bet ($0.08) returned to Scaaalll
Scaaalll collected $0.06 from pot
Scaaalll: doesn't show hand 
*** SUMMARY ***
Total pot $0.06 | Rake $0 
Seat 1: SniperTano (button) folded before Flop (didn't bet)
Seat 2: Scaaalll (small blind) collected ($0.06)
Seat 3: HubertFroh (big blind) folded before Flop
Seat 4: kukulagosleep folded before Flop (didn't bet)
Seat 5: kboskov123 folded before Flop
Seat 6: MsSuffolk folded before Flop (didn't bet)



PokerStars Zoom Hand #229232467738:  Hold'em No Limit ($0.01/$0.02) - 2021/08/21 22:51:51 CET [2021/08/21 16:51:51 ET]
Table 'Halley' 6-max Seat #1 is the button
Seat 1: Scaaalll ($3.06 in chips) 
Seat 2: WhoBetsWins ($2 in chips) 
Seat 3: Osetrov.A.A ($2.38 in chips) 
Seat 4: NoEff0rt2w1n ($6.53 in chips) 
Seat 5: valet_hai ($1.07 in chips) 
Seat 6: TheW3irdo ($2.04 in chips) 
WhoBetsWins: posts small blind $0.01
Osetrov.A.A: posts big blind $0.02
*** HOLE CARDS ***
Dealt to Scaaalll [Qc 8s]
NoEff0rt2w1n: folds 
valet_hai: folds 
TheW3irdo: raises $0.03 to $0.05
Scaaalll: folds 
WhoBetsWins: calls $0.04
Osetrov.A.A: calls $0.03
*** FLOP *** [9h 8h Qd]
WhoBetsWins: checks 
Osetrov.A.A: bets $0.06
TheW3irdo: calls $0.06
WhoBetsWins: calls $0.06
*** TURN *** [9h 8h Qd] [5h]
WhoBetsWins: checks 
Osetrov.A.A: checks 
TheW3irdo: checks 
*** RIVER *** [9h 8h Qd 5h] [8c]
WhoBetsWins: checks 
Osetrov.A.A: checks 
TheW3irdo: bets $0.20
WhoBetsWins: calls $0.20
Osetrov.A.A: folds 
*** SHOW DOWN ***
TheW3irdo: shows [6c 7c] (a straight, Five to Nine)
WhoBetsWins: mucks hand 
TheW3irdo collected $0.70 from pot
*** SUMMARY ***
Total pot $0.73 | Rake $0.03 
Board [9h 8h Qd 5h 8c]
Seat 1: Scaaalll (button) folded before Flop (didn't bet)
Seat 2: WhoBetsWins (small blind) mucked [Qs Ac]
Seat 3: Osetrov.A.A (big blind) folded on the River
Seat 4: NoEff0rt2w1n folded before Flop (didn't bet)
Seat 5: valet_hai folded before Flop (didn't bet)
Seat 6: TheW3irdo showed [6c 7c] and won ($0.70) with a straight, Five to Nine



PokerStars Zoom Hand #229232502669:  Hold'em No Limit ($0.01/$0.02) - 2021/08/21 22:53:10 CET [2021/08/21 16:53:10 ET]
Table 'Halley' 6-max Seat #1 is the button
Seat 1: Scaaalll ($3.07 in chips) 
Seat 2: Thaleshs ($4.54 in chips) 
Seat 3: Ne0net ($2.08 in chips) 
Seat 4: Umnik_M ($1.92 in chips) 
Seat 5: Phoenixxxxxxxx ($2.07 in chips) 
Seat 6: 78joniboy ($3.07 in chips) 
Thaleshs: posts small blind $0.01
Ne0net: posts big blind $0.02
*** HOLE CARDS ***
Dealt to Scaaalll [Jh As]
Umnik_M: folds 
Phoenixxxxxxxx: folds 
78joniboy: folds 
Scaaalll: raises $0.02 to $0.04
Thaleshs: calls $0.03
Ne0net: folds 
*** FLOP *** [Jd 2h 4h]
Thaleshs: checks 
Scaaalll: bets $0.07
Thaleshs: calls $0.07
*** TURN *** [Jd 2h 4h] [Ad]
Thaleshs: checks 
Scaaalll: bets $0.15
Thaleshs: calls $0.15
*** RIVER *** [Jd 2h 4h Ad] [Ac]
Thaleshs: checks 
Scaaalll: bets $0.36
Thaleshs: folds 
Uncalled bet ($0.36) returned to Scaaalll
Scaaalll collected $0.52 from pot
Scaaalll: doesn't show hand 
*** SUMMARY ***
Total pot $0.54 | Rake $0.02 
Board [Jd 2h 4h Ad Ac]
Seat 1: Scaaalll (button) collected ($0.52)
Seat 2: Thaleshs (small blind) folded on the River
Seat 3: Ne0net (big blind) folded before Flop
Seat 4: Umnik_M folded before Flop (didn't bet)
Seat 5: Phoenixxxxxxxx folded before Flop (didn't bet)
Seat 6: 78joniboy folded before Flop (didn't bet)



PokerStars Zoom Hand #229232530639:  Hold'em No Limit ($0.01/$0.02) - 2021/08/21 22:54:13 CET [2021/08/21 16:54:13 ET]
Table 'Halley' 6-max Seat #1 is the button
Seat 1: BlackhawKK's ($2.36 in chips) 
Seat 2: 01527368 ($5.61 in chips) 
Seat 3: MsSuffolk ($2.28 in chips) 
Seat 4: lucksuckdonk ($6.25 in chips) 
Seat 5: Scaaalll ($3.33 in chips) 
Seat 6: CordiPS ($4.98 in chips) 
01527368: posts small blind $0.01
MsSuffolk: posts big blind $0.02
*** HOLE CARDS ***
Dealt to Scaaalll [8c Tc]
lucksuckdonk: folds 
Scaaalll: raises $0.04 to $0.06
CordiPS: folds 
BlackhawKK's: folds 
01527368: folds 
MsSuffolk: folds 
Uncalled bet ($0.04) returned to Scaaalll
Scaaalll collected $0.05 from pot
Scaaalll: doesn't show hand 
*** SUMMARY ***
Total pot $0.05 | Rake $0 
Seat 1: BlackhawKK's (button) folded before Flop (didn't bet)
Seat 2: 01527368 (small blind) folded before Flop
Seat 3: MsSuffolk (big blind) folded before Flop
Seat 4: lucksuckdonk folded before Flop (didn't bet)
Seat 5: Scaaalll collected ($0.05)
Seat 6: CordiPS folded before Flop (didn't bet)



PokerStars Zoom Hand #229232528839:  Hold'em No Limit ($0.01/$0.02) - 2021/08/21 22:54:09 CET [2021/08/21 16:54:09 ET]
Table 'Halley' 6-max Seat #1 is the button
Seat 1: Tibelloni ($3.16 in chips) 
Seat 2: Billy Beane1 ($2.21 in chips) 
Seat 3: stanthema661 ($2.56 in chips) 
Seat 4: 01527368 ($5.61 in chips) 
Seat 5: kboskov123 ($1.31 in chips) 
Seat 6: Scaaalll ($3.33 in chips) 
Billy Beane1: posts small blind $0.01
stanthema661: posts big blind $0.02
*** HOLE CARDS ***
Dealt to Scaaalll [9h Ac]
01527368: folds 
kboskov123: folds 
Scaaalll: folds 
Tibelloni: raises $0.04 to $0.06
Billy Beane1: folds 
stanthema661: calls $0.04
*** FLOP *** [Td 5s Jd]
stanthema661: checks 
Tibelloni: bets $0.06
stanthema661: calls $0.06
*** TURN *** [Td 5s Jd] [3h]
stanthema661: checks 
Tibelloni: checks 
*** RIVER *** [Td 5s Jd 3h] [Js]
stanthema661: bets $0.24
Tibelloni: calls $0.24
*** SHOW DOWN ***
stanthema661: shows [7h Kc] (a pair of Jacks)
Tibelloni: shows [Ad Th] (two pair, Jacks and Tens)
Tibelloni collected $0.70 from pot
*** SUMMARY ***
Total pot $0.73 | Rake $0.03 
Board [Td 5s Jd 3h Js]
Seat 1: Tibelloni (button) showed [Ad Th] and won ($0.70) with two pair, Jacks and Tens
Seat 2: Billy Beane1 (small blind) folded before Flop
Seat 3: stanthema661 (big blind) showed [7h Kc] and lost with a pair of Jacks
Seat 4: 01527368 folded before Flop (didn't bet)
Seat 5: kboskov123 folded before Flop (didn't bet)
Seat 6: Scaaalll folded before Flop (didn't bet)



PokerStars Zoom Hand #229232535412:  Hold'em No Limit ($0.01/$0.02) - 2021/08/21 22:54:24 CET [2021/08/21 16:54:24 ET]
Table 'Halley' 6-max Seat #1 is the button
Seat 1: ASAjr ($2.37 in chips) 
Seat 2: Thaleshs ($2.02 in chips) 
Seat 3: RomiSex ($5.66 in chips) 
Seat 4: Scaaalll ($3.36 in chips) 
Seat 5: maressen ($2.24 in chips) 
Seat 6: HubertFroh ($2 in chips) 
Thaleshs: posts small blind $0.01
RomiSex: posts big blind $0.02
*** HOLE CARDS ***
Dealt to Scaaalll [Kh Qd]
Scaaalll: raises $0.04 to $0.06
maressen: folds 
HubertFroh: folds 
ASAjr: calls $0.06
Thaleshs: folds 
RomiSex: folds 
*** FLOP *** [Ah 6c 9s]
Scaaalll: checks 
ASAjr: checks 
*** TURN *** [Ah 6c 9s] [Tc]
Scaaalll: checks 
ASAjr: checks 
*** RIVER *** [Ah 6c 9s Tc] [5c]
Scaaalll: checks 
ASAjr: checks 
*** SHOW DOWN ***
Scaaalll: shows [Kh Qd] (high card Ace)
ASAjr: shows [4d 4s] (a pair of Fours)
ASAjr collected $0.14 from pot
*** SUMMARY ***
Total pot $0.15 | Rake $0.01 
Board [Ah 6c 9s Tc 5c]
Seat 1: ASAjr (button) showed [4d 4s] and won ($0.14) with a pair of Fours
Seat 2: Thaleshs (small blind) folded before Flop
Seat 3: RomiSex (big blind) folded before Flop
Seat 4: Scaaalll showed [Kh Qd] and lost with high card Ace
Seat 5: maressen folded before Flop (didn't bet)
Seat 6: HubertFroh folded before Flop (didn't bet)



PokerStars Zoom Hand #229232555781:  Hold'em No Limit ($0.01/$0.02) - 2021/08/21 22:55:13 CET [2021/08/21 16:55:13 ET]
Table 'Halley' 6-max Seat #1 is the button
Seat 1: HDYD18 ($3.34 in chips) 
Seat 2: RomiSex ($5.62 in chips) 
Seat 3: Scaaalll ($3.30 in chips) 
Seat 4: sg.32rus ($1.66 in chips) 
Seat 5: Koldun 2636 ($4.03 in chips) 
Seat 6: TheW3irdo ($2.41 in chips) 
RomiSex: posts small blind $0.01
Scaaalll: posts big blind $0.02
*** HOLE CARDS ***
Dealt to Scaaalll [6d Ts]
sg.32rus: folds 
Koldun 2636 has timed out
Koldun 2636: folds 
TheW3irdo: folds 
HDYD18: raises $0.04 to $0.06
RomiSex: folds 
Scaaalll: folds 
Uncalled bet ($0.04) returned to HDYD18
HDYD18 collected $0.05 from pot
HDYD18: doesn't show hand 
*** SUMMARY ***
Total pot $0.05 | Rake $0 
Seat 1: HDYD18 (button) collected ($0.05)
Seat 2: RomiSex (small blind) folded before Flop
Seat 3: Scaaalll (big blind) folded before Flop
Seat 4: sg.32rus folded before Flop (didn't bet)
Seat 5: Koldun 2636 folded before Flop (didn't bet)
Seat 6: TheW3irdo folded before Flop (didn't bet)



PokerStars Zoom Hand #229232566995:  Hold'em No Limit ($0.01/$0.02) - 2021/08/21 22:55:48 CET [2021/08/21 16:55:48 ET]
Table 'Halley' 6-max Seat #1 is the button
Seat 1: gilberto98 ($2.62 in chips) 
Seat 2: SirBatish ($2 in chips) 
Seat 3: Dr.stromg ($3.27 in chips) 
Seat 4: Scaaalll ($3.28 in chips) 
Seat 5: maliniak75 ($2 in chips) 
Seat 6: Santa.Sangr3 ($1.88 in chips) 
SirBatish: posts small blind $0.01
Dr.stromg: posts big blind $0.02
*** HOLE CARDS ***
Dealt to Scaaalll [3s 5s]
Scaaalll: folds 
maliniak75: folds 
Santa.Sangr3: folds 
gilberto98: folds 
SirBatish: raises $1.98 to $2 and is all-in
Dr.stromg: folds 
Uncalled bet ($1.98) returned to SirBatish
SirBatish collected $0.04 from pot
SirBatish: doesn't show hand 
*** SUMMARY ***
Total pot $0.04 | Rake $0 
Seat 1: gilberto98 (button) folded before Flop (didn't bet)
Seat 2: SirBatish (small blind) collected ($0.04)
Seat 3: Dr.stromg (big blind) folded before Flop
Seat 4: Scaaalll folded before Flop (didn't bet)
Seat 5: maliniak75 folded before Flop (didn't bet)
Seat 6: Santa.Sangr3 folded before Flop (didn't bet)



PokerStars Zoom Hand #229232572517:  Hold'em No Limit ($0.01/$0.02) - 2021/08/21 22:56:05 CET [2021/08/21 16:56:05 ET]
Table 'Halley' 6-max Seat #1 is the button
Seat 1: Scaaalll ($3.27 in chips) 
Seat 2: DaBaDaBaDooo ($3.40 in chips) 
Seat 3: gerhavfc ($1.03 in chips) 
Seat 4: NecromiconP ($5.13 in chips) 
Seat 5: SKV_1985 ($2.37 in chips) 
Seat 6: WITKOW_AV ($2.22 in chips) 
DaBaDaBaDooo: posts small blind $0.01
gerhavfc: posts big blind $0.02
*** HOLE CARDS ***
Dealt to Scaaalll [2s 6s]
NecromiconP: folds 
SKV_1985: folds 
WITKOW_AV: folds 
Scaaalll: folds 
DaBaDaBaDooo: folds 
Uncalled bet ($0.01) returned to gerhavfc
gerhavfc collected $0.02 from pot
gerhavfc: doesn't show hand 
*** SUMMARY ***
Total pot $0.02 | Rake $0 
Seat 1: Scaaalll (button) folded before Flop (didn't bet)
Seat 2: DaBaDaBaDooo (small blind) folded before Flop
Seat 3: gerhavfc (big blind) collected ($0.02)
Seat 4: NecromiconP folded before Flop (didn't bet)
Seat 5: SKV_1985 folded before Flop (didn't bet)
Seat 6: WITKOW_AV folded before Flop (didn't bet)



PokerStars Zoom Hand #229232568302:  Hold'em No Limit ($0.01/$0.02) - 2021/08/21 22:55:52 CET [2021/08/21 16:55:52 ET]
Table 'Halley' 6-max Seat #1 is the button
Seat 1: HighCard8887 ($1.97 in chips) 
Seat 2: Scaaalll ($3.28 in chips) 
Seat 3: BlackhawKK's ($2.73 in chips) 
Seat 4: YGrandmaster ($2.97 in chips) 
Seat 5: CrazyyParis ($2.10 in chips) 
Seat 6: new face onl ($3.50 in chips) 
Scaaalll: posts small blind $0.01
BlackhawKK's: posts big blind $0.02
*** HOLE CARDS ***
Dealt to Scaaalll [Qh Td]
YGrandmaster: folds 
CrazyyParis: folds 
YGrandmaster is disconnected 
new face onl: raises $0.05 to $0.07
HighCard8887: calls $0.07
Scaaalll: folds 
BlackhawKK's: folds 
*** FLOP *** [6c 4h 9d]
new face onl: checks 
HighCard8887: bets $0.10
new face onl: folds 
Uncalled bet ($0.10) returned to HighCard8887
HighCard8887 collected $0.16 from pot
HighCard8887: doesn't show hand 
*** SUMMARY ***
Total pot $0.17 | Rake $0.01 
Board [6c 4h 9d]
Seat 1: HighCard8887 (button) collected ($0.16)
Seat 2: Scaaalll (small blind) folded before Flop
Seat 3: BlackhawKK's (big blind) folded before Flop
Seat 4: YGrandmaster folded before Flop (didn't bet)
Seat 5: CrazyyParis folded before Flop (didn't bet)
Seat 6: new face onl folded on the Flop



PokerStars Zoom Hand #229232573806:  Hold'em No Limit ($0.01/$0.02) - 2021/08/21 22:56:09 CET [2021/08/21 16:56:09 ET]
Table 'Halley' 6-max Seat #1 is the button
Seat 1: WITKOW_AV ($2.22 in chips) 
Seat 2: estelionat171 ($0.78 in chips) 
Seat 3: Scaaalll ($3.27 in chips) 
Seat 4: Koldun 2636 ($3 in chips) 
Seat 5: egopi ($2.17 in chips) 
Seat 6: eutepegu ($1.56 in chips) 
estelionat171: posts small blind $0.01
Scaaalll: posts big blind $0.02
*** HOLE CARDS ***
Dealt to Scaaalll [7h 4s]
Koldun 2636: folds 
eutepegu is disconnected 
egopi: raises $0.02 to $0.04
eutepegu: folds 
WITKOW_AV: folds 
estelionat171: folds 
Scaaalll: folds 
Uncalled bet ($0.02) returned to egopi
egopi collected $0.05 from pot
egopi: doesn't show hand 
*** SUMMARY ***
Total pot $0.05 | Rake $0 
Seat 1: WITKOW_AV (button) folded before Flop (didn't bet)
Seat 2: estelionat171 (small blind) folded before Flop
Seat 3: Scaaalll (big blind) folded before Flop
Seat 4: Koldun 2636 folded before Flop (didn't bet)
Seat 5: egopi collected ($0.05)
Seat 6: eutepegu folded before Flop (didn't bet)



PokerStars Zoom Hand #229232590792:  Hold'em No Limit ($0.01/$0.02) - 2021/08/21 22:56:23 CET [2021/08/21 16:56:23 ET]
Table 'Halley' 6-max Seat #1 is the button
Seat 1: IceTdannyB ($2.80 in chips) 
Seat 2: Colby1771 ($3.69 in chips) 
Seat 3: Healthys07 ($3.38 in chips) 
Seat 4: egopi ($1.17 in chips) 
Seat 5: polymorhp ($1.94 in chips) 
Seat 6: Scaaalll ($3.25 in chips) 
Colby1771: posts small blind $0.01
Healthys07: posts big blind $0.02
*** HOLE CARDS ***
Dealt to Scaaalll [Qs 4h]
egopi: folds 
egopi is disconnected 
IceTdannyB is disconnected 
polymorhp: raises $0.03 to $0.05
Scaaalll: folds 
IceTdannyB: folds 
Colby1771: folds 
Healthys07: folds 
Uncalled bet ($0.03) returned to polymorhp
polymorhp collected $0.05 from pot
polymorhp: doesn't show hand 
*** SUMMARY ***
Total pot $0.05 | Rake $0 
Seat 1: IceTdannyB (button) folded before Flop (didn't bet)
Seat 2: Colby1771 (small blind) folded before Flop
Seat 3: Healthys07 (big blind) folded before Flop
Seat 4: egopi folded before Flop (didn't bet)
Seat 5: polymorhp collected ($0.05)
Seat 6: Scaaalll folded before Flop (didn't bet)



PokerStars Zoom Hand #229232592724:  Hold'em No Limit ($0.01/$0.02) - 2021/08/21 22:56:29 CET [2021/08/21 16:56:29 ET]
Table 'Halley' 6-max Seat #1 is the button
Seat 1: Caabz ($2.71 in chips) 
Seat 2: alphabeta1d ($2.01 in chips) 
Seat 3: kahzura ($2 in chips) 
Seat 4: keb1981 ($2 in chips) 
Seat 5: Scaaalll ($3.25 in chips) 
Seat 6: Nolimit.208 ($3.14 in chips) 
alphabeta1d: posts small blind $0.01
kahzura: posts big blind $0.02
*** HOLE CARDS ***
Dealt to Scaaalll [9d 3d]
keb1981: folds 
Scaaalll: folds 
Nolimit.208: raises $0.02 to $0.04
Caabz: folds 
alphabeta1d: folds 
kahzura: folds 
Uncalled bet ($0.02) returned to Nolimit.208
Nolimit.208 collected $0.05 from pot
Nolimit.208: doesn't show hand 
*** SUMMARY ***
Total pot $0.05 | Rake $0 
Seat 1: Caabz (button) folded before Flop (didn't bet)
Seat 2: alphabeta1d (small blind) folded before Flop
Seat 3: kahzura (big blind) folded before Flop
Seat 4: keb1981 folded before Flop (didn't bet)
Seat 5: Scaaalll folded before Flop (didn't bet)
Seat 6: Nolimit.208 collected ($0.05)



PokerStars Zoom Hand #229232601142:  Hold'em No Limit ($0.01/$0.02) - 2021/08/21 22:56:55 CET [2021/08/21 16:56:55 ET]
Table 'Halley' 6-max Seat #1 is the button
Seat 1: RomiSex ($5.52 in chips) 
Seat 2: BlackhawKK's ($2.47 in chips) 
Seat 3: Roachy 92 ($2 in chips) 
Seat 4: lucksuckdonk ($4.35 in chips) 
Seat 5: HDYD18 ($2.38 in chips) 
Seat 6: Scaaalll ($3.24 in chips) 
BlackhawKK's: posts small blind $0.01
Roachy 92: posts big blind $0.02
*** HOLE CARDS ***
Dealt to Scaaalll [Ac 9s]
lucksuckdonk: folds 
HDYD18: folds 
Scaaalll: folds 
RomiSex: folds 
BlackhawKK's: folds 
Uncalled bet ($0.01) returned to Roachy 92
Roachy 92 collected $0.02 from pot
Roachy 92: doesn't show hand 
*** SUMMARY ***
Total pot $0.02 | Rake $0 
Seat 1: RomiSex (button) folded before Flop (didn't bet)
Seat 2: BlackhawKK's (small blind) folded before Flop
Seat 3: Roachy 92 (big blind) collected ($0.02)
Seat 4: lucksuckdonk folded before Flop (didn't bet)
Seat 5: HDYD18 folded before Flop (didn't bet)
Seat 6: Scaaalll folded before Flop (didn't bet)



PokerStars Zoom Hand #229232593983:  Hold'em No Limit ($0.01/$0.02) - 2021/08/21 22:56:33 CET [2021/08/21 16:56:33 ET]
Table 'Halley' 6-max Seat #1 is the button
Seat 1: bananAAbandit ($5.12 in chips) 
Seat 2: $ergo772 ($0.98 in chips) 
Seat 3: keb1981 ($2 in chips) 
Seat 4: Scaaalll ($3.25 in chips) 
Seat 5: dkno77 ($2.13 in chips) 
Seat 6: CrazyyParis ($2 in chips) 
$ergo772: posts small blind $0.01
keb1981: posts big blind $0.02
*** HOLE CARDS ***
Dealt to Scaaalll [9s 8h]
$ergo772 is disconnected 
Scaaalll: folds 
dkno77: folds 
CrazyyParis: folds 
bananAAbandit: raises $0.04 to $0.06
$ergo772: folds 
keb1981: raises $0.14 to $0.20
bananAAbandit: calls $0.14
*** FLOP *** [3d 5c 5s]
keb1981: bets $0.20
bananAAbandit: calls $0.20
*** TURN *** [3d 5c 5s] [Jd]
keb1981: bets $0.39
bananAAbandit: folds 
Uncalled bet ($0.39) returned to keb1981
keb1981 collected $0.78 from pot
keb1981: doesn't show hand 
*** SUMMARY ***
Total pot $0.81 | Rake $0.03 
Board [3d 5c 5s Jd]
Seat 1: bananAAbandit (button) folded on the Turn
Seat 2: $ergo772 (small blind) folded before Flop
Seat 3: keb1981 (big blind) collected ($0.78)
Seat 4: Scaaalll folded before Flop (didn't bet)
Seat 5: dkno77 folded before Flop (didn't bet)
Seat 6: CrazyyParis folded before Flop (didn't bet)



PokerStars Zoom Hand #229232603469:  Hold'em No Limit ($0.01/$0.02) - 2021/08/21 22:57:02 CET [2021/08/21 16:57:02 ET]
Table 'Halley' 6-max Seat #1 is the button
Seat 1: Scaaalll ($3.24 in chips) 
Seat 2: Gofman A ($1.65 in chips) 
Seat 3: STE1NBERG ($2.79 in chips) 
Seat 4: BlackhawKK's ($2.70 in chips) 
Seat 5: Posaunengodi ($2.48 in chips) 
Seat 6: Nolimit.208 ($3.17 in chips) 
Gofman A: posts small blind $0.01
STE1NBERG: posts big blind $0.02
*** HOLE CARDS ***
Dealt to Scaaalll [2s 6c]
BlackhawKK's: folds 
Posaunengodi: folds 
Nolimit.208: raises $0.02 to $0.04
Scaaalll: folds 
Gofman A: folds 
STE1NBERG: folds 
Uncalled bet ($0.02) returned to Nolimit.208
Nolimit.208 collected $0.05 from pot
Nolimit.208: doesn't show hand 
*** SUMMARY ***
Total pot $0.05 | Rake $0 
Seat 1: Scaaalll (button) folded before Flop (didn't bet)
Seat 2: Gofman A (small blind) folded before Flop
Seat 3: STE1NBERG (big blind) folded before Flop
Seat 4: BlackhawKK's folded before Flop (didn't bet)
Seat 5: Posaunengodi folded before Flop (didn't bet)
Seat 6: Nolimit.208 collected ($0.05)



PokerStars Zoom Hand #229232596268:  Hold'em No Limit ($0.01/$0.02) - 2021/08/21 22:56:40 CET [2021/08/21 16:56:40 ET]
Table 'Halley' 6-max Seat #1 is the button
Seat 1: OFSHOR ($2 in chips) 
Seat 2: Scaaalll ($3.25 in chips) 
Seat 3: zaharoff74 ($2.16 in chips) 
Seat 4: Jellycube ($5.55 in chips) 
Seat 5: Jaket1200 ($1.47 in chips) 
Seat 6: Koldun 2636 ($4 in chips) 
Scaaalll: posts small blind $0.01
zaharoff74: posts big blind $0.02
*** HOLE CARDS ***
Dealt to Scaaalll [5h 5d]
Jellycube: folds 
Jaket1200: raises $0.02 to $0.04
Koldun 2636: calls $0.04
OFSHOR: raises $0.23 to $0.27
Scaaalll: folds 
zaharoff74: folds 
Jaket1200: raises $0.23 to $0.50
Koldun 2636: folds 
OFSHOR: calls $0.23
*** FLOP *** [9d 6h Kd]
Jaket1200: bets $0.51
OFSHOR: folds 
Uncalled bet ($0.51) returned to Jaket1200
Jaket1200 collected $1.03 from pot
Jaket1200: doesn't show hand 
*** SUMMARY ***
Total pot $1.07 | Rake $0.04 
Board [9d 6h Kd]
Seat 1: OFSHOR (button) folded on the Flop
Seat 2: Scaaalll (small blind) folded before Flop
Seat 3: zaharoff74 (big blind) folded before Flop
Seat 4: Jellycube folded before Flop (didn't bet)
Seat 5: Jaket1200 collected ($1.03)
Seat 6: Koldun 2636 folded before Flop



PokerStars Zoom Hand #229232604802:  Hold'em No Limit ($0.01/$0.02) - 2021/08/21 22:57:06 CET [2021/08/21 16:57:06 ET]
Table 'Halley' 6-max Seat #1 is the button
Seat 1: Laonikos ($6.76 in chips) 
Seat 2: Dutchie509 ($1.94 in chips) 
Seat 3: Xlavariable ($2.05 in chips) 
Seat 4: Billy Beane1 ($1.47 in chips) 
Seat 5: Scaaalll ($3.24 in chips) 
Seat 6: TomoKondo ($3.51 in chips) 
Dutchie509: posts small blind $0.01
Xlavariable: posts big blind $0.02
*** HOLE CARDS ***
Dealt to Scaaalll [Kh Qh]
Billy Beane1: folds 
Scaaalll: raises $0.04 to $0.06
TomoKondo: folds 
Laonikos: folds 
Dutchie509: folds 
Xlavariable: folds 
Uncalled bet ($0.04) returned to Scaaalll
Scaaalll collected $0.05 from pot
Scaaalll: doesn't show hand 
*** SUMMARY ***
Total pot $0.05 | Rake $0 
Seat 1: Laonikos (button) folded before Flop (didn't bet)
Seat 2: Dutchie509 (small blind) folded before Flop
Seat 3: Xlavariable (big blind) folded before Flop
Seat 4: Billy Beane1 folded before Flop (didn't bet)
Seat 5: Scaaalll collected ($0.05)
Seat 6: TomoKondo folded before Flop (didn't bet)



PokerStars Zoom Hand #229232613322:  Hold'em No Limit ($0.01/$0.02) - 2021/08/21 22:57:32 CET [2021/08/21 16:57:32 ET]
Table 'Halley' 6-max Seat #1 is the button
Seat 1: uniicecube ($5.33 in chips) 
Seat 2: evolucion100 ($2.14 in chips) 
Seat 3: Scaaalll ($3.27 in chips) 
Seat 4: dominik7315 ($2.42 in chips) 
Seat 5: sal_sagev41 ($2.51 in chips) 
Seat 6: Tacojesuscrisp ($2.19 in chips) 
evolucion100: posts small blind $0.01
Scaaalll: posts big blind $0.02
*** HOLE CARDS ***
Dealt to Scaaalll [9h 2s]
dominik7315: folds 
dominik7315 is disconnected 
sal_sagev41: folds 
Tacojesuscrisp: folds 
uniicecube: folds 
evolucion100: raises $0.05 to $0.07
Scaaalll: folds 
Uncalled bet ($0.05) returned to evolucion100
evolucion100 collected $0.04 from pot
evolucion100: doesn't show hand 
*** SUMMARY ***
Total pot $0.04 | Rake $0 
Seat 1: uniicecube (button) folded before Flop (didn't bet)
Seat 2: evolucion100 (small blind) collected ($0.04)
Seat 3: Scaaalll (big blind) folded before Flop
Seat 4: dominik7315 folded before Flop (didn't bet)
Seat 5: sal_sagev41 folded before Flop (didn't bet)
Seat 6: Tacojesuscrisp folded before Flop (didn't bet)



PokerStars Zoom Hand #229232621154:  Hold'em No Limit ($0.01/$0.02) - 2021/08/21 22:57:56 CET [2021/08/21 16:57:56 ET]
Table 'Halley' 6-max Seat #1 is the button
Seat 1: Gofman A ($1.57 in chips) 
Seat 2: PapiMik3 ($5.64 in chips) 
Seat 3: vot-tebe888 ($2 in chips) 
Seat 4: SKV_1985 ($2 in chips) 
Seat 5: MattieBOZ ($2.04 in chips) 
Seat 6: Scaaalll ($3.24 in chips) 
PapiMik3: posts small blind $0.01
vot-tebe888: posts big blind $0.02
*** HOLE CARDS ***
Dealt to Scaaalll [3s 4d]
SKV_1985: folds 
MattieBOZ: folds 
Scaaalll: folds 
MattieBOZ is disconnected 
Gofman A: raises $0.03 to $0.05
PapiMik3: folds 
vot-tebe888: folds 
Uncalled bet ($0.03) returned to Gofman A
Gofman A collected $0.05 from pot
Gofman A: doesn't show hand 
*** SUMMARY ***
Total pot $0.05 | Rake $0 
Seat 1: Gofman A (button) collected ($0.05)
Seat 2: PapiMik3 (small blind) folded before Flop
Seat 3: vot-tebe888 (big blind) folded before Flop
Seat 4: SKV_1985 folded before Flop (didn't bet)
Seat 5: MattieBOZ folded before Flop (didn't bet)
Seat 6: Scaaalll folded before Flop (didn't bet)



PokerStars Zoom Hand #229232622465:  Hold'em No Limit ($0.01/$0.02) - 2021/08/21 22:58:00 CET [2021/08/21 16:58:00 ET]
Table 'Halley' 6-max Seat #1 is the button
Seat 1: fishh_play ($3.71 in chips) 
Seat 2: Koldun 2636 ($2.86 in chips) 
Seat 3: Tsopan77 ($0.98 in chips) 
Seat 4: Scaaalll ($3.24 in chips) 
Seat 5: Yangyang1407 ($2.07 in chips) 
Seat 6: ash1448 ($3.83 in chips) 
Koldun 2636: posts small blind $0.01
Tsopan77: posts big blind $0.02
*** HOLE CARDS ***
Dealt to Scaaalll [7h As]
Scaaalll: folds 
Yangyang1407: folds 
ash1448: raises $0.02 to $0.04
fishh_play: folds 
Koldun 2636: folds 
Tsopan77: folds 
Uncalled bet ($0.02) returned to ash1448
ash1448 collected $0.05 from pot
ash1448: doesn't show hand 
*** SUMMARY ***
Total pot $0.05 | Rake $0 
Seat 1: fishh_play (button) folded before Flop (didn't bet)
Seat 2: Koldun 2636 (small blind) folded before Flop
Seat 3: Tsopan77 (big blind) folded before Flop
Seat 4: Scaaalll folded before Flop (didn't bet)
Seat 5: Yangyang1407 folded before Flop (didn't bet)
Seat 6: ash1448 collected ($0.05)



PokerStars Zoom Hand #229232624056:  Hold'em No Limit ($0.01/$0.02) - 2021/08/21 22:58:05 CET [2021/08/21 16:58:05 ET]
Table 'Halley' 6-max Seat #1 is the button
Seat 1: SirBatish ($3.98 in chips) 
Seat 2: SIGREX ($2.04 in chips) 
Seat 3: Scaaalll ($3.24 in chips) 
Seat 4: barton1007 ($1.75 in chips) 
Seat 5: $ergo772 ($0.74 in chips) 
Seat 6: BexleyBoy ($2.25 in chips) 
SIGREX: posts small blind $0.01
Scaaalll: posts big blind $0.02
*** HOLE CARDS ***
Dealt to Scaaalll [8d Kc]
barton1007: folds 
$ergo772: folds 
BexleyBoy: folds 
$ergo772 is disconnected 
barton1007 is disconnected 
SirBatish: folds 
SIGREX: folds 
Uncalled bet ($0.01) returned to Scaaalll
Scaaalll collected $0.02 from pot
Scaaalll: doesn't show hand 
*** SUMMARY ***
Total pot $0.02 | Rake $0 
Seat 1: SirBatish (button) folded before Flop (didn't bet)
Seat 2: SIGREX (small blind) folded before Flop
Seat 3: Scaaalll (big blind) collected ($0.02)
Seat 4: barton1007 folded before Flop (didn't bet)
Seat 5: $ergo772 folded before Flop (didn't bet)
Seat 6: BexleyBoy folded before Flop (didn't bet)



PokerStars Zoom Hand #229232619201:  Hold'em No Limit ($0.01/$0.02) - 2021/08/21 22:57:50 CET [2021/08/21 16:57:50 ET]
Table 'Halley' 6-max Seat #1 is the button
Seat 1: egopi ($2.06 in chips) 
Seat 2: Scaaalll ($3.25 in chips) 
Seat 3: FabOliveira9 ($2.32 in chips) 
Seat 4: sg.32rus ($1.80 in chips) 
Seat 5: NoEff0rt2w1n ($2 in chips) 
Seat 6: mcisaac05 ($4.33 in chips) 
Scaaalll: posts small blind $0.01
FabOliveira9: posts big blind $0.02
*** HOLE CARDS ***
Dealt to Scaaalll [3s 4c]
egopi is disconnected 
sg.32rus: calls $0.02
NoEff0rt2w1n: folds 
mcisaac05: calls $0.02
egopi: folds 
Scaaalll: folds 
FabOliveira9: checks 
*** FLOP *** [Jc Tc 9c]
FabOliveira9: checks 
sg.32rus: bets $0.07
mcisaac05: calls $0.07
FabOliveira9: calls $0.07
*** TURN *** [Jc Tc 9c] [3c]
FabOliveira9: checks 
sg.32rus: bets $0.02
mcisaac05: folds 
mcisaac05 is disconnected 
FabOliveira9: folds 
Uncalled bet ($0.02) returned to sg.32rus
sg.32rus collected $0.27 from pot
sg.32rus: doesn't show hand 
*** SUMMARY ***
Total pot $0.28 | Rake $0.01 
Board [Jc Tc 9c 3c]
Seat 1: egopi (button) folded before Flop (didn't bet)
Seat 2: Scaaalll (small blind) folded before Flop
Seat 3: FabOliveira9 (big blind) folded on the Turn
Seat 4: sg.32rus collected ($0.27)
Seat 5: NoEff0rt2w1n folded before Flop (didn't bet)
Seat 6: mcisaac05 folded on the Turn



PokerStars Zoom Hand #229232627990:  Hold'em No Limit ($0.01/$0.02) - 2021/08/21 22:58:17 CET [2021/08/21 16:58:17 ET]
Table 'Halley' 6-max Seat #1 is the button
Seat 1: Scaaalll ($3.25 in chips) 
Seat 2: simensgh ($2.01 in chips) 
Seat 3: ISBman ($3.89 in chips) 
Seat 4: giselerebelo ($3.66 in chips) 
Seat 5: Koldun 2636 ($2.85 in chips) 
Seat 6: Ehrewind ($2.13 in chips) 
simensgh: posts small blind $0.01
ISBman: posts big blind $0.02
*** HOLE CARDS ***
Dealt to Scaaalll [6d Ts]
giselerebelo: folds 
Koldun 2636: folds 
Ehrewind: folds 
Scaaalll: folds 
simensgh: raises $0.03 to $0.05
ISBman: folds 
Uncalled bet ($0.03) returned to simensgh
simensgh collected $0.04 from pot
simensgh: doesn't show hand 
*** SUMMARY ***
Total pot $0.04 | Rake $0 
Seat 1: Scaaalll (button) folded before Flop (didn't bet)
Seat 2: simensgh (small blind) collected ($0.04)
Seat 3: ISBman (big blind) folded before Flop
Seat 4: giselerebelo folded before Flop (didn't bet)
Seat 5: Koldun 2636 folded before Flop (didn't bet)
Seat 6: Ehrewind folded before Flop (didn't bet)



PokerStars Zoom Hand #229232630911:  Hold'em No Limit ($0.01/$0.02) - 2021/08/21 22:58:26 CET [2021/08/21 16:58:26 ET]
Table 'Halley' 6-max Seat #1 is the button
Seat 1: Gek77 ($5.19 in chips) 
Seat 2: sg.32rus ($1.59 in chips) 
Seat 3: ash1448 ($3.85 in chips) 
Seat 4: Roachy 92 ($2.66 in chips) 
Seat 5: Smirandal ($2.89 in chips) 
Seat 6: Scaaalll ($3.25 in chips) 
sg.32rus: posts small blind $0.01
ash1448: posts big blind $0.02
*** HOLE CARDS ***
Dealt to Scaaalll [Qd 4h]
Roachy 92: folds 
Smirandal: folds 
Scaaalll: folds 
Gek77: raises $0.04 to $0.06
sg.32rus: folds 
ash1448: folds 
Uncalled bet ($0.04) returned to Gek77
Gek77 collected $0.05 from pot
Gek77: doesn't show hand 
*** SUMMARY ***
Total pot $0.05 | Rake $0 
Seat 1: Gek77 (button) collected ($0.05)
Seat 2: sg.32rus (small blind) folded before Flop
Seat 3: ash1448 (big blind) folded before Flop
Seat 4: Roachy 92 folded before Flop (didn't bet)
Seat 5: Smirandal folded before Flop (didn't bet)
Seat 6: Scaaalll folded before Flop (didn't bet)



PokerStars Zoom Hand #229232632482:  Hold'em No Limit ($0.01/$0.02) - 2021/08/21 22:58:31 CET [2021/08/21 16:58:31 ET]
Table 'Halley' 6-max Seat #1 is the button
Seat 1: Yangyang1407 ($2 in chips) 
Seat 2: Smirandal ($2.89 in chips) 
Seat 3: Posaunengodi ($2.45 in chips) 
Seat 4: Scaaalll ($3.25 in chips) 
Seat 5: rodrigoasor ($3.17 in chips) 
Seat 6: Dr.stromg ($3.05 in chips) 
Smirandal: posts small blind $0.01
Posaunengodi: posts big blind $0.02
*** HOLE CARDS ***
Dealt to Scaaalll [7c 2d]
Scaaalll: folds 
rodrigoasor: folds 
Dr.stromg: folds 
Yangyang1407: folds 
Smirandal: folds 
Uncalled bet ($0.01) returned to Posaunengodi
Posaunengodi collected $0.02 from pot
Posaunengodi: doesn't show hand 
*** SUMMARY ***
Total pot $0.02 | Rake $0 
Seat 1: Yangyang1407 (button) folded before Flop (didn't bet)
Seat 2: Smirandal (small blind) folded before Flop
Seat 3: Posaunengodi (big blind) collected ($0.02)
Seat 4: Scaaalll folded before Flop (didn't bet)
Seat 5: rodrigoasor folded before Flop (didn't bet)
Seat 6: Dr.stromg folded before Flop (didn't bet)



PokerStars Zoom Hand #229232635718:  Hold'em No Limit ($0.01/$0.02) - 2021/08/21 22:58:41 CET [2021/08/21 16:58:41 ET]
Table 'Halley' 6-max Seat #1 is the button
Seat 1: Scaaalll ($3.25 in chips) 
Seat 2: MattieBOZ ($2.12 in chips) 
Seat 3: XaMpLEr ($2.09 in chips) 
Seat 4: astapowitsch ($2.20 in chips) 
Seat 5: Apollonnn_13 ($1.76 in chips) 
Seat 6: AXXILLES ($2.06 in chips) 
MattieBOZ: posts small blind $0.01
XaMpLEr: posts big blind $0.02
*** HOLE CARDS ***
Dealt to Scaaalll [5d 6d]
astapowitsch: folds 
Apollonnn_13: folds 
AXXILLES: folds 
Scaaalll: raises $0.02 to $0.04
MattieBOZ: folds 
MattieBOZ is disconnected 
XaMpLEr: calls $0.02
*** FLOP *** [3c 5c Jd]
XaMpLEr: checks 
Scaaalll: bets $0.06
XaMpLEr: folds 
Uncalled bet ($0.06) returned to Scaaalll
Scaaalll collected $0.09 from pot
Scaaalll: doesn't show hand 
*** SUMMARY ***
Total pot $0.09 | Rake $0 
Board [3c 5c Jd]
Seat 1: Scaaalll (button) collected ($0.09)
Seat 2: MattieBOZ (small blind) folded before Flop
Seat 3: XaMpLEr (big blind) folded on the Flop
Seat 4: astapowitsch folded before Flop (didn't bet)
Seat 5: Apollonnn_13 folded before Flop (didn't bet)
Seat 6: AXXILLES folded before Flop (didn't bet)



PokerStars Zoom Hand #229232641859:  Hold'em No Limit ($0.01/$0.02) - 2021/08/21 22:59:00 CET [2021/08/21 16:59:00 ET]
Table 'Halley' 6-max Seat #1 is the button
Seat 1: MarioDios ($3.84 in chips) 
Seat 2: Scaaalll ($3.30 in chips) 
Seat 3: kukulagosleep ($2.99 in chips) 
Seat 4: Yangyang1407 ($2.24 in chips) 
Seat 5: vovo4kapooh ($6.70 in chips) 
Seat 6: guappa007 ($2.51 in chips) 
Scaaalll: posts small blind $0.01
kukulagosleep: posts big blind $0.02
*** HOLE CARDS ***
Dealt to Scaaalll [Jh 2d]
Yangyang1407: folds 
vovo4kapooh: folds 
guappa007: raises $0.05 to $0.07
MarioDios: folds 
Scaaalll: folds 
kukulagosleep: folds 
Uncalled bet ($0.05) returned to guappa007
guappa007 collected $0.05 from pot
guappa007: doesn't show hand 
*** SUMMARY ***
Total pot $0.05 | Rake $0 
Seat 1: MarioDios (button) folded before Flop (didn't bet)
Seat 2: Scaaalll (small blind) folded before Flop
Seat 3: kukulagosleep (big blind) folded before Flop
Seat 4: Yangyang1407 folded before Flop (didn't bet)
Seat 5: vovo4kapooh folded before Flop (didn't bet)
Seat 6: guappa007 collected ($0.05)



PokerStars Zoom Hand #229232633795:  Hold'em No Limit ($0.01/$0.02) - 2021/08/21 22:58:35 CET [2021/08/21 16:58:35 ET]
Table 'Halley' 6-max Seat #1 is the button
Seat 1: Manco2010 ($1.20 in chips) 
Seat 2: WITKOW_AV ($2 in chips) 
Seat 3: RomiSex ($5.44 in chips) 
Seat 4: joaoottavio ($0.67 in chips) 
Seat 5: Scaaalll ($3.25 in chips) 
Seat 6: alphabeta1d ($2.30 in chips) 
WITKOW_AV: posts small blind $0.01
RomiSex: posts big blind $0.02
*** HOLE CARDS ***
Dealt to Scaaalll [2s 3c]
joaoottavio: folds 
Scaaalll: folds 
alphabeta1d: folds 
Manco2010: calls $0.02
WITKOW_AV: folds 
RomiSex: checks 
*** FLOP *** [8s Ah Th]
RomiSex: checks 
Manco2010: checks 
*** TURN *** [8s Ah Th] [7d]
RomiSex: bets $0.04
Manco2010: raises $0.04 to $0.08
RomiSex: calls $0.04
*** RIVER *** [8s Ah Th 7d] [4h]
RomiSex: checks 
Manco2010: bets $0.30
RomiSex: folds 
Uncalled bet ($0.30) returned to Manco2010
Manco2010 collected $0.20 from pot
Manco2010: doesn't show hand 
*** SUMMARY ***
Total pot $0.21 | Rake $0.01 
Board [8s Ah Th 7d 4h]
Seat 1: Manco2010 (button) collected ($0.20)
Seat 2: WITKOW_AV (small blind) folded before Flop
Seat 3: RomiSex (big blind) folded on the River
Seat 4: joaoottavio folded before Flop (didn't bet)
Seat 5: Scaaalll folded before Flop (didn't bet)
Seat 6: alphabeta1d folded before Flop (didn't bet)



PokerStars Zoom Hand #229232650590:  Hold'em No Limit ($0.01/$0.02) - 2021/08/21 22:59:27 CET [2021/08/21 16:59:27 ET]
Table 'Halley' 6-max Seat #1 is the button
Seat 1: XaMpLEr ($2 in chips) 
Seat 2: Iv3rson18 ($2.07 in chips) 
Seat 3: WITKOW_AV ($3 in chips) 
Seat 4: kboskov123 ($1.25 in chips) 
Seat 5: Tabitaji ($2.03 in chips) 
Seat 6: Scaaalll ($3.27 in chips) 
Iv3rson18: posts small blind $0.01
WITKOW_AV: posts big blind $0.02
*** HOLE CARDS ***
Dealt to Scaaalll [As Ah]
kboskov123: folds 
Tabitaji: folds 
Scaaalll: raises $0.04 to $0.06
XaMpLEr: folds 
Iv3rson18: folds 
WITKOW_AV: folds 
Uncalled bet ($0.04) returned to Scaaalll
Scaaalll collected $0.05 from pot
Scaaalll: doesn't show hand 
*** SUMMARY ***
Total pot $0.05 | Rake $0 
Seat 1: XaMpLEr (button) folded before Flop (didn't bet)
Seat 2: Iv3rson18 (small blind) folded before Flop
Seat 3: WITKOW_AV (big blind) folded before Flop
Seat 4: kboskov123 folded before Flop (didn't bet)
Seat 5: Tabitaji folded before Flop (didn't bet)
Seat 6: Scaaalll collected ($0.05)



PokerStars Zoom Hand #229232647042:  Hold'em No Limit ($0.01/$0.02) - 2021/08/21 22:59:16 CET [2021/08/21 16:59:16 ET]
Table 'Halley' 6-max Seat #1 is the button
Seat 1: smileakafray ($5.38 in chips) 
Seat 2: Busya777 ($2.01 in chips) 
Seat 3: Scaaalll ($3.29 in chips) 
Seat 4: Shaimiev ($2.66 in chips) 
Seat 5: TheW3irdo ($4.28 in chips) 
Seat 6: AtZ3899 ($1 in chips) 
Busya777: posts small blind $0.01
Scaaalll: posts big blind $0.02
*** HOLE CARDS ***
Dealt to Scaaalll [Ks 2d]
Busya777 is disconnected 
Shaimiev: calls $0.02
TheW3irdo: folds 
AtZ3899: folds 
smileakafray: raises $0.06 to $0.08
Busya777: folds 
Scaaalll: folds 
Shaimiev: calls $0.06
*** FLOP *** [Qc 7h 5d]
Shaimiev: bets $0.02
smileakafray: raises $0.11 to $0.13
Shaimiev: folds 
Uncalled bet ($0.11) returned to smileakafray
smileakafray collected $0.22 from pot
smileakafray: doesn't show hand 
Shaimiev is disconnected 
*** SUMMARY ***
Total pot $0.23 | Rake $0.01 
Board [Qc 7h 5d]
Seat 1: smileakafray (button) collected ($0.22)
Seat 2: Busya777 (small blind) folded before Flop
Seat 3: Scaaalll (big blind) folded before Flop
Seat 4: Shaimiev folded on the Flop
Seat 5: TheW3irdo folded before Flop (didn't bet)
Seat 6: AtZ3899 folded before Flop (didn't bet)



PokerStars Zoom Hand #229232645756:  Hold'em No Limit ($0.01/$0.02) - 2021/08/21 22:59:12 CET [2021/08/21 16:59:12 ET]
Table 'Halley' 6-max Seat #1 is the button
Seat 1: KonopDima ($2.36 in chips) 
Seat 2: Tibeau21 ($1.07 in chips) 
Seat 3: MattieBOZ ($2.02 in chips) 
Seat 4: Scaaalll ($3.29 in chips) 
Seat 5: Roachy 92 ($3.03 in chips) 
Seat 6: Xlavariable ($2.30 in chips) 
Tibeau21: posts small blind $0.01
MattieBOZ: posts big blind $0.02
*** HOLE CARDS ***
Dealt to Scaaalll [5c 9h]
Scaaalll: folds 
Roachy 92: raises $0.02 to $0.04
MattieBOZ is disconnected 
Xlavariable: folds 
KonopDima: folds 
Tibeau21: raises $0.02 to $0.06
MattieBOZ: folds 
Roachy 92: calls $0.02
*** FLOP *** [Qc 3h 2h]
Tibeau21: bets $0.07
Roachy 92: calls $0.07
*** TURN *** [Qc 3h 2h] [Ah]
Tibeau21: bets $0.14
Roachy 92: raises $0.39 to $0.53
Tibeau21: folds 
Uncalled bet ($0.39) returned to Roachy 92
Roachy 92 collected $0.54 from pot
Roachy 92: doesn't show hand 
*** SUMMARY ***
Total pot $0.56 | Rake $0.02 
Board [Qc 3h 2h Ah]
Seat 1: KonopDima (button) folded before Flop (didn't bet)
Seat 2: Tibeau21 (small blind) folded on the Turn
Seat 3: MattieBOZ (big blind) folded before Flop
Seat 4: Scaaalll folded before Flop (didn't bet)
Seat 5: Roachy 92 collected ($0.54)
Seat 6: Xlavariable folded before Flop (didn't bet)



PokerStars Zoom Hand #229232654783:  Hold'em No Limit ($0.01/$0.02) - 2021/08/21 22:59:40 CET [2021/08/21 16:59:40 ET]
Table 'Halley' 6-max Seat #1 is the button
Seat 1: egroj1700 ($2 in chips) 
Seat 2: Scaaalll ($3.30 in chips) 
Seat 3: Shaimiev ($2.56 in chips) 
Seat 4: punkosk8 ($1.98 in chips) 
Seat 5: lucksuckdonk ($4.51 in chips) 
Seat 6: Ljw91 ($2 in chips) 
Scaaalll: posts small blind $0.01
Shaimiev: posts big blind $0.02
*** HOLE CARDS ***
Dealt to Scaaalll [4s 7h]
punkosk8: folds 
lucksuckdonk: folds 
punkosk8 is disconnected 
Ljw91: folds 
egroj1700: raises $0.03 to $0.05
Scaaalll: folds 
Shaimiev: calls $0.03
*** FLOP *** [8c Js Kd]
Shaimiev: checks 
egroj1700: bets $0.04
Shaimiev: folds 
Uncalled bet ($0.04) returned to egroj1700
egroj1700 collected $0.11 from pot
egroj1700: doesn't show hand 
Shaimiev is disconnected 
*** SUMMARY ***
Total pot $0.11 | Rake $0 
Board [8c Js Kd]
Seat 1: egroj1700 (button) collected ($0.11)
Seat 2: Scaaalll (small blind) folded before Flop
Seat 3: Shaimiev (big blind) folded on the Flop
Seat 4: punkosk8 folded before Flop (didn't bet)
Seat 5: lucksuckdonk folded before Flop (didn't bet)
Seat 6: Ljw91 folded before Flop (didn't bet)



PokerStars Zoom Hand #229232659628:  Hold'em No Limit ($0.01/$0.02) - 2021/08/21 22:59:55 CET [2021/08/21 16:59:55 ET]
Table 'Halley' 6-max Seat #1 is the button
Seat 1: SIGREX ($2 in chips) 
Seat 2: Chapaev136 ($5.37 in chips) 
Seat 3: Gofman A ($1.59 in chips) 
Seat 4: Hantsirg ($1.42 in chips) 
Seat 5: Scaaalll ($3.29 in chips) 
Seat 6: BriceDo1917 ($3.52 in chips) 
Chapaev136: posts small blind $0.01
Gofman A: posts big blind $0.02
*** HOLE CARDS ***
Dealt to Scaaalll [4s Ac]
BriceDo1917 is disconnected 
Hantsirg: folds 
Hantsirg is disconnected 
Scaaalll: folds 
BriceDo1917: folds 
SIGREX: raises $0.02 to $0.04
Chapaev136: folds 
Gofman A: folds 
Uncalled bet ($0.02) returned to SIGREX
SIGREX collected $0.05 from pot
SIGREX: doesn't show hand 
*** SUMMARY ***
Total pot $0.05 | Rake $0 
Seat 1: SIGREX (button) collected ($0.05)
Seat 2: Chapaev136 (small blind) folded before Flop
Seat 3: Gofman A (big blind) folded before Flop
Seat 4: Hantsirg folded before Flop (didn't bet)
Seat 5: Scaaalll folded before Flop (didn't bet)
Seat 6: BriceDo1917 folded before Flop (didn't bet)



PokerStars Zoom Hand #229232662254:  Hold'em No Limit ($0.01/$0.02) - 2021/08/21 23:00:03 CET [2021/08/21 17:00:03 ET]
Table 'Halley' 6-max Seat #1 is the button
Seat 1: chigilaci ($3.58 in chips) 
Seat 2: Thaleshs ($3.86 in chips) 
Seat 3: zaharoff74 ($2.14 in chips) 
Seat 4: pavel play pay ($3.12 in chips) 
Seat 5: Dakosm ($2.01 in chips) 
Seat 6: Scaaalll ($3.29 in chips) 
Thaleshs: posts small blind $0.01
zaharoff74: posts big blind $0.02
*** HOLE CARDS ***
Dealt to Scaaalll [Th Kh]
pavel play pay: calls $0.02
Dakosm: folds 
Scaaalll: raises $0.04 to $0.06
chigilaci: folds 
Thaleshs: folds 
zaharoff74: folds 
pavel play pay: calls $0.04
*** FLOP *** [Kc 7h Qh]
pavel play pay: checks 
Scaaalll: bets $0.09
pavel play pay: folds 
Uncalled bet ($0.09) returned to Scaaalll
Scaaalll collected $0.14 from pot
Scaaalll: doesn't show hand 
pavel play pay is disconnected 
*** SUMMARY ***
Total pot $0.15 | Rake $0.01 
Board [Kc 7h Qh]
Seat 1: chigilaci (button) folded before Flop (didn't bet)
Seat 2: Thaleshs (small blind) folded before Flop
Seat 3: zaharoff74 (big blind) folded before Flop
Seat 4: pavel play pay folded on the Flop
Seat 5: Dakosm folded before Flop (didn't bet)
Seat 6: Scaaalll collected ($0.14)



PokerStars Zoom Hand #229232676459:  Hold'em No Limit ($0.01/$0.02) - 2021/08/21 23:00:44 CET [2021/08/21 17:00:44 ET]
Table 'Halley' 6-max Seat #1 is the button
Seat 1: DaBaDaBaDooo ($3.02 in chips) 
Seat 2: FabOliveira9 ($2.63 in chips) 
Seat 3: Scaaalll ($3.37 in chips) 
Seat 4: osantos401 ($5.83 in chips) 
Seat 5: cubanhippy ($1.40 in chips) 
Seat 6: didiclavi777 ($2.26 in chips) 
FabOliveira9: posts small blind $0.01
Scaaalll: posts big blind $0.02
*** HOLE CARDS ***
Dealt to Scaaalll [4h 3c]
osantos401: raises $0.04 to $0.06
cubanhippy: folds 
didiclavi777: folds 
DaBaDaBaDooo: folds 
FabOliveira9: folds 
Scaaalll: folds 
Uncalled bet ($0.04) returned to osantos401
osantos401 collected $0.05 from pot
osantos401: doesn't show hand 
*** SUMMARY ***
Total pot $0.05 | Rake $0 
Seat 1: DaBaDaBaDooo (button) folded before Flop (didn't bet)
Seat 2: FabOliveira9 (small blind) folded before Flop
Seat 3: Scaaalll (big blind) folded before Flop
Seat 4: osantos401 collected ($0.05)
Seat 5: cubanhippy folded before Flop (didn't bet)
Seat 6: didiclavi777 folded before Flop (didn't bet)



PokerStars Zoom Hand #229232681389:  Hold'em No Limit ($0.01/$0.02) - 2021/08/21 23:00:57 CET [2021/08/21 17:00:57 ET]
Table 'Halley' 6-max Seat #1 is the button
Seat 1: Scaaalll ($3.35 in chips) 
Seat 2: F_oksi(BLR) ($4.37 in chips) 
Seat 3: Earl_greyPL ($1.50 in chips) 
Seat 4: zaharoff74 ($2.19 in chips) 
Seat 5: Apollonnn_13 ($1.70 in chips) 
Seat 6: YGrandmaster ($3.11 in chips) 
F_oksi(BLR): posts small blind $0.01
Earl_greyPL: posts big blind $0.02
*** HOLE CARDS ***
Dealt to Scaaalll [8s 5c]
zaharoff74: folds 
Apollonnn_13: folds 
YGrandmaster: folds 
YGrandmaster is disconnected 
Scaaalll: folds 
F_oksi(BLR): folds 
Uncalled bet ($0.01) returned to Earl_greyPL
Earl_greyPL collected $0.02 from pot
Earl_greyPL: doesn't show hand 
*** SUMMARY ***
Total pot $0.02 | Rake $0 
Seat 1: Scaaalll (button) folded before Flop (didn't bet)
Seat 2: F_oksi(BLR) (small blind) folded before Flop
Seat 3: Earl_greyPL (big blind) collected ($0.02)
Seat 4: zaharoff74 folded before Flop (didn't bet)
Seat 5: Apollonnn_13 folded before Flop (didn't bet)
Seat 6: YGrandmaster folded before Flop (didn't bet)



PokerStars Zoom Hand #229232685898:  Hold'em No Limit ($0.01/$0.02) - 2021/08/21 23:01:08 CET [2021/08/21 17:01:08 ET]
Table 'Halley' 6-max Seat #1 is the button
Seat 1: Scaaalll ($3.35 in chips) 
Seat 2: Iv3rson18 ($2.09 in chips) 
Seat 3: Koldun 2636 ($3.15 in chips) 
Seat 4: FabOliveira9 ($2.08 in chips) 
Seat 5: Gamer577 ($2.12 in chips) 
Seat 6: Feliciano16 ($3.55 in chips) 
Iv3rson18: posts small blind $0.01
Koldun 2636: posts big blind $0.02
*** HOLE CARDS ***
Dealt to Scaaalll [3s Kd]
FabOliveira9: folds 
Gamer577: folds 
Feliciano16: folds 
Scaaalll: folds 
Iv3rson18: raises $0.04 to $0.06
Koldun 2636: folds 
Uncalled bet ($0.04) returned to Iv3rson18
Iv3rson18 collected $0.04 from pot
Iv3rson18: doesn't show hand 
*** SUMMARY ***
Total pot $0.04 | Rake $0 
Seat 1: Scaaalll (button) folded before Flop (didn't bet)
Seat 2: Iv3rson18 (small blind) collected ($0.04)
Seat 3: Koldun 2636 (big blind) folded before Flop
Seat 4: FabOliveira9 folded before Flop (didn't bet)
Seat 5: Gamer577 folded before Flop (didn't bet)
Seat 6: Feliciano16 folded before Flop (didn't bet)



PokerStars Zoom Hand #229232674640:  Hold'em No Limit ($0.01/$0.02) - 2021/08/21 23:00:39 CET [2021/08/21 17:00:39 ET]
Table 'Halley' 6-max Seat #1 is the button
Seat 1: EevAA190 ($2 in chips) 
Seat 2: SirBatish ($3.48 in chips) 
Seat 3: stanthema661 ($0.54 in chips) 
Seat 4: Scaaalll ($3.37 in chips) 
Seat 5: pipecmolodec ($2.11 in chips) 
Seat 6: vovo4kapooh ($2.07 in chips) 
SirBatish: posts small blind $0.01
stanthema661: posts big blind $0.02
*** HOLE CARDS ***
Dealt to Scaaalll [Js Qh]
Scaaalll: folds 
pipecmolodec: folds 
vovo4kapooh: raises $0.03 to $0.05
EevAA190: folds 
SirBatish: raises $0.15 to $0.20
stanthema661: folds 
stanthema661 is disconnected 
vovo4kapooh: calls $0.15
*** FLOP *** [7h Jh 6d]
SirBatish: bets $0.20
vovo4kapooh: calls $0.20
*** TURN *** [7h Jh 6d] [Qc]
SirBatish: checks 
vovo4kapooh: bets $0.59
SirBatish: folds 
Uncalled bet ($0.59) returned to vovo4kapooh
vovo4kapooh collected $0.79 from pot
vovo4kapooh: doesn't show hand 
*** SUMMARY ***
Total pot $0.82 | Rake $0.03 
Board [7h Jh 6d Qc]
Seat 1: EevAA190 (button) folded before Flop (didn't bet)
Seat 2: SirBatish (small blind) folded on the Turn
Seat 3: stanthema661 (big blind) folded before Flop
Seat 4: Scaaalll folded before Flop (didn't bet)
Seat 5: pipecmolodec folded before Flop (didn't bet)
Seat 6: vovo4kapooh collected ($0.79)



PokerStars Zoom Hand #229232705008:  Hold'em No Limit ($0.01/$0.02) - 2021/08/21 23:01:54 CET [2021/08/21 17:01:54 ET]
Table 'Halley' 6-max Seat #1 is the button
Seat 1: Bluff2WlN ($1.21 in chips) 
Seat 2: KRITAYA ($1.05 in chips) 
Seat 3: znak312 ($2.05 in chips) 
Seat 4: twiti174 ($1.61 in chips) 
Seat 5: Scaaalll ($3.33 in chips) 
Seat 6: so0love ($7.10 in chips) 
KRITAYA: posts small blind $0.01
znak312: posts big blind $0.02
*** HOLE CARDS ***
Dealt to Scaaalll [Qc 6s]
twiti174: folds 
Scaaalll: folds 
twiti174 is disconnected 
so0love: folds 
Bluff2WlN: folds 
KRITAYA: folds 
Uncalled bet ($0.01) returned to znak312
znak312 collected $0.02 from pot
znak312: doesn't show hand 
*** SUMMARY ***
Total pot $0.02 | Rake $0 
Seat 1: Bluff2WlN (button) folded before Flop (didn't bet)
Seat 2: KRITAYA (small blind) folded before Flop
Seat 3: znak312 (big blind) collected ($0.02)
Seat 4: twiti174 folded before Flop (didn't bet)
Seat 5: Scaaalll folded before Flop (didn't bet)
Seat 6: so0love folded before Flop (didn't bet)



PokerStars Zoom Hand #229232690439:  Hold'em No Limit ($0.01/$0.02) - 2021/08/21 23:01:19 CET [2021/08/21 17:01:19 ET]
Table 'Halley' 6-max Seat #1 is the button
Seat 1: Posaunengodi ($3.08 in chips) 
Seat 2: Scaaalll ($3.35 in chips) 
Seat 3: Andnet ($2.58 in chips) 
Seat 4: maliniak75 ($3.44 in chips) 
Seat 5: KRITAYA ($1.07 in chips) 
Seat 6: S3XY_PADRE ($3.44 in chips) 
Scaaalll: posts small blind $0.01
Andnet: posts big blind $0.02
*** HOLE CARDS ***
Dealt to Scaaalll [Ah 6d]
maliniak75: calls $0.02
KRITAYA: folds 
S3XY_PADRE: folds 
Posaunengodi: folds 
Scaaalll: calls $0.01
Andnet: checks 
*** FLOP *** [Jd 7d 4c]
Scaaalll: checks 
Andnet: checks 
maliniak75: checks 
*** TURN *** [Jd 7d 4c] [9c]
Scaaalll: checks 
Andnet: bets $0.04
maliniak75: calls $0.04
Scaaalll: folds 
*** RIVER *** [Jd 7d 4c 9c] [3h]
Andnet: checks 
maliniak75: checks 
*** SHOW DOWN ***
Andnet: shows [5c 7c] (a pair of Sevens)
maliniak75: shows [Qs 9s] (a pair of Nines)
maliniak75 collected $0.14 from pot
*** SUMMARY ***
Total pot $0.14 | Rake $0 
Board [Jd 7d 4c 9c 3h]
Seat 1: Posaunengodi (button) folded before Flop (didn't bet)
Seat 2: Scaaalll (small blind) folded on the Turn
Seat 3: Andnet (big blind) showed [5c 7c] and lost with a pair of Sevens
Seat 4: maliniak75 showed [Qs 9s] and won ($0.14) with a pair of Nines
Seat 5: KRITAYA folded before Flop (didn't bet)
Seat 6: S3XY_PADRE folded before Flop (didn't bet)



PokerStars Zoom Hand #229232706753:  Hold'em No Limit ($0.01/$0.02) - 2021/08/21 23:01:58 CET [2021/08/21 17:01:58 ET]
Table 'Halley' 6-max Seat #1 is the button
Seat 1: rekopo203 ($6.37 in chips) 
Seat 2: egopi ($2.21 in chips) 
Seat 3: udav26 ($2.20 in chips) 
Seat 4: ISBman ($2.94 in chips) 
Seat 5: Billy Beane1 ($0.93 in chips) 
Seat 6: Scaaalll ($3.33 in chips) 
egopi: posts small blind $0.01
udav26: posts big blind $0.02
*** HOLE CARDS ***
Dealt to Scaaalll [Ah Kd]
egopi is disconnected 
ISBman: folds 
Billy Beane1: folds 
Scaaalll: raises $0.04 to $0.06
rekopo203: folds 
egopi: folds 
udav26: folds 
Uncalled bet ($0.04) returned to Scaaalll
Scaaalll collected $0.05 from pot
Scaaalll: doesn't show hand 
*** SUMMARY ***
Total pot $0.05 | Rake $0 
Seat 1: rekopo203 (button) folded before Flop (didn't bet)
Seat 2: egopi (small blind) folded before Flop
Seat 3: udav26 (big blind) folded before Flop
Seat 4: ISBman folded before Flop (didn't bet)
Seat 5: Billy Beane1 folded before Flop (didn't bet)
Seat 6: Scaaalll collected ($0.05)



PokerStars Zoom Hand #229232713381:  Hold'em No Limit ($0.01/$0.02) - 2021/08/21 23:02:13 CET [2021/08/21 17:02:13 ET]
Table 'Halley' 6-max Seat #1 is the button
Seat 1: OmahaWheels ($4.22 in chips) 
Seat 2: BlackhawKK's ($4.87 in chips) 
Seat 3: egopi ($1.05 in chips) 
Seat 4: davidalejag ($3.02 in chips) 
Seat 5: Scaaalll ($3.36 in chips) 
Seat 6: sinkthe8 ($0.32 in chips) 
BlackhawKK's: posts small blind $0.01
egopi: posts big blind $0.02
*** HOLE CARDS ***
Dealt to Scaaalll [5h Qs]
sinkthe8 is disconnected 
davidalejag: folds 
Scaaalll: folds 
sinkthe8: folds 
OmahaWheels: folds 
BlackhawKK's: raises $0.04 to $0.06
egopi: folds 
Uncalled bet ($0.04) returned to BlackhawKK's
BlackhawKK's collected $0.04 from pot
BlackhawKK's: doesn't show hand 
egopi is disconnected 
*** SUMMARY ***
Total pot $0.04 | Rake $0 
Seat 1: OmahaWheels (button) folded before Flop (didn't bet)
Seat 2: BlackhawKK's (small blind) collected ($0.04)
Seat 3: egopi (big blind) folded before Flop
Seat 4: davidalejag folded before Flop (didn't bet)
Seat 5: Scaaalll folded before Flop (didn't bet)
Seat 6: sinkthe8 folded before Flop (didn't bet)



PokerStars Zoom Hand #229232714915:  Hold'em No Limit ($0.01/$0.02) - 2021/08/21 23:02:17 CET [2021/08/21 17:02:17 ET]
Table 'Halley' 6-max Seat #1 is the button
Seat 1: PEDACIT0 ($2.21 in chips) 
Seat 2: xxVanquishxx ($15 in chips) 
Seat 3: Scaaalll ($3.36 in chips) 
Seat 4: YGrandmaster ($3.02 in chips) 
Seat 5: guappa007 ($1.77 in chips) 
Seat 6: Mikeloko182 ($6.10 in chips) 
xxVanquishxx: posts small blind $0.01
Scaaalll: posts big blind $0.02
*** HOLE CARDS ***
Dealt to Scaaalll [5s 2d]
YGrandmaster: folds 
YGrandmaster is disconnected 
guappa007: raises $0.04 to $0.06
Mikeloko182: folds 
PEDACIT0: folds 
xxVanquishxx: folds 
Scaaalll: folds 
Uncalled bet ($0.04) returned to guappa007
guappa007 collected $0.05 from pot
guappa007: doesn't show hand 
*** SUMMARY ***
Total pot $0.05 | Rake $0 
Seat 1: PEDACIT0 (button) folded before Flop (didn't bet)
Seat 2: xxVanquishxx (small blind) folded before Flop
Seat 3: Scaaalll (big blind) folded before Flop
Seat 4: YGrandmaster folded before Flop (didn't bet)
Seat 5: guappa007 collected ($0.05)
Seat 6: Mikeloko182 folded before Flop (didn't bet)



PokerStars Zoom Hand #229232725488:  Hold'em No Limit ($0.01/$0.02) - 2021/08/21 23:02:41 CET [2021/08/21 17:02:41 ET]
Table 'Halley' 6-max Seat #1 is the button
Seat 1: queen830 ($13.76 in chips) 
Seat 2: WITKOW_AV ($2.36 in chips) 
Seat 3: SIGREX ($2.19 in chips) 
Seat 4: rpycmbEM ($3.70 in chips) 
Seat 5: twiti174 ($1.72 in chips) 
Seat 6: Scaaalll ($3.34 in chips) 
WITKOW_AV: posts small blind $0.01
SIGREX: posts big blind $0.02
*** HOLE CARDS ***
Dealt to Scaaalll [8h Qh]
rpycmbEM: raises $0.04 to $0.06
twiti174: folds 
twiti174 is disconnected 
Scaaalll: folds 
queen830: folds 
WITKOW_AV: folds 
SIGREX: folds 
Uncalled bet ($0.04) returned to rpycmbEM
rpycmbEM collected $0.05 from pot
rpycmbEM: doesn't show hand 
*** SUMMARY ***
Total pot $0.05 | Rake $0 
Seat 1: queen830 (button) folded before Flop (didn't bet)
Seat 2: WITKOW_AV (small blind) folded before Flop
Seat 3: SIGREX (big blind) folded before Flop
Seat 4: rpycmbEM collected ($0.05)
Seat 5: twiti174 folded before Flop (didn't bet)
Seat 6: Scaaalll folded before Flop (didn't bet)



PokerStars Zoom Hand #229232733242:  Hold'em No Limit ($0.01/$0.02) - 2021/08/21 23:02:59 CET [2021/08/21 17:02:59 ET]
Table 'Halley' 6-max Seat #1 is the button
Seat 1: leeroy818 ($2.08 in chips) 
Seat 2: Scaaalll ($3.34 in chips) 
Seat 3: bananAAbandit ($5.11 in chips) 
Seat 4: A.luckebeggr ($5.61 in chips) 
Seat 5: GVMELLO ($2.06 in chips) 
Seat 6: Feliciano16 ($7.76 in chips) 
Scaaalll: posts small blind $0.01
bananAAbandit: posts big blind $0.02
*** HOLE CARDS ***
Dealt to Scaaalll [2s 5d]
A.luckebeggr: folds 
GVMELLO: folds 
Feliciano16: folds 
leeroy818: folds 
Scaaalll: folds 
Uncalled bet ($0.01) returned to bananAAbandit
bananAAbandit collected $0.02 from pot
bananAAbandit: doesn't show hand 
*** SUMMARY ***
Total pot $0.02 | Rake $0 
Seat 1: leeroy818 (button) folded before Flop (didn't bet)
Seat 2: Scaaalll (small blind) folded before Flop
Seat 3: bananAAbandit (big blind) collected ($0.02)
Seat 4: A.luckebeggr folded before Flop (didn't bet)
Seat 5: GVMELLO folded before Flop (didn't bet)
Seat 6: Feliciano16 folded before Flop (didn't bet)



PokerStars Zoom Hand #229232730661:  Hold'em No Limit ($0.01/$0.02) - 2021/08/21 23:02:53 CET [2021/08/21 17:02:53 ET]
Table 'Halley' 6-max Seat #1 is the button
Seat 1: Revairo ($3.55 in chips) 
Seat 2: newen83 ($2.27 in chips) 
Seat 3: Phoenixxxxxxxx ($2.19 in chips) 
Seat 4: Scaaalll ($3.34 in chips) 
Seat 5: dryan04 ($1.75 in chips) 
Seat 6: RChinenov ($2.26 in chips) 
newen83: posts small blind $0.01
Phoenixxxxxxxx: posts big blind $0.02
*** HOLE CARDS ***
Dealt to Scaaalll [6h 5s]
newen83 is disconnected 
Scaaalll: folds 
dryan04: raises $0.02 to $0.04
RChinenov: folds 
Revairo: raises $0.10 to $0.14
newen83: folds 
Phoenixxxxxxxx: folds 
dryan04: folds 
Uncalled bet ($0.10) returned to Revairo
Revairo collected $0.11 from pot
Revairo: doesn't show hand 
dryan04 is disconnected 
*** SUMMARY ***
Total pot $0.11 | Rake $0 
Seat 1: Revairo (button) collected ($0.11)
Seat 2: newen83 (small blind) folded before Flop
Seat 3: Phoenixxxxxxxx (big blind) folded before Flop
Seat 4: Scaaalll folded before Flop (didn't bet)
Seat 5: dryan04 folded before Flop
Seat 6: RChinenov folded before Flop (didn't bet)



PokerStars Zoom Hand #229232735907:  Hold'em No Limit ($0.01/$0.02) - 2021/08/21 23:03:05 CET [2021/08/21 17:03:05 ET]
Table 'Halley' 6-max Seat #1 is the button
Seat 1: Peimievvt ($2.24 in chips) 
Seat 2: JTbukowski ($4.07 in chips) 
Seat 3: Scaaalll ($3.33 in chips) 
Seat 4: snowpepsi ($2.32 in chips) 
Seat 5: Pulp Hands ($1.58 in chips) 
Seat 6: Kb013497 ($1.97 in chips) 
JTbukowski: posts small blind $0.01
Scaaalll: posts big blind $0.02
*** HOLE CARDS ***
Dealt to Scaaalll [7d 2s]
snowpepsi: folds 
Pulp Hands: folds 
Kb013497: folds 
Peimievvt: raises $0.04 to $0.06
JTbukowski: folds 
Scaaalll: folds 
Uncalled bet ($0.04) returned to Peimievvt
Peimievvt collected $0.05 from pot
Peimievvt: doesn't show hand 
*** SUMMARY ***
Total pot $0.05 | Rake $0 
Seat 1: Peimievvt (button) collected ($0.05)
Seat 2: JTbukowski (small blind) folded before Flop
Seat 3: Scaaalll (big blind) folded before Flop
Seat 4: snowpepsi folded before Flop (didn't bet)
Seat 5: Pulp Hands folded before Flop (didn't bet)
Seat 6: Kb013497 folded before Flop (didn't bet)



PokerStars Zoom Hand #229232743805:  Hold'em No Limit ($0.01/$0.02) - 2021/08/21 23:03:23 CET [2021/08/21 17:03:23 ET]
Table 'Halley' 6-max Seat #1 is the button
Seat 1: Scaaalll ($3.31 in chips) 
Seat 2: wrfregati ($1.98 in chips) 
Seat 3: PapiMik3 ($5.95 in chips) 
Seat 4: Andnet ($2.48 in chips) 
Seat 5: HDYD18 ($2.50 in chips) 
Seat 6: nitzed12 ($2.20 in chips) 
wrfregati: posts small blind $0.01
PapiMik3: posts big blind $0.02
*** HOLE CARDS ***
Dealt to Scaaalll [Qc 2s]
Andnet: folds 
HDYD18: raises $0.04 to $0.06
nitzed12: folds 
Scaaalll: folds 
wrfregati: calls $0.05
PapiMik3: folds 
*** FLOP *** [2d 9s 9c]
wrfregati: checks 
HDYD18: bets $0.07
wrfregati: folds 
Uncalled bet ($0.07) returned to HDYD18
HDYD18 collected $0.14 from pot
HDYD18: doesn't show hand 
*** SUMMARY ***
Total pot $0.14 | Rake $0 
Board [2d 9s 9c]
Seat 1: Scaaalll (button) folded before Flop (didn't bet)
Seat 2: wrfregati (small blind) folded on the Flop
Seat 3: PapiMik3 (big blind) folded before Flop
Seat 4: Andnet folded before Flop (didn't bet)
Seat 5: HDYD18 collected ($0.14)
Seat 6: nitzed12 folded before Flop (didn't bet)



PokerStars Zoom Hand #229232751321:  Hold'em No Limit ($0.01/$0.02) - 2021/08/21 23:03:40 CET [2021/08/21 17:03:40 ET]
Table 'Halley' 6-max Seat #1 is the button
Seat 1: davidalejag ($2.91 in chips) 
Seat 2: Tibeau21 ($0.67 in chips) 
Seat 3: Ramirres ($2.10 in chips) 
Seat 4: Scaaalll ($3.31 in chips) 
Seat 5: HubertFroh ($2.13 in chips) 
Seat 6: snowpepsi ($2.29 in chips) 
Tibeau21: posts small blind $0.01
Ramirres: posts big blind $0.02
*** HOLE CARDS ***
Dealt to Scaaalll [Ah 7h]
Scaaalll: folds 
HubertFroh: folds 
snowpepsi: folds 
davidalejag: folds 
Tibeau21: calls $0.01
Ramirres: checks 
*** FLOP *** [5c 2d 7s]
Tibeau21: bets $0.02
Ramirres: calls $0.02
*** TURN *** [5c 2d 7s] [8h]
Tibeau21: bets $0.04
Ramirres: calls $0.04
*** RIVER *** [5c 2d 7s 8h] [As]
Tibeau21: bets $0.08
Ramirres: folds 
Uncalled bet ($0.08) returned to Tibeau21
Tibeau21 collected $0.15 from pot
Tibeau21: doesn't show hand 
*** SUMMARY ***
Total pot $0.16 | Rake $0.01 
Board [5c 2d 7s 8h As]
Seat 1: davidalejag (button) folded before Flop (didn't bet)
Seat 2: Tibeau21 (small blind) collected ($0.15)
Seat 3: Ramirres (big blind) folded on the River
Seat 4: Scaaalll folded before Flop (didn't bet)
Seat 5: HubertFroh folded before Flop (didn't bet)
Seat 6: snowpepsi folded before Flop (didn't bet)



PokerStars Zoom Hand #229232756146:  Hold'em No Limit ($0.01/$0.02) - 2021/08/21 23:03:51 CET [2021/08/21 17:03:51 ET]
Table 'Halley' 6-max Seat #1 is the button
Seat 1: Knutzers ($2.12 in chips) 
Seat 2: ARS_POLI13 ($0.58 in chips) 
Seat 3: Scaaalll ($3.31 in chips) 
Seat 4: TTGemi ($2 in chips) 
Seat 5: OGTripleOG247 ($2.28 in chips) 
Seat 6: snowpepsi ($2.29 in chips) 
ARS_POLI13: posts small blind $0.01
Scaaalll: posts big blind $0.02
*** HOLE CARDS ***
Dealt to Scaaalll [3c Td]
TTGemi: folds 
OGTripleOG247: folds 
snowpepsi: raises $0.04 to $0.06
Knutzers: folds 
ARS_POLI13: folds 
Scaaalll: folds 
Uncalled bet ($0.04) returned to snowpepsi
snowpepsi collected $0.05 from pot
snowpepsi: doesn't show hand 
*** SUMMARY ***
Total pot $0.05 | Rake $0 
Seat 1: Knutzers (button) folded before Flop (didn't bet)
Seat 2: ARS_POLI13 (small blind) folded before Flop
Seat 3: Scaaalll (big blind) folded before Flop
Seat 4: TTGemi folded before Flop (didn't bet)
Seat 5: OGTripleOG247 folded before Flop (didn't bet)
Seat 6: snowpepsi collected ($0.05)



PokerStars Zoom Hand #229232749510:  Hold'em No Limit ($0.01/$0.02) - 2021/08/21 23:03:36 CET [2021/08/21 17:03:36 ET]
Table 'Halley' 6-max Seat #1 is the button
Seat 1: Tsopan77 ($1.18 in chips) 
Seat 2: igara tigara ($3.18 in chips) 
Seat 3: Mr.Kurier ($1.38 in chips) 
Seat 4: BlackhawKK's ($4.84 in chips) 
Seat 5: Scaaalll ($3.31 in chips) 
Seat 6: MsSuffolk ($2.32 in chips) 
igara tigara: posts small blind $0.01
Mr.Kurier: posts big blind $0.02
*** HOLE CARDS ***
Dealt to Scaaalll [Ks 9h]
BlackhawKK's: folds 
Scaaalll: folds 
MsSuffolk: folds 
Tsopan77: raises $0.06 to $0.08
igara tigara: folds 
Mr.Kurier: calls $0.06
*** FLOP *** [8s 5s Tc]
Mr.Kurier: checks 
Tsopan77: checks 
*** TURN *** [8s 5s Tc] [7s]
Mr.Kurier: checks 
Tsopan77: checks 
*** RIVER *** [8s 5s Tc 7s] [Js]
Mr.Kurier: checks 
Tsopan77: checks 
*** SHOW DOWN ***
Mr.Kurier: shows [3h Ah] (high card Ace)
Tsopan77: shows [Ac Qc] (high card Ace - Queen kicker)
Tsopan77 collected $0.16 from pot
*** SUMMARY ***
Total pot $0.17 | Rake $0.01 
Board [8s 5s Tc 7s Js]
Seat 1: Tsopan77 (button) showed [Ac Qc] and won ($0.16) with high card Ace
Seat 2: igara tigara (small blind) folded before Flop
Seat 3: Mr.Kurier (big blind) showed [3h Ah] and lost with high card Ace
Seat 4: BlackhawKK's folded before Flop (didn't bet)
Seat 5: Scaaalll folded before Flop (didn't bet)
Seat 6: MsSuffolk folded before Flop (didn't bet)



PokerStars Zoom Hand #229232754220:  Hold'em No Limit ($0.01/$0.02) - 2021/08/21 23:03:46 CET [2021/08/21 17:03:46 ET]
Table 'Halley' 6-max Seat #1 is the button
Seat 1: Baldisback ($4.50 in chips) 
Seat 2: CordiPS ($4.04 in chips) 
Seat 3: leeroy818 ($2.04 in chips) 
Seat 4: Scaaalll ($3.31 in chips) 
Seat 5: Jellycube ($3.45 in chips) 
Seat 6: LijanaV ($5.70 in chips) 
CordiPS: posts small blind $0.01
leeroy818: posts big blind $0.02
*** HOLE CARDS ***
Dealt to Scaaalll [7d 3h]
Scaaalll: folds 
Jellycube: raises $0.04 to $0.06
LijanaV: calls $0.06
Baldisback: folds 
CordiPS: folds 
leeroy818: calls $0.04
*** FLOP *** [2d 7s Qd]
leeroy818: checks 
Jellycube: checks 
LijanaV: checks 
*** TURN *** [2d 7s Qd] [Jc]
leeroy818: checks 
Jellycube: checks 
LijanaV: checks 
*** RIVER *** [2d 7s Qd Jc] [Qc]
leeroy818: checks 
Jellycube: bets $0.10
LijanaV: calls $0.10
leeroy818: folds 
*** SHOW DOWN ***
Jellycube: shows [Ah 8c] (a pair of Queens)
LijanaV: shows [8s 8d] (two pair, Queens and Eights)
LijanaV collected $0.38 from pot
*** SUMMARY ***
Total pot $0.39 | Rake $0.01 
Board [2d 7s Qd Jc Qc]
Seat 1: Baldisback (button) folded before Flop (didn't bet)
Seat 2: CordiPS (small blind) folded before Flop
Seat 3: leeroy818 (big blind) folded on the River
Seat 4: Scaaalll folded before Flop (didn't bet)
Seat 5: Jellycube showed [Ah 8c] and lost with a pair of Queens
Seat 6: LijanaV showed [8s 8d] and won ($0.38) with two pair, Queens and Eights



PokerStars Zoom Hand #229232762807:  Hold'em No Limit ($0.01/$0.02) - 2021/08/21 23:04:06 CET [2021/08/21 17:04:06 ET]
Table 'Halley' 6-max Seat #1 is the button
Seat 1: boysDcrye ($2.59 in chips) 
Seat 2: AlexGTPS ($2.22 in chips) 
Seat 3: SIGREX ($2.75 in chips) 
Seat 4: Soko 1381 ($2.15 in chips) 
Seat 5: WITKOW_AV ($2 in chips) 
Seat 6: Scaaalll ($3.29 in chips) 
AlexGTPS: posts small blind $0.01
SIGREX: posts big blind $0.02
*** HOLE CARDS ***
Dealt to Scaaalll [As 2d]
Soko 1381: folds 
WITKOW_AV: raises $0.04 to $0.06
Scaaalll: folds 
boysDcrye: folds 
AlexGTPS: folds 
SIGREX: folds 
Uncalled bet ($0.04) returned to WITKOW_AV
WITKOW_AV collected $0.05 from pot
WITKOW_AV: doesn't show hand 
*** SUMMARY ***
Total pot $0.05 | Rake $0 
Seat 1: boysDcrye (button) folded before Flop (didn't bet)
Seat 2: AlexGTPS (small blind) folded before Flop
Seat 3: SIGREX (big blind) folded before Flop
Seat 4: Soko 1381 folded before Flop (didn't bet)
Seat 5: WITKOW_AV collected ($0.05)
Seat 6: Scaaalll folded before Flop (didn't bet)



PokerStars Zoom Hand #229232772887:  Hold'em No Limit ($0.01/$0.02) - 2021/08/21 23:04:29 CET [2021/08/21 17:04:29 ET]
Table 'Halley' 6-max Seat #1 is the button
Seat 1: Scaaalll ($3.28 in chips) 
Seat 2: stUPolak ($2.21 in chips) 
Seat 3: martoniv ($3.19 in chips) 
Seat 4: schrumpeI_ ($1.68 in chips) 
Seat 5: BlackhawKK's ($4.87 in chips) 
Seat 6: MattieBOZ ($1.98 in chips) 
stUPolak: posts small blind $0.01
martoniv: posts big blind $0.02
*** HOLE CARDS ***
Dealt to Scaaalll [3h 9c]
schrumpeI_: folds 
schrumpeI_ is disconnected 
BlackhawKK's: raises $0.04 to $0.06
MattieBOZ: folds 
Scaaalll: folds 
MattieBOZ is disconnected 
stUPolak: folds 
martoniv: folds 
Uncalled bet ($0.04) returned to BlackhawKK's
BlackhawKK's collected $0.05 from pot
BlackhawKK's: doesn't show hand 
*** SUMMARY ***
Total pot $0.05 | Rake $0 
Seat 1: Scaaalll (button) folded before Flop (didn't bet)
Seat 2: stUPolak (small blind) folded before Flop
Seat 3: martoniv (big blind) folded before Flop
Seat 4: schrumpeI_ folded before Flop (didn't bet)
Seat 5: BlackhawKK's collected ($0.05)
Seat 6: MattieBOZ folded before Flop (didn't bet)



PokerStars Zoom Hand #229232774586:  Hold'em No Limit ($0.01/$0.02) - 2021/08/21 23:04:33 CET [2021/08/21 17:04:33 ET]
Table 'Halley' 6-max Seat #1 is the button
Seat 1: alphabeta1d ($2.41 in chips) 
Seat 2: jribeiros ($0.96 in chips) 
Seat 3: BMRB1991 ($0.52 in chips) 
Seat 4: pipecmolodec ($2 in chips) 
Seat 5: Scaaalll ($3.28 in chips) 
Seat 6: F_oksi(BLR) ($4.52 in chips) 
jribeiros: posts small blind $0.01
BMRB1991: posts big blind $0.02
*** HOLE CARDS ***
Dealt to Scaaalll [7h Tc]
pipecmolodec: folds 
Scaaalll: folds 
F_oksi(BLR): folds 
alphabeta1d: folds 
jribeiros: folds 
Uncalled bet ($0.01) returned to BMRB1991
BMRB1991 collected $0.02 from pot
BMRB1991: doesn't show hand 
*** SUMMARY ***
Total pot $0.02 | Rake $0 
Seat 1: alphabeta1d (button) folded before Flop (didn't bet)
Seat 2: jribeiros (small blind) folded before Flop
Seat 3: BMRB1991 (big blind) collected ($0.02)
Seat 4: pipecmolodec folded before Flop (didn't bet)
Seat 5: Scaaalll folded before Flop (didn't bet)
Seat 6: F_oksi(BLR) folded before Flop (didn't bet)



PokerStars Zoom Hand #229232776349:  Hold'em No Limit ($0.01/$0.02) - 2021/08/21 23:04:37 CET [2021/08/21 17:04:37 ET]
Table 'Halley' 6-max Seat #1 is the button
Seat 1: i.m.bluffing002 ($2.03 in chips) 
Seat 2: Scaaalll ($3.28 in chips) 
Seat 3: alphabeta1d ($2.41 in chips) 
Seat 4: pavlo8855 ($2.05 in chips) 
Seat 5: tisadaisy ($2.29 in chips) 
Seat 6: so0love ($2.16 in chips) 
Scaaalll: posts small blind $0.01
alphabeta1d: posts big blind $0.02
*** HOLE CARDS ***
Dealt to Scaaalll [Qc 3d]
pavlo8855: folds 
tisadaisy: folds 
so0love: folds 
i.m.bluffing002: calls $0.02
Scaaalll: folds 
alphabeta1d: checks 
*** FLOP *** [Jc 8s 7s]
alphabeta1d: checks 
i.m.bluffing002: checks 
*** TURN *** [Jc 8s 7s] [2d]
alphabeta1d: checks 
i.m.bluffing002: checks 
*** RIVER *** [Jc 8s 7s 2d] [Ac]
alphabeta1d: checks 
i.m.bluffing002: bets $0.02
alphabeta1d: folds 
Uncalled bet ($0.02) returned to i.m.bluffing002
i.m.bluffing002 collected $0.05 from pot
i.m.bluffing002: doesn't show hand 
*** SUMMARY ***
Total pot $0.05 | Rake $0 
Board [Jc 8s 7s 2d Ac]
Seat 1: i.m.bluffing002 (button) collected ($0.05)
Seat 2: Scaaalll (small blind) folded before Flop
Seat 3: alphabeta1d (big blind) folded on the River
Seat 4: pavlo8855 folded before Flop (didn't bet)
Seat 5: tisadaisy folded before Flop (didn't bet)
Seat 6: so0love folded before Flop (didn't bet)



PokerStars Zoom Hand #229232770245:  Hold'em No Limit ($0.01/$0.02) - 2021/08/21 23:04:23 CET [2021/08/21 17:04:23 ET]
Table 'Halley' 6-max Seat #1 is the button
Seat 1: fishh_play ($2.56 in chips) 
Seat 2: Scaaalll ($3.29 in chips) 
Seat 3: RrriotGrrrl ($8.01 in chips) 
Seat 4: Mac9Monty2 ($2.28 in chips) 
Seat 5: pipecmolodec ($2.26 in chips) 
Seat 6: Iv3rson18 ($2.35 in chips) 
Scaaalll: posts small blind $0.01
RrriotGrrrl: posts big blind $0.02
*** HOLE CARDS ***
Dealt to Scaaalll [7c 4c]
Mac9Monty2: folds 
pipecmolodec: folds 
Iv3rson18: folds 
fishh_play: raises $0.03 to $0.05
Scaaalll: folds 
RrriotGrrrl: raises $0.19 to $0.24
fishh_play: calls $0.19
*** FLOP *** [9h Qs 8h]
RrriotGrrrl: bets $0.24
fishh_play: raises $2.08 to $2.32 and is all-in
RrriotGrrrl: folds 
Uncalled bet ($2.08) returned to fishh_play
fishh_play collected $0.94 from pot
fishh_play: doesn't show hand 
*** SUMMARY ***
Total pot $0.97 | Rake $0.03 
Board [9h Qs 8h]
Seat 1: fishh_play (button) collected ($0.94)
Seat 2: Scaaalll (small blind) folded before Flop
Seat 3: RrriotGrrrl (big blind) folded on the Flop
Seat 4: Mac9Monty2 folded before Flop (didn't bet)
Seat 5: pipecmolodec folded before Flop (didn't bet)
Seat 6: Iv3rson18 folded before Flop (didn't bet)



PokerStars Zoom Hand #229232778093:  Hold'em No Limit ($0.01/$0.02) - 2021/08/21 23:04:41 CET [2021/08/21 17:04:41 ET]
Table 'Halley' 6-max Seat #1 is the button
Seat 1: Scaaalll ($3.27 in chips) 
Seat 2: Vanekakqj ($2.26 in chips) 
Seat 3: Koldun 2636 ($2.21 in chips) 
Seat 4: simensgh ($6.91 in chips) 
Seat 5: Xlavariable ($2.86 in chips) 
Seat 6: ciucibaby ($3.75 in chips) 
Vanekakqj: posts small blind $0.01
Koldun 2636: posts big blind $0.02
*** HOLE CARDS ***
Dealt to Scaaalll [Kc Ks]
simensgh: folds 
Xlavariable: folds 
ciucibaby: raises $0.04 to $0.06
Scaaalll: raises $0.14 to $0.20
Vanekakqj: folds 
Koldun 2636: folds 
ciucibaby: calls $0.14
*** FLOP *** [3c 4c Ah]
ciucibaby: checks 
Scaaalll: bets $0.23
ciucibaby: folds 
Uncalled bet ($0.23) returned to Scaaalll
Scaaalll collected $0.41 from pot
Scaaalll: doesn't show hand 
*** SUMMARY ***
Total pot $0.43 | Rake $0.02 
Board [3c 4c Ah]
Seat 1: Scaaalll (button) collected ($0.41)
Seat 2: Vanekakqj (small blind) folded before Flop
Seat 3: Koldun 2636 (big blind) folded before Flop
Seat 4: simensgh folded before Flop (didn't bet)
Seat 5: Xlavariable folded before Flop (didn't bet)
Seat 6: ciucibaby folded on the Flop



PokerStars Zoom Hand #229232804480:  Hold'em No Limit ($0.01/$0.02) - 2021/08/21 23:05:41 CET [2021/08/21 17:05:41 ET]
Table 'Halley' 6-max Seat #1 is the button
Seat 1: Hejpåre ($2 in chips) 
Seat 2: IceTdannyB ($3.41 in chips) 
Seat 3: ussr246 ($3.11 in chips) 
Seat 4: NickAlex18 ($2.08 in chips) 
Seat 5: Scaaalll ($3.48 in chips) 
Seat 6: Vanekakqj ($1.84 in chips) 
IceTdannyB: posts small blind $0.01
ussr246: posts big blind $0.02
*** HOLE CARDS ***
Dealt to Scaaalll [6s Ah]
NickAlex18: folds 
Scaaalll: folds 
Vanekakqj: raises $0.04 to $0.06
Hejpåre: folds 
IceTdannyB: folds 
ussr246: folds 
Uncalled bet ($0.04) returned to Vanekakqj
IceTdannyB is disconnected 
Vanekakqj collected $0.05 from pot
Vanekakqj: doesn't show hand 
*** SUMMARY ***
Total pot $0.05 | Rake $0 
Seat 1: Hejpåre (button) folded before Flop (didn't bet)
Seat 2: IceTdannyB (small blind) folded before Flop
Seat 3: ussr246 (big blind) folded before Flop
Seat 4: NickAlex18 folded before Flop (didn't bet)
Seat 5: Scaaalll folded before Flop (didn't bet)
Seat 6: Vanekakqj collected ($0.05)



PokerStars Zoom Hand #229232798838:  Hold'em No Limit ($0.01/$0.02) - 2021/08/21 23:05:28 CET [2021/08/21 17:05:28 ET]
Table 'Halley' 6-max Seat #1 is the button
Seat 1: gizum17 ($2.73 in chips) 
Seat 2: babiloniaxxx ($2 in chips) 
Seat 3: RaulacateFolds ($2.78 in chips) 
Seat 4: Solarios ($1.57 in chips) 
Seat 5: PEDACIT0 ($2 in chips) 
Seat 6: Scaaalll ($3.48 in chips) 
babiloniaxxx: posts small blind $0.01
RaulacateFolds: posts big blind $0.02
*** HOLE CARDS ***
Dealt to Scaaalll [7c 2c]
Solarios: raises $0.02 to $0.04
PEDACIT0: folds 
Scaaalll: folds 
gizum17: folds 
babiloniaxxx: folds 
RaulacateFolds: folds 
Uncalled bet ($0.02) returned to Solarios
Solarios collected $0.05 from pot
Solarios: doesn't show hand 
*** SUMMARY ***
Total pot $0.05 | Rake $0 
Seat 1: gizum17 (button) folded before Flop (didn't bet)
Seat 2: babiloniaxxx (small blind) folded before Flop
Seat 3: RaulacateFolds (big blind) folded before Flop
Seat 4: Solarios collected ($0.05)
Seat 5: PEDACIT0 folded before Flop (didn't bet)
Seat 6: Scaaalll folded before Flop (didn't bet)



PokerStars Zoom Hand #229232807934:  Hold'em No Limit ($0.01/$0.02) - 2021/08/21 23:05:49 CET [2021/08/21 17:05:49 ET]
Table 'Halley' 6-max Seat #1 is the button
Seat 1: didiclavi777 ($1.75 in chips) 
Seat 2: diamonds410 ($1.01 in chips) 
Seat 3: Scaaalll ($3.48 in chips) 
Seat 4: Yangyang1407 ($2 in chips) 
Seat 5: gilberto98 ($1.59 in chips) 
Seat 6: Kojak34 ($5.90 in chips) 
diamonds410: posts small blind $0.01
Scaaalll: posts big blind $0.02
*** HOLE CARDS ***
Dealt to Scaaalll [4h 7h]
Yangyang1407: folds 
gilberto98: folds 
Kojak34: folds 
didiclavi777: folds 
diamonds410: raises $0.02 to $0.04
Scaaalll: calls $0.02
*** FLOP *** [Ad 3d Kh]
diamonds410: checks 
Scaaalll: bets $0.04
diamonds410: folds 
Uncalled bet ($0.04) returned to Scaaalll
Scaaalll collected $0.08 from pot
Scaaalll: doesn't show hand 
diamonds410 is disconnected 
*** SUMMARY ***
Total pot $0.08 | Rake $0 
Board [Ad 3d Kh]
Seat 1: didiclavi777 (button) folded before Flop (didn't bet)
Seat 2: diamonds410 (small blind) folded on the Flop
Seat 3: Scaaalll (big blind) collected ($0.08)
Seat 4: Yangyang1407 folded before Flop (didn't bet)
Seat 5: gilberto98 folded before Flop (didn't bet)
Seat 6: Kojak34 folded before Flop (didn't bet)



PokerStars Zoom Hand #229232821612:  Hold'em No Limit ($0.01/$0.02) - 2021/08/21 23:06:20 CET [2021/08/21 17:06:20 ET]
Table 'Halley' 6-max Seat #1 is the button
Seat 1: tsalik ($2.12 in chips) 
Seat 2: EevAA190 ($2.20 in chips) 
Seat 3: castrosis ($2.06 in chips) 
Seat 4: Scaaalll ($3.52 in chips) 
Seat 5: Peimievvt ($2.40 in chips) 
Seat 6: Phoenixxxxxxxx ($2.03 in chips) 
EevAA190: posts small blind $0.01
castrosis: posts big blind $0.02
*** HOLE CARDS ***
Dealt to Scaaalll [9d Qd]
Scaaalll: folds 
Peimievvt: folds 
Phoenixxxxxxxx: folds 
tsalik: folds 
EevAA190: folds 
Uncalled bet ($0.01) returned to castrosis
castrosis collected $0.02 from pot
castrosis: doesn't show hand 
*** SUMMARY ***
Total pot $0.02 | Rake $0 
Seat 1: tsalik (button) folded before Flop (didn't bet)
Seat 2: EevAA190 (small blind) folded before Flop
Seat 3: castrosis (big blind) collected ($0.02)
Seat 4: Scaaalll folded before Flop (didn't bet)
Seat 5: Peimievvt folded before Flop (didn't bet)
Seat 6: Phoenixxxxxxxx folded before Flop (didn't bet)



PokerStars Zoom Hand #229232823371:  Hold'em No Limit ($0.01/$0.02) - 2021/08/21 23:06:24 CET [2021/08/21 17:06:24 ET]
Table 'Halley' 6-max Seat #1 is the button
Seat 1: HubertFroh ($4.75 in chips) 
Seat 2: queen830 ($12.56 in chips) 
Seat 3: Apollonnn_13 ($2.34 in chips) 
Seat 4: Scaaalll ($3.52 in chips) 
Seat 5: Koldun 2636 ($2.14 in chips) 
Seat 6: Wegezin ($2.84 in chips) 
queen830: posts small blind $0.01
Apollonnn_13: posts big blind $0.02
*** HOLE CARDS ***
Dealt to Scaaalll [Qd 9c]
Scaaalll: folds 
Koldun 2636: folds 
Wegezin: folds 
HubertFroh: folds 
queen830: folds 
Uncalled bet ($0.01) returned to Apollonnn_13
Apollonnn_13 collected $0.02 from pot
Apollonnn_13: doesn't show hand 
*** SUMMARY ***
Total pot $0.02 | Rake $0 
Seat 1: HubertFroh (button) folded before Flop (didn't bet)
Seat 2: queen830 (small blind) folded before Flop
Seat 3: Apollonnn_13 (big blind) collected ($0.02)
Seat 4: Scaaalll folded before Flop (didn't bet)
Seat 5: Koldun 2636 folded before Flop (didn't bet)
Seat 6: Wegezin folded before Flop (didn't bet)



PokerStars Zoom Hand #229232835115:  Hold'em No Limit ($0.01/$0.02) - 2021/08/21 23:06:51 CET [2021/08/21 17:06:51 ET]
Table 'Halley' 6-max Seat #1 is the button
Seat 1: Scaaalll ($3.49 in chips) 
Seat 2: Umnik_M ($3.23 in chips) 
Seat 3: cutter2468 ($2 in chips) 
Seat 4: GVMELLO ($2 in chips) 
Seat 5: Sharabora ($0.89 in chips) 
Seat 6: bioern ($3.49 in chips) 
Umnik_M: posts small blind $0.01
cutter2468: posts big blind $0.02
*** HOLE CARDS ***
Dealt to Scaaalll [5h 3c]
GVMELLO: folds 
Sharabora: folds 
bioern: folds 
Scaaalll: folds 
Umnik_M: raises $0.28 to $0.30
cutter2468: folds 
Uncalled bet ($0.28) returned to Umnik_M
Umnik_M collected $0.04 from pot
Umnik_M: doesn't show hand 
*** SUMMARY ***
Total pot $0.04 | Rake $0 
Seat 1: Scaaalll (button) folded before Flop (didn't bet)
Seat 2: Umnik_M (small blind) collected ($0.04)
Seat 3: cutter2468 (big blind) folded before Flop
Seat 4: GVMELLO folded before Flop (didn't bet)
Seat 5: Sharabora folded before Flop (didn't bet)
Seat 6: bioern folded before Flop (didn't bet)



PokerStars Zoom Hand #229232825133:  Hold'em No Limit ($0.01/$0.02) - 2021/08/21 23:06:28 CET [2021/08/21 17:06:28 ET]
Table 'Halley' 6-max Seat #1 is the button
Seat 1: SKV_1985 ($2.14 in chips) 
Seat 2: Gamer577 ($2 in chips) 
Seat 3: Scaaalll ($3.52 in chips) 
Seat 4: EevAA190 ($2.19 in chips) 
Seat 5: maliniak75 ($1.99 in chips) 
Seat 6: Espartacus5222 ($2.26 in chips) 
Gamer577: posts small blind $0.01
Scaaalll: posts big blind $0.02
*** HOLE CARDS ***
Dealt to Scaaalll [5d Qs]
EevAA190: folds 
maliniak75: calls $0.02
Espartacus5222: raises $0.04 to $0.06
SKV_1985: folds 
Gamer577: folds 
Scaaalll: folds 
maliniak75: calls $0.04
*** FLOP *** [Td 2c Tc]
maliniak75: checks 
Espartacus5222: bets $0.04
maliniak75: folds 
Uncalled bet ($0.04) returned to Espartacus5222
Espartacus5222 collected $0.14 from pot
Espartacus5222: doesn't show hand 
*** SUMMARY ***
Total pot $0.15 | Rake $0.01 
Board [Td 2c Tc]
Seat 1: SKV_1985 (button) folded before Flop (didn't bet)
Seat 2: Gamer577 (small blind) folded before Flop
Seat 3: Scaaalll (big blind) folded before Flop
Seat 4: EevAA190 folded before Flop (didn't bet)
Seat 5: maliniak75 folded on the Flop
Seat 6: Espartacus5222 collected ($0.14)



PokerStars Zoom Hand #229232838612:  Hold'em No Limit ($0.01/$0.02) - 2021/08/21 23:06:59 CET [2021/08/21 17:06:59 ET]
Table 'Halley' 6-max Seat #1 is the button
Seat 1: ARS_POLI13 ($0.46 in chips) 
Seat 2: castrosis ($2.45 in chips) 
Seat 3: pavlo8855 ($2 in chips) 
Seat 4: Iv3rson18 ($2 in chips) 
Seat 5: Scaaalll ($3.49 in chips) 
Seat 6: Leonpy92 ($2.65 in chips) 
castrosis: posts small blind $0.01
pavlo8855: posts big blind $0.02
*** HOLE CARDS ***
Dealt to Scaaalll [8c Kd]
Iv3rson18: folds 
Scaaalll: folds 
Leonpy92: folds 
ARS_POLI13: folds 
castrosis: folds 
Uncalled bet ($0.01) returned to pavlo8855
pavlo8855 collected $0.02 from pot
pavlo8855: doesn't show hand 
*** SUMMARY ***
Total pot $0.02 | Rake $0 
Seat 1: ARS_POLI13 (button) folded before Flop (didn't bet)
Seat 2: castrosis (small blind) folded before Flop
Seat 3: pavlo8855 (big blind) collected ($0.02)
Seat 4: Iv3rson18 folded before Flop (didn't bet)
Seat 5: Scaaalll folded before Flop (didn't bet)
Seat 6: Leonpy92 folded before Flop (didn't bet)



PokerStars Zoom Hand #229232831202:  Hold'em No Limit ($0.01/$0.02) - 2021/08/21 23:06:42 CET [2021/08/21 17:06:42 ET]
Table 'Halley' 6-max Seat #1 is the button
Seat 1: ISBman ($3.26 in chips) 
Seat 2: Scaaalll ($3.50 in chips) 
Seat 3: Ck@tih@ ($2.24 in chips) 
Seat 4: nitzed12 ($2 in chips) 
Seat 5: newen83 ($2.72 in chips) 
Seat 6: kai_inge_mar ($1.53 in chips) 
Scaaalll: posts small blind $0.01
Ck@tih@: posts big blind $0.02
*** HOLE CARDS ***
Dealt to Scaaalll [8s 2d]
nitzed12: folds 
newen83: folds 
newen83 is disconnected 
kai_inge_mar: calls $0.02
ISBman: folds 
Scaaalll: folds 
Ck@tih@: checks 
*** FLOP *** [Jc 7s 4d]
Ck@tih@: checks 
kai_inge_mar: checks 
*** TURN *** [Jc 7s 4d] [8c]
Ck@tih@: checks 
kai_inge_mar: checks 
*** RIVER *** [Jc 7s 4d 8c] [Qc]
Ck@tih@: checks 
kai_inge_mar: checks 
*** SHOW DOWN ***
Ck@tih@: shows [Th 3d] (high card Queen)
kai_inge_mar: shows [Jd 6d] (a pair of Jacks)
kai_inge_mar collected $0.05 from pot
*** SUMMARY ***
Total pot $0.05 | Rake $0 
Board [Jc 7s 4d 8c Qc]
Seat 1: ISBman (button) folded before Flop (didn't bet)
Seat 2: Scaaalll (small blind) folded before Flop
Seat 3: Ck@tih@ (big blind) showed [Th 3d] and lost with high card Queen
Seat 4: nitzed12 folded before Flop (didn't bet)
Seat 5: newen83 folded before Flop (didn't bet)
Seat 6: kai_inge_mar showed [Jd 6d] and won ($0.05) with a pair of Jacks



PokerStars Zoom Hand #229232840317:  Hold'em No Limit ($0.01/$0.02) - 2021/08/21 23:07:03 CET [2021/08/21 17:07:03 ET]
Table 'Halley' 6-max Seat #1 is the button
Seat 1: gilberto98 ($1.61 in chips) 
Seat 2: Scaaalll ($3.49 in chips) 
Seat 3: alphabeta1d ($2.07 in chips) 
Seat 4: nitzed12 ($2.03 in chips) 
Seat 5: martinob11 ($1.94 in chips) 
Seat 6: SirBatish ($3.19 in chips) 
Scaaalll: posts small blind $0.01
alphabeta1d: posts big blind $0.02
*** HOLE CARDS ***
Dealt to Scaaalll [8h Ah]
nitzed12: folds 
martinob11: folds 
SirBatish: folds 
gilberto98: folds 
Scaaalll: raises $0.04 to $0.06
alphabeta1d: folds 
Uncalled bet ($0.04) returned to Scaaalll
Scaaalll collected $0.04 from pot
Scaaalll: doesn't show hand 
*** SUMMARY ***
Total pot $0.04 | Rake $0 
Seat 1: gilberto98 (button) folded before Flop (didn't bet)
Seat 2: Scaaalll (small blind) collected ($0.04)
Seat 3: alphabeta1d (big blind) folded before Flop
Seat 4: nitzed12 folded before Flop (didn't bet)
Seat 5: martinob11 folded before Flop (didn't bet)
Seat 6: SirBatish folded before Flop (didn't bet)



PokerStars Zoom Hand #229232836832:  Hold'em No Limit ($0.01/$0.02) - 2021/08/21 23:06:55 CET [2021/08/21 17:06:55 ET]
Table 'Halley' 6-max Seat #1 is the button
Seat 1: PapiMik3 ($6.61 in chips) 
Seat 2: pavlo8855 ($2 in chips) 
Seat 3: kumanotiger ($1.63 in chips) 
Seat 4: fishh_play ($3.24 in chips) 
Seat 5: OmahaWheels ($3.60 in chips) 
Seat 6: Scaaalll ($3.49 in chips) 
pavlo8855: posts small blind $0.01
kumanotiger: posts big blind $0.02
*** HOLE CARDS ***
Dealt to Scaaalll [4s Qc]
fishh_play: folds 
OmahaWheels: folds 
Scaaalll: folds 
PapiMik3: folds 
pavlo8855: raises $0.04 to $0.06
kumanotiger: calls $0.04
*** FLOP *** [Kh 7h Jc]
pavlo8855: checks 
kumanotiger: checks 
*** TURN *** [Kh 7h Jc] [4h]
pavlo8855: checks 
kumanotiger: checks 
*** RIVER *** [Kh 7h Jc 4h] [4c]
pavlo8855: checks 
kumanotiger: checks 
*** SHOW DOWN ***
pavlo8855: shows [3c 3s] (two pair, Fours and Threes)
kumanotiger: shows [Js 9c] (two pair, Jacks and Fours)
kumanotiger collected $0.12 from pot
*** SUMMARY ***
Total pot $0.12 | Rake $0 
Board [Kh 7h Jc 4h 4c]
Seat 1: PapiMik3 (button) folded before Flop (didn't bet)
Seat 2: pavlo8855 (small blind) showed [3c 3s] and lost with two pair, Fours and Threes
Seat 3: kumanotiger (big blind) showed [Js 9c] and won ($0.12) with two pair, Jacks and Fours
Seat 4: fishh_play folded before Flop (didn't bet)
Seat 5: OmahaWheels folded before Flop (didn't bet)
Seat 6: Scaaalll folded before Flop (didn't bet)



PokerStars Zoom Hand #229232861584:  Hold'em No Limit ($0.01/$0.02) - 2021/08/21 23:07:52 CET [2021/08/21 17:07:52 ET]
Table 'Halley' 6-max Seat #1 is the button
Seat 1: NoEff0rt2w1n ($3.64 in chips) 
Seat 2: kawish ($1.75 in chips) 
Seat 3: Scaaalll ($3.47 in chips) 
Seat 4: Kb013497 ($2.64 in chips) 
Seat 5: King-Pin2707 ($1.97 in chips) 
Seat 6: STE1NBERG ($2.60 in chips) 
kawish: posts small blind $0.01
Scaaalll: posts big blind $0.02
*** HOLE CARDS ***
Dealt to Scaaalll [Ks 4d]
Kb013497: folds 
King-Pin2707: folds 
STE1NBERG: folds 
NoEff0rt2w1n: folds 
kawish: raises $0.02 to $0.04
Scaaalll: folds 
Uncalled bet ($0.02) returned to kawish
kawish collected $0.04 from pot
kawish: doesn't show hand 
*** SUMMARY ***
Total pot $0.04 | Rake $0 
Seat 1: NoEff0rt2w1n (button) folded before Flop (didn't bet)
Seat 2: kawish (small blind) collected ($0.04)
Seat 3: Scaaalll (big blind) folded before Flop
Seat 4: Kb013497 folded before Flop (didn't bet)
Seat 5: King-Pin2707 folded before Flop (didn't bet)
Seat 6: STE1NBERG folded before Flop (didn't bet)



PokerStars Zoom Hand #229232848149:  Hold'em No Limit ($0.01/$0.02) - 2021/08/21 23:07:21 CET [2021/08/21 17:07:21 ET]
Table 'Halley' 6-max Seat #1 is the button
Seat 1: newen83 ($2.69 in chips) 
Seat 2: Chapaev136 ($5.85 in chips) 
Seat 3: dominik7315 ($2.09 in chips) 
Seat 4: NetoFLX ($2.01 in chips) 
Seat 5: ctaceo ($2.04 in chips) 
Seat 6: Scaaalll ($3.51 in chips) 
Chapaev136: posts small blind $0.01
dominik7315: posts big blind $0.02
*** HOLE CARDS ***
Dealt to Scaaalll [Ks 2h]
NetoFLX: folds 
ctaceo: folds 
Scaaalll: folds 
newen83: calls $0.02
Chapaev136: folds 
dominik7315: checks 
*** FLOP *** [Ah Qc 6h]
dominik7315: checks 
newen83: checks 
*** TURN *** [Ah Qc 6h] [8s]
dominik7315: checks 
newen83: bets $0.02
dominik7315: calls $0.02
*** RIVER *** [Ah Qc 6h 8s] [8h]
dominik7315: checks 
newen83: bets $0.17
dominik7315: folds 
Uncalled bet ($0.17) returned to newen83
newen83 collected $0.09 from pot
newen83: doesn't show hand 
dominik7315 is disconnected 
*** SUMMARY ***
Total pot $0.09 | Rake $0 
Board [Ah Qc 6h 8s 8h]
Seat 1: newen83 (button) collected ($0.09)
Seat 2: Chapaev136 (small blind) folded before Flop
Seat 3: dominik7315 (big blind) folded on the River
Seat 4: NetoFLX folded before Flop (didn't bet)
Seat 5: ctaceo folded before Flop (didn't bet)
Seat 6: Scaaalll folded before Flop (didn't bet)



PokerStars Zoom Hand #229232851736:  Hold'em No Limit ($0.01/$0.02) - 2021/08/21 23:07:29 CET [2021/08/21 17:07:29 ET]
Table 'Halley' 6-max Seat #1 is the button
Seat 1: Scaaalll ($3.51 in chips) 
Seat 2: Xlavariable ($2.33 in chips) 
Seat 3: xxRoseIloveu ($8.64 in chips) 
Seat 4: alphabeta1d ($2.05 in chips) 
Seat 5: Tibelloni ($4.95 in chips) 
Seat 6: Pulp Hands ($1.52 in chips) 
Xlavariable: posts small blind $0.01
xxRoseIloveu: posts big blind $0.02
*** HOLE CARDS ***
Dealt to Scaaalll [9h Jc]
alphabeta1d: folds 
Tibelloni: folds 
Pulp Hands: folds 
Tibelloni is disconnected 
Scaaalll: raises $0.02 to $0.04
Xlavariable: raises $0.16 to $0.20
xxRoseIloveu: calls $0.18
Scaaalll: folds 
*** FLOP *** [Ah Ks Qd]
Xlavariable: bets $0.21
xxRoseIloveu: raises $8.23 to $8.44 and is all-in
Xlavariable: calls $1.92 and is all-in
Uncalled bet ($6.31) returned to xxRoseIloveu
*** TURN *** [Ah Ks Qd] [7s]
*** RIVER *** [Ah Ks Qd 7s] [Kc]
*** SHOW DOWN ***
Xlavariable: shows [Qs As] (two pair, Aces and Kings)
xxRoseIloveu: shows [Kh Ac] (a full house, Kings full of Aces)
xxRoseIloveu cashed out the hand for $3.88 | Cash Out Fee $0.04
*** SUMMARY ***
Total pot $4.70 | Rake $0.16 
Board [Ah Ks Qd 7s Kc]
Seat 1: Scaaalll (button) folded before Flop
Seat 2: Xlavariable (small blind) showed [Qs As] and lost with two pair, Aces and Kings
Seat 3: xxRoseIloveu (big blind) showed [Kh Ac] and won ($4.54) with a full house, Kings full of Aces (pot not awarded as player cashed out)
Seat 4: alphabeta1d folded before Flop (didn't bet)
Seat 5: Tibelloni folded before Flop (didn't bet)
Seat 6: Pulp Hands folded before Flop (didn't bet)



PokerStars Zoom Hand #229232875513:  Hold'em No Limit ($0.01/$0.02) - 2021/08/21 23:08:24 CET [2021/08/21 17:08:24 ET]
Table 'Halley' 6-max Seat #1 is the button
Seat 1: Scaaalll ($3.45 in chips) 
Seat 2: Leonpy92 ($2.63 in chips) 
Seat 3: bioern ($3.61 in chips) 
Seat 4: Espartacus5222 ($2.22 in chips) 
Seat 5: Apollonnn_13 ($1.76 in chips) 
Seat 6: PapiMik3 ($6.55 in chips) 
Leonpy92: posts small blind $0.01
bioern: posts big blind $0.02
*** HOLE CARDS ***
Dealt to Scaaalll [3h 6c]
Espartacus5222: folds 
Apollonnn_13: folds 
PapiMik3: folds 
Scaaalll: folds 
Leonpy92: raises $0.04 to $0.06
bioern: folds 
Uncalled bet ($0.04) returned to Leonpy92
Leonpy92 collected $0.04 from pot
Leonpy92: doesn't show hand 
*** SUMMARY ***
Total pot $0.04 | Rake $0 
Seat 1: Scaaalll (button) folded before Flop (didn't bet)
Seat 2: Leonpy92 (small blind) collected ($0.04)
Seat 3: bioern (big blind) folded before Flop
Seat 4: Espartacus5222 folded before Flop (didn't bet)
Seat 5: Apollonnn_13 folded before Flop (didn't bet)
Seat 6: PapiMik3 folded before Flop (didn't bet)



PokerStars Zoom Hand #229232869382:  Hold'em No Limit ($0.01/$0.02) - 2021/08/21 23:08:10 CET [2021/08/21 17:08:10 ET]
Table 'Halley' 6-max Seat #1 is the button
Seat 1: Canoinhas37 ($7.01 in chips) 
Seat 2: vipan2011 ($0.62 in chips) 
Seat 3: SIGREX ($2.96 in chips) 
Seat 4: z3317111711 ($5.02 in chips) 
Seat 5: Scaaalll ($3.45 in chips) 
Seat 6: NecromiconP ($2.69 in chips) 
vipan2011: posts small blind $0.01
SIGREX: posts big blind $0.02
*** HOLE CARDS ***
Dealt to Scaaalll [Jd 8h]
z3317111711: folds 
vipan2011 is disconnected 
Scaaalll: folds 
NecromiconP: folds 
Canoinhas37: raises $0.02 to $0.04
vipan2011: folds 
SIGREX: calls $0.02
*** FLOP *** [7h Ks Ah]
SIGREX: checks 
Canoinhas37: checks 
*** TURN *** [7h Ks Ah] [6h]
SIGREX: checks 
Canoinhas37: checks 
*** RIVER *** [7h Ks Ah 6h] [8c]
SIGREX: checks 
Canoinhas37: checks 
*** SHOW DOWN ***
SIGREX: shows [Jc 3c] (high card Ace)
Canoinhas37: shows [9c 7c] (a pair of Sevens)
Canoinhas37 collected $0.09 from pot
*** SUMMARY ***
Total pot $0.09 | Rake $0 
Board [7h Ks Ah 6h 8c]
Seat 1: Canoinhas37 (button) showed [9c 7c] and won ($0.09) with a pair of Sevens
Seat 2: vipan2011 (small blind) folded before Flop
Seat 3: SIGREX (big blind) showed [Jc 3c] and lost with high card Ace
Seat 4: z3317111711 folded before Flop (didn't bet)
Seat 5: Scaaalll folded before Flop (didn't bet)
Seat 6: NecromiconP folded before Flop (didn't bet)



PokerStars Zoom Hand #229232880734:  Hold'em No Limit ($0.01/$0.02) - 2021/08/21 23:08:36 CET [2021/08/21 17:08:36 ET]
Table 'Halley' 6-max Seat #1 is the button
Seat 1: Craitastrophe ($2 in chips) 
Seat 2: Scaaalll ($3.45 in chips) 
Seat 3: NetoFLX ($2 in chips) 
Seat 4: dinoVIEIRA ($2.47 in chips) 
Seat 5: bananAAbandit ($5.01 in chips) 
Seat 6: WITKOW_AV ($3.20 in chips) 
Scaaalll: posts small blind $0.01
NetoFLX: posts big blind $0.02
*** HOLE CARDS ***
Dealt to Scaaalll [Ad 6d]
dinoVIEIRA: folds 
Craitastrophe is disconnected 
bananAAbandit: folds 
WITKOW_AV: folds 
Craitastrophe: folds 
Scaaalll: raises $0.04 to $0.06
NetoFLX: folds 
Uncalled bet ($0.04) returned to Scaaalll
Scaaalll collected $0.04 from pot
Scaaalll: doesn't show hand 
*** SUMMARY ***
Total pot $0.04 | Rake $0 
Seat 1: Craitastrophe (button) folded before Flop (didn't bet)
Seat 2: Scaaalll (small blind) collected ($0.04)
Seat 3: NetoFLX (big blind) folded before Flop
Seat 4: dinoVIEIRA folded before Flop (didn't bet)
Seat 5: bananAAbandit folded before Flop (didn't bet)
Seat 6: WITKOW_AV folded before Flop (didn't bet)



PokerStars Zoom Hand #229232878605:  Hold'em No Limit ($0.01/$0.02) - 2021/08/21 23:08:31 CET [2021/08/21 17:08:31 ET]
Table 'Halley' 6-max Seat #1 is the button
Seat 1: HDYD18 ($2 in chips) 
Seat 2: kawish ($1.75 in chips) 
Seat 3: maliniak75 ($1.72 in chips) 
Seat 4: Scaaalll ($3.45 in chips) 
Seat 5: Yangyang1407 ($2 in chips) 
Seat 6: osantos401 ($7.97 in chips) 
kawish: posts small blind $0.01
maliniak75: posts big blind $0.02
*** HOLE CARDS ***
Dealt to Scaaalll [8c 2c]
Scaaalll: folds 
Yangyang1407: folds 
osantos401: raises $0.04 to $0.06
HDYD18: folds 
kawish: folds 
maliniak75: calls $0.04
*** FLOP *** [As 3d 5d]
maliniak75: checks 
osantos401: bets $0.07
maliniak75: calls $0.07
*** TURN *** [As 3d 5d] [9h]
maliniak75: checks 
osantos401: checks 
*** RIVER *** [As 3d 5d 9h] [Th]
maliniak75: bets $0.13
osantos401: calls $0.13
*** SHOW DOWN ***
maliniak75: shows [8s 8d] (a pair of Eights)
osantos401: shows [Jh Ts] (a pair of Tens)
osantos401 collected $0.51 from pot
*** SUMMARY ***
Total pot $0.53 | Rake $0.02 
Board [As 3d 5d 9h Th]
Seat 1: HDYD18 (button) folded before Flop (didn't bet)
Seat 2: kawish (small blind) folded before Flop
Seat 3: maliniak75 (big blind) showed [8s 8d] and lost with a pair of Eights
Seat 4: Scaaalll folded before Flop (didn't bet)
Seat 5: Yangyang1407 folded before Flop (didn't bet)
Seat 6: osantos401 showed [Jh Ts] and won ($0.51) with a pair of Tens



PokerStars Zoom Hand #229232892904:  Hold'em No Limit ($0.01/$0.02) - 2021/08/21 23:09:04 CET [2021/08/21 17:09:04 ET]
Table 'Halley' 6-max Seat #1 is the button
Seat 1: zaharoff74 ($1.99 in chips) 
Seat 2: maria west side ($2 in chips) 
Seat 3: cutter2468 ($2.03 in chips) 
Seat 4: Scaaalll ($3.47 in chips) 
Seat 5: NecromiconP ($2.09 in chips) 
Seat 6: *88VIC88* ($1.03 in chips) 
maria west side: posts small blind $0.01
cutter2468: posts big blind $0.02
*** HOLE CARDS ***
Dealt to Scaaalll [7s 8d]
maria west side is disconnected 
*88VIC88* is disconnected 
Scaaalll: folds 
NecromiconP: folds 
*88VIC88*: folds 
zaharoff74: folds 
maria west side: folds 
Uncalled bet ($0.01) returned to cutter2468
cutter2468 collected $0.02 from pot
cutter2468: doesn't show hand 
*** SUMMARY ***
Total pot $0.02 | Rake $0 
Seat 1: zaharoff74 (button) folded before Flop (didn't bet)
Seat 2: maria west side (small blind) folded before Flop
Seat 3: cutter2468 (big blind) collected ($0.02)
Seat 4: Scaaalll folded before Flop (didn't bet)
Seat 5: NecromiconP folded before Flop (didn't bet)
Seat 6: *88VIC88* folded before Flop (didn't bet)



PokerStars Zoom Hand #229232891233:  Hold'em No Limit ($0.01/$0.02) - 2021/08/21 23:09:00 CET [2021/08/21 17:09:00 ET]
Table 'Halley' 6-max Seat #1 is the button
Seat 1: fishh_play ($3.26 in chips) 
Seat 2: nitzed12 ($2.20 in chips) 
Seat 3: olga3021221 ($2 in chips) 
Seat 4: derry,me ($3.07 in chips) 
Seat 5: sg.32rus ($1 in chips) 
Seat 6: Scaaalll ($3.47 in chips) 
nitzed12: posts small blind $0.01
olga3021221: posts big blind $0.02
*** HOLE CARDS ***
Dealt to Scaaalll [Th 9d]
derry,me: raises $0.02 to $0.04
sg.32rus: folds 
Scaaalll: folds 
fishh_play: folds 
nitzed12: raises $0.14 to $0.18
olga3021221: folds 
derry,me: calls $0.14
*** FLOP *** [8s Ks 5s]
nitzed12: bets $0.19
derry,me: raises $2.70 to $2.89 and is all-in
nitzed12: folds 
Uncalled bet ($2.70) returned to derry,me
derry,me collected $0.73 from pot
derry,me: doesn't show hand 
*** SUMMARY ***
Total pot $0.76 | Rake $0.03 
Board [8s Ks 5s]
Seat 1: fishh_play (button) folded before Flop (didn't bet)
Seat 2: nitzed12 (small blind) folded on the Flop
Seat 3: olga3021221 (big blind) folded before Flop
Seat 4: derry,me collected ($0.73)
Seat 5: sg.32rus folded before Flop (didn't bet)
Seat 6: Scaaalll folded before Flop (didn't bet)



PokerStars Zoom Hand #229232902055:  Hold'em No Limit ($0.01/$0.02) - 2021/08/21 23:09:25 CET [2021/08/21 17:09:25 ET]
Table 'Halley' 6-max Seat #1 is the button
Seat 1: Mac9Monty2 ($2.55 in chips) 
Seat 2: punkosk8 ($1.32 in chips) 
Seat 3: PapiMik3 ($6.42 in chips) 
Seat 4: Scaaalll ($3.45 in chips) 
Seat 5: bananAAbandit ($5.99 in chips) 
Seat 6: 888lifeIS ($2 in chips) 
punkosk8: posts small blind $0.01
PapiMik3: posts big blind $0.02
*** HOLE CARDS ***
Dealt to Scaaalll [Qd Ad]
Scaaalll: raises $0.04 to $0.06
bananAAbandit: folds 
888lifeIS: folds 
Mac9Monty2: folds 
punkosk8: folds 
PapiMik3: folds 
Uncalled bet ($0.04) returned to Scaaalll
punkosk8 is disconnected 
Scaaalll collected $0.05 from pot
Scaaalll: doesn't show hand 
*** SUMMARY ***
Total pot $0.05 | Rake $0 
Seat 1: Mac9Monty2 (button) folded before Flop (didn't bet)
Seat 2: punkosk8 (small blind) folded before Flop
Seat 3: PapiMik3 (big blind) folded before Flop
Seat 4: Scaaalll collected ($0.05)
Seat 5: bananAAbandit folded before Flop (didn't bet)
Seat 6: 888lifeIS folded before Flop (didn't bet)



PokerStars Zoom Hand #229232899483:  Hold'em No Limit ($0.01/$0.02) - 2021/08/21 23:09:19 CET [2021/08/21 17:09:19 ET]
Table 'Halley' 6-max Seat #1 is the button
Seat 1: Colby1771 ($4.27 in chips) 
Seat 2: pavlo8855 ($2 in chips) 
Seat 3: ffffj ($1.22 in chips) 
Seat 4: Gamer577 ($7.09 in chips) 
Seat 5: Scaaalll ($3.45 in chips) 
Seat 6: Wantmyribbon ($1.46 in chips) 
pavlo8855: posts small blind $0.01
ffffj: posts big blind $0.02
*** HOLE CARDS ***
Dealt to Scaaalll [8h Qh]
Gamer577: folds 
Scaaalll: folds 
Wantmyribbon has timed out while disconnected
Wantmyribbon: folds 
Colby1771: raises $0.04 to $0.06
pavlo8855: folds 
ffffj: folds 
Uncalled bet ($0.04) returned to Colby1771
Colby1771 collected $0.05 from pot
Colby1771: doesn't show hand 
*** SUMMARY ***
Total pot $0.05 | Rake $0 
Seat 1: Colby1771 (button) collected ($0.05)
Seat 2: pavlo8855 (small blind) folded before Flop
Seat 3: ffffj (big blind) folded before Flop
Seat 4: Gamer577 folded before Flop (didn't bet)
Seat 5: Scaaalll folded before Flop (didn't bet)
Seat 6: Wantmyribbon folded before Flop (didn't bet)



PokerStars Zoom Hand #229232894694:  Hold'em No Limit ($0.01/$0.02) - 2021/08/21 23:09:08 CET [2021/08/21 17:09:08 ET]
Table 'Halley' 6-max Seat #1 is the button
Seat 1: zergmiky ($3.18 in chips) 
Seat 2: vot-tebe888 ($3.90 in chips) 
Seat 3: Scaaalll ($3.47 in chips) 
Seat 4: BlackhawKK's ($5.45 in chips) 
Seat 5: maria west side ($1.99 in chips) 
Seat 6: San4oWV ($1.74 in chips) 
vot-tebe888: posts small blind $0.01
Scaaalll: posts big blind $0.02
*** HOLE CARDS ***
Dealt to Scaaalll [3c 2d]
BlackhawKK's: folds 
maria west side: raises $0.05 to $0.07
San4oWV: raises $0.17 to $0.24
zergmiky: folds 
vot-tebe888: folds 
Scaaalll: folds 
maria west side: calls $0.17
*** FLOP *** [3d 4c 3s]
maria west side: bets $0.49
San4oWV: folds 
Uncalled bet ($0.49) returned to maria west side
maria west side collected $0.49 from pot
maria west side: doesn't show hand 
*** SUMMARY ***
Total pot $0.51 | Rake $0.02 
Board [3d 4c 3s]
Seat 1: zergmiky (button) folded before Flop (didn't bet)
Seat 2: vot-tebe888 (small blind) folded before Flop
Seat 3: Scaaalll (big blind) folded before Flop
Seat 4: BlackhawKK's folded before Flop (didn't bet)
Seat 5: maria west side collected ($0.49)
Seat 6: San4oWV folded on the Flop



PokerStars Zoom Hand #229232911063:  Hold'em No Limit ($0.01/$0.02) - 2021/08/21 23:09:46 CET [2021/08/21 17:09:46 ET]
Table 'Halley' 6-max Seat #1 is the button
Seat 1: AlexGTPS ($5.07 in chips) 
Seat 2: Scaaalll ($3.48 in chips) 
Seat 3: Jellycube ($4.44 in chips) 
Seat 4: HDYD18 ($5.39 in chips) 
Seat 5: Chapaev136 ($9.75 in chips) 
Seat 6: ASAjr ($2.07 in chips) 
Scaaalll: posts small blind $0.01
Jellycube: posts big blind $0.02
*** HOLE CARDS ***
Dealt to Scaaalll [7h 3s]
HDYD18: folds 
Chapaev136: folds 
ASAjr: raises $0.02 to $0.04
AlexGTPS: folds 
Scaaalll: folds 
Jellycube: folds 
Uncalled bet ($0.02) returned to ASAjr
ASAjr collected $0.05 from pot
ASAjr: doesn't show hand 
*** SUMMARY ***
Total pot $0.05 | Rake $0 
Seat 1: AlexGTPS (button) folded before Flop (didn't bet)
Seat 2: Scaaalll (small blind) folded before Flop
Seat 3: Jellycube (big blind) folded before Flop
Seat 4: HDYD18 folded before Flop (didn't bet)
Seat 5: Chapaev136 folded before Flop (didn't bet)
Seat 6: ASAjr collected ($0.05)



PokerStars Zoom Hand #229232915034:  Hold'em No Limit ($0.01/$0.02) - 2021/08/21 23:09:55 CET [2021/08/21 17:09:55 ET]
Table 'Halley' 6-max Seat #1 is the button
Seat 1: Scaaalll ($3.47 in chips) 
Seat 2: maliniak75 ($3.25 in chips) 
Seat 3: pavlo8855 ($2 in chips) 
Seat 4: vovan100157 ($2.31 in chips) 
Seat 5: Craitastrophe ($2 in chips) 
Seat 6: elmex886 ($2 in chips) 
maliniak75: posts small blind $0.01
pavlo8855: posts big blind $0.02
*** HOLE CARDS ***
Dealt to Scaaalll [Kd 7c]
vovan100157: folds 
Craitastrophe: folds 
Craitastrophe is disconnected 
elmex886: folds 
Scaaalll: raises $0.02 to $0.04
maliniak75: calls $0.03
pavlo8855: folds 
*** FLOP *** [4d 9d 4c]
maliniak75: checks 
Scaaalll: bets $0.06
maliniak75: folds 
Uncalled bet ($0.06) returned to Scaaalll
Scaaalll collected $0.10 from pot
Scaaalll: doesn't show hand 
*** SUMMARY ***
Total pot $0.10 | Rake $0 
Board [4d 9d 4c]
Seat 1: Scaaalll (button) collected ($0.10)
Seat 2: maliniak75 (small blind) folded on the Flop
Seat 3: pavlo8855 (big blind) folded before Flop
Seat 4: vovan100157 folded before Flop (didn't bet)
Seat 5: Craitastrophe folded before Flop (didn't bet)
Seat 6: elmex886 folded before Flop (didn't bet)



PokerStars Zoom Hand #229232935365:  Hold'em No Limit ($0.01/$0.02) - 2021/08/21 23:10:42 CET [2021/08/21 17:10:42 ET]
Table 'Halley' 6-max Seat #1 is the button
Seat 1: WITKOW_AV ($2.64 in chips) 
Seat 2: San4oWV ($2.40 in chips) 
Seat 3: Scaaalll ($3.53 in chips) 
Seat 4: dinoVIEIRA ($2.21 in chips) 
Seat 5: AlexGTPS ($2.02 in chips) 
Seat 6: Ramirres ($2.09 in chips) 
San4oWV: posts small blind $0.01
Scaaalll: posts big blind $0.02
*** HOLE CARDS ***
Dealt to Scaaalll [Qh 7d]
dinoVIEIRA: folds 
AlexGTPS: folds 
Ramirres: folds 
WITKOW_AV: raises $0.03 to $0.05
San4oWV: folds 
Scaaalll: folds 
Uncalled bet ($0.03) returned to WITKOW_AV
WITKOW_AV collected $0.05 from pot
WITKOW_AV: doesn't show hand 
*** SUMMARY ***
Total pot $0.05 | Rake $0 
Seat 1: WITKOW_AV (button) collected ($0.05)
Seat 2: San4oWV (small blind) folded before Flop
Seat 3: Scaaalll (big blind) folded before Flop
Seat 4: dinoVIEIRA folded before Flop (didn't bet)
Seat 5: AlexGTPS folded before Flop (didn't bet)
Seat 6: Ramirres folded before Flop (didn't bet)



PokerStars Zoom Hand #229232939692:  Hold'em No Limit ($0.01/$0.02) - 2021/08/21 23:10:52 CET [2021/08/21 17:10:52 ET]
Table 'Halley' 6-max Seat #1 is the button
Seat 1: zergmiky ($3.15 in chips) 
Seat 2: squidy4 ($3.70 in chips) 
Seat 3: Wilsonwing1 ($1.73 in chips) 
Seat 4: lucksuckdonk ($2.16 in chips) 
Seat 5: BARDICHExSIN ($5.18 in chips) 
Seat 6: Scaaalll ($3.51 in chips) 
squidy4: posts small blind $0.01
Wilsonwing1: posts big blind $0.02
*** HOLE CARDS ***
Dealt to Scaaalll [5h As]
squidy4 is disconnected 
lucksuckdonk: folds 
BARDICHExSIN: raises $0.03 to $0.05
Scaaalll: folds 
zergmiky: folds 
squidy4: folds 
Wilsonwing1: raises $1.68 to $1.73 and is all-in
BARDICHExSIN: folds 
Uncalled bet ($1.68) returned to Wilsonwing1
Wilsonwing1 collected $0.11 from pot
Wilsonwing1: doesn't show hand 
BARDICHExSIN is disconnected 
*** SUMMARY ***
Total pot $0.11 | Rake $0 
Seat 1: zergmiky (button) folded before Flop (didn't bet)
Seat 2: squidy4 (small blind) folded before Flop
Seat 3: Wilsonwing1 (big blind) collected ($0.11)
Seat 4: lucksuckdonk folded before Flop (didn't bet)
Seat 5: BARDICHExSIN folded before Flop
Seat 6: Scaaalll folded before Flop (didn't bet)



PokerStars Zoom Hand #229232941321:  Hold'em No Limit ($0.01/$0.02) - 2021/08/21 23:10:56 CET [2021/08/21 17:10:56 ET]
Table 'Halley' 6-max Seat #1 is the button
Seat 1: OFSHOR ($2.50 in chips) 
Seat 2: Scaaalll ($3.51 in chips) 
Seat 3: Apollonnn_13 ($1.64 in chips) 
Seat 4: Knutzers ($2.11 in chips) 
Seat 5: Jellycube ($4.02 in chips) 
Seat 6: Holmie111 ($1.97 in chips) 
Scaaalll: posts small blind $0.01
Apollonnn_13: posts big blind $0.02
*** HOLE CARDS ***
Dealt to Scaaalll [6c 2c]
Knutzers: folds 
Jellycube: folds 
Holmie111: raises $0.02 to $0.04
OFSHOR: folds 
Scaaalll: folds 
Apollonnn_13: calls $0.02
*** FLOP *** [Td Js Jc]
Apollonnn_13: checks 
Holmie111: bets $0.09
Apollonnn_13: folds 
Uncalled bet ($0.09) returned to Holmie111
Holmie111 collected $0.09 from pot
Holmie111: doesn't show hand 
*** SUMMARY ***
Total pot $0.09 | Rake $0 
Board [Td Js Jc]
Seat 1: OFSHOR (button) folded before Flop (didn't bet)
Seat 2: Scaaalll (small blind) folded before Flop
Seat 3: Apollonnn_13 (big blind) folded on the Flop
Seat 4: Knutzers folded before Flop (didn't bet)
Seat 5: Jellycube folded before Flop (didn't bet)
Seat 6: Holmie111 collected ($0.09)



PokerStars Zoom Hand #229232932277:  Hold'em No Limit ($0.01/$0.02) - 2021/08/21 23:10:35 CET [2021/08/21 17:10:35 ET]
Table 'Halley' 6-max Seat #1 is the button
Seat 1: SIGREX ($2.93 in chips) 
Seat 2: leeroy818 ($2.14 in chips) 
Seat 3: AbusiveLion ($1.24 in chips) 
Seat 4: Posaunengodi ($2.30 in chips) 
Seat 5: Scaaalll ($3.53 in chips) 
Seat 6: Busya777 ($2.27 in chips) 
leeroy818: posts small blind $0.01
AbusiveLion: posts big blind $0.02
*** HOLE CARDS ***
Dealt to Scaaalll [7d 2s]
Busya777 is disconnected 
Posaunengodi: raises $0.04 to $0.06
Scaaalll: folds 
Busya777: folds 
SIGREX: folds 
leeroy818: folds 
AbusiveLion: calls $0.04
*** FLOP *** [As 6s 5d]
AbusiveLion: checks 
Posaunengodi: bets $0.09
AbusiveLion: folds 
Uncalled bet ($0.09) returned to Posaunengodi
Posaunengodi collected $0.13 from pot
Posaunengodi: doesn't show hand 
AbusiveLion is disconnected 
*** SUMMARY ***
Total pot $0.13 | Rake $0 
Board [As 6s 5d]
Seat 1: SIGREX (button) folded before Flop (didn't bet)
Seat 2: leeroy818 (small blind) folded before Flop
Seat 3: AbusiveLion (big blind) folded on the Flop
Seat 4: Posaunengodi collected ($0.13)
Seat 5: Scaaalll folded before Flop (didn't bet)
Seat 6: Busya777 folded before Flop (didn't bet)



PokerStars Zoom Hand #229232945033:  Hold'em No Limit ($0.01/$0.02) - 2021/08/21 23:11:04 CET [2021/08/21 17:11:04 ET]
Table 'Halley' 6-max Seat #1 is the button
Seat 1: Scaaalll ($3.50 in chips) 
Seat 2: zergmiky ($2 in chips) 
Seat 3: OmahaWheels ($3.40 in chips) 
Seat 4: PEDACIT0 ($3.32 in chips) 
Seat 5: pavlo8855 ($2.34 in chips) 
Seat 6: kukulagosleep ($2 in chips) 
zergmiky: posts small blind $0.01
OmahaWheels: posts big blind $0.02
*** HOLE CARDS ***
Dealt to Scaaalll [2d Th]
PEDACIT0: folds 
pavlo8855: folds 
kukulagosleep: raises $0.04 to $0.06
Scaaalll: folds 
zergmiky: folds 
OmahaWheels: calls $0.04
*** FLOP *** [4c 5d Ac]
OmahaWheels: checks 
kukulagosleep: bets $0.06
OmahaWheels: calls $0.06
*** TURN *** [4c 5d Ac] [3s]
OmahaWheels: checks 
kukulagosleep: checks 
*** RIVER *** [4c 5d Ac 3s] [9c]
OmahaWheels: checks 
kukulagosleep: checks 
*** SHOW DOWN ***
OmahaWheels: shows [8h Ah] (a pair of Aces)
kukulagosleep: mucks hand 
OmahaWheels collected $0.24 from pot
*** SUMMARY ***
Total pot $0.25 | Rake $0.01 
Board [4c 5d Ac 3s 9c]
Seat 1: Scaaalll (button) folded before Flop (didn't bet)
Seat 2: zergmiky (small blind) folded before Flop
Seat 3: OmahaWheels (big blind) showed [8h Ah] and won ($0.24) with a pair of Aces
Seat 4: PEDACIT0 folded before Flop (didn't bet)
Seat 5: pavlo8855 folded before Flop (didn't bet)
Seat 6: kukulagosleep mucked [6h 6d]



PokerStars Zoom Hand #229232948464:  Hold'em No Limit ($0.01/$0.02) - 2021/08/21 23:11:12 CET [2021/08/21 17:11:12 ET]
Table 'Halley' 6-max Seat #1 is the button
Seat 1: Apollonnn_13 ($1.74 in chips) 
Seat 2: Ramirres ($2.07 in chips) 
Seat 3: RrriotGrrrl ($7.58 in chips) 
Seat 4: TTGemi ($2.39 in chips) 
Seat 5: pipecmolodec ($2.07 in chips) 
Seat 6: Scaaalll ($3.50 in chips) 
Ramirres: posts small blind $0.01
RrriotGrrrl: posts big blind $0.02
*** HOLE CARDS ***
Dealt to Scaaalll [9c 8s]
TTGemi: raises $0.04 to $0.06
pipecmolodec: folds 
Scaaalll: folds 
Apollonnn_13: folds 
Ramirres: folds 
RrriotGrrrl: folds 
Uncalled bet ($0.04) returned to TTGemi
TTGemi collected $0.05 from pot
TTGemi: doesn't show hand 
*** SUMMARY ***
Total pot $0.05 | Rake $0 
Seat 1: Apollonnn_13 (button) folded before Flop (didn't bet)
Seat 2: Ramirres (small blind) folded before Flop
Seat 3: RrriotGrrrl (big blind) folded before Flop
Seat 4: TTGemi collected ($0.05)
Seat 5: pipecmolodec folded before Flop (didn't bet)
Seat 6: Scaaalll folded before Flop (didn't bet)



PokerStars Zoom Hand #229232951048:  Hold'em No Limit ($0.01/$0.02) - 2021/08/21 23:11:18 CET [2021/08/21 17:11:18 ET]
Table 'Halley' 6-max Seat #1 is the button
Seat 1: ivorypiano ($1.07 in chips) 
Seat 2: Leonpy92 ($2.59 in chips) 
Seat 3: Scaaalll ($3.50 in chips) 
Seat 4: Sharabora ($1.88 in chips) 
Seat 5: Jackb9908 ($1.08 in chips) 
Seat 6: h3cTics ($0.88 in chips) 
Leonpy92: posts small blind $0.01
Scaaalll: posts big blind $0.02
*** HOLE CARDS ***
Dealt to Scaaalll [4c Kh]
Sharabora: folds 
Jackb9908: raises $0.03 to $0.05
h3cTics: folds 
ivorypiano: folds 
Leonpy92: folds 
Scaaalll: folds 
Uncalled bet ($0.03) returned to Jackb9908
Jackb9908 collected $0.05 from pot
Jackb9908: doesn't show hand 
*** SUMMARY ***
Total pot $0.05 | Rake $0 
Seat 1: ivorypiano (button) folded before Flop (didn't bet)
Seat 2: Leonpy92 (small blind) folded before Flop
Seat 3: Scaaalll (big blind) folded before Flop
Seat 4: Sharabora folded before Flop (didn't bet)
Seat 5: Jackb9908 collected ($0.05)
Seat 6: h3cTics folded before Flop (didn't bet)



PokerStars Zoom Hand #229232956272:  Hold'em No Limit ($0.01/$0.02) - 2021/08/21 23:11:30 CET [2021/08/21 17:11:30 ET]
Table 'Halley' 6-max Seat #1 is the button
Seat 1: selinus007 ($0.85 in chips) 
Seat 2: NoEff0rt2w1n ($5.67 in chips) 
Seat 3: HubertFroh ($2 in chips) 
Seat 4: Scaaalll ($3.48 in chips) 
Seat 5: Kergie ($15.65 in chips) 
Seat 6: Merlin_Arg ($2 in chips) 
NoEff0rt2w1n: posts small blind $0.01
HubertFroh: posts big blind $0.02
*** HOLE CARDS ***
Dealt to Scaaalll [7c Kd]
Scaaalll: folds 
Kergie: folds 
Merlin_Arg: folds 
selinus007: calls $0.02
NoEff0rt2w1n: folds 
HubertFroh: checks 
*** FLOP *** [7d Kc 9h]
HubertFroh: checks 
selinus007: checks 
*** TURN *** [7d Kc 9h] [Ac]
HubertFroh: checks 
selinus007: bets $0.02
HubertFroh: folds 
Uncalled bet ($0.02) returned to selinus007
selinus007 collected $0.05 from pot
selinus007: doesn't show hand 
*** SUMMARY ***
Total pot $0.05 | Rake $0 
Board [7d Kc 9h Ac]
Seat 1: selinus007 (button) collected ($0.05)
Seat 2: NoEff0rt2w1n (small blind) folded before Flop
Seat 3: HubertFroh (big blind) folded on the Turn
Seat 4: Scaaalll folded before Flop (didn't bet)
Seat 5: Kergie folded before Flop (didn't bet)
Seat 6: Merlin_Arg folded before Flop (didn't bet)



PokerStars Zoom Hand #229232964810:  Hold'em No Limit ($0.01/$0.02) - 2021/08/21 23:11:50 CET [2021/08/21 17:11:50 ET]
Table 'Halley' 6-max Seat #1 is the button
Seat 1: pavlo8855 ($2.01 in chips) 
Seat 2: Craitastrophe ($2 in chips) 
Seat 3: sg.32rus ($0.87 in chips) 
Seat 4: Feliciano16 ($5.03 in chips) 
Seat 5: Scaaalll ($3.47 in chips) 
Seat 6: Tabitaji ($2.83 in chips) 
Craitastrophe: posts small blind $0.01
sg.32rus: posts big blind $0.02
*** HOLE CARDS ***
Dealt to Scaaalll [3d 7c]
Feliciano16: raises $0.02 to $0.04
Scaaalll: folds 
Tabitaji: folds 
pavlo8855: folds 
Craitastrophe: folds 
sg.32rus: folds 
Uncalled bet ($0.02) returned to Feliciano16
Craitastrophe is disconnected 
Feliciano16 collected $0.05 from pot
Feliciano16: doesn't show hand 
*** SUMMARY ***
Total pot $0.05 | Rake $0 
Seat 1: pavlo8855 (button) folded before Flop (didn't bet)
Seat 2: Craitastrophe (small blind) folded before Flop
Seat 3: sg.32rus (big blind) folded before Flop
Seat 4: Feliciano16 collected ($0.05)
Seat 5: Scaaalll folded before Flop (didn't bet)
Seat 6: Tabitaji folded before Flop (didn't bet)



PokerStars Zoom Hand #229232966498:  Hold'em No Limit ($0.01/$0.02) - 2021/08/21 23:11:54 CET [2021/08/21 17:11:54 ET]
Table 'Halley' 6-max Seat #1 is the button
Seat 1: polymorhp ($2.22 in chips) 
Seat 2: WITKOW_AV ($2.67 in chips) 
Seat 3: BIITRU ($2.58 in chips) 
Seat 4: Scaaalll ($3.47 in chips) 
Seat 5: MetalCrüe ($1.98 in chips) 
Seat 6: martinob11 ($1.95 in chips) 
WITKOW_AV: posts small blind $0.01
BIITRU: posts big blind $0.02
*** HOLE CARDS ***
Dealt to Scaaalll [9d 5s]
Scaaalll: folds 
MetalCrüe: folds 
martinob11: folds 
polymorhp: raises $0.04 to $0.06
WITKOW_AV: raises $0.14 to $0.20
BIITRU: folds 
polymorhp: raises $2.02 to $2.22 and is all-in
WITKOW_AV: folds 
Uncalled bet ($2.02) returned to polymorhp
polymorhp collected $0.42 from pot
polymorhp: doesn't show hand 
*** SUMMARY ***
Total pot $0.42 | Rake $0 
Seat 1: polymorhp (button) collected ($0.42)
Seat 2: WITKOW_AV (small blind) folded before Flop
Seat 3: BIITRU (big blind) folded before Flop
Seat 4: Scaaalll folded before Flop (didn't bet)
Seat 5: MetalCrüe folded before Flop (didn't bet)
Seat 6: martinob11 folded before Flop (didn't bet)



PokerStars Zoom Hand #229232960506:  Hold'em No Limit ($0.01/$0.02) - 2021/08/21 23:11:40 CET [2021/08/21 17:11:40 ET]
Table 'Halley' 6-max Seat #1 is the button
Seat 1: 888lifeIS ($2.03 in chips) 
Seat 2: Scaaalll ($3.48 in chips) 
Seat 3: chigilaci ($5.29 in chips) 
Seat 4: Yangyang1407 ($2.34 in chips) 
Seat 5: ctaceo ($2 in chips) 
Seat 6: calybahia27 ($0.27 in chips) 
Scaaalll: posts small blind $0.01
chigilaci: posts big blind $0.02
*** HOLE CARDS ***
Dealt to Scaaalll [5h 4c]
Yangyang1407: folds 
ctaceo: raises $0.03 to $0.05
calybahia27: folds 
888lifeIS: folds 
Scaaalll: folds 
chigilaci: calls $0.03
*** FLOP *** [8c Ts Jh]
chigilaci: checks 
ctaceo: bets $0.06
chigilaci: calls $0.06
*** TURN *** [8c Ts Jh] [3h]
chigilaci: bets $0.11
ctaceo: folds 
Uncalled bet ($0.11) returned to chigilaci
chigilaci collected $0.22 from pot
chigilaci: doesn't show hand 
*** SUMMARY ***
Total pot $0.23 | Rake $0.01 
Board [8c Ts Jh 3h]
Seat 1: 888lifeIS (button) folded before Flop (didn't bet)
Seat 2: Scaaalll (small blind) folded before Flop
Seat 3: chigilaci (big blind) collected ($0.22)
Seat 4: Yangyang1407 folded before Flop (didn't bet)
Seat 5: ctaceo folded on the Turn
Seat 6: calybahia27 folded before Flop (didn't bet)



PokerStars Zoom Hand #229232968195:  Hold'em No Limit ($0.01/$0.02) - 2021/08/21 23:11:58 CET [2021/08/21 17:11:58 ET]
Table 'Halley' 6-max Seat #1 is the button
Seat 1: Scaaalll ($3.47 in chips) 
Seat 2: rotfei02 ($2.26 in chips) 
Seat 3: Apollonnn_13 ($2.26 in chips) 
Seat 4: MetalCrüe ($1.98 in chips) 
Seat 5: new face onl ($2.21 in chips) 
Seat 6: HDYD18 ($2 in chips) 
rotfei02: posts small blind $0.01
Apollonnn_13: posts big blind $0.02
*** HOLE CARDS ***
Dealt to Scaaalll [9s Qc]
MetalCrüe: folds 
new face onl: folds 
HDYD18: raises $0.04 to $0.06
Scaaalll: folds 
rotfei02: folds 
Apollonnn_13: calls $0.04
*** FLOP *** [5s 4h 6d]
Apollonnn_13: checks 
HDYD18: checks 
*** TURN *** [5s 4h 6d] [2d]
Apollonnn_13: bets $0.07
HDYD18: folds 
Uncalled bet ($0.07) returned to Apollonnn_13
Apollonnn_13 collected $0.13 from pot
Apollonnn_13: doesn't show hand 
*** SUMMARY ***
Total pot $0.13 | Rake $0 
Board [5s 4h 6d 2d]
Seat 1: Scaaalll (button) folded before Flop (didn't bet)
Seat 2: rotfei02 (small blind) folded before Flop
Seat 3: Apollonnn_13 (big blind) collected ($0.13)
Seat 4: MetalCrüe folded before Flop (didn't bet)
Seat 5: new face onl folded before Flop (didn't bet)
Seat 6: HDYD18 folded on the Turn



PokerStars Zoom Hand #229232981145:  Hold'em No Limit ($0.01/$0.02) - 2021/08/21 23:12:28 CET [2021/08/21 17:12:28 ET]
Table 'Halley' 6-max Seat #1 is the button
Seat 1: olga3021221 ($2.28 in chips) 
Seat 2: Scaaalll ($3.45 in chips) 
Seat 3: Ck@tih@ ($2.05 in chips) 
Seat 4: Sv1ch ($0.72 in chips) 
Seat 5: kukulagosleep ($3.42 in chips) 
Seat 6: dkno77 ($1.97 in chips) 
Scaaalll: posts small blind $0.01
Ck@tih@: posts big blind $0.02
*** HOLE CARDS ***
Dealt to Scaaalll [8h 6d]
Sv1ch: folds 
kukulagosleep: folds 
dkno77: folds 
olga3021221: folds 
Scaaalll: folds 
Uncalled bet ($0.01) returned to Ck@tih@
Ck@tih@ collected $0.02 from pot
Ck@tih@: doesn't show hand 
*** SUMMARY ***
Total pot $0.02 | Rake $0 
Seat 1: olga3021221 (button) folded before Flop (didn't bet)
Seat 2: Scaaalll (small blind) folded before Flop
Seat 3: Ck@tih@ (big blind) collected ($0.02)
Seat 4: Sv1ch folded before Flop (didn't bet)
Seat 5: kukulagosleep folded before Flop (didn't bet)
Seat 6: dkno77 folded before Flop (didn't bet)



PokerStars Zoom Hand #229232972963:  Hold'em No Limit ($0.01/$0.02) - 2021/08/21 23:12:09 CET [2021/08/21 17:12:09 ET]
Table 'Halley' 6-max Seat #1 is the button
Seat 1: igara tigara ($3.34 in chips) 
Seat 2: AlexGTPS ($5.36 in chips) 
Seat 3: Scaaalll ($3.47 in chips) 
Seat 4: dryan04 ($1.15 in chips) 
Seat 5: 9 All Inn 9 ($2.07 in chips) 
Seat 6: PEDACIT0 ($3.32 in chips) 
AlexGTPS: posts small blind $0.01
Scaaalll: posts big blind $0.02
*** HOLE CARDS ***
Dealt to Scaaalll [Jh 5s]
dryan04: folds 
dryan04 is disconnected 
9 All Inn 9: folds 
PEDACIT0: raises $0.04 to $0.06
igara tigara: raises $0.12 to $0.18
AlexGTPS: folds 
Scaaalll: folds 
PEDACIT0: calls $0.12
*** FLOP *** [2h 7d 3c]
PEDACIT0: checks 
igara tigara: bets $0.13
PEDACIT0: calls $0.13
*** TURN *** [2h 7d 3c] [7c]
PEDACIT0: checks 
igara tigara: checks 
*** RIVER *** [2h 7d 3c 7c] [As]
PEDACIT0: bets $0.18
igara tigara: raises $0.50 to $0.68
PEDACIT0: folds 
Uncalled bet ($0.50) returned to igara tigara
igara tigara collected $0.97 from pot
igara tigara: doesn't show hand 
*** SUMMARY ***
Total pot $1.01 | Rake $0.04 
Board [2h 7d 3c 7c As]
Seat 1: igara tigara (button) collected ($0.97)
Seat 2: AlexGTPS (small blind) folded before Flop
Seat 3: Scaaalll (big blind) folded before Flop
Seat 4: dryan04 folded before Flop (didn't bet)
Seat 5: 9 All Inn 9 folded before Flop (didn't bet)
Seat 6: PEDACIT0 folded on the River



PokerStars Zoom Hand #229232987195:  Hold'em No Limit ($0.01/$0.02) - 2021/08/21 23:12:42 CET [2021/08/21 17:12:42 ET]
Table 'Halley' 6-max Seat #1 is the button
Seat 1: ISBman ($2.93 in chips) 
Seat 2: RaulacateFolds ($2.13 in chips) 
Seat 3: didiclavi777 ($2.13 in chips) 
Seat 4: zergmiky ($2.10 in chips) 
Seat 5: Canoinhas37 ($6.82 in chips) 
Seat 6: Scaaalll ($3.44 in chips) 
RaulacateFolds: posts small blind $0.01
didiclavi777: posts big blind $0.02
*** HOLE CARDS ***
Dealt to Scaaalll [Js 5c]
zergmiky: folds 
Canoinhas37: raises $0.02 to $0.04
Scaaalll: folds 
ISBman: folds 
RaulacateFolds: folds 
didiclavi777: calls $0.02
*** FLOP *** [3h 4c 4h]
didiclavi777: checks 
Canoinhas37: checks 
*** TURN *** [3h 4c 4h] [2c]
didiclavi777: checks 
Canoinhas37: checks 
*** RIVER *** [3h 4c 4h 2c] [Kc]
didiclavi777: checks 
Canoinhas37: bets $0.05
didiclavi777: folds 
Uncalled bet ($0.05) returned to Canoinhas37
Canoinhas37 collected $0.09 from pot
Canoinhas37: doesn't show hand 
*** SUMMARY ***
Total pot $0.09 | Rake $0 
Board [3h 4c 4h 2c Kc]
Seat 1: ISBman (button) folded before Flop (didn't bet)
Seat 2: RaulacateFolds (small blind) folded before Flop
Seat 3: didiclavi777 (big blind) folded on the River
Seat 4: zergmiky folded before Flop (didn't bet)
Seat 5: Canoinhas37 collected ($0.09)
Seat 6: Scaaalll folded before Flop (didn't bet)



PokerStars Zoom Hand #229232969926:  Hold'em No Limit ($0.01/$0.02) - 2021/08/21 23:12:02 CET [2021/08/21 17:12:02 ET]
Table 'Halley' 6-max Seat #1 is the button
Seat 1: Espartacus5222 ($4.28 in chips) 
Seat 2: Knutzers ($2.05 in chips) 
Seat 3: cr@sh test ($2.41 in chips) 
Seat 4: johnpa89 ($2.65 in chips) 
Seat 5: YGrandmaster ($3.14 in chips) 
Seat 6: Scaaalll ($3.47 in chips) 
Knutzers: posts small blind $0.01
cr@sh test: posts big blind $0.02
*** HOLE CARDS ***
Dealt to Scaaalll [5s 8s]
johnpa89: folds 
YGrandmaster: folds 
YGrandmaster is disconnected 
Scaaalll: folds 
Espartacus5222: folds 
Knutzers: raises $0.02 to $0.04
cr@sh test: raises $0.02 to $0.06
Knutzers: calls $0.02
*** FLOP *** [Ad 4d 6c]
Knutzers: checks 
cr@sh test: bets $0.08
Knutzers: raises $0.15 to $0.23
cr@sh test: calls $0.15
*** TURN *** [Ad 4d 6c] [3c]
Knutzers: bets $0.30
cr@sh test: calls $0.30
*** RIVER *** [Ad 4d 6c 3c] [Ac]
Knutzers: bets $1.46 and is all-in
cr@sh test: folds 
Uncalled bet ($1.46) returned to Knutzers
Knutzers collected $1.14 from pot
Knutzers: doesn't show hand 
*** SUMMARY ***
Total pot $1.18 | Rake $0.04 
Board [Ad 4d 6c 3c Ac]
Seat 1: Espartacus5222 (button) folded before Flop (didn't bet)
Seat 2: Knutzers (small blind) collected ($1.14)
Seat 3: cr@sh test (big blind) folded on the River
Seat 4: johnpa89 folded before Flop (didn't bet)
Seat 5: YGrandmaster folded before Flop (didn't bet)
Seat 6: Scaaalll folded before Flop (didn't bet)



PokerStars Zoom Hand #229232992766:  Hold'em No Limit ($0.01/$0.02) - 2021/08/21 23:12:55 CET [2021/08/21 17:12:55 ET]
Table 'Halley' 6-max Seat #1 is the button
Seat 1: Scaaalll ($3.44 in chips) 
Seat 2: pipecmolodec ($2.07 in chips) 
Seat 3: Reipinguimm ($2 in chips) 
Seat 4: bananAAbandit ($2.73 in chips) 
Seat 5: BriceDo1917 ($3.93 in chips) 
Seat 6: Roachy 92 ($3.24 in chips) 
pipecmolodec: posts small blind $0.01
Reipinguimm: posts big blind $0.02
*** HOLE CARDS ***
Dealt to Scaaalll [2s Qc]
bananAAbandit: raises $0.04 to $0.06
BriceDo1917: folds 
Roachy 92: folds 
BriceDo1917 is disconnected 
Scaaalll: folds 
pipecmolodec: folds 
Reipinguimm: folds 
Uncalled bet ($0.04) returned to bananAAbandit
bananAAbandit collected $0.05 from pot
bananAAbandit: doesn't show hand 
*** SUMMARY ***
Total pot $0.05 | Rake $0 
Seat 1: Scaaalll (button) folded before Flop (didn't bet)
Seat 2: pipecmolodec (small blind) folded before Flop
Seat 3: Reipinguimm (big blind) folded before Flop
Seat 4: bananAAbandit collected ($0.05)
Seat 5: BriceDo1917 folded before Flop (didn't bet)
Seat 6: Roachy 92 folded before Flop (didn't bet)



PokerStars Zoom Hand #229233000947:  Hold'em No Limit ($0.01/$0.02) - 2021/08/21 23:13:14 CET [2021/08/21 17:13:14 ET]
Table 'Halley' 6-max Seat #1 is the button
Seat 1: maliniak75 ($2.40 in chips) 
Seat 2: Scaaalll ($3.44 in chips) 
Seat 3: GrindToGlory ($4.15 in chips) 
Seat 4: MKIronCrAAzy ($3.47 in chips) 
Seat 5: SIGREX ($3.18 in chips) 
Seat 6: HDYD18 ($5.27 in chips) 
Scaaalll: posts small blind $0.01
GrindToGlory: posts big blind $0.02
*** HOLE CARDS ***
Dealt to Scaaalll [8d 2h]
MKIronCrAAzy: folds 
SIGREX: folds 
HDYD18: folds 
maliniak75: folds 
Scaaalll: folds 
Uncalled bet ($0.01) returned to GrindToGlory
GrindToGlory collected $0.02 from pot
GrindToGlory: doesn't show hand 
*** SUMMARY ***
Total pot $0.02 | Rake $0 
Seat 1: maliniak75 (button) folded before Flop (didn't bet)
Seat 2: Scaaalll (small blind) folded before Flop
Seat 3: GrindToGlory (big blind) collected ($0.02)
Seat 4: MKIronCrAAzy folded before Flop (didn't bet)
Seat 5: SIGREX folded before Flop (didn't bet)
Seat 6: HDYD18 folded before Flop (didn't bet)



PokerStars Zoom Hand #229232991039:  Hold'em No Limit ($0.01/$0.02) - 2021/08/21 23:12:51 CET [2021/08/21 17:12:51 ET]
Table 'Halley' 6-max Seat #1 is the button
Seat 1: Bluff2WlN ($5.93 in chips) 
Seat 2: pavlo8855 ($2.12 in chips) 
Seat 3: Mana27 ($1.06 in chips) 
Seat 4: gasmar_29 ($2.14 in chips) 
Seat 5: Scaaalll ($3.44 in chips) 
Seat 6: PapiMik3 ($3.22 in chips) 
pavlo8855: posts small blind $0.01
Mana27: posts big blind $0.02
*** HOLE CARDS ***
Dealt to Scaaalll [5h Kc]
gasmar_29: folds 
Scaaalll: folds 
PapiMik3: raises $0.04 to $0.06
Bluff2WlN: folds 
pavlo8855: raises $0.14 to $0.20
Mana27: folds 
PapiMik3: calls $0.14
*** FLOP *** [2h 7s 4c]
pavlo8855: bets $0.21
PapiMik3: calls $0.21
*** TURN *** [2h 7s 4c] [6s]
pavlo8855: checks 
PapiMik3: checks 
*** RIVER *** [2h 7s 4c 6s] [2c]
pavlo8855: checks 
PapiMik3: bets $0.70
pavlo8855: folds 
Uncalled bet ($0.70) returned to PapiMik3
PapiMik3 collected $0.81 from pot
PapiMik3: doesn't show hand 
*** SUMMARY ***
Total pot $0.84 | Rake $0.03 
Board [2h 7s 4c 6s 2c]
Seat 1: Bluff2WlN (button) folded before Flop (didn't bet)
Seat 2: pavlo8855 (small blind) folded on the River
Seat 3: Mana27 (big blind) folded before Flop
Seat 4: gasmar_29 folded before Flop (didn't bet)
Seat 5: Scaaalll folded before Flop (didn't bet)
Seat 6: PapiMik3 collected ($0.81)



PokerStars Zoom Hand #229233097588:  Hold'em No Limit ($0.01/$0.02) - 2021/08/21 23:16:59 CET [2021/08/21 17:16:59 ET]
Table 'Halley' 6-max Seat #1 is the button
Seat 1: maliniak75 ($1.36 in chips) 
Seat 2: Sinad1302 ($2.47 in chips) 
Seat 3: Scaaalll ($3.43 in chips) 
Seat 4: CAMBA.bo ($1.79 in chips) 
Seat 5: MarselTop ($4.92 in chips) 
Seat 6: Xpokerfreak ($1.99 in chips) 
Sinad1302: posts small blind $0.01
Scaaalll: posts big blind $0.02
*** HOLE CARDS ***
Dealt to Scaaalll [Jc 6d]
MarselTop is disconnected 
Sinad1302 is disconnected 
CAMBA.bo: folds 
MarselTop: folds 
Xpokerfreak: folds 
maliniak75: calls $0.02
Sinad1302: folds 
Scaaalll: checks 
*** FLOP *** [Jh Qc Qs]
Scaaalll: checks 
maliniak75: checks 
*** TURN *** [Jh Qc Qs] [7c]
Scaaalll: bets $0.04
maliniak75: folds 
Uncalled bet ($0.04) returned to Scaaalll
Scaaalll collected $0.05 from pot
Scaaalll: doesn't show hand 
*** SUMMARY ***
Total pot $0.05 | Rake $0 
Board [Jh Qc Qs 7c]
Seat 1: maliniak75 (button) folded on the Turn
Seat 2: Sinad1302 (small blind) folded before Flop
Seat 3: Scaaalll (big blind) collected ($0.05)
Seat 4: CAMBA.bo folded before Flop (didn't bet)
Seat 5: MarselTop folded before Flop (didn't bet)
Seat 6: Xpokerfreak folded before Flop (didn't bet)



PokerStars Zoom Hand #229233111763:  Hold'em No Limit ($0.01/$0.02) - 2021/08/21 23:17:32 CET [2021/08/21 17:17:32 ET]
Table 'Halley' 6-max Seat #1 is the button
Seat 1: amario89 ($2.21 in chips) 
Seat 2: Scaaalll ($3.46 in chips) 
Seat 3: ctaceo ($2.07 in chips) 
Seat 4: sg.32rus ($1.13 in chips) 
Seat 5: jaamonra ($2.10 in chips) 
Seat 6: Gamer577 ($8.52 in chips) 
Scaaalll: posts small blind $0.01
ctaceo: posts big blind $0.02
*** HOLE CARDS ***
Dealt to Scaaalll [8s 8c]
sg.32rus: calls $0.02
jaamonra: raises $0.08 to $0.10
Gamer577: folds 
amario89: folds 
Scaaalll: calls $0.09
ctaceo: folds 
sg.32rus: folds 
*** FLOP *** [Ad Ks 8d]
Scaaalll: checks 
jaamonra: checks 
*** TURN *** [Ad Ks 8d] [Jc]
Scaaalll: bets $0.15
jaamonra: folds 
Uncalled bet ($0.15) returned to Scaaalll
Scaaalll collected $0.23 from pot
Scaaalll: doesn't show hand 
*** SUMMARY ***
Total pot $0.24 | Rake $0.01 
Board [Ad Ks 8d Jc]
Seat 1: amario89 (button) folded before Flop (didn't bet)
Seat 2: Scaaalll (small blind) collected ($0.23)
Seat 3: ctaceo (big blind) folded before Flop
Seat 4: sg.32rus folded before Flop
Seat 5: jaamonra folded on the Turn
Seat 6: Gamer577 folded before Flop (didn't bet)



PokerStars Zoom Hand #229233131210:  Hold'em No Limit ($0.01/$0.02) - 2021/08/21 23:18:18 CET [2021/08/21 17:18:18 ET]
Table 'Halley' 6-max Seat #1 is the button
Seat 1: Scaaalll ($3.59 in chips) 
Seat 2: owtwilldo ($2 in chips) 
Seat 3: dansemmens1 ($1.28 in chips) 
Seat 4: cr@sh test ($4.80 in chips) 
Seat 5: vovan100157 ($2.42 in chips) 
Seat 6: Stillmare ($0.89 in chips) 
owtwilldo: posts small blind $0.01
dansemmens1: posts big blind $0.02
*** HOLE CARDS ***
Dealt to Scaaalll [Jd Kd]
cr@sh test: folds 
Stillmare is disconnected 
vovan100157: folds 
Stillmare: folds 
Scaaalll: raises $0.03 to $0.05
owtwilldo: folds 
dansemmens1: folds 
Uncalled bet ($0.03) returned to Scaaalll
Scaaalll collected $0.05 from pot
Scaaalll: doesn't show hand 
*** SUMMARY ***
Total pot $0.05 | Rake $0 
Seat 1: Scaaalll (button) collected ($0.05)
Seat 2: owtwilldo (small blind) folded before Flop
Seat 3: dansemmens1 (big blind) folded before Flop
Seat 4: cr@sh test folded before Flop (didn't bet)
Seat 5: vovan100157 folded before Flop (didn't bet)
Seat 6: Stillmare folded before Flop (didn't bet)



PokerStars Zoom Hand #229233137073:  Hold'em No Limit ($0.01/$0.02) - 2021/08/21 23:18:32 CET [2021/08/21 17:18:32 ET]
Table 'Halley' 6-max Seat #1 is the button
Seat 1: so0love ($2.16 in chips) 
Seat 2: blubfishi Òó ($1.98 in chips) 
Seat 3: Boris_Garich ($3.78 in chips) 
Seat 4: KonopDima ($2.10 in chips) 
Seat 5: Posaunengodi ($2.58 in chips) 
Seat 6: Scaaalll ($3.62 in chips) 
blubfishi Òó: posts small blind $0.01
Boris_Garich: posts big blind $0.02
*** HOLE CARDS ***
Dealt to Scaaalll [Ah Th]
KonopDima: folds 
Posaunengodi: folds 
Scaaalll: raises $0.04 to $0.06
so0love: raises $0.15 to $0.21
blubfishi Òó: folds 
Boris_Garich: folds 
Scaaalll: folds 
Uncalled bet ($0.15) returned to so0love
so0love collected $0.15 from pot
so0love: doesn't show hand 
*** SUMMARY ***
Total pot $0.15 | Rake $0 
Seat 1: so0love (button) collected ($0.15)
Seat 2: blubfishi Òó (small blind) folded before Flop
Seat 3: Boris_Garich (big blind) folded before Flop
Seat 4: KonopDima folded before Flop (didn't bet)
Seat 5: Posaunengodi folded before Flop (didn't bet)
Seat 6: Scaaalll folded before Flop



PokerStars Zoom Hand #229233170061:  Hold'em No Limit ($0.01/$0.02) - 2021/08/21 23:19:40 CET [2021/08/21 17:19:40 ET]
Table 'Halley' 6-max Seat #1 is the button
Seat 1: juraa14 ($1.42 in chips) 
Seat 2: SIGREX ($2.61 in chips) 
Seat 3: Thaleshs ($4.12 in chips) 
Seat 4: Koldun 2636 ($2.89 in chips) 
Seat 5: Scaaalll ($3.52 in chips) 
Seat 6: F_oksi(BLR) ($4.98 in chips) 
SIGREX: posts small blind $0.01
Thaleshs: posts big blind $0.02
*** HOLE CARDS ***
Dealt to Scaaalll [As Qd]
Koldun 2636: folds 
Scaaalll: raises $0.03 to $0.05
F_oksi(BLR): folds 
juraa14: folds 
SIGREX: folds 
Thaleshs: folds 
Uncalled bet ($0.03) returned to Scaaalll
Scaaalll collected $0.05 from pot
Scaaalll: doesn't show hand 
*** SUMMARY ***
Total pot $0.05 | Rake $0 
Seat 1: juraa14 (button) folded before Flop (didn't bet)
Seat 2: SIGREX (small blind) folded before Flop
Seat 3: Thaleshs (big blind) folded before Flop
Seat 4: Koldun 2636 folded before Flop (didn't bet)
Seat 5: Scaaalll collected ($0.05)
Seat 6: F_oksi(BLR) folded before Flop (didn't bet)



PokerStars Zoom Hand #229233150928:  Hold'em No Limit ($0.01/$0.02) - 2021/08/21 23:18:55 CET [2021/08/21 17:18:55 ET]
Table 'Halley' 6-max Seat #1 is the button
Seat 1: MattieBOZ ($1.82 in chips) 
Seat 2: ivorypiano ($3.86 in chips) 
Seat 3: dansemmens1 ($1.25 in chips) 
Seat 4: estelionat171 ($0.67 in chips) 
Seat 5: Scaaalll ($3.56 in chips) 
Seat 6: Vahenta ($2.36 in chips) 
ivorypiano: posts small blind $0.01
dansemmens1: posts big blind $0.02
*** HOLE CARDS ***
Dealt to Scaaalll [As 8h]
Vahenta is disconnected 
estelionat171: folds 
Scaaalll: folds 
Vahenta: folds 
MattieBOZ: raises $0.04 to $0.06
ivorypiano: folds 
dansemmens1: calls $0.04
*** FLOP *** [5s 9s 8d]
dansemmens1: checks 
MattieBOZ: bets $0.06
dansemmens1: raises $0.13 to $0.19
MattieBOZ: calls $0.13
*** TURN *** [5s 9s 8d] [5c]
dansemmens1: bets $0.33
MattieBOZ: raises $1.24 to $1.57 and is all-in
dansemmens1: calls $0.67 and is all-in
Uncalled bet ($0.57) returned to MattieBOZ
*** RIVER *** [5s 9s 8d 5c] [9d]
*** SHOW DOWN ***
dansemmens1: shows [Td Jh] (two pair, Nines and Fives)
MattieBOZ: shows [6c 7c] (a straight, Five to Nine)
MattieBOZ collected $2.42 from pot
*** SUMMARY ***
Total pot $2.51 | Rake $0.09 
Board [5s 9s 8d 5c 9d]
Seat 1: MattieBOZ (button) showed [6c 7c] and won ($2.42) with a straight, Five to Nine
Seat 2: ivorypiano (small blind) folded before Flop
Seat 3: dansemmens1 (big blind) showed [Td Jh] and lost with two pair, Nines and Fives
Seat 4: estelionat171 folded before Flop (didn't bet)
Seat 5: Scaaalll folded before Flop (didn't bet)
Seat 6: Vahenta folded before Flop (didn't bet)



PokerStars Zoom Hand #229233160631:  Hold'em No Limit ($0.01/$0.02) - 2021/08/21 23:19:18 CET [2021/08/21 17:19:18 ET]
Table 'Halley' 6-max Seat #1 is the button
Seat 1: Yangyang1407 ($2.03 in chips) 
Seat 2: Scaaalll ($3.54 in chips) 
Seat 3: Apollonnn_13 ($1.45 in chips) 
Seat 4: HDYD18 ($5.02 in chips) 
Seat 5: ctaceo ($2.03 in chips) 
Seat 6: maliniak75 ($1.38 in chips) 
Scaaalll: posts small blind $0.01
Apollonnn_13: posts big blind $0.02
*** HOLE CARDS ***
Dealt to Scaaalll [8c Tc]
HDYD18: folds 
ctaceo: folds 
maliniak75: calls $0.02
Yangyang1407: folds 
Scaaalll: calls $0.01
Apollonnn_13: raises $0.10 to $0.12
maliniak75: raises $1.26 to $1.38 and is all-in
Scaaalll: folds 
Apollonnn_13: calls $1.26
*** FLOP *** [2s Kc 2d]
*** TURN *** [2s Kc 2d] [4h]
*** RIVER *** [2s Kc 2d 4h] [Jd]
*** SHOW DOWN ***
Apollonnn_13: shows [Ks Ac] (two pair, Kings and Deuces)
maliniak75: shows [Ad As] (two pair, Aces and Deuces)
Apollonnn_13 cashed out the hand for $0.18
maliniak75 cashed out the hand for $2.48 | Cash Out Fee $0.02
*** SUMMARY ***
Total pot $2.78 | Rake $0.10 
Board [2s Kc 2d 4h Jd]
Seat 1: Yangyang1407 (button) folded before Flop (didn't bet)
Seat 2: Scaaalll (small blind) folded before Flop
Seat 3: Apollonnn_13 (big blind) showed [Ks Ac] and lost with two pair, Kings and Deuces (cashed out).
Seat 4: HDYD18 folded before Flop (didn't bet)
Seat 5: ctaceo folded before Flop (didn't bet)
Seat 6: maliniak75 showed [Ad As] and won ($2.68) with two pair, Aces and Deuces (pot not awarded as player cashed out)



PokerStars Zoom Hand #229233175531:  Hold'em No Limit ($0.01/$0.02) - 2021/08/21 23:19:53 CET [2021/08/21 17:19:53 ET]
Table 'Halley' 6-max Seat #1 is the button
Seat 1: Scaaalll ($3.55 in chips) 
Seat 2: cr@sh test ($4.78 in chips) 
Seat 3: Umnik_M ($2.46 in chips) 
Seat 4: Pulp Hands ($1.89 in chips) 
Seat 5: RrriotGrrrl ($4.72 in chips) 
Seat 6: zergmiky ($2.08 in chips) 
cr@sh test: posts small blind $0.01
Umnik_M: posts big blind $0.02
*** HOLE CARDS ***
Dealt to Scaaalll [8s 6s]
Pulp Hands: calls $0.02
RrriotGrrrl: folds 
zergmiky: folds 
Scaaalll: folds 
cr@sh test: raises $0.02 to $0.04
Umnik_M: folds 
Pulp Hands: folds 
Uncalled bet ($0.02) returned to cr@sh test
cr@sh test collected $0.06 from pot
cr@sh test: doesn't show hand 
*** SUMMARY ***
Total pot $0.06 | Rake $0 
Seat 1: Scaaalll (button) folded before Flop (didn't bet)
Seat 2: cr@sh test (small blind) collected ($0.06)
Seat 3: Umnik_M (big blind) folded before Flop
Seat 4: Pulp Hands folded before Flop
Seat 5: RrriotGrrrl folded before Flop (didn't bet)
Seat 6: zergmiky folded before Flop (didn't bet)



PokerStars Zoom Hand #229233155601:  Hold'em No Limit ($0.01/$0.02) - 2021/08/21 23:19:06 CET [2021/08/21 17:19:06 ET]
Table 'Halley' 6-max Seat #1 is the button
Seat 1: lukito222 ($2.25 in chips) 
Seat 2: AtZ3899 ($2.78 in chips) 
Seat 3: Scaaalll ($3.56 in chips) 
Seat 4: Zigsol ($0.72 in chips) 
Seat 5: Feyqdoi ($2 in chips) 
Seat 6: le_vlimeux ($2.06 in chips) 
AtZ3899: posts small blind $0.01
Scaaalll: posts big blind $0.02
*** HOLE CARDS ***
Dealt to Scaaalll [6s 4d]
Zigsol: folds 
Zigsol is disconnected 
Feyqdoi: folds 
le_vlimeux: raises $0.02 to $0.04
lukito222: calls $0.04
AtZ3899: folds 
Scaaalll: folds 
*** FLOP *** [2h 8c Qh]
le_vlimeux: bets $0.07
lukito222: calls $0.07
*** TURN *** [2h 8c Qh] [Jd]
le_vlimeux: checks 
lukito222: bets $0.06
le_vlimeux: raises $0.10 to $0.16
lukito222: raises $0.10 to $0.26
le_vlimeux: calls $0.10
*** RIVER *** [2h 8c Qh Jd] [4h]
le_vlimeux: bets $1.69 and is all-in
lukito222: calls $1.69
*** SHOW DOWN ***
le_vlimeux: shows [Js Tc] (a pair of Jacks)
lukito222: shows [Th 9s] (a straight, Eight to Queen)
lukito222 collected $4 from pot
*** SUMMARY ***
Total pot $4.15 | Rake $0.15 
Board [2h 8c Qh Jd 4h]
Seat 1: lukito222 (button) showed [Th 9s] and won ($4) with a straight, Eight to Queen
Seat 2: AtZ3899 (small blind) folded before Flop
Seat 3: Scaaalll (big blind) folded before Flop
Seat 4: Zigsol folded before Flop (didn't bet)
Seat 5: Feyqdoi folded before Flop (didn't bet)
Seat 6: le_vlimeux showed [Js Tc] and lost with a pair of Jacks



PokerStars Zoom Hand #229233179022:  Hold'em No Limit ($0.01/$0.02) - 2021/08/21 23:20:01 CET [2021/08/21 17:20:01 ET]
Table 'Halley' 6-max Seat #1 is the button
Seat 1: Ck@tih@ ($3.55 in chips) 
Seat 2: juelz_ua ($1.43 in chips) 
Seat 3: Scaaalll ($3.55 in chips) 
Seat 4: WaiT4U ($2.01 in chips) 
Seat 5: Carlos_glaza ($2.01 in chips) 
Seat 6: KonopDima ($2 in chips) 
juelz_ua: posts small blind $0.01
Scaaalll: posts big blind $0.02
*** HOLE CARDS ***
Dealt to Scaaalll [6s 4d]
WaiT4U: folds 
Carlos_glaza: folds 
KonopDima: folds 
Ck@tih@ has timed out
Ck@tih@: folds 
juelz_ua: raises $0.04 to $0.06
Scaaalll: folds 
Uncalled bet ($0.04) returned to juelz_ua
juelz_ua collected $0.04 from pot
juelz_ua: doesn't show hand 
*** SUMMARY ***
Total pot $0.04 | Rake $0 
Seat 1: Ck@tih@ (button) folded before Flop (didn't bet)
Seat 2: juelz_ua (small blind) collected ($0.04)
Seat 3: Scaaalll (big blind) folded before Flop
Seat 4: WaiT4U folded before Flop (didn't bet)
Seat 5: Carlos_glaza folded before Flop (didn't bet)
Seat 6: KonopDima folded before Flop (didn't bet)



PokerStars Zoom Hand #229233188798:  Hold'em No Limit ($0.01/$0.02) - 2021/08/21 23:20:24 CET [2021/08/21 17:20:24 ET]
Table 'Halley' 6-max Seat #1 is the button
Seat 1: Scaaalll ($3.53 in chips) 
Seat 2: Ne0net ($7.89 in chips) 
Seat 3: GVMELLO ($2.34 in chips) 
Seat 4: Alspexyranos ($2.09 in chips) 
Seat 5: ctaceo ($2.07 in chips) 
Seat 6: pavlo8855 ($2.06 in chips) 
Ne0net: posts small blind $0.01
GVMELLO: posts big blind $0.02
*** HOLE CARDS ***
Dealt to Scaaalll [Jc 4d]
Alspexyranos: folds 
ctaceo: folds 
pavlo8855: folds 
Scaaalll: folds 
Ne0net: folds 
Uncalled bet ($0.01) returned to GVMELLO
GVMELLO collected $0.02 from pot
GVMELLO: doesn't show hand 
*** SUMMARY ***
Total pot $0.02 | Rake $0 
Seat 1: Scaaalll (button) folded before Flop (didn't bet)
Seat 2: Ne0net (small blind) folded before Flop
Seat 3: GVMELLO (big blind) collected ($0.02)
Seat 4: Alspexyranos folded before Flop (didn't bet)
Seat 5: ctaceo folded before Flop (didn't bet)
Seat 6: pavlo8855 folded before Flop (didn't bet)



PokerStars Zoom Hand #229233191738:  Hold'em No Limit ($0.01/$0.02) - 2021/08/21 23:20:31 CET [2021/08/21 17:20:31 ET]
Table 'Halley' 6-max Seat #1 is the button
Seat 1: ibstah ($0.78 in chips) 
Seat 2: SIGREX ($2 in chips) 
Seat 3: lukito222 ($2 in chips) 
Seat 4: Xpokerfreak ($2.11 in chips) 
Seat 5: levachok ($5.20 in chips) 
Seat 6: Scaaalll ($3.53 in chips) 
SIGREX: posts small blind $0.01
lukito222: posts big blind $0.02
*** HOLE CARDS ***
Dealt to Scaaalll [Ah 9d]
Xpokerfreak: calls $0.02
levachok: folds 
Scaaalll: folds 
ibstah: folds 
SIGREX: folds 
lukito222: checks 
*** FLOP *** [Kc 8h 2s]
lukito222: checks 
Xpokerfreak: checks 
*** TURN *** [Kc 8h 2s] [Kh]
lukito222: checks 
Xpokerfreak: checks 
*** RIVER *** [Kc 8h 2s Kh] [5d]
lukito222: bets $0.06
Xpokerfreak: folds 
Uncalled bet ($0.06) returned to lukito222
lukito222 collected $0.05 from pot
lukito222: doesn't show hand 
*** SUMMARY ***
Total pot $0.05 | Rake $0 
Board [Kc 8h 2s Kh 5d]
Seat 1: ibstah (button) folded before Flop (didn't bet)
Seat 2: SIGREX (small blind) folded before Flop
Seat 3: lukito222 (big blind) collected ($0.05)
Seat 4: Xpokerfreak folded on the River
Seat 5: levachok folded before Flop (didn't bet)
Seat 6: Scaaalll folded before Flop (didn't bet)



PokerStars Zoom Hand #229233194702:  Hold'em No Limit ($0.01/$0.02) - 2021/08/21 23:20:38 CET [2021/08/21 17:20:38 ET]
Table 'Halley' 6-max Seat #1 is the button
Seat 1: Meskalita ($2.90 in chips) 
Seat 2: Scaaalll ($3.53 in chips) 
Seat 3: fishh_play ($2.37 in chips) 
Seat 4: ASAjr ($2.31 in chips) 
Seat 5: babiloniaxxx ($2.73 in chips) 
Seat 6: pavlo8855 ($2.03 in chips) 
Scaaalll: posts small blind $0.01
fishh_play: posts big blind $0.02
*** HOLE CARDS ***
Dealt to Scaaalll [5d 2c]
ASAjr: folds 
babiloniaxxx: raises $0.03 to $0.05
pavlo8855: folds 
Meskalita: folds 
Scaaalll: folds 
fishh_play: folds 
Uncalled bet ($0.03) returned to babiloniaxxx
babiloniaxxx collected $0.05 from pot
babiloniaxxx: doesn't show hand 
*** SUMMARY ***
Total pot $0.05 | Rake $0 
Seat 1: Meskalita (button) folded before Flop (didn't bet)
Seat 2: Scaaalll (small blind) folded before Flop
Seat 3: fishh_play (big blind) folded before Flop
Seat 4: ASAjr folded before Flop (didn't bet)
Seat 5: babiloniaxxx collected ($0.05)
Seat 6: pavlo8855 folded before Flop (didn't bet)



PokerStars Zoom Hand #229233204033:  Hold'em No Limit ($0.01/$0.02) - 2021/08/21 23:21:00 CET [2021/08/21 17:21:00 ET]
Table 'Halley' 6-max Seat #1 is the button
Seat 1: alkraf ($2.03 in chips) 
Seat 2: djovex ($2.32 in chips) 
Seat 3: Xlavariable ($2.48 in chips) 
Seat 4: Koldun 2636 ($3.37 in chips) 
Seat 5: Scaaalll ($3.52 in chips) 
Seat 6: Doktor Yes ($2.79 in chips) 
djovex: posts small blind $0.01
Xlavariable: posts big blind $0.02
*** HOLE CARDS ***
Dealt to Scaaalll [6d Qh]
Koldun 2636: folds 
djovex is disconnected 
Scaaalll: folds 
Doktor Yes: folds 
alkraf: raises $0.04 to $0.06
djovex: folds 
Xlavariable: folds 
Uncalled bet ($0.04) returned to alkraf
alkraf collected $0.05 from pot
alkraf: doesn't show hand 
*** SUMMARY ***
Total pot $0.05 | Rake $0 
Seat 1: alkraf (button) collected ($0.05)
Seat 2: djovex (small blind) folded before Flop
Seat 3: Xlavariable (big blind) folded before Flop
Seat 4: Koldun 2636 folded before Flop (didn't bet)
Seat 5: Scaaalll folded before Flop (didn't bet)
Seat 6: Doktor Yes folded before Flop (didn't bet)



PokerStars Zoom Hand #229233207818:  Hold'em No Limit ($0.01/$0.02) - 2021/08/21 23:21:09 CET [2021/08/21 17:21:09 ET]
Table 'Halley' 6-max Seat #1 is the button
Seat 1: Yangyang1407 ($2.47 in chips) 
Seat 2: KonopDima ($2.28 in chips) 
Seat 3: zergmiky ($2 in chips) 
Seat 4: rooGL ($1.15 in chips) 
Seat 5: causavera ($0.92 in chips) 
Seat 6: Scaaalll ($3.52 in chips) 
KonopDima: posts small blind $0.01
zergmiky: posts big blind $0.02
*** HOLE CARDS ***
Dealt to Scaaalll [7d 9c]
rooGL: raises $0.04 to $0.06
causavera: folds 
Scaaalll: folds 
Yangyang1407: folds 
KonopDima: folds 
zergmiky: folds 
Uncalled bet ($0.04) returned to rooGL
rooGL collected $0.05 from pot
rooGL: doesn't show hand 
*** SUMMARY ***
Total pot $0.05 | Rake $0 
Seat 1: Yangyang1407 (button) folded before Flop (didn't bet)
Seat 2: KonopDima (small blind) folded before Flop
Seat 3: zergmiky (big blind) folded before Flop
Seat 4: rooGL collected ($0.05)
Seat 5: causavera folded before Flop (didn't bet)
Seat 6: Scaaalll folded before Flop (didn't bet)



PokerStars Zoom Hand #229233213813:  Hold'em No Limit ($0.01/$0.02) - 2021/08/21 23:21:23 CET [2021/08/21 17:21:23 ET]
Table 'Halley' 6-max Seat #1 is the button
Seat 1: Xlavariable ($2.46 in chips) 
Seat 2: 888lifeIS ($2 in chips) 
Seat 3: Scaaalll ($3.52 in chips) 
Seat 4: alphabeta1d ($2.03 in chips) 
Seat 5: Colby1771 ($3.74 in chips) 
Seat 6: ernmic ($2.24 in chips) 
888lifeIS: posts small blind $0.01
Scaaalll: posts big blind $0.02
*** HOLE CARDS ***
Dealt to Scaaalll [8d 3c]
alphabeta1d: folds 
Colby1771: folds 
ernmic: folds 
Xlavariable: folds 
888lifeIS: folds 
Uncalled bet ($0.01) returned to Scaaalll
Scaaalll collected $0.02 from pot
Scaaalll: doesn't show hand 
*** SUMMARY ***
Total pot $0.02 | Rake $0 
Seat 1: Xlavariable (button) folded before Flop (didn't bet)
Seat 2: 888lifeIS (small blind) folded before Flop
Seat 3: Scaaalll (big blind) collected ($0.02)
Seat 4: alphabeta1d folded before Flop (didn't bet)
Seat 5: Colby1771 folded before Flop (didn't bet)
Seat 6: ernmic folded before Flop (didn't bet)



PokerStars Zoom Hand #229233221037:  Hold'em No Limit ($0.01/$0.02) - 2021/08/21 23:21:40 CET [2021/08/21 17:21:40 ET]
Table 'Halley' 6-max Seat #1 is the button
Seat 1: FabOliveira9 ($2 in chips) 
Seat 2: Scaaalll ($3.53 in chips) 
Seat 3: RrriotGrrrl ($5.11 in chips) 
Seat 4: gasmar_29 ($2 in chips) 
Seat 5: Reipinguimm ($2 in chips) 
Seat 6: z3317111711 ($3.57 in chips) 
Scaaalll: posts small blind $0.01
RrriotGrrrl: posts big blind $0.02
*** HOLE CARDS ***
Dealt to Scaaalll [9c 5h]
gasmar_29: folds 
Reipinguimm: folds 
z3317111711: folds 
FabOliveira9: raises $0.03 to $0.05
Scaaalll: folds 
RrriotGrrrl: folds 
Uncalled bet ($0.03) returned to FabOliveira9
FabOliveira9 collected $0.05 from pot
FabOliveira9: doesn't show hand 
*** SUMMARY ***
Total pot $0.05 | Rake $0 
Seat 1: FabOliveira9 (button) collected ($0.05)
Seat 2: Scaaalll (small blind) folded before Flop
Seat 3: RrriotGrrrl (big blind) folded before Flop
Seat 4: gasmar_29 folded before Flop (didn't bet)
Seat 5: Reipinguimm folded before Flop (didn't bet)
Seat 6: z3317111711 folded before Flop (didn't bet)



PokerStars Zoom Hand #229233212074:  Hold'em No Limit ($0.01/$0.02) - 2021/08/21 23:21:19 CET [2021/08/21 17:21:19 ET]
Table 'Halley' 6-max Seat #1 is the button
Seat 1: Keeviiin 28 ($1.42 in chips) 
Seat 2: Ogni ($4.97 in chips) 
Seat 3: kai_inge_mar ($2.40 in chips) 
Seat 4: Scaaalll ($3.52 in chips) 
Seat 5: HubertFroh ($2 in chips) 
Seat 6: MetalCrüe ($1.47 in chips) 
Ogni: posts small blind $0.01
kai_inge_mar: posts big blind $0.02
*** HOLE CARDS ***
Dealt to Scaaalll [4s 7h]
Scaaalll: folds 
HubertFroh: folds 
MetalCrüe: folds 
Keeviiin 28: raises $0.04 to $0.06
Ogni: calls $0.05
kai_inge_mar: calls $0.04
*** FLOP *** [3d 9s Tc]
Ogni: checks 
kai_inge_mar: checks 
Keeviiin 28: bets $0.08
Ogni: folds 
kai_inge_mar: calls $0.08
*** TURN *** [3d 9s Tc] [Ts]
kai_inge_mar: bets $0.16
Keeviiin 28: folds 
Uncalled bet ($0.16) returned to kai_inge_mar
kai_inge_mar collected $0.33 from pot
kai_inge_mar: doesn't show hand 
Keeviiin 28 is disconnected 
*** SUMMARY ***
Total pot $0.34 | Rake $0.01 
Board [3d 9s Tc Ts]
Seat 1: Keeviiin 28 (button) folded on the Turn
Seat 2: Ogni (small blind) folded on the Flop
Seat 3: kai_inge_mar (big blind) collected ($0.33)
Seat 4: Scaaalll folded before Flop (didn't bet)
Seat 5: HubertFroh folded before Flop (didn't bet)
Seat 6: MetalCrüe folded before Flop (didn't bet)



PokerStars Zoom Hand #229233226952:  Hold'em No Limit ($0.01/$0.02) - 2021/08/21 23:21:54 CET [2021/08/21 17:21:54 ET]
Table 'Halley' 6-max Seat #1 is the button
Seat 1: Scaaalll ($3.52 in chips) 
Seat 2: PapiMik3 ($8.27 in chips) 
Seat 3: WITKOW_AV ($2 in chips) 
Seat 4: Boris_Garich ($2.01 in chips) 
Seat 5: BIITRU ($2.04 in chips) 
Seat 6: GVMELLO ($2.43 in chips) 
PapiMik3: posts small blind $0.01
WITKOW_AV: posts big blind $0.02
*** HOLE CARDS ***
Dealt to Scaaalll [5s 3c]
Boris_Garich: folds 
BIITRU: raises $0.04 to $0.06
GVMELLO: folds 
Scaaalll: folds 
PapiMik3: folds 
WITKOW_AV: folds 
Uncalled bet ($0.04) returned to BIITRU
BIITRU collected $0.05 from pot
BIITRU: doesn't show hand 
*** SUMMARY ***
Total pot $0.05 | Rake $0 
Seat 1: Scaaalll (button) folded before Flop (didn't bet)
Seat 2: PapiMik3 (small blind) folded before Flop
Seat 3: WITKOW_AV (big blind) folded before Flop
Seat 4: Boris_Garich folded before Flop (didn't bet)
Seat 5: BIITRU collected ($0.05)
Seat 6: GVMELLO folded before Flop (didn't bet)



PokerStars Zoom Hand #229233219399:  Hold'em No Limit ($0.01/$0.02) - 2021/08/21 23:21:36 CET [2021/08/21 17:21:36 ET]
Table 'Halley' 6-max Seat #1 is the button
Seat 1: Chapaev136 ($6.58 in chips) 
Seat 2: maliniak75 ($2.74 in chips) 
Seat 3: Baldisback ($3.32 in chips) 
Seat 4: Scaaalll ($3.53 in chips) 
Seat 5: adrianh2002 ($4.19 in chips) 
Seat 6: RrriotGrrrl ($5.11 in chips) 
maliniak75: posts small blind $0.01
Baldisback: posts big blind $0.02
*** HOLE CARDS ***
Dealt to Scaaalll [6d Tc]
Scaaalll: folds 
adrianh2002: folds 
RrriotGrrrl: folds 
Chapaev136: raises $0.04 to $0.06
maliniak75: raises $0.04 to $0.10
Baldisback: folds 
Chapaev136: calls $0.04
*** FLOP *** [As 2h 8c]
maliniak75: checks 
Chapaev136: bets $0.04
maliniak75: calls $0.04
*** TURN *** [As 2h 8c] [7s]
maliniak75: checks 
Chapaev136: checks 
*** RIVER *** [As 2h 8c 7s] [Jc]
maliniak75: checks 
Chapaev136: checks 
*** SHOW DOWN ***
maliniak75: shows [8d 5d] (a pair of Eights)
Chapaev136: shows [Ks 8s] (a pair of Eights - Ace+King kicker)
Chapaev136 collected $0.29 from pot
*** SUMMARY ***
Total pot $0.30 | Rake $0.01 
Board [As 2h 8c 7s Jc]
Seat 1: Chapaev136 (button) showed [Ks 8s] and won ($0.29) with a pair of Eights
Seat 2: maliniak75 (small blind) showed [8d 5d] and lost with a pair of Eights
Seat 3: Baldisback (big blind) folded before Flop
Seat 4: Scaaalll folded before Flop (didn't bet)
Seat 5: adrianh2002 folded before Flop (didn't bet)
Seat 6: RrriotGrrrl folded before Flop (didn't bet)



PokerStars Zoom Hand #229233228564:  Hold'em No Limit ($0.01/$0.02) - 2021/08/21 23:21:58 CET [2021/08/21 17:21:58 ET]
Table 'Halley' 6-max Seat #1 is the button
Seat 1: Cineva81 ($2.42 in chips) 
Seat 2: FARA1982 ($1.50 in chips) 
Seat 3: Richaud ($4.47 in chips) 
Seat 4: estelionat171 ($0.45 in chips) 
Seat 5: Wilsonwing1 ($1.88 in chips) 
Seat 6: Scaaalll ($3.52 in chips) 
FARA1982: posts small blind $0.01
Richaud: posts big blind $0.02
*** HOLE CARDS ***
Dealt to Scaaalll [2h 2s]
estelionat171: folds 
Wilsonwing1: folds 
Wilsonwing1 is disconnected 
Scaaalll: raises $0.04 to $0.06
Cineva81: folds 
FARA1982: calls $0.05
Richaud: folds 
*** FLOP *** [6d As Qh]
FARA1982: checks 
Scaaalll: checks 
*** TURN *** [6d As Qh] [7d]
FARA1982: checks 
Scaaalll: checks 
*** RIVER *** [6d As Qh 7d] [4d]
FARA1982: bets $0.04
Scaaalll: folds 
Uncalled bet ($0.04) returned to FARA1982
FARA1982 collected $0.14 from pot
FARA1982: doesn't show hand 
*** SUMMARY ***
Total pot $0.14 | Rake $0 
Board [6d As Qh 7d 4d]
Seat 1: Cineva81 (button) folded before Flop (didn't bet)
Seat 2: FARA1982 (small blind) collected ($0.14)
Seat 3: Richaud (big blind) folded before Flop
Seat 4: estelionat171 folded before Flop (didn't bet)
Seat 5: Wilsonwing1 folded before Flop (didn't bet)
Seat 6: Scaaalll folded on the River



PokerStars Zoom Hand #229233243879:  Hold'em No Limit ($0.01/$0.02) - 2021/08/21 23:22:34 CET [2021/08/21 17:22:34 ET]
Table 'Halley' 6-max Seat #1 is the button
Seat 1: rpycmbEM ($6.01 in chips) 
Seat 2: alphabeta1d ($2.03 in chips) 
Seat 3: KKARMELO ($2.75 in chips) 
Seat 4: Vanekakqj ($4.46 in chips) 
Seat 5: Scaaalll ($3.46 in chips) 
Seat 6: dannybird1 ($1.38 in chips) 
alphabeta1d: posts small blind $0.01
KKARMELO: posts big blind $0.02
*** HOLE CARDS ***
Dealt to Scaaalll [Tc 8s]
Vanekakqj: raises $0.02 to $0.04
Scaaalll: folds 
dannybird1: raises $0.11 to $0.15
rpycmbEM: folds 
alphabeta1d: folds 
KKARMELO: folds 
Vanekakqj: folds 
Uncalled bet ($0.11) returned to dannybird1
dannybird1 collected $0.11 from pot
dannybird1: doesn't show hand 
*** SUMMARY ***
Total pot $0.11 | Rake $0 
Seat 1: rpycmbEM (button) folded before Flop (didn't bet)
Seat 2: alphabeta1d (small blind) folded before Flop
Seat 3: KKARMELO (big blind) folded before Flop
Seat 4: Vanekakqj folded before Flop
Seat 5: Scaaalll folded before Flop (didn't bet)
Seat 6: dannybird1 collected ($0.11)



PokerStars Zoom Hand #229233246025:  Hold'em No Limit ($0.01/$0.02) - 2021/08/21 23:22:39 CET [2021/08/21 17:22:39 ET]
Table 'Halley' 6-max Seat #1 is the button
Seat 1: Thaleshs ($4.10 in chips) 
Seat 2: gordoatlantico ($3.01 in chips) 
Seat 3: ffffj ($0.82 in chips) 
Seat 4: Xlavariable ($2.19 in chips) 
Seat 5: maliniak75 ($1.82 in chips) 
Seat 6: Scaaalll ($3.46 in chips) 
gordoatlantico: posts small blind $0.01
ffffj: posts big blind $0.02
*** HOLE CARDS ***
Dealt to Scaaalll [Td Ac]
Xlavariable: folds 
maliniak75: calls $0.02
Scaaalll: raises $0.06 to $0.08
Thaleshs: folds 
gordoatlantico: folds 
ffffj: folds 
maliniak75: calls $0.06
*** FLOP *** [4c 6d Jh]
maliniak75: checks 
Scaaalll: checks 
*** TURN *** [4c 6d Jh] [7s]
maliniak75: checks 
Scaaalll: checks 
*** RIVER *** [4c 6d Jh 7s] [8d]
maliniak75: checks 
Scaaalll: checks 
*** SHOW DOWN ***
maliniak75: shows [5s Ts] (a straight, Four to Eight)
Scaaalll: mucks hand 
maliniak75 collected $0.18 from pot
*** SUMMARY ***
Total pot $0.19 | Rake $0.01 
Board [4c 6d Jh 7s 8d]
Seat 1: Thaleshs (button) folded before Flop (didn't bet)
Seat 2: gordoatlantico (small blind) folded before Flop
Seat 3: ffffj (big blind) folded before Flop
Seat 4: Xlavariable folded before Flop (didn't bet)
Seat 5: maliniak75 showed [5s Ts] and won ($0.18) with a straight, Four to Eight
Seat 6: Scaaalll mucked [Td Ac]



PokerStars Zoom Hand #229233271513:  Hold'em No Limit ($0.01/$0.02) - 2021/08/21 23:23:40 CET [2021/08/21 17:23:40 ET]
Table 'Halley' 6-max Seat #1 is the button
Seat 1: slipknot956 ($2.53 in chips) 
Seat 2: Goingold77 ($1.96 in chips) 
Seat 3: rpycmbEM ($5.98 in chips) 
Seat 4: ctaceo ($2.14 in chips) 
Seat 5: Scaaalll ($3.38 in chips) 
Seat 6: DemonsDude ($2.99 in chips) 
Goingold77: posts small blind $0.01
rpycmbEM: posts big blind $0.02
*** HOLE CARDS ***
Dealt to Scaaalll [5c Kc]
ctaceo: folds 
Goingold77 is disconnected 
Scaaalll: folds 
DemonsDude: folds 
DemonsDude is disconnected 
slipknot956: raises $0.04 to $0.06
Goingold77: folds 
rpycmbEM: folds 
Uncalled bet ($0.04) returned to slipknot956
slipknot956 collected $0.05 from pot
slipknot956: doesn't show hand 
*** SUMMARY ***
Total pot $0.05 | Rake $0 
Seat 1: slipknot956 (button) collected ($0.05)
Seat 2: Goingold77 (small blind) folded before Flop
Seat 3: rpycmbEM (big blind) folded before Flop
Seat 4: ctaceo folded before Flop (didn't bet)
Seat 5: Scaaalll folded before Flop (didn't bet)
Seat 6: DemonsDude folded before Flop (didn't bet)



PokerStars Zoom Hand #229233274017:  Hold'em No Limit ($0.01/$0.02) - 2021/08/21 23:23:46 CET [2021/08/21 17:23:46 ET]
Table 'Halley' 6-max Seat #1 is the button
Seat 1: kukulagosleep ($3.43 in chips) 
Seat 2: jaamonra ($2.11 in chips) 
Seat 3: Scaaalll ($3.38 in chips) 
Seat 4: Posaunengodi ($2 in chips) 
Seat 5: Xlavariable ($2.67 in chips) 
Seat 6: BORODA-X ($3.06 in chips) 
jaamonra: posts small blind $0.01
Scaaalll: posts big blind $0.02
*** HOLE CARDS ***
Dealt to Scaaalll [Ad 9s]
Posaunengodi: raises $0.04 to $0.06
Xlavariable: folds 
BORODA-X: raises $0.26 to $0.32
kukulagosleep: folds 
jaamonra: folds 
Scaaalll: folds 
Posaunengodi: raises $0.67 to $0.99
BORODA-X: raises $2.07 to $3.06 and is all-in
Posaunengodi: calls $1.01 and is all-in
Uncalled bet ($1.06) returned to BORODA-X
*** FLOP *** [8h 8s 4s]
*** TURN *** [8h 8s 4s] [4d]
*** RIVER *** [8h 8s 4s 4d] [4c]
*** SHOW DOWN ***
Posaunengodi: shows [As Kc] (a full house, Fours full of Eights)
BORODA-X: shows [Qc Ac] (a full house, Fours full of Eights)
Posaunengodi collected $1.95 from pot
BORODA-X collected $1.94 from pot
*** SUMMARY ***
Total pot $4.03 | Rake $0.14 
Board [8h 8s 4s 4d 4c]
Seat 1: kukulagosleep (button) folded before Flop (didn't bet)
Seat 2: jaamonra (small blind) folded before Flop
Seat 3: Scaaalll (big blind) folded before Flop
Seat 4: Posaunengodi showed [As Kc] and won ($1.95) with a full house, Fours full of Eights
Seat 5: Xlavariable folded before Flop (didn't bet)
Seat 6: BORODA-X showed [Qc Ac] and won ($1.94) with a full house, Fours full of Eights



PokerStars Zoom Hand #229233288237:  Hold'em No Limit ($0.01/$0.02) - 2021/08/21 23:24:20 CET [2021/08/21 17:24:20 ET]
Table 'Halley' 6-max Seat #1 is the button
Seat 1: Scaaalll ($3.35 in chips) 
Seat 2: pavlo8855 ($2.42 in chips) 
Seat 3: cr@sh test ($2.42 in chips) 
Seat 4: rpycmbEM ($3.66 in chips) 
Seat 5: Cineva81 ($2 in chips) 
Seat 6: Tibeau21 ($0.74 in chips) 
pavlo8855: posts small blind $0.01
cr@sh test: posts big blind $0.02
*** HOLE CARDS ***
Dealt to Scaaalll [2d 9s]
Tibeau21 is disconnected 
rpycmbEM: folds 
Cineva81: raises $0.04 to $0.06
Tibeau21: folds 
Scaaalll: folds 
pavlo8855: folds 
cr@sh test: folds 
Uncalled bet ($0.04) returned to Cineva81
Cineva81 collected $0.05 from pot
Cineva81: doesn't show hand 
*** SUMMARY ***
Total pot $0.05 | Rake $0 
Seat 1: Scaaalll (button) folded before Flop (didn't bet)
Seat 2: pavlo8855 (small blind) folded before Flop
Seat 3: cr@sh test (big blind) folded before Flop
Seat 4: rpycmbEM folded before Flop (didn't bet)
Seat 5: Cineva81 collected ($0.05)
Seat 6: Tibeau21 folded before Flop (didn't bet)



PokerStars Zoom Hand #229233294528:  Hold'em No Limit ($0.01/$0.02) - 2021/08/21 23:24:35 CET [2021/08/21 17:24:35 ET]
Table 'Halley' 6-max Seat #1 is the button
Seat 1: S3XY_PADRE ($4.97 in chips) 
Seat 2: Kb013497 ($1.88 in chips) 
Seat 3: HubertFroh ($4.67 in chips) 
Seat 4: Scaaalll ($3.35 in chips) 
Seat 5: Phoenixxxxxxxx ($3.51 in chips) 
Seat 6: CrazyyParis ($2.02 in chips) 
Kb013497: posts small blind $0.01
HubertFroh: posts big blind $0.02
*** HOLE CARDS ***
Dealt to Scaaalll [Tc 3s]
Scaaalll: folds 
Phoenixxxxxxxx: folds 
CrazyyParis: folds 
S3XY_PADRE: folds 
Kb013497: folds 
Uncalled bet ($0.01) returned to HubertFroh
HubertFroh collected $0.02 from pot
HubertFroh: doesn't show hand 
*** SUMMARY ***
Total pot $0.02 | Rake $0 
Seat 1: S3XY_PADRE (button) folded before Flop (didn't bet)
Seat 2: Kb013497 (small blind) folded before Flop
Seat 3: HubertFroh (big blind) collected ($0.02)
Seat 4: Scaaalll folded before Flop (didn't bet)
Seat 5: Phoenixxxxxxxx folded before Flop (didn't bet)
Seat 6: CrazyyParis folded before Flop (didn't bet)



PokerStars Zoom Hand #229233278995:  Hold'em No Limit ($0.01/$0.02) - 2021/08/21 23:23:58 CET [2021/08/21 17:23:58 ET]
Table 'Halley' 6-max Seat #1 is the button
Seat 1: so0love ($2.59 in chips) 
Seat 2: Scaaalll ($3.36 in chips) 
Seat 3: nightwacher ($1.79 in chips) 
Seat 4: ulisessoria ($2 in chips) 
Seat 5: keldh ($7.50 in chips) 
Seat 6: dannyluijten ($2 in chips) 
Scaaalll: posts small blind $0.01
nightwacher: posts big blind $0.02
*** HOLE CARDS ***
Dealt to Scaaalll [Kd 3s]
ulisessoria: folds 
keldh: raises $0.03 to $0.05
dannyluijten: folds 
so0love: folds 
Scaaalll: folds 
nightwacher: raises $0.12 to $0.17
keldh: calls $0.12
*** FLOP *** [Qc 6s 9c]
nightwacher: bets $0.17
keldh: calls $0.17
*** TURN *** [Qc 6s 9c] [4h]
nightwacher: checks 
keldh: bets $0.50
nightwacher: calls $0.50
*** RIVER *** [Qc 6s 9c 4h] [Ac]
nightwacher: checks 
keldh: bets $6.66 and is all-in
nightwacher: calls $0.95 and is all-in
Uncalled bet ($5.71) returned to keldh
*** SHOW DOWN ***
keldh: shows [As Jh] (a pair of Aces)
nightwacher: shows [Qh Ad] (two pair, Aces and Queens)
nightwacher collected $3.46 from pot
*** SUMMARY ***
Total pot $3.59 | Rake $0.13 
Board [Qc 6s 9c 4h Ac]
Seat 1: so0love (button) folded before Flop (didn't bet)
Seat 2: Scaaalll (small blind) folded before Flop
Seat 3: nightwacher (big blind) showed [Qh Ad] and won ($3.46) with two pair, Aces and Queens
Seat 4: ulisessoria folded before Flop (didn't bet)
Seat 5: keldh showed [As Jh] and lost with a pair of Aces
Seat 6: dannyluijten folded before Flop (didn't bet)



PokerStars Zoom Hand #229233296661:  Hold'em No Limit ($0.01/$0.02) - 2021/08/21 23:24:40 CET [2021/08/21 17:24:40 ET]
Table 'Halley' 6-max Seat #1 is the button
Seat 1: kingdieter1 ($1.90 in chips) 
Seat 2: Vahenta ($2.99 in chips) 
Seat 3: Balada trip ($0.73 in chips) 
Seat 4: FreddyFlips ($2.19 in chips) 
Seat 5: StayFunky ($1.97 in chips) 
Seat 6: Scaaalll ($3.35 in chips) 
Vahenta: posts small blind $0.01
Balada trip: posts big blind $0.02
*** HOLE CARDS ***
Dealt to Scaaalll [7h Js]
FreddyFlips: folds 
FreddyFlips is disconnected 
Vahenta is disconnected 
StayFunky: raises $0.04 to $0.06
Scaaalll: folds 
kingdieter1: folds 
Vahenta: folds 
kingdieter1 is disconnected 
Balada trip: folds 
Uncalled bet ($0.04) returned to StayFunky
StayFunky collected $0.05 from pot
StayFunky: doesn't show hand 
*** SUMMARY ***
Total pot $0.05 | Rake $0 
Seat 1: kingdieter1 (button) folded before Flop (didn't bet)
Seat 2: Vahenta (small blind) folded before Flop
Seat 3: Balada trip (big blind) folded before Flop
Seat 4: FreddyFlips folded before Flop (didn't bet)
Seat 5: StayFunky collected ($0.05)
Seat 6: Scaaalll folded before Flop (didn't bet)



PokerStars Zoom Hand #229233292013:  Hold'em No Limit ($0.01/$0.02) - 2021/08/21 23:24:29 CET [2021/08/21 17:24:29 ET]
Table 'Halley' 6-max Seat #1 is the button
Seat 1: Fenix888888 ($1.12 in chips) 
Seat 2: TM 69 UIE ($2.16 in chips) 
Seat 3: isaeg ($2.17 in chips) 
Seat 4: maliniak75 ($3.51 in chips) 
Seat 5: Scaaalll ($3.35 in chips) 
Seat 6: Mikeloko182 ($2 in chips) 
TM 69 UIE: posts small blind $0.01
isaeg: posts big blind $0.02
*** HOLE CARDS ***
Dealt to Scaaalll [Th Jd]
maliniak75: folds 
Scaaalll: folds 
Mikeloko182: raises $0.04 to $0.06
Fenix888888: folds 
TM 69 UIE: calls $0.05
isaeg: folds 
*** FLOP *** [5h 2c Jc]
isaeg is disconnected 
TM 69 UIE: checks 
Mikeloko182: bets $0.05
TM 69 UIE: folds 
Uncalled bet ($0.05) returned to Mikeloko182
Mikeloko182 collected $0.14 from pot
Mikeloko182: doesn't show hand 
TM 69 UIE is disconnected 
*** SUMMARY ***
Total pot $0.14 | Rake $0 
Board [5h 2c Jc]
Seat 1: Fenix888888 (button) folded before Flop (didn't bet)
Seat 2: TM 69 UIE (small blind) folded on the Flop
Seat 3: isaeg (big blind) folded before Flop
Seat 4: maliniak75 folded before Flop (didn't bet)
Seat 5: Scaaalll folded before Flop (didn't bet)
Seat 6: Mikeloko182 collected ($0.14)



PokerStars Zoom Hand #229233302775:  Hold'em No Limit ($0.01/$0.02) - 2021/08/21 23:24:55 CET [2021/08/21 17:24:55 ET]
Table 'Halley' 6-max Seat #1 is the button
Seat 1: Dakosm ($3.55 in chips) 
Seat 2: Scaaalll ($3.33 in chips) 
Seat 3: Mikeloko182 ($2.99 in chips) 
Seat 4: Thaleshs ($6.92 in chips) 
Seat 5: NoEff0rt2w1n ($2.33 in chips) 
Seat 6: The-End-snglr ($1.58 in chips) 
Scaaalll: posts small blind $0.01
Mikeloko182: posts big blind $0.02
*** HOLE CARDS ***
Dealt to Scaaalll [5s 4s]
Thaleshs: raises $0.02 to $0.04
NoEff0rt2w1n: folds 
The-End-snglr: folds 
Dakosm: folds 
Scaaalll: folds 
Mikeloko182: folds 
Uncalled bet ($0.02) returned to Thaleshs
Thaleshs collected $0.05 from pot
Thaleshs: doesn't show hand 
*** SUMMARY ***
Total pot $0.05 | Rake $0 
Seat 1: Dakosm (button) folded before Flop (didn't bet)
Seat 2: Scaaalll (small blind) folded before Flop
Seat 3: Mikeloko182 (big blind) folded before Flop
Seat 4: Thaleshs collected ($0.05)
Seat 5: NoEff0rt2w1n folded before Flop (didn't bet)
Seat 6: The-End-snglr folded before Flop (didn't bet)



PokerStars Zoom Hand #229233298178:  Hold'em No Limit ($0.01/$0.02) - 2021/08/21 23:24:44 CET [2021/08/21 17:24:44 ET]
Table 'Halley' 6-max Seat #1 is the button
Seat 1: juelz_ua ($1.58 in chips) 
Seat 2: HubertFroh ($2.75 in chips) 
Seat 3: Scaaalll ($3.35 in chips) 
Seat 4: kidninja888 ($2.51 in chips) 
Seat 5: gizum17 ($1.97 in chips) 
Seat 6: nodtress ($2.54 in chips) 
HubertFroh: posts small blind $0.01
Scaaalll: posts big blind $0.02
*** HOLE CARDS ***
Dealt to Scaaalll [9c Ah]
kidninja888: folds 
gizum17: folds 
nodtress: raises $0.03 to $0.05
juelz_ua: calls $0.05
HubertFroh: folds 
Scaaalll: folds 
*** FLOP *** [Kc 9s Kh]
nodtress: checks 
juelz_ua: bets $0.08
nodtress: calls $0.08
*** TURN *** [Kc 9s Kh] [8c]
nodtress: bets $0.14
juelz_ua: calls $0.14
*** RIVER *** [Kc 9s Kh 8c] [2d]
nodtress: checks 
juelz_ua: bets $0.27
nodtress: folds 
Uncalled bet ($0.27) returned to juelz_ua
juelz_ua collected $0.55 from pot
juelz_ua: doesn't show hand 
*** SUMMARY ***
Total pot $0.57 | Rake $0.02 
Board [Kc 9s Kh 8c 2d]
Seat 1: juelz_ua (button) collected ($0.55)
Seat 2: HubertFroh (small blind) folded before Flop
Seat 3: Scaaalll (big blind) folded before Flop
Seat 4: kidninja888 folded before Flop (didn't bet)
Seat 5: gizum17 folded before Flop (didn't bet)
Seat 6: nodtress folded on the River



PokerStars Zoom Hand #229233313934:  Hold'em No Limit ($0.01/$0.02) - 2021/08/21 23:25:08 CET [2021/08/21 17:25:08 ET]
Table 'Halley' 6-max Seat #1 is the button
Seat 1: Scaaalll ($3.32 in chips) 
Seat 2: alexchamps ($1.72 in chips) 
Seat 3: rpycmbEM ($5.95 in chips) 
Seat 4: KKARMELO ($2.19 in chips) 
Seat 5: Sv1ch ($2.23 in chips) 
Seat 6: shingo594 ($4.66 in chips) 
alexchamps: posts small blind $0.01
rpycmbEM: posts big blind $0.02
*** HOLE CARDS ***
Dealt to Scaaalll [7d 8d]
shingo594 is disconnected 
KKARMELO: folds 
Sv1ch: folds 
shingo594: folds 
Scaaalll: raises $0.02 to $0.04
alexchamps: calls $0.03
rpycmbEM: folds 
*** FLOP *** [9d 9c 4c]
alexchamps: checks 
Scaaalll: bets $0.06
alexchamps: folds 
Uncalled bet ($0.06) returned to Scaaalll
Scaaalll collected $0.10 from pot
Scaaalll: doesn't show hand 
alexchamps is disconnected 
*** SUMMARY ***
Total pot $0.10 | Rake $0 
Board [9d 9c 4c]
Seat 1: Scaaalll (button) collected ($0.10)
Seat 2: alexchamps (small blind) folded on the Flop
Seat 3: rpycmbEM (big blind) folded before Flop
Seat 4: KKARMELO folded before Flop (didn't bet)
Seat 5: Sv1ch folded before Flop (didn't bet)
Seat 6: shingo594 folded before Flop (didn't bet)



PokerStars Zoom Hand #229233326698:  Hold'em No Limit ($0.01/$0.02) - 2021/08/21 23:25:38 CET [2021/08/21 17:25:38 ET]
Table 'Halley' 6-max Seat #1 is the button
Seat 1: KKARMELO ($3.40 in chips) 
Seat 2: queen830 ($14.86 in chips) 
Seat 3: LijanaV ($5.42 in chips) 
Seat 4: Scaaalll ($3.38 in chips) 
Seat 5: Iv3rson18 ($2.13 in chips) 
Seat 6: Z0omer_420 ($2.03 in chips) 
queen830: posts small blind $0.01
LijanaV: posts big blind $0.02
*** HOLE CARDS ***
Dealt to Scaaalll [5d Kh]
Scaaalll: folds 
Iv3rson18: folds 
Z0omer_420: raises $0.03 to $0.05
KKARMELO: folds 
queen830: folds 
LijanaV: folds 
Uncalled bet ($0.03) returned to Z0omer_420
Z0omer_420 collected $0.05 from pot
Z0omer_420: doesn't show hand 
LijanaV is disconnected 
*** SUMMARY ***
Total pot $0.05 | Rake $0 
Seat 1: KKARMELO (button) folded before Flop (didn't bet)
Seat 2: queen830 (small blind) folded before Flop
Seat 3: LijanaV (big blind) folded before Flop
Seat 4: Scaaalll folded before Flop (didn't bet)
Seat 5: Iv3rson18 folded before Flop (didn't bet)
Seat 6: Z0omer_420 collected ($0.05)



PokerStars Zoom Hand #229233329894:  Hold'em No Limit ($0.01/$0.02) - 2021/08/21 23:25:46 CET [2021/08/21 17:25:46 ET]
Table 'Halley' 6-max Seat #1 is the button
Seat 1: SIGREX ($2.80 in chips) 
Seat 2: Sharabora ($0.80 in chips) 
Seat 3: Scaaalll ($3.38 in chips) 
Seat 4: ctaceo ($2.08 in chips) 
Seat 5: Xpokerfreak ($1.63 in chips) 
Seat 6: Iv3rson18 ($2.42 in chips) 
Sharabora: posts small blind $0.01
Scaaalll: posts big blind $0.02
*** HOLE CARDS ***
Dealt to Scaaalll [Ah Ac]
ctaceo: folds 
Xpokerfreak: folds 
Iv3rson18: folds 
SIGREX: folds 
Sharabora: folds 
Uncalled bet ($0.01) returned to Scaaalll
Scaaalll collected $0.02 from pot
Scaaalll: doesn't show hand 
*** SUMMARY ***
Total pot $0.02 | Rake $0 
Seat 1: SIGREX (button) folded before Flop (didn't bet)
Seat 2: Sharabora (small blind) folded before Flop
Seat 3: Scaaalll (big blind) collected ($0.02)
Seat 4: ctaceo folded before Flop (didn't bet)
Seat 5: Xpokerfreak folded before Flop (didn't bet)
Seat 6: Iv3rson18 folded before Flop (didn't bet)



PokerStars Zoom Hand #229233334572:  Hold'em No Limit ($0.01/$0.02) - 2021/08/21 23:25:57 CET [2021/08/21 17:25:57 ET]
Table 'Halley' 6-max Seat #1 is the button
Seat 1: KonopDima ($2.30 in chips) 
Seat 2: Scaaalll ($3.39 in chips) 
Seat 3: Cineva81 ($2.08 in chips) 
Seat 4: rpycmbEM ($5.95 in chips) 
Seat 5: Smaill174 ($3.61 in chips) 
Seat 6: OneFaw ($2.22 in chips) 
Scaaalll: posts small blind $0.01
Cineva81: posts big blind $0.02
*** HOLE CARDS ***
Dealt to Scaaalll [4h 6h]
OneFaw is disconnected 
rpycmbEM: folds 
Smaill174: raises $0.04 to $0.06
OneFaw: folds 
KonopDima: folds 
Scaaalll: folds 
Cineva81: folds 
Uncalled bet ($0.04) returned to Smaill174
Smaill174 collected $0.05 from pot
Smaill174: doesn't show hand 
*** SUMMARY ***
Total pot $0.05 | Rake $0 
Seat 1: KonopDima (button) folded before Flop (didn't bet)
Seat 2: Scaaalll (small blind) folded before Flop
Seat 3: Cineva81 (big blind) folded before Flop
Seat 4: rpycmbEM folded before Flop (didn't bet)
Seat 5: Smaill174 collected ($0.05)
Seat 6: OneFaw folded before Flop (didn't bet)



PokerStars Zoom Hand #229233324129:  Hold'em No Limit ($0.01/$0.02) - 2021/08/21 23:25:32 CET [2021/08/21 17:25:32 ET]
Table 'Halley' 6-max Seat #1 is the button
Seat 1: gordoatlantico ($3.03 in chips) 
Seat 2: Wonka77777 ($1.09 in chips) 
Seat 3: Xlavariable ($2.94 in chips) 
Seat 4: Scaaalll ($3.38 in chips) 
Seat 5: causavera ($0.53 in chips) 
Seat 6: Larson_mfk ($0.94 in chips) 
Wonka77777: posts small blind $0.01
Xlavariable: posts big blind $0.02
*** HOLE CARDS ***
Dealt to Scaaalll [7d 8c]
Larson_mfk is disconnected 
Scaaalll: folds 
causavera: raises $0.03 to $0.05
Larson_mfk: folds 
gordoatlantico: raises $0.09 to $0.14
Wonka77777: folds 
Xlavariable: folds 
Wonka77777 is disconnected 
causavera: calls $0.09
*** FLOP *** [2d Kc 4h]
causavera: checks 
gordoatlantico: checks 
*** TURN *** [2d Kc 4h] [Qc]
causavera: checks 
gordoatlantico: bets $0.09
causavera: raises $0.30 to $0.39 and is all-in
gordoatlantico: calls $0.30
*** RIVER *** [2d Kc 4h Qc] [Js]
*** SHOW DOWN ***
causavera: shows [Ts Qs] (a pair of Queens)
gordoatlantico: shows [Ad As] (a pair of Aces)
gordoatlantico collected $1.05 from pot
causavera cashed out the hand for $0.12
*** SUMMARY ***
Total pot $1.09 | Rake $0.04 
Board [2d Kc 4h Qc Js]
Seat 1: gordoatlantico (button) showed [Ad As] and won ($1.05) with a pair of Aces
Seat 2: Wonka77777 (small blind) folded before Flop
Seat 3: Xlavariable (big blind) folded before Flop
Seat 4: Scaaalll folded before Flop (didn't bet)
Seat 5: causavera showed [Ts Qs] and lost with a pair of Queens (cashed out).
Seat 6: Larson_mfk folded before Flop (didn't bet)



PokerStars Zoom Hand #229233341622:  Hold'em No Limit ($0.01/$0.02) - 2021/08/21 23:26:14 CET [2021/08/21 17:26:14 ET]
Table 'Halley' 6-max Seat #1 is the button
Seat 1: Scaaalll ($3.38 in chips) 
Seat 2: 888lifeIS ($2.02 in chips) 
Seat 3: johnpa89 ($2 in chips) 
Seat 4: SIGREX ($2.77 in chips) 
Seat 5: MKIronCrAAzy ($5.99 in chips) 
Seat 6: kukulagosleep ($3.61 in chips) 
888lifeIS: posts small blind $0.01
johnpa89: posts big blind $0.02
*** HOLE CARDS ***
Dealt to Scaaalll [4h 4s]
SIGREX: folds 
MKIronCrAAzy: folds 
kukulagosleep: folds 
Scaaalll: raises $0.03 to $0.05
888lifeIS: folds 
johnpa89: folds 
Uncalled bet ($0.03) returned to Scaaalll
Scaaalll collected $0.05 from pot
Scaaalll: doesn't show hand 
*** SUMMARY ***
Total pot $0.05 | Rake $0 
Seat 1: Scaaalll (button) collected ($0.05)
Seat 2: 888lifeIS (small blind) folded before Flop
Seat 3: johnpa89 (big blind) folded before Flop
Seat 4: SIGREX folded before Flop (didn't bet)
Seat 5: MKIronCrAAzy folded before Flop (didn't bet)
Seat 6: kukulagosleep folded before Flop (didn't bet)



PokerStars Zoom Hand #229233352546:  Hold'em No Limit ($0.01/$0.02) - 2021/08/21 23:26:40 CET [2021/08/21 17:26:40 ET]
Table 'Halley' 6-max Seat #1 is the button
Seat 1: alphabeta1d ($2 in chips) 
Seat 2: kukulagosleep ($3.69 in chips) 
Seat 3: Dakosm ($3.42 in chips) 
Seat 4: Kb013497 ($2.14 in chips) 
Seat 5: Scaaalll ($3.41 in chips) 
Seat 6: estelionat171 ($0.58 in chips) 
kukulagosleep: posts small blind $0.01
Dakosm: posts big blind $0.02
*** HOLE CARDS ***
Dealt to Scaaalll [3c Jc]
Kb013497: folds 
Scaaalll: folds 
estelionat171: folds 
alphabeta1d: folds 
kukulagosleep: folds 
Uncalled bet ($0.01) returned to Dakosm
Dakosm collected $0.02 from pot
Dakosm: doesn't show hand 
*** SUMMARY ***
Total pot $0.02 | Rake $0 
Seat 1: alphabeta1d (button) folded before Flop (didn't bet)
Seat 2: kukulagosleep (small blind) folded before Flop
Seat 3: Dakosm (big blind) collected ($0.02)
Seat 4: Kb013497 folded before Flop (didn't bet)
Seat 5: Scaaalll folded before Flop (didn't bet)
Seat 6: estelionat171 folded before Flop (didn't bet)



PokerStars Zoom Hand #229233355983:  Hold'em No Limit ($0.01/$0.02) - 2021/08/21 23:26:48 CET [2021/08/21 17:26:48 ET]
Table 'Halley' 6-max Seat #1 is the button
Seat 1: adrianh2002 ($2 in chips) 
Seat 2: Reipinguimm ($3.33 in chips) 
Seat 3: lucksuckdonk ($6.64 in chips) 
Seat 4: Scaaalll ($3.41 in chips) 
Seat 5: estelionat171 ($1.26 in chips) 
Seat 6: roukoun1984 ($1.23 in chips) 
Reipinguimm: posts small blind $0.01
lucksuckdonk: posts big blind $0.02
*** HOLE CARDS ***
Dealt to Scaaalll [8d Ah]
Scaaalll: folds 
roukoun1984 is disconnected 
estelionat171: folds 
roukoun1984: folds 
adrianh2002: folds 
Reipinguimm: raises $0.04 to $0.06
lucksuckdonk: folds 
Uncalled bet ($0.04) returned to Reipinguimm
Reipinguimm collected $0.04 from pot
Reipinguimm: doesn't show hand 
*** SUMMARY ***
Total pot $0.04 | Rake $0 
Seat 1: adrianh2002 (button) folded before Flop (didn't bet)
Seat 2: Reipinguimm (small blind) collected ($0.04)
Seat 3: lucksuckdonk (big blind) folded before Flop
Seat 4: Scaaalll folded before Flop (didn't bet)
Seat 5: estelionat171 folded before Flop (didn't bet)
Seat 6: roukoun1984 folded before Flop (didn't bet)



PokerStars Zoom Hand #229233338671:  Hold'em No Limit ($0.01/$0.02) - 2021/08/21 23:26:07 CET [2021/08/21 17:26:07 ET]
Table 'Halley' 6-max Seat #1 is the button
Seat 1: TTGemi ($2.55 in chips) 
Seat 2: Mr.Kurier ($4.49 in chips) 
Seat 3: SIGREX ($2.79 in chips) 
Seat 4: pavlo8855 ($2.67 in chips) 
Seat 5: fishh_play ($2.15 in chips) 
Seat 6: Scaaalll ($3.38 in chips) 
Mr.Kurier: posts small blind $0.01
SIGREX: posts big blind $0.02
*** HOLE CARDS ***
Dealt to Scaaalll [7h Jc]
pavlo8855: folds 
fishh_play: raises $0.03 to $0.05
Scaaalll: folds 
TTGemi: raises $0.19 to $0.24
Mr.Kurier: folds 
SIGREX: folds 
fishh_play: calls $0.19
*** FLOP *** [2d Kc 5h]
fishh_play: checks 
TTGemi: bets $0.16
fishh_play: calls $0.16
*** TURN *** [2d Kc 5h] [5s]
fishh_play: bets $0.46
TTGemi: folds 
Uncalled bet ($0.46) returned to fishh_play
fishh_play collected $0.80 from pot
fishh_play: doesn't show hand 
*** SUMMARY ***
Total pot $0.83 | Rake $0.03 
Board [2d Kc 5h 5s]
Seat 1: TTGemi (button) folded on the Turn
Seat 2: Mr.Kurier (small blind) folded before Flop
Seat 3: SIGREX (big blind) folded before Flop
Seat 4: pavlo8855 folded before Flop (didn't bet)
Seat 5: fishh_play collected ($0.80)
Seat 6: Scaaalll folded before Flop (didn't bet)



PokerStars Zoom Hand #229233354334:  Hold'em No Limit ($0.01/$0.02) - 2021/08/21 23:26:44 CET [2021/08/21 17:26:44 ET]
Table 'Halley' 6-max Seat #1 is the button
Seat 1: Scaaalll ($3.41 in chips) 
Seat 2: Cineva81 ($2.53 in chips) 
Seat 3: alphabeta1d ($2 in chips) 
Seat 4: Jones278 ($2.31 in chips) 
Seat 5: KKARMELO ($2 in chips) 
Seat 6: LSDenny ($2.51 in chips) 
Cineva81: posts small blind $0.01
alphabeta1d: posts big blind $0.02
*** HOLE CARDS ***
Dealt to Scaaalll [Kh 3d]
LSDenny is disconnected 
Jones278: raises $0.04 to $0.06
KKARMELO: raises $0.12 to $0.18
LSDenny: folds 
Scaaalll: folds 
Cineva81: folds 
alphabeta1d: folds 
Jones278: calls $0.12
*** FLOP *** [Qs 9h Js]
Jones278: checks 
KKARMELO: checks 
*** TURN *** [Qs 9h Js] [Jc]
Jones278: checks 
KKARMELO: checks 
*** RIVER *** [Qs 9h Js Jc] [6h]
Jones278: checks 
KKARMELO: checks 
*** SHOW DOWN ***
Jones278: shows [3s 3c] (two pair, Jacks and Threes)
KKARMELO: shows [Th Ts] (two pair, Jacks and Tens)
KKARMELO collected $0.38 from pot
*** SUMMARY ***
Total pot $0.39 | Rake $0.01 
Board [Qs 9h Js Jc 6h]
Seat 1: Scaaalll (button) folded before Flop (didn't bet)
Seat 2: Cineva81 (small blind) folded before Flop
Seat 3: alphabeta1d (big blind) folded before Flop
Seat 4: Jones278 showed [3s 3c] and lost with two pair, Jacks and Threes
Seat 5: KKARMELO showed [Th Ts] and won ($0.38) with two pair, Jacks and Tens
Seat 6: LSDenny folded before Flop (didn't bet)



PokerStars Zoom Hand #229233357655:  Hold'em No Limit ($0.01/$0.02) - 2021/08/21 23:26:52 CET [2021/08/21 17:26:52 ET]
Table 'Halley' 6-max Seat #1 is the button
Seat 1: OFSHOR ($3.25 in chips) 
Seat 2: Habarovs18 ($2.62 in chips) 
Seat 3: Scaaalll ($3.41 in chips) 
Seat 4: Reipinguimm ($2.02 in chips) 
Seat 5: Espartacus5222 ($4.94 in chips) 
Seat 6: Ck@tih@ ($0.83 in chips) 
Habarovs18: posts small blind $0.01
Scaaalll: posts big blind $0.02
*** HOLE CARDS ***
Dealt to Scaaalll [Kd Qs]
Reipinguimm: folds 
Habarovs18 is disconnected 
Espartacus5222: raises $0.04 to $0.06
Ck@tih@: folds 
OFSHOR: folds 
Habarovs18: folds 
Scaaalll: calls $0.04
*** FLOP *** [8s Jh Kh]
Scaaalll: checks 
Espartacus5222: bets $0.04
Scaaalll: calls $0.04
*** TURN *** [8s Jh Kh] [Th]
Scaaalll: checks 
Espartacus5222: checks 
*** RIVER *** [8s Jh Kh Th] [Ad]
Scaaalll: bets $0.09
Espartacus5222: raises $0.38 to $0.47
Scaaalll: folds 
Uncalled bet ($0.38) returned to Espartacus5222
Espartacus5222 collected $0.38 from pot
Espartacus5222: doesn't show hand 
*** SUMMARY ***
Total pot $0.39 | Rake $0.01 
Board [8s Jh Kh Th Ad]
Seat 1: OFSHOR (button) folded before Flop (didn't bet)
Seat 2: Habarovs18 (small blind) folded before Flop
Seat 3: Scaaalll (big blind) folded on the River
Seat 4: Reipinguimm folded before Flop (didn't bet)
Seat 5: Espartacus5222 collected ($0.38)
Seat 6: Ck@tih@ folded before Flop (didn't bet)



PokerStars Zoom Hand #229233383730:  Hold'em No Limit ($0.01/$0.02) - 2021/08/21 23:27:54 CET [2021/08/21 17:27:54 ET]
Table 'Halley' 6-max Seat #1 is the button
Seat 1: Healthys07 ($3.17 in chips) 
Seat 2: rodrigoasor ($3.61 in chips) 
Seat 3: timatrue ($2.12 in chips) 
Seat 4: Mikmaq Caper ($1.34 in chips) 
Seat 5: Scaaalll ($3.22 in chips) 
Seat 6: Dr.stromg ($2 in chips) 
rodrigoasor: posts small blind $0.01
timatrue: posts big blind $0.02
*** HOLE CARDS ***
Dealt to Scaaalll [2c 5c]
Mikmaq Caper: calls $0.02
Scaaalll: folds 
Dr.stromg: folds 
Healthys07: folds 
rodrigoasor: folds 
timatrue: checks 
*** FLOP *** [Kd 3s As]
timatrue: checks 
Mikmaq Caper: bets $0.02
timatrue: calls $0.02
*** TURN *** [Kd 3s As] [2d]
timatrue: checks 
Mikmaq Caper: checks 
*** RIVER *** [Kd 3s As 2d] [6s]
timatrue: checks 
Mikmaq Caper: bets $0.02
timatrue: folds 
Uncalled bet ($0.02) returned to Mikmaq Caper
Mikmaq Caper collected $0.09 from pot
Mikmaq Caper: doesn't show hand 
timatrue is disconnected 
*** SUMMARY ***
Total pot $0.09 | Rake $0 
Board [Kd 3s As 2d 6s]
Seat 1: Healthys07 (button) folded before Flop (didn't bet)
Seat 2: rodrigoasor (small blind) folded before Flop
Seat 3: timatrue (big blind) folded on the River
Seat 4: Mikmaq Caper collected ($0.09)
Seat 5: Scaaalll folded before Flop (didn't bet)
Seat 6: Dr.stromg folded before Flop (didn't bet)



PokerStars Zoom Hand #229233395570:  Hold'em No Limit ($0.01/$0.02) - 2021/08/21 23:28:22 CET [2021/08/21 17:28:22 ET]
Table 'Halley' 6-max Seat #1 is the button
Seat 1: PapiMik3 ($3.24 in chips) 
Seat 2: estelionat171 ($1.18 in chips) 
Seat 3: zzooll 9 ($2.97 in chips) 
Seat 4: Feyqdoi ($2.17 in chips) 
Seat 5: Stormzilla ($2.03 in chips) 
Seat 6: Scaaalll ($3.21 in chips) 
estelionat171: posts small blind $0.01
zzooll 9: posts big blind $0.02
*** HOLE CARDS ***
Dealt to Scaaalll [4c 5h]
Feyqdoi: folds 
Stormzilla: folds 
Scaaalll: folds 
PapiMik3: folds 
estelionat171: folds 
Uncalled bet ($0.01) returned to zzooll 9
zzooll 9 collected $0.02 from pot
zzooll 9: doesn't show hand 
*** SUMMARY ***
Total pot $0.02 | Rake $0 
Seat 1: PapiMik3 (button) folded before Flop (didn't bet)
Seat 2: estelionat171 (small blind) folded before Flop
Seat 3: zzooll 9 (big blind) collected ($0.02)
Seat 4: Feyqdoi folded before Flop (didn't bet)
Seat 5: Stormzilla folded before Flop (didn't bet)
Seat 6: Scaaalll folded before Flop (didn't bet)



PokerStars Zoom Hand #229233388756:  Hold'em No Limit ($0.01/$0.02) - 2021/08/21 23:28:06 CET [2021/08/21 17:28:06 ET]
Table 'Halley' 6-max Seat #1 is the button
Seat 1: rotfei02 ($2.95 in chips) 
Seat 2: Scaaalll ($3.22 in chips) 
Seat 3: Treadero ($2.46 in chips) 
Seat 4: TM 69 UIE ($2.21 in chips) 
Seat 5: *88VIC88* ($1.32 in chips) 
Seat 6: gilberto98 ($1.84 in chips) 
Scaaalll: posts small blind $0.01
Treadero: posts big blind $0.02
*** HOLE CARDS ***
Dealt to Scaaalll [2d Jd]
TM 69 UIE: folds 
TM 69 UIE is disconnected 
*88VIC88*: calls $0.02
gilberto98 has timed out
gilberto98: folds 
rotfei02: calls $0.02
Scaaalll: folds 
Treadero: checks 
*** FLOP *** [Js Tc 9s]
Treadero: checks 
*88VIC88*: checks 
rotfei02: bets $0.05
Treadero: folds 
*88VIC88*: calls $0.05
*** TURN *** [Js Tc 9s] [Ah]
*88VIC88*: checks 
rotfei02: checks 
*** RIVER *** [Js Tc 9s Ah] [5s]
*88VIC88*: bets $1.25 and is all-in
rotfei02: folds 
Uncalled bet ($1.25) returned to *88VIC88*
*88VIC88* collected $0.16 from pot
*88VIC88*: doesn't show hand 
*** SUMMARY ***
Total pot $0.17 | Rake $0.01 
Board [Js Tc 9s Ah 5s]
Seat 1: rotfei02 (button) folded on the River
Seat 2: Scaaalll (small blind) folded before Flop
Seat 3: Treadero (big blind) folded on the Flop
Seat 4: TM 69 UIE folded before Flop (didn't bet)
Seat 5: *88VIC88* collected ($0.16)
Seat 6: gilberto98 folded before Flop (didn't bet)



PokerStars Zoom Hand #229233397213:  Hold'em No Limit ($0.01/$0.02) - 2021/08/21 23:28:26 CET [2021/08/21 17:28:26 ET]
Table 'Halley' 6-max Seat #1 is the button
Seat 1: MetalCrüe ($1.82 in chips) 
Seat 2: cutter2468 ($6.75 in chips) 
Seat 3: isurusa ($0.85 in chips) 
Seat 4: Scaaalll ($3.21 in chips) 
Seat 5: ussr246 ($2.87 in chips) 
Seat 6: Koldun 2636 ($3.94 in chips) 
cutter2468: posts small blind $0.01
isurusa: posts big blind $0.02
*** HOLE CARDS ***
Dealt to Scaaalll [Tc 9s]
Scaaalll: folds 
ussr246: folds 
Koldun 2636: folds 
MetalCrüe: raises $0.04 to $0.06
cutter2468: folds 
isurusa: folds 
Uncalled bet ($0.04) returned to MetalCrüe
MetalCrüe collected $0.05 from pot
MetalCrüe: doesn't show hand 
*** SUMMARY ***
Total pot $0.05 | Rake $0 
Seat 1: MetalCrüe (button) collected ($0.05)
Seat 2: cutter2468 (small blind) folded before Flop
Seat 3: isurusa (big blind) folded before Flop
Seat 4: Scaaalll folded before Flop (didn't bet)
Seat 5: ussr246 folded before Flop (didn't bet)
Seat 6: Koldun 2636 folded before Flop (didn't bet)



PokerStars Zoom Hand #229233398913:  Hold'em No Limit ($0.01/$0.02) - 2021/08/21 23:28:30 CET [2021/08/21 17:28:30 ET]
Table 'Halley' 6-max Seat #1 is the button
Seat 1: 888lifeIS ($2.03 in chips) 
Seat 2: ussr246 ($2.87 in chips) 
Seat 3: Scaaalll ($3.21 in chips) 
Seat 4: nightwacher ($1.03 in chips) 
Seat 5: djovex ($1.49 in chips) 
Seat 6: KonopDima ($2.16 in chips) 
ussr246: posts small blind $0.01
Scaaalll: posts big blind $0.02
*** HOLE CARDS ***
Dealt to Scaaalll [Ts 3c]
djovex is disconnected 
nightwacher: folds 
djovex: folds 
KonopDima: raises $0.04 to $0.06
888lifeIS: folds 
ussr246: folds 
Scaaalll: folds 
Uncalled bet ($0.04) returned to KonopDima
KonopDima collected $0.05 from pot
KonopDima: doesn't show hand 
*** SUMMARY ***
Total pot $0.05 | Rake $0 
Seat 1: 888lifeIS (button) folded before Flop (didn't bet)
Seat 2: ussr246 (small blind) folded before Flop
Seat 3: Scaaalll (big blind) folded before Flop
Seat 4: nightwacher folded before Flop (didn't bet)
Seat 5: djovex folded before Flop (didn't bet)
Seat 6: KonopDima collected ($0.05)



PokerStars Zoom Hand #229233405657:  Hold'em No Limit ($0.01/$0.02) - 2021/08/21 23:28:46 CET [2021/08/21 17:28:46 ET]
Table 'Halley' 6-max Seat #1 is the button
Seat 1: plmanuelpl ($0.26 in chips) 
Seat 2: baksu12 ($2.03 in chips) 
Seat 3: Pechorin.G ($2.04 in chips) 
Seat 4: pavel play pay ($1.76 in chips) 
Seat 5: Scaaalll ($3.19 in chips) 
Seat 6: NoEff0rt2w1n ($2.05 in chips) 
baksu12: posts small blind $0.01
Pechorin.G: posts big blind $0.02
*** HOLE CARDS ***
Dealt to Scaaalll [Kh 3h]
pavel play pay: calls $0.02
Scaaalll: folds 
NoEff0rt2w1n: folds 
plmanuelpl: calls $0.02
baksu12: folds 
Pechorin.G: checks 
*** FLOP *** [Ks 8s 3s]
Pechorin.G: checks 
pavel play pay: bets $0.07
plmanuelpl: folds 
Pechorin.G: folds 
Uncalled bet ($0.07) returned to pavel play pay
plmanuelpl is disconnected 
pavel play pay collected $0.07 from pot
pavel play pay: doesn't show hand 
*** SUMMARY ***
Total pot $0.07 | Rake $0 
Board [Ks 8s 3s]
Seat 1: plmanuelpl (button) folded on the Flop
Seat 2: baksu12 (small blind) folded before Flop
Seat 3: Pechorin.G (big blind) folded on the Flop
Seat 4: pavel play pay collected ($0.07)
Seat 5: Scaaalll folded before Flop (didn't bet)
Seat 6: NoEff0rt2w1n folded before Flop (didn't bet)



PokerStars Zoom Hand #229233408316:  Hold'em No Limit ($0.01/$0.02) - 2021/08/21 23:28:52 CET [2021/08/21 17:28:52 ET]
Table 'Halley' 6-max Seat #1 is the button
Seat 1: adrianh2002 ($3.58 in chips) 
Seat 2: Scaaalll ($3.19 in chips) 
Seat 3: BexleyBoy ($1.97 in chips) 
Seat 4: Valansen ($2 in chips) 
Seat 5: PapiMik3 ($8.72 in chips) 
Seat 6: KM2splashy ($1.18 in chips) 
Scaaalll: posts small blind $0.01
BexleyBoy: posts big blind $0.02
*** HOLE CARDS ***
Dealt to Scaaalll [2d Ah]
Valansen: folds 
KM2splashy is disconnected 
PapiMik3: folds 
KM2splashy: folds 
adrianh2002: raises $0.03 to $0.05
Scaaalll: folds 
BexleyBoy: folds 
Uncalled bet ($0.03) returned to adrianh2002
adrianh2002 collected $0.05 from pot
adrianh2002: doesn't show hand 
*** SUMMARY ***
Total pot $0.05 | Rake $0 
Seat 1: adrianh2002 (button) collected ($0.05)
Seat 2: Scaaalll (small blind) folded before Flop
Seat 3: BexleyBoy (big blind) folded before Flop
Seat 4: Valansen folded before Flop (didn't bet)
Seat 5: PapiMik3 folded before Flop (didn't bet)
Seat 6: KM2splashy folded before Flop (didn't bet)



PokerStars Zoom Hand #229233414233:  Hold'em No Limit ($0.01/$0.02) - 2021/08/21 23:29:06 CET [2021/08/21 17:29:06 ET]
Table 'Halley' 6-max Seat #1 is the button
Seat 1: Scaaalll ($3.18 in chips) 
Seat 2: dannyluijten ($2.51 in chips) 
Seat 3: Cineva81 ($2 in chips) 
Seat 4: GVMELLO ($2.07 in chips) 
Seat 5: kumka8812 ($0.81 in chips) 
Seat 6: BDrew1 ($2 in chips) 
dannyluijten: posts small blind $0.01
Cineva81: posts big blind $0.02
*** HOLE CARDS ***
Dealt to Scaaalll [7s 6c]
GVMELLO: folds 
kumka8812: calls $0.02
BDrew1: folds 
Scaaalll: folds 
dannyluijten: raises $0.04 to $0.06
Cineva81: folds 
kumka8812: calls $0.04
*** FLOP *** [8d 6d Kc]
dannyluijten: bets $0.07
kumka8812: calls $0.07
*** TURN *** [8d 6d Kc] [4d]
dannyluijten: checks 
kumka8812: checks 
*** RIVER *** [8d 6d Kc 4d] [4h]
dannyluijten: checks 
kumka8812: checks 
*** SHOW DOWN ***
dannyluijten: shows [9s Qs] (a pair of Fours)
kumka8812: shows [5s Ah] (a pair of Fours - Ace kicker)
kumka8812 collected $0.27 from pot
*** SUMMARY ***
Total pot $0.28 | Rake $0.01 
Board [8d 6d Kc 4d 4h]
Seat 1: Scaaalll (button) folded before Flop (didn't bet)
Seat 2: dannyluijten (small blind) showed [9s Qs] and lost with a pair of Fours
Seat 3: Cineva81 (big blind) folded before Flop
Seat 4: GVMELLO folded before Flop (didn't bet)
Seat 5: kumka8812 showed [5s Ah] and won ($0.27) with a pair of Fours
Seat 6: BDrew1 folded before Flop (didn't bet)



PokerStars Zoom Hand #229233418419:  Hold'em No Limit ($0.01/$0.02) - 2021/08/21 23:29:16 CET [2021/08/21 17:29:16 ET]
Table 'Halley' 6-max Seat #1 is the button
Seat 1: ivorypiano ($1.89 in chips) 
Seat 2: nodtress ($2.23 in chips) 
Seat 3: KM2splashy ($1.17 in chips) 
Seat 4: estelionat171 ($1.14 in chips) 
Seat 5: punkosk8 ($3.54 in chips) 
Seat 6: Scaaalll ($3.18 in chips) 
nodtress: posts small blind $0.01
KM2splashy: posts big blind $0.02
*** HOLE CARDS ***
Dealt to Scaaalll [As Qc]
estelionat171: folds 
punkosk8: folds 
punkosk8 is disconnected 
Scaaalll: raises $0.04 to $0.06
ivorypiano: folds 
nodtress: folds 
KM2splashy: calls $0.04
*** FLOP *** [Kc 3s 8s]
KM2splashy: checks 
Scaaalll: bets $0.08
KM2splashy: folds 
Uncalled bet ($0.08) returned to Scaaalll
Scaaalll collected $0.13 from pot
Scaaalll: doesn't show hand 
KM2splashy is disconnected 
*** SUMMARY ***
Total pot $0.13 | Rake $0 
Board [Kc 3s 8s]
Seat 1: ivorypiano (button) folded before Flop (didn't bet)
Seat 2: nodtress (small blind) folded before Flop
Seat 3: KM2splashy (big blind) folded on the Flop
Seat 4: estelionat171 folded before Flop (didn't bet)
Seat 5: punkosk8 folded before Flop (didn't bet)
Seat 6: Scaaalll collected ($0.13)



PokerStars Zoom Hand #229233415899:  Hold'em No Limit ($0.01/$0.02) - 2021/08/21 23:29:10 CET [2021/08/21 17:29:10 ET]
Table 'Halley' 6-max Seat #1 is the button
Seat 1: San4oWV ($1.97 in chips) 
Seat 2: El Chicha.CL ($2.05 in chips) 
Seat 3: calybahia27 ($5.47 in chips) 
Seat 4: Scaaalll ($3.18 in chips) 
Seat 5: ronald1982 ($2.66 in chips) 
Seat 6: Xlavariable ($2 in chips) 
El Chicha.CL: posts small blind $0.01
calybahia27: posts big blind $0.02
*** HOLE CARDS ***
Dealt to Scaaalll [8d 9d]
Scaaalll: folds 
ronald1982: folds 
Xlavariable: folds 
San4oWV: raises $0.04 to $0.06
El Chicha.CL: folds 
calybahia27: calls $0.04
*** FLOP *** [4d Kh 7s]
calybahia27: checks 
San4oWV: bets $0.06
calybahia27: folds 
Uncalled bet ($0.06) returned to San4oWV
San4oWV collected $0.13 from pot
San4oWV: doesn't show hand 
*** SUMMARY ***
Total pot $0.13 | Rake $0 
Board [4d Kh 7s]
Seat 1: San4oWV (button) collected ($0.13)
Seat 2: El Chicha.CL (small blind) folded before Flop
Seat 3: calybahia27 (big blind) folded on the Flop
Seat 4: Scaaalll folded before Flop (didn't bet)
Seat 5: ronald1982 folded before Flop (didn't bet)
Seat 6: Xlavariable folded before Flop (didn't bet)



PokerStars Zoom Hand #229233430999:  Hold'em No Limit ($0.01/$0.02) - 2021/08/21 23:29:46 CET [2021/08/21 17:29:46 ET]
Table 'Halley' 6-max Seat #1 is the button
Seat 1: WhoBetsWins ($5.81 in chips) 
Seat 2: leeroy818 ($2.06 in chips) 
Seat 3: Cineva81 ($2.23 in chips) 
Seat 4: Scaaalll ($3.25 in chips) 
Seat 5: GGopenBet ($2.79 in chips) 
Seat 6: WaiT4U ($4.27 in chips) 
leeroy818: posts small blind $0.01
Cineva81: posts big blind $0.02
*** HOLE CARDS ***
Dealt to Scaaalll [8s Ks]
Scaaalll: folds 
GGopenBet: folds 
GGopenBet is disconnected 
WaiT4U: folds 
WhoBetsWins: folds 
leeroy818: folds 
Uncalled bet ($0.01) returned to Cineva81
Cineva81 collected $0.02 from pot
Cineva81: doesn't show hand 
*** SUMMARY ***
Total pot $0.02 | Rake $0 
Seat 1: WhoBetsWins (button) folded before Flop (didn't bet)
Seat 2: leeroy818 (small blind) folded before Flop
Seat 3: Cineva81 (big blind) collected ($0.02)
Seat 4: Scaaalll folded before Flop (didn't bet)
Seat 5: GGopenBet folded before Flop (didn't bet)
Seat 6: WaiT4U folded before Flop (didn't bet)



PokerStars Zoom Hand #229233432637:  Hold'em No Limit ($0.01/$0.02) - 2021/08/21 23:29:50 CET [2021/08/21 17:29:50 ET]
Table 'Halley' 6-max Seat #1 is the button
Seat 1: castrosis ($3.41 in chips) 
Seat 2: cutter2468 ($2.15 in chips) 
Seat 3: Scaaalll ($3.25 in chips) 
Seat 4: FreddyFlips ($1.95 in chips) 
Seat 5: Shoxuzb ($1.76 in chips) 
Seat 6: ukesco ($1.30 in chips) 
cutter2468: posts small blind $0.01
Scaaalll: posts big blind $0.02
*** HOLE CARDS ***
Dealt to Scaaalll [6c 8c]
FreddyFlips: folds 
FreddyFlips is disconnected 
Shoxuzb: folds 
ukesco: folds 
Shoxuzb is disconnected 
castrosis: folds 
cutter2468: raises $0.03 to $0.05
Scaaalll: calls $0.03
*** FLOP *** [Qc Jc Kd]
cutter2468: checks 
Scaaalll: bets $0.06
cutter2468: raises $0.06 to $0.12
Scaaalll: calls $0.06
*** TURN *** [Qc Jc Kd] [Jd]
cutter2468: bets $0.21
Scaaalll: folds 
Uncalled bet ($0.21) returned to cutter2468
cutter2468 collected $0.33 from pot
cutter2468: doesn't show hand 
*** SUMMARY ***
Total pot $0.34 | Rake $0.01 
Board [Qc Jc Kd Jd]
Seat 1: castrosis (button) folded before Flop (didn't bet)
Seat 2: cutter2468 (small blind) collected ($0.33)
Seat 3: Scaaalll (big blind) folded on the Turn
Seat 4: FreddyFlips folded before Flop (didn't bet)
Seat 5: Shoxuzb folded before Flop (didn't bet)
Seat 6: ukesco folded before Flop (didn't bet)



PokerStars Zoom Hand #229233448698:  Hold'em No Limit ($0.01/$0.02) - 2021/08/21 23:30:28 CET [2021/08/21 17:30:28 ET]
Table 'Halley' 6-max Seat #1 is the button
Seat 1: Scaaalll ($3.08 in chips) 
Seat 2: zergmiky ($2.07 in chips) 
Seat 3: Sadikson ($2.25 in chips) 
Seat 4: maliniak75 ($3.06 in chips) 
Seat 5: Soko 1381 ($2.08 in chips) 
Seat 6: 888lifeIS ($2 in chips) 
zergmiky: posts small blind $0.01
Sadikson: posts big blind $0.02
*** HOLE CARDS ***
Dealt to Scaaalll [Th Kh]
maliniak75: calls $0.02
Soko 1381: folds 
888lifeIS: folds 
Scaaalll: raises $0.07 to $0.09
zergmiky: folds 
Sadikson: folds 
Sadikson is disconnected 
maliniak75: calls $0.07
*** FLOP *** [5d 6d Qc]
maliniak75: checks 
Scaaalll: bets $0.12
maliniak75: folds 
Uncalled bet ($0.12) returned to Scaaalll
Scaaalll collected $0.20 from pot
Scaaalll: doesn't show hand 
*** SUMMARY ***
Total pot $0.21 | Rake $0.01 
Board [5d 6d Qc]
Seat 1: Scaaalll (button) collected ($0.20)
Seat 2: zergmiky (small blind) folded before Flop
Seat 3: Sadikson (big blind) folded before Flop
Seat 4: maliniak75 folded on the Flop
Seat 5: Soko 1381 folded before Flop (didn't bet)
Seat 6: 888lifeIS folded before Flop (didn't bet)



PokerStars Zoom Hand #229233469660:  Hold'em No Limit ($0.01/$0.02) - 2021/08/21 23:31:18 CET [2021/08/21 17:31:18 ET]
Table 'Halley' 6-max Seat #1 is the button
Seat 1: Mikeloko182 ($3.29 in chips) 
Seat 2: Umnik_M ($2 in chips) 
Seat 3: leeroy818 ($2 in chips) 
Seat 4: ronald1982 ($1.21 in chips) 
Seat 5: Scaaalll ($3.18 in chips) 
Seat 6: so0love ($2.16 in chips) 
Umnik_M: posts small blind $0.01
leeroy818: posts big blind $0.02
*** HOLE CARDS ***
Dealt to Scaaalll [9h 5s]
ronald1982: folds 
Scaaalll: folds 
so0love: folds 
Mikeloko182: folds 
Umnik_M: folds 
Uncalled bet ($0.01) returned to leeroy818
leeroy818 collected $0.02 from pot
leeroy818: doesn't show hand 
*** SUMMARY ***
Total pot $0.02 | Rake $0 
Seat 1: Mikeloko182 (button) folded before Flop (didn't bet)
Seat 2: Umnik_M (small blind) folded before Flop
Seat 3: leeroy818 (big blind) collected ($0.02)
Seat 4: ronald1982 folded before Flop (didn't bet)
Seat 5: Scaaalll folded before Flop (didn't bet)
Seat 6: so0love folded before Flop (didn't bet)



PokerStars Zoom Hand #229233461787:  Hold'em No Limit ($0.01/$0.02) - 2021/08/21 23:30:59 CET [2021/08/21 17:30:59 ET]
Table 'Halley' 6-max Seat #1 is the button
Seat 1: Ape$apiens ($2.01 in chips) 
Seat 2: Scaaalll ($3.19 in chips) 
Seat 3: GGopenBet ($2.52 in chips) 
Seat 4: Dr.stromg ($5.12 in chips) 
Seat 5: Sadikson ($2.22 in chips) 
Seat 6: hairy navel ($1.96 in chips) 
Scaaalll: posts small blind $0.01
GGopenBet: posts big blind $0.02
*** HOLE CARDS ***
Dealt to Scaaalll [3d Qd]
Sadikson is disconnected 
Dr.stromg: folds 
Sadikson: folds 
hairy navel: calls $0.02
Ape$apiens: calls $0.02
Scaaalll: folds 
GGopenBet: checks 
*** FLOP *** [7h 7c 3c]
GGopenBet: checks 
hairy navel: checks 
Ape$apiens: bets $0.07
GGopenBet: folds 
GGopenBet is disconnected 
hairy navel: folds 
Uncalled bet ($0.07) returned to Ape$apiens
Ape$apiens collected $0.07 from pot
Ape$apiens: doesn't show hand 
*** SUMMARY ***
Total pot $0.07 | Rake $0 
Board [7h 7c 3c]
Seat 1: Ape$apiens (button) collected ($0.07)
Seat 2: Scaaalll (small blind) folded before Flop
Seat 3: GGopenBet (big blind) folded on the Flop
Seat 4: Dr.stromg folded before Flop (didn't bet)
Seat 5: Sadikson folded before Flop (didn't bet)
Seat 6: hairy navel folded on the Flop



PokerStars Zoom Hand #229233465128:  Hold'em No Limit ($0.01/$0.02) - 2021/08/21 23:31:07 CET [2021/08/21 17:31:07 ET]
Table 'Halley' 6-max Seat #1 is the button
Seat 1: sg.32rus ($3.43 in chips) 
Seat 2: bioern ($2.01 in chips) 
Seat 3: HubertFroh ($4.48 in chips) 
Seat 4: DrewRich420 ($3.95 in chips) 
Seat 5: BeastBoy18 ($2.09 in chips) 
Seat 6: Scaaalll ($3.18 in chips) 
bioern: posts small blind $0.01
HubertFroh: posts big blind $0.02
*** HOLE CARDS ***
Dealt to Scaaalll [6c Ad]
DrewRich420: calls $0.02
BeastBoy18: folds 
Scaaalll: folds 
sg.32rus: folds 
bioern: raises $0.04 to $0.06
HubertFroh: folds 
DrewRich420: calls $0.04
*** FLOP *** [6s Th Ks]
bioern: bets $0.08
DrewRich420: folds 
Uncalled bet ($0.08) returned to bioern
bioern collected $0.14 from pot
bioern: doesn't show hand 
DrewRich420 is disconnected 
*** SUMMARY ***
Total pot $0.14 | Rake $0 
Board [6s Th Ks]
Seat 1: sg.32rus (button) folded before Flop (didn't bet)
Seat 2: bioern (small blind) collected ($0.14)
Seat 3: HubertFroh (big blind) folded before Flop
Seat 4: DrewRich420 folded on the Flop
Seat 5: BeastBoy18 folded before Flop (didn't bet)
Seat 6: Scaaalll folded before Flop (didn't bet)



PokerStars Zoom Hand #229233474627:  Hold'em No Limit ($0.01/$0.02) - 2021/08/21 23:31:30 CET [2021/08/21 17:31:30 ET]
Table 'Halley' 6-max Seat #1 is the button
Seat 1: Scaaalll ($3.16 in chips) 
Seat 2: Cineva81 ($2.01 in chips) 
Seat 3: lucksuckdonk ($3.61 in chips) 
Seat 4: jaamonra ($2.55 in chips) 
Seat 5: Ne0net ($2 in chips) 
Seat 6: udav26 ($2.31 in chips) 
Cineva81: posts small blind $0.01
lucksuckdonk: posts big blind $0.02
*** HOLE CARDS ***
Dealt to Scaaalll [5d 4d]
jaamonra: folds 
Ne0net: folds 
udav26: folds 
Scaaalll: raises $0.03 to $0.05
Cineva81: folds 
lucksuckdonk: folds 
Uncalled bet ($0.03) returned to Scaaalll
Scaaalll collected $0.05 from pot
Scaaalll: doesn't show hand 
*** SUMMARY ***
Total pot $0.05 | Rake $0 
Seat 1: Scaaalll (button) collected ($0.05)
Seat 2: Cineva81 (small blind) folded before Flop
Seat 3: lucksuckdonk (big blind) folded before Flop
Seat 4: jaamonra folded before Flop (didn't bet)
Seat 5: Ne0net folded before Flop (didn't bet)
Seat 6: udav26 folded before Flop (didn't bet)



PokerStars Zoom Hand #229233471289:  Hold'em No Limit ($0.01/$0.02) - 2021/08/21 23:31:22 CET [2021/08/21 17:31:22 ET]
Table 'Halley' 6-max Seat #1 is the button
Seat 1: franek369 ($5.35 in chips) 
Seat 2: alexan00 ($3.18 in chips) 
Seat 3: Scaaalll ($3.18 in chips) 
Seat 4: BeastBoy18 ($3 in chips) 
Seat 5: Pechorin.G ($2.15 in chips) 
Seat 6: rpycmbEM ($3.72 in chips) 
alexan00: posts small blind $0.01
Scaaalll: posts big blind $0.02
*** HOLE CARDS ***
Dealt to Scaaalll [7d 9s]
BeastBoy18: raises $0.04 to $0.06
Pechorin.G: folds 
rpycmbEM: calls $0.06
franek369: calls $0.06
alexan00: folds 
Scaaalll: folds 
*** FLOP *** [Ac 4h 2c]
BeastBoy18: bets $0.07
rpycmbEM: folds 
franek369: folds 
Uncalled bet ($0.07) returned to BeastBoy18
BeastBoy18 collected $0.20 from pot
BeastBoy18: doesn't show hand 
*** SUMMARY ***
Total pot $0.21 | Rake $0.01 
Board [Ac 4h 2c]
Seat 1: franek369 (button) folded on the Flop
Seat 2: alexan00 (small blind) folded before Flop
Seat 3: Scaaalll (big blind) folded before Flop
Seat 4: BeastBoy18 collected ($0.20)
Seat 5: Pechorin.G folded before Flop (didn't bet)
Seat 6: rpycmbEM folded on the Flop



PokerStars Zoom Hand #229233481034:  Hold'em No Limit ($0.01/$0.02) - 2021/08/21 23:31:45 CET [2021/08/21 17:31:45 ET]
Table 'Halley' 6-max Seat #1 is the button
Seat 1: 47911728 ($1.21 in chips) 
Seat 2: Scaaalll ($3.19 in chips) 
Seat 3: shingo594 ($4.85 in chips) 
Seat 4: MattieBOZ ($2.02 in chips) 
Seat 5: MKIronCrAAzy ($5.89 in chips) 
Seat 6: causavera ($0.47 in chips) 
Scaaalll: posts small blind $0.01
shingo594: posts big blind $0.02
*** HOLE CARDS ***
Dealt to Scaaalll [Qh Kd]
MattieBOZ: folds 
MKIronCrAAzy: folds 
MattieBOZ is disconnected 
causavera: raises $0.03 to $0.05
shingo594 is disconnected 
47911728: calls $0.05
Scaaalll: calls $0.04
shingo594: folds 
*** FLOP *** [7c 3c Kc]
Scaaalll: checks 
causavera: checks 
47911728: checks 
*** TURN *** [7c 3c Kc] [Ad]
Scaaalll: checks 
causavera: checks 
47911728: checks 
*** RIVER *** [7c 3c Kc Ad] [Ts]
Scaaalll: checks 
causavera: checks 
47911728: checks 
*** SHOW DOWN ***
Scaaalll: shows [Qh Kd] (a pair of Kings)
causavera: shows [9s As] (a pair of Aces)
47911728: mucks hand 
causavera collected $0.16 from pot
*** SUMMARY ***
Total pot $0.17 | Rake $0.01 
Board [7c 3c Kc Ad Ts]
Seat 1: 47911728 (button) mucked [6s 4s]
Seat 2: Scaaalll (small blind) showed [Qh Kd] and lost with a pair of Kings
Seat 3: shingo594 (big blind) folded before Flop
Seat 4: MattieBOZ folded before Flop (didn't bet)
Seat 5: MKIronCrAAzy folded before Flop (didn't bet)
Seat 6: causavera showed [9s As] and won ($0.16) with a pair of Aces



PokerStars Zoom Hand #229233501546:  Hold'em No Limit ($0.01/$0.02) - 2021/08/21 23:32:34 CET [2021/08/21 17:32:34 ET]
Table 'Halley' 6-max Seat #1 is the button
Seat 1: Jones278 ($2.33 in chips) 
Seat 2: Treadero ($2.31 in chips) 
Seat 3: Koldun 2636 ($4.75 in chips) 
Seat 4: ukesco ($1.17 in chips) 
Seat 5: Scaaalll ($3.14 in chips) 
Seat 6: byakuda ($2.03 in chips) 
Treadero: posts small blind $0.01
Koldun 2636: posts big blind $0.02
*** HOLE CARDS ***
Dealt to Scaaalll [9s 4d]
ukesco: folds 
Scaaalll: folds 
byakuda: folds 
Jones278: folds 
Treadero: folds 
Uncalled bet ($0.01) returned to Koldun 2636
Koldun 2636 collected $0.02 from pot
Koldun 2636: doesn't show hand 
*** SUMMARY ***
Total pot $0.02 | Rake $0 
Seat 1: Jones278 (button) folded before Flop (didn't bet)
Seat 2: Treadero (small blind) folded before Flop
Seat 3: Koldun 2636 (big blind) collected ($0.02)
Seat 4: ukesco folded before Flop (didn't bet)
Seat 5: Scaaalll folded before Flop (didn't bet)
Seat 6: byakuda folded before Flop (didn't bet)



PokerStars Zoom Hand #229233498208:  Hold'em No Limit ($0.01/$0.02) - 2021/08/21 23:32:26 CET [2021/08/21 17:32:26 ET]
Table 'Halley' 6-max Seat #1 is the button
Seat 1: NoEff0rt2w1n ($5.60 in chips) 
Seat 2: GGopenBet ($2.56 in chips) 
Seat 3: juelz_ua ($1.88 in chips) 
Seat 4: LijanaV ($5.38 in chips) 
Seat 5: botyesz999 ($1.37 in chips) 
Seat 6: Scaaalll ($3.14 in chips) 
GGopenBet: posts small blind $0.01
juelz_ua: posts big blind $0.02
*** HOLE CARDS ***
Dealt to Scaaalll [2d Qh]
LijanaV: calls $0.02
botyesz999: folds 
Scaaalll: folds 
NoEff0rt2w1n: raises $0.07 to $0.09
LijanaV is disconnected 
GGopenBet: folds 
GGopenBet is disconnected 
juelz_ua: folds 
LijanaV: folds 
Uncalled bet ($0.07) returned to NoEff0rt2w1n
juelz_ua is disconnected 
NoEff0rt2w1n collected $0.07 from pot
NoEff0rt2w1n: doesn't show hand 
*** SUMMARY ***
Total pot $0.07 | Rake $0 
Seat 1: NoEff0rt2w1n (button) collected ($0.07)
Seat 2: GGopenBet (small blind) folded before Flop
Seat 3: juelz_ua (big blind) folded before Flop
Seat 4: LijanaV folded before Flop
Seat 5: botyesz999 folded before Flop (didn't bet)
Seat 6: Scaaalll folded before Flop (didn't bet)



PokerStars Zoom Hand #229233503240:  Hold'em No Limit ($0.01/$0.02) - 2021/08/21 23:32:38 CET [2021/08/21 17:32:38 ET]
Table 'Halley' 6-max Seat #1 is the button
Seat 1: jjLG99 ($1.82 in chips) 
Seat 2: Alexasha78 ($3.18 in chips) 
Seat 3: Cineva81 ($2.02 in chips) 
Seat 4: Scaaalll ($3.14 in chips) 
Seat 5: babiloniaxxx ($4.68 in chips) 
Seat 6: pavlo8855 ($2.22 in chips) 
Alexasha78: posts small blind $0.01
Cineva81: posts big blind $0.02
*** HOLE CARDS ***
Dealt to Scaaalll [3h Qd]
Scaaalll: folds 
Alexasha78 is disconnected 
jjLG99 is disconnected 
babiloniaxxx: raises $0.03 to $0.05
pavlo8855: folds 
jjLG99: folds 
Alexasha78: folds 
Cineva81: calls $0.03
*** FLOP *** [4c 7d 7s]
Cineva81: checks 
babiloniaxxx: checks 
*** TURN *** [4c 7d 7s] [Kd]
Cineva81: checks 
babiloniaxxx: bets $0.09
Cineva81: folds 
Uncalled bet ($0.09) returned to babiloniaxxx
babiloniaxxx collected $0.11 from pot
babiloniaxxx: doesn't show hand 
*** SUMMARY ***
Total pot $0.11 | Rake $0 
Board [4c 7d 7s Kd]
Seat 1: jjLG99 (button) folded before Flop (didn't bet)
Seat 2: Alexasha78 (small blind) folded before Flop
Seat 3: Cineva81 (big blind) folded on the Turn
Seat 4: Scaaalll folded before Flop (didn't bet)
Seat 5: babiloniaxxx collected ($0.11)
Seat 6: pavlo8855 folded before Flop (didn't bet)



PokerStars Zoom Hand #229233504853:  Hold'em No Limit ($0.01/$0.02) - 2021/08/21 23:32:42 CET [2021/08/21 17:32:42 ET]
Table 'Halley' 6-max Seat #1 is the button
Seat 1: prosto lili ($0.85 in chips) 
Seat 2: jaamonra ($2.55 in chips) 
Seat 3: orlovac1995 ($4.77 in chips) 
Seat 4: Scaaalll ($3.14 in chips) 
Seat 5: LucasLMdS ($3.10 in chips) 
Seat 6: Ck@tih@ ($5.51 in chips) 
jaamonra: posts small blind $0.01
orlovac1995: posts big blind $0.02
*** HOLE CARDS ***
Dealt to Scaaalll [Jh Ah]
Scaaalll: raises $0.04 to $0.06
LucasLMdS: folds 
Ck@tih@: folds 
prosto lili: folds 
jaamonra: calls $0.05
orlovac1995: folds 
*** FLOP *** [Js 5h 8c]
jaamonra: checks 
Scaaalll: bets $0.08
jaamonra: raises $0.12 to $0.20
Scaaalll: calls $0.12
*** TURN *** [Js 5h 8c] [6c]
jaamonra: checks 
Scaaalll: bets $0.29
jaamonra: folds 
Uncalled bet ($0.29) returned to Scaaalll
Scaaalll collected $0.52 from pot
Scaaalll: doesn't show hand 
*** SUMMARY ***
Total pot $0.54 | Rake $0.02 
Board [Js 5h 8c 6c]
Seat 1: prosto lili (button) folded before Flop (didn't bet)
Seat 2: jaamonra (small blind) folded on the Turn
Seat 3: orlovac1995 (big blind) folded before Flop
Seat 4: Scaaalll collected ($0.52)
Seat 5: LucasLMdS folded before Flop (didn't bet)
Seat 6: Ck@tih@ folded before Flop (didn't bet)



PokerStars Zoom Hand #229233529249:  Hold'em No Limit ($0.01/$0.02) - 2021/08/21 23:33:41 CET [2021/08/21 17:33:41 ET]
Table 'Halley' 6-max Seat #1 is the button
Seat 1: fabor1303 ($3.40 in chips) 
Seat 2: causavera ($0.50 in chips) 
Seat 3: Scaaalll ($3.40 in chips) 
Seat 4: BexleyBoy ($2.80 in chips) 
Seat 5: Reipinguimm ($2.63 in chips) 
Seat 6: TimBarton ($1.51 in chips) 
causavera: posts small blind $0.01
Scaaalll: posts big blind $0.02
*** HOLE CARDS ***
Dealt to Scaaalll [6s Jc]
BexleyBoy: folds 
Reipinguimm: folds 
TimBarton: raises $0.05 to $0.07
fabor1303: folds 
causavera: folds 
Scaaalll: folds 
Uncalled bet ($0.05) returned to TimBarton
TimBarton collected $0.05 from pot
TimBarton: doesn't show hand 
*** SUMMARY ***
Total pot $0.05 | Rake $0 
Seat 1: fabor1303 (button) folded before Flop (didn't bet)
Seat 2: causavera (small blind) folded before Flop
Seat 3: Scaaalll (big blind) folded before Flop
Seat 4: BexleyBoy folded before Flop (didn't bet)
Seat 5: Reipinguimm folded before Flop (didn't bet)
Seat 6: TimBarton collected ($0.05)



PokerStars Zoom Hand #229233538288:  Hold'em No Limit ($0.01/$0.02) - 2021/08/21 23:34:03 CET [2021/08/21 17:34:03 ET]
Table 'Halley' 6-max Seat #1 is the button
Seat 1: olga3021221 ($2.16 in chips) 
Seat 2: Scaaalll ($3.38 in chips) 
Seat 3: NoEff0rt2w1n ($2 in chips) 
Seat 4: 1984gonzo33 ($1.36 in chips) 
Seat 5: WITKOW_AV ($2 in chips) 
Seat 6: gizum17 ($1.89 in chips) 
Scaaalll: posts small blind $0.01
NoEff0rt2w1n: posts big blind $0.02
*** HOLE CARDS ***
Dealt to Scaaalll [7d 8d]
1984gonzo33: raises $1.34 to $1.36 and is all-in
WITKOW_AV: folds 
gizum17: folds 
olga3021221: folds 
Scaaalll: folds 
NoEff0rt2w1n: folds 
Uncalled bet ($1.34) returned to 1984gonzo33
1984gonzo33 collected $0.05 from pot
1984gonzo33: doesn't show hand 
*** SUMMARY ***
Total pot $0.05 | Rake $0 
Seat 1: olga3021221 (button) folded before Flop (didn't bet)
Seat 2: Scaaalll (small blind) folded before Flop
Seat 3: NoEff0rt2w1n (big blind) folded before Flop
Seat 4: 1984gonzo33 collected ($0.05)
Seat 5: WITKOW_AV folded before Flop (didn't bet)
Seat 6: gizum17 folded before Flop (didn't bet)



PokerStars Zoom Hand #229233551360:  Hold'em No Limit ($0.01/$0.02) - 2021/08/21 23:34:19 CET [2021/08/21 17:34:19 ET]
Table 'Halley' 6-max Seat #1 is the button
Seat 1: Scaaalll ($3.37 in chips) 
Seat 2: PEDACIT0 ($2.40 in chips) 
Seat 3: owtwilldo ($2.47 in chips) 
Seat 4: ronald1982 ($1.04 in chips) 
Seat 5: fabor1303 ($3.38 in chips) 
Seat 6: Gerar NB ($2 in chips) 
PEDACIT0: posts small blind $0.01
owtwilldo: posts big blind $0.02
*** HOLE CARDS ***
Dealt to Scaaalll [8s 7s]
ronald1982: folds 
fabor1303: folds 
Gerar NB: folds 
Scaaalll: raises $0.02 to $0.04
PEDACIT0: raises $0.12 to $0.16
owtwilldo: folds 
Scaaalll: calls $0.12
*** FLOP *** [9c 7c 2d]
PEDACIT0: checks 
Scaaalll: bets $0.18
PEDACIT0: folds 
Uncalled bet ($0.18) returned to Scaaalll
Scaaalll collected $0.33 from pot
Scaaalll: doesn't show hand 
*** SUMMARY ***
Total pot $0.34 | Rake $0.01 
Board [9c 7c 2d]
Seat 1: Scaaalll (button) collected ($0.33)
Seat 2: PEDACIT0 (small blind) folded on the Flop
Seat 3: owtwilldo (big blind) folded before Flop
Seat 4: ronald1982 folded before Flop (didn't bet)
Seat 5: fabor1303 folded before Flop (didn't bet)
Seat 6: Gerar NB folded before Flop (didn't bet)



PokerStars Zoom Hand #229233563717:  Hold'em No Limit ($0.01/$0.02) - 2021/08/21 23:34:49 CET [2021/08/21 17:34:49 ET]
Table 'Halley' 6-max Seat #1 is the button
Seat 1: alphabeta1d ($2.07 in chips) 
Seat 2: tisadaisy ($2.17 in chips) 
Seat 3: phlopit ($2.02 in chips) 
Seat 4: tarogame ($2 in chips) 
Seat 5: Scaaalll ($3.54 in chips) 
Seat 6: Gamer577 ($6.18 in chips) 
tisadaisy: posts small blind $0.01
phlopit: posts big blind $0.02
*** HOLE CARDS ***
Dealt to Scaaalll [As 3d]
tarogame: folds 
Scaaalll: folds 
Gamer577: folds 
alphabeta1d: folds 
tisadaisy: folds 
Uncalled bet ($0.01) returned to phlopit
phlopit collected $0.02 from pot
phlopit: doesn't show hand 
*** SUMMARY ***
Total pot $0.02 | Rake $0 
Seat 1: alphabeta1d (button) folded before Flop (didn't bet)
Seat 2: tisadaisy (small blind) folded before Flop
Seat 3: phlopit (big blind) collected ($0.02)
Seat 4: tarogame folded before Flop (didn't bet)
Seat 5: Scaaalll folded before Flop (didn't bet)
Seat 6: Gamer577 folded before Flop (didn't bet)



PokerStars Zoom Hand #229233566603:  Hold'em No Limit ($0.01/$0.02) - 2021/08/21 23:34:56 CET [2021/08/21 17:34:56 ET]
Table 'Halley' 6-max Seat #1 is the button
Seat 1: djovex ($1.91 in chips) 
Seat 2: Hallyson_23 ($4.62 in chips) 
Seat 3: Koldun 2636 ($4.71 in chips) 
Seat 4: juelz_ua ($1.33 in chips) 
Seat 5: Langusta1 ($1.66 in chips) 
Seat 6: Scaaalll ($3.54 in chips) 
Hallyson_23: posts small blind $0.01
Koldun 2636: posts big blind $0.02
*** HOLE CARDS ***
Dealt to Scaaalll [Ah Jd]
juelz_ua: folds 
juelz_ua is disconnected 
Langusta1: folds 
djovex is disconnected 
Scaaalll: raises $0.04 to $0.06
djovex: folds 
Hallyson_23: folds 
Koldun 2636: folds 
Uncalled bet ($0.04) returned to Scaaalll
Scaaalll collected $0.05 from pot
Scaaalll: doesn't show hand 
*** SUMMARY ***
Total pot $0.05 | Rake $0 
Seat 1: djovex (button) folded before Flop (didn't bet)
Seat 2: Hallyson_23 (small blind) folded before Flop
Seat 3: Koldun 2636 (big blind) folded before Flop
Seat 4: juelz_ua folded before Flop (didn't bet)
Seat 5: Langusta1 folded before Flop (didn't bet)
Seat 6: Scaaalll collected ($0.05)



PokerStars Zoom Hand #229233573122:  Hold'em No Limit ($0.01/$0.02) - 2021/08/21 23:35:12 CET [2021/08/21 17:35:12 ET]
Table 'Halley' 6-max Seat #1 is the button
Seat 1: Scaaalll ($3.57 in chips) 
Seat 2: Bina_sweety ($2.83 in chips) 
Seat 3: fishh_play ($2.63 in chips) 
Seat 4: ash1448 ($13.99 in chips) 
Seat 5: ulisessoria ($3.91 in chips) 
Seat 6: auxy89 ($3.19 in chips) 
Bina_sweety: posts small blind $0.01
fishh_play: posts big blind $0.02
*** HOLE CARDS ***
Dealt to Scaaalll [5d Qc]
ash1448: folds 
auxy89 is disconnected 
ulisessoria: folds 
auxy89: folds 
Scaaalll: folds 
Bina_sweety: folds 
Uncalled bet ($0.01) returned to fishh_play
fishh_play collected $0.02 from pot
fishh_play: doesn't show hand 
*** SUMMARY ***
Total pot $0.02 | Rake $0 
Seat 1: Scaaalll (button) folded before Flop (didn't bet)
Seat 2: Bina_sweety (small blind) folded before Flop
Seat 3: fishh_play (big blind) collected ($0.02)
Seat 4: ash1448 folded before Flop (didn't bet)
Seat 5: ulisessoria folded before Flop (didn't bet)
Seat 6: auxy89 folded before Flop (didn't bet)



PokerStars Zoom Hand #229233583834:  Hold'em No Limit ($0.01/$0.02) - 2021/08/21 23:35:38 CET [2021/08/21 17:35:38 ET]
Table 'Halley' 6-max Seat #1 is the button
Seat 1: ctaceo ($2.02 in chips) 
Seat 2: Scaaalll ($3.55 in chips) 
Seat 3: giselerebelo ($0.86 in chips) 
Seat 4: egroj1700 ($2.08 in chips) 
Seat 5: lauti214 ($1.97 in chips) 
Seat 6: bart8612 ($2.70 in chips) 
Scaaalll: posts small blind $0.01
giselerebelo: posts big blind $0.02
*** HOLE CARDS ***
Dealt to Scaaalll [4h Qc]
egroj1700: folds 
lauti214: folds 
bart8612: folds 
ctaceo: folds 
Scaaalll: folds 
Uncalled bet ($0.01) returned to giselerebelo
giselerebelo collected $0.02 from pot
giselerebelo: doesn't show hand 
*** SUMMARY ***
Total pot $0.02 | Rake $0 
Seat 1: ctaceo (button) folded before Flop (didn't bet)
Seat 2: Scaaalll (small blind) folded before Flop
Seat 3: giselerebelo (big blind) collected ($0.02)
Seat 4: egroj1700 folded before Flop (didn't bet)
Seat 5: lauti214 folded before Flop (didn't bet)
Seat 6: bart8612 folded before Flop (didn't bet)



PokerStars Zoom Hand #229233592539:  Hold'em No Limit ($0.01/$0.02) - 2021/08/21 23:35:59 CET [2021/08/21 17:35:59 ET]
Table 'Halley' 6-max Seat #1 is the button
Seat 1: HubertFroh ($2.75 in chips) 
Seat 2: GGopenBet ($2.40 in chips) 
Seat 3: ulisessoria ($3.91 in chips) 
Seat 4: Mr.Kurier ($4.30 in chips) 
Seat 5: Scaaalll ($3.54 in chips) 
Seat 6: Bol'tazar111 ($1.84 in chips) 
GGopenBet: posts small blind $0.01
ulisessoria: posts big blind $0.02
*** HOLE CARDS ***
Dealt to Scaaalll [Js 6d]
Mr.Kurier: folds 
GGopenBet is disconnected 
Scaaalll: folds 
Bol'tazar111: folds 
HubertFroh: folds 
GGopenBet: folds 
Uncalled bet ($0.01) returned to ulisessoria
ulisessoria collected $0.02 from pot
ulisessoria: doesn't show hand 
*** SUMMARY ***
Total pot $0.02 | Rake $0 
Seat 1: HubertFroh (button) folded before Flop (didn't bet)
Seat 2: GGopenBet (small blind) folded before Flop
Seat 3: ulisessoria (big blind) collected ($0.02)
Seat 4: Mr.Kurier folded before Flop (didn't bet)
Seat 5: Scaaalll folded before Flop (didn't bet)
Seat 6: Bol'tazar111 folded before Flop (didn't bet)



PokerStars Zoom Hand #229233576422:  Hold'em No Limit ($0.01/$0.02) - 2021/08/21 23:35:20 CET [2021/08/21 17:35:20 ET]
Table 'Halley' 6-max Seat #1 is the button
Seat 1: alphabeta1d ($2.04 in chips) 
Seat 2: Mikmaq Caper ($0.69 in chips) 
Seat 3: Scaaalll ($3.57 in chips) 
Seat 4: trickywizard64 ($1.86 in chips) 
Seat 5: vadim777125 ($1.51 in chips) 
Seat 6: estelionat171 ($0.96 in chips) 
Mikmaq Caper: posts small blind $0.01
Scaaalll: posts big blind $0.02
*** HOLE CARDS ***
Dealt to Scaaalll [5s Ts]
trickywizard64: folds 
vadim777125: calls $0.02
estelionat171: folds 
alphabeta1d: raises $0.07 to $0.09
Mikmaq Caper: calls $0.08
Scaaalll: folds 
vadim777125: calls $0.07
*** FLOP *** [8d 7c 6s]
Mikmaq Caper: bets $0.02
vadim777125: calls $0.02
alphabeta1d: folds 
*** TURN *** [8d 7c 6s] [Js]
Mikmaq Caper: bets $0.16
vadim777125: calls $0.16
*** RIVER *** [8d 7c 6s Js] [7s]
Mikmaq Caper: bets $0.42 and is all-in
vadim777125: folds 
Uncalled bet ($0.42) returned to Mikmaq Caper
Mikmaq Caper collected $0.63 from pot
Mikmaq Caper: doesn't show hand 
vadim777125 is disconnected 
*** SUMMARY ***
Total pot $0.65 | Rake $0.02 
Board [8d 7c 6s Js 7s]
Seat 1: alphabeta1d (button) folded on the Flop
Seat 2: Mikmaq Caper (small blind) collected ($0.63)
Seat 3: Scaaalll (big blind) folded before Flop
Seat 4: trickywizard64 folded before Flop (didn't bet)
Seat 5: vadim777125 folded on the River
Seat 6: estelionat171 folded before Flop (didn't bet)



PokerStars Zoom Hand #229233595787:  Hold'em No Limit ($0.01/$0.02) - 2021/08/21 23:36:07 CET [2021/08/21 17:36:07 ET]
Table 'Halley' 6-max Seat #1 is the button
Seat 1: bennodiem ($0.70 in chips) 
Seat 2: gaturamard ($2.36 in chips) 
Seat 3: SaLoMaN4iK ($1.77 in chips) 
Seat 4: Dr.stromg ($5.18 in chips) 
Seat 5: fishh_play ($3.62 in chips) 
Seat 6: Scaaalll ($3.54 in chips) 
gaturamard: posts small blind $0.01
SaLoMaN4iK: posts big blind $0.02
*** HOLE CARDS ***
Dealt to Scaaalll [Jc 4s]
Dr.stromg: folds 
fishh_play: folds 
Scaaalll: folds 
bennodiem: raises $0.02 to $0.04
gaturamard: folds 
SaLoMaN4iK: raises $0.15 to $0.19
bennodiem: calls $0.15
*** FLOP *** [Ah Kh 9h]
SaLoMaN4iK: checks 
bennodiem: checks 
*** TURN *** [Ah Kh 9h] [Qd]
SaLoMaN4iK: bets $0.15
bennodiem: raises $0.15 to $0.30
SaLoMaN4iK: calls $0.15
*** RIVER *** [Ah Kh 9h Qd] [5s]
SaLoMaN4iK: bets $0.22
bennodiem: calls $0.21 and is all-in
Uncalled bet ($0.01) returned to SaLoMaN4iK
*** SHOW DOWN ***
SaLoMaN4iK: shows [Ks Qc] (two pair, Kings and Queens)
bennodiem: shows [4h 7h] (a flush, Ace high)
bennodiem collected $1.36 from pot
*** SUMMARY ***
Total pot $1.41 | Rake $0.05 
Board [Ah Kh 9h Qd 5s]
Seat 1: bennodiem (button) showed [4h 7h] and won ($1.36) with a flush, Ace high
Seat 2: gaturamard (small blind) folded before Flop
Seat 3: SaLoMaN4iK (big blind) showed [Ks Qc] and lost with two pair, Kings and Queens
Seat 4: Dr.stromg folded before Flop (didn't bet)
Seat 5: fishh_play folded before Flop (didn't bet)
Seat 6: Scaaalll folded before Flop (didn't bet)



PokerStars Zoom Hand #229233598650:  Hold'em No Limit ($0.01/$0.02) - 2021/08/21 23:36:14 CET [2021/08/21 17:36:14 ET]
Table 'Halley' 6-max Seat #1 is the button
Seat 1: handrowan ($1.04 in chips) 
Seat 2: Cineva81 ($2.05 in chips) 
Seat 3: San4oWV ($2.06 in chips) 
Seat 4: Scaaalll ($3.54 in chips) 
Seat 5: Tibeau21 ($0.94 in chips) 
Seat 6: pavlo8855 ($2 in chips) 
Cineva81: posts small blind $0.01
San4oWV: posts big blind $0.02
*** HOLE CARDS ***
Dealt to Scaaalll [Qc Ks]
Scaaalll: raises $0.04 to $0.06
Tibeau21 has timed out
Tibeau21: folds 
pavlo8855: folds 
Tibeau21 is disconnected 
handrowan: folds 
Cineva81: folds 
San4oWV: calls $0.04
*** FLOP *** [Qd 9s 3d]
San4oWV: checks 
Scaaalll: bets $0.08
San4oWV: folds 
Uncalled bet ($0.08) returned to Scaaalll
Scaaalll collected $0.13 from pot
Scaaalll: doesn't show hand 
*** SUMMARY ***
Total pot $0.13 | Rake $0 
Board [Qd 9s 3d]
Seat 1: handrowan (button) folded before Flop (didn't bet)
Seat 2: Cineva81 (small blind) folded before Flop
Seat 3: San4oWV (big blind) folded on the Flop
Seat 4: Scaaalll collected ($0.13)
Seat 5: Tibeau21 folded before Flop (didn't bet)
Seat 6: pavlo8855 folded before Flop (didn't bet)



PokerStars Zoom Hand #229233622310:  Hold'em No Limit ($0.01/$0.02) - 2021/08/21 23:37:12 CET [2021/08/21 17:37:12 ET]
Table 'Halley' 6-max Seat #1 is the button
Seat 1: Marcelo17184 ($0.85 in chips) 
Seat 2: hustlehero ($2.03 in chips) 
Seat 3: didiclavi777 ($2.25 in chips) 
Seat 4: ronald1982 ($2.83 in chips) 
Seat 5: Scaaalll ($3.61 in chips) 
Seat 6: Xlavariable ($3.87 in chips) 
hustlehero: posts small blind $0.01
didiclavi777: posts big blind $0.02
*** HOLE CARDS ***
Dealt to Scaaalll [Tc 4d]
ronald1982: folds 
Scaaalll has timed out
Scaaalll: folds 
Xlavariable: folds 
Marcelo17184: folds 
hustlehero: folds 
Uncalled bet ($0.01) returned to didiclavi777
didiclavi777 collected $0.02 from pot
didiclavi777: doesn't show hand 
*** SUMMARY ***
Total pot $0.02 | Rake $0 
Seat 1: Marcelo17184 (button) folded before Flop (didn't bet)
Seat 2: hustlehero (small blind) folded before Flop
Seat 3: didiclavi777 (big blind) collected ($0.02)
Seat 4: ronald1982 folded before Flop (didn't bet)
Seat 5: Scaaalll folded before Flop (didn't bet)
Seat 6: Xlavariable folded before Flop (didn't bet)



PokerStars Zoom Hand #229233629628:  Hold'em No Limit ($0.01/$0.02) - 2021/08/21 23:37:30 CET [2021/08/21 17:37:30 ET]
Table 'Halley' 6-max Seat #1 is the button
Seat 1: HubertFroh ($2.71 in chips) 
Seat 2: hairy navel ($2.32 in chips) 
Seat 3: Scaaalll ($3.61 in chips) 
Seat 4: Lekcey05 ($2.01 in chips) 
Seat 5: WITKOW_AV ($6.76 in chips) 
Seat 6: sg.32rus ($0.49 in chips) 
hairy navel: posts small blind $0.01
Scaaalll: posts big blind $0.02
*** HOLE CARDS ***
Dealt to Scaaalll [4s 4c]
Lekcey05: folds 
WITKOW_AV: folds 
sg.32rus: folds 
HubertFroh: folds 
hairy navel: folds 
Uncalled bet ($0.01) returned to Scaaalll
Scaaalll collected $0.02 from pot
Scaaalll: doesn't show hand 
*** SUMMARY ***
Total pot $0.02 | Rake $0 
Seat 1: HubertFroh (button) folded before Flop (didn't bet)
Seat 2: hairy navel (small blind) folded before Flop
Seat 3: Scaaalll (big blind) collected ($0.02)
Seat 4: Lekcey05 folded before Flop (didn't bet)
Seat 5: WITKOW_AV folded before Flop (didn't bet)
Seat 6: sg.32rus folded before Flop (didn't bet)



PokerStars Zoom Hand #229233632911:  Hold'em No Limit ($0.01/$0.02) - 2021/08/21 23:37:38 CET [2021/08/21 17:37:38 ET]
Table 'Halley' 6-max Seat #1 is the button
Seat 1: Scaaalll ($3.62 in chips) 
Seat 2: AtZ3899 ($2.33 in chips) 
Seat 3: nightwacher ($1.87 in chips) 
Seat 4: i.m.bluffing002 ($2.32 in chips) 
Seat 5: Bina_sweety ($2.46 in chips) 
Seat 6: Rafa13brr ($0.66 in chips) 
AtZ3899: posts small blind $0.01
nightwacher: posts big blind $0.02
*** HOLE CARDS ***
Dealt to Scaaalll [7h Qd]
i.m.bluffing002: folds 
i.m.bluffing002 is disconnected 
Bina_sweety: raises $2.44 to $2.46 and is all-in
Rafa13brr: folds 
Scaaalll: folds 
AtZ3899: folds 
nightwacher: folds 
Uncalled bet ($2.44) returned to Bina_sweety
Bina_sweety collected $0.05 from pot
Bina_sweety: doesn't show hand 
*** SUMMARY ***
Total pot $0.05 | Rake $0 
Seat 1: Scaaalll (button) folded before Flop (didn't bet)
Seat 2: AtZ3899 (small blind) folded before Flop
Seat 3: nightwacher (big blind) folded before Flop
Seat 4: i.m.bluffing002 folded before Flop (didn't bet)
Seat 5: Bina_sweety collected ($0.05)
Seat 6: Rafa13brr folded before Flop (didn't bet)



PokerStars Zoom Hand #229233639078:  Hold'em No Limit ($0.01/$0.02) - 2021/08/21 23:37:53 CET [2021/08/21 17:37:53 ET]
Table 'Halley' 6-max Seat #1 is the button
Seat 1: lucksuckdonk ($3.12 in chips) 
Seat 2: Ape$apiens ($1.73 in chips) 
Seat 3: NickAlex18 ($2.31 in chips) 
Seat 4: Scaaalll ($3.61 in chips) 
Seat 5: prosto lili ($0.91 in chips) 
Seat 6: Koldun 2636 ($3.93 in chips) 
Ape$apiens: posts small blind $0.01
NickAlex18: posts big blind $0.02
*** HOLE CARDS ***
Dealt to Scaaalll [4h 3h]
Scaaalll: folds 
Ape$apiens is disconnected 
prosto lili: folds 
Koldun 2636: raises $0.03 to $0.05
lucksuckdonk: folds 
Ape$apiens: folds 
NickAlex18: folds 
Uncalled bet ($0.03) returned to Koldun 2636
Koldun 2636 collected $0.05 from pot
Koldun 2636: doesn't show hand 
*** SUMMARY ***
Total pot $0.05 | Rake $0 
Seat 1: lucksuckdonk (button) folded before Flop (didn't bet)
Seat 2: Ape$apiens (small blind) folded before Flop
Seat 3: NickAlex18 (big blind) folded before Flop
Seat 4: Scaaalll folded before Flop (didn't bet)
Seat 5: prosto lili folded before Flop (didn't bet)
Seat 6: Koldun 2636 collected ($0.05)



PokerStars Zoom Hand #229233637378:  Hold'em No Limit ($0.01/$0.02) - 2021/08/21 23:37:49 CET [2021/08/21 17:37:49 ET]
Table 'Halley' 6-max Seat #1 is the button
Seat 1: HubertFroh ($4.14 in chips) 
Seat 2: Scaaalll ($3.62 in chips) 
Seat 3: becolea ($1.92 in chips) 
Seat 4: Gamer577 ($8.09 in chips) 
Seat 5: OneFaw ($2.99 in chips) 
Seat 6: pizzaroni159 ($2 in chips) 
Scaaalll: posts small blind $0.01
becolea: posts big blind $0.02
*** HOLE CARDS ***
Dealt to Scaaalll [2d Ac]
Gamer577: folds 
OneFaw: raises $0.02 to $0.04
pizzaroni159: folds 
HubertFroh: folds 
Scaaalll: folds 
becolea: calls $0.02
*** FLOP *** [Kd Jd Tc]
becolea: checks 
OneFaw: checks 
*** TURN *** [Kd Jd Tc] [4s]
becolea: bets $0.09
OneFaw: folds 
Uncalled bet ($0.09) returned to becolea
becolea collected $0.09 from pot
becolea: doesn't show hand 
OneFaw is disconnected 
*** SUMMARY ***
Total pot $0.09 | Rake $0 
Board [Kd Jd Tc 4s]
Seat 1: HubertFroh (button) folded before Flop (didn't bet)
Seat 2: Scaaalll (small blind) folded before Flop
Seat 3: becolea (big blind) collected ($0.09)
Seat 4: Gamer577 folded before Flop (didn't bet)
Seat 5: OneFaw folded on the Turn
Seat 6: pizzaroni159 folded before Flop (didn't bet)



PokerStars Zoom Hand #229233640678:  Hold'em No Limit ($0.01/$0.02) - 2021/08/21 23:37:57 CET [2021/08/21 17:37:57 ET]
Table 'Halley' 6-max Seat #1 is the button
Seat 1: El Chicha.CL ($2 in chips) 
Seat 2: queen830 ($15.88 in chips) 
Seat 3: giselerebelo ($1.19 in chips) 
Seat 4: kingdieter1 ($2.03 in chips) 
Seat 5: you_my_bich ($0.90 in chips) 
Seat 6: Scaaalll ($3.61 in chips) 
queen830: posts small blind $0.01
giselerebelo: posts big blind $0.02
*** HOLE CARDS ***
Dealt to Scaaalll [8d 4h]
kingdieter1: folds 
kingdieter1 is disconnected 
you_my_bich: raises $0.04 to $0.06
Scaaalll: folds 
El Chicha.CL: calls $0.06
queen830: folds 
giselerebelo: calls $0.04
*** FLOP *** [8s Js 7c]
giselerebelo: checks 
you_my_bich: bets $0.13
El Chicha.CL: folds 
giselerebelo: calls $0.13
*** TURN *** [8s Js 7c] [2h]
giselerebelo: checks 
you_my_bich: checks 
*** RIVER *** [8s Js 7c 2h] [3d]
giselerebelo: bets $0.30
you_my_bich: folds 
Uncalled bet ($0.30) returned to giselerebelo
giselerebelo collected $0.43 from pot
giselerebelo: doesn't show hand 
you_my_bich is disconnected 
*** SUMMARY ***
Total pot $0.45 | Rake $0.02 
Board [8s Js 7c 2h 3d]
Seat 1: El Chicha.CL (button) folded on the Flop
Seat 2: queen830 (small blind) folded before Flop
Seat 3: giselerebelo (big blind) collected ($0.43)
Seat 4: kingdieter1 folded before Flop (didn't bet)
Seat 5: you_my_bich folded on the River
Seat 6: Scaaalll folded before Flop (didn't bet)



PokerStars Zoom Hand #229233643120:  Hold'em No Limit ($0.01/$0.02) - 2021/08/21 23:38:03 CET [2021/08/21 17:38:03 ET]
Table 'Halley' 6-max Seat #1 is the button
Seat 1: LSDenny ($2.50 in chips) 
Seat 2: alphabeta1d ($2.36 in chips) 
Seat 3: Scaaalll ($3.61 in chips) 
Seat 4: Umnik_M ($1.93 in chips) 
Seat 5: nodtress ($2 in chips) 
Seat 6: MinorityRule ($1.16 in chips) 
alphabeta1d: posts small blind $0.01
Scaaalll: posts big blind $0.02
*** HOLE CARDS ***
Dealt to Scaaalll [7c 8c]
Umnik_M: folds 
MinorityRule is disconnected 
nodtress: folds 
MinorityRule: folds 
LSDenny: raises $0.02 to $0.04
alphabeta1d: folds 
Scaaalll: calls $0.02
*** FLOP *** [4d 4s 4c]
Scaaalll: checks 
LSDenny: checks 
*** TURN *** [4d 4s 4c] [Kd]
Scaaalll: checks 
LSDenny: bets $0.04
Scaaalll: folds 
Uncalled bet ($0.04) returned to LSDenny
LSDenny collected $0.09 from pot
LSDenny: doesn't show hand 
*** SUMMARY ***
Total pot $0.09 | Rake $0 
Board [4d 4s 4c Kd]
Seat 1: LSDenny (button) collected ($0.09)
Seat 2: alphabeta1d (small blind) folded before Flop
Seat 3: Scaaalll (big blind) folded on the Turn
Seat 4: Umnik_M folded before Flop (didn't bet)
Seat 5: nodtress folded before Flop (didn't bet)
Seat 6: MinorityRule folded before Flop (didn't bet)



PokerStars Zoom Hand #229233660568:  Hold'em No Limit ($0.01/$0.02) - 2021/08/21 23:38:46 CET [2021/08/21 17:38:46 ET]
Table 'Halley' 6-max Seat #1 is the button
Seat 1: KKARMELO ($2.88 in chips) 
Seat 2: Scaaalll ($3.57 in chips) 
Seat 3: pipecmolodec ($2.08 in chips) 
Seat 4: surrender147 ($1.95 in chips) 
Seat 5: Gerar NB ($2 in chips) 
Seat 6: Tabitaji ($7 in chips) 
Scaaalll: posts small blind $0.01
pipecmolodec: posts big blind $0.02
*** HOLE CARDS ***
Dealt to Scaaalll [Ac 3d]
surrender147: folds 
Gerar NB: folds 
Tabitaji: folds 
KKARMELO: folds 
Scaaalll: folds 
Uncalled bet ($0.01) returned to pipecmolodec
pipecmolodec collected $0.02 from pot
pipecmolodec: doesn't show hand 
*** SUMMARY ***
Total pot $0.02 | Rake $0 
Seat 1: KKARMELO (button) folded before Flop (didn't bet)
Seat 2: Scaaalll (small blind) folded before Flop
Seat 3: pipecmolodec (big blind) collected ($0.02)
Seat 4: surrender147 folded before Flop (didn't bet)
Seat 5: Gerar NB folded before Flop (didn't bet)
Seat 6: Tabitaji folded before Flop (didn't bet)



PokerStars Zoom Hand #229233666968:  Hold'em No Limit ($0.01/$0.02) - 2021/08/21 23:39:02 CET [2021/08/21 17:39:02 ET]
Table 'Halley' 6-max Seat #1 is the button
Seat 1: S3XY_PADRE ($5.53 in chips) 
Seat 2: leeroy818 ($2.42 in chips) 
Seat 3: Lekcey05 ($2 in chips) 
Seat 4: Scaaalll ($3.56 in chips) 
Seat 5: plmanuelpl ($1.20 in chips) 
Seat 6: Healthys07 ($3.35 in chips) 
leeroy818: posts small blind $0.01
Lekcey05: posts big blind $0.02
*** HOLE CARDS ***
Dealt to Scaaalll [6s 5d]
Scaaalll: folds 
plmanuelpl: folds 
Healthys07: folds 
S3XY_PADRE: folds 
plmanuelpl is disconnected 
leeroy818: raises $0.04 to $0.06
Lekcey05: calls $0.04
*** FLOP *** [Qh Ks 2c]
leeroy818: bets $0.04
Lekcey05: calls $0.04
*** TURN *** [Qh Ks 2c] [5c]
leeroy818: checks 
Lekcey05: checks 
*** RIVER *** [Qh Ks 2c 5c] [4d]
leeroy818: checks 
Lekcey05: checks 
*** SHOW DOWN ***
leeroy818: shows [Ah 2d] (a pair of Deuces)
Lekcey05: mucks hand 
leeroy818 collected $0.19 from pot
*** SUMMARY ***
Total pot $0.20 | Rake $0.01 
Board [Qh Ks 2c 5c 4d]
Seat 1: S3XY_PADRE (button) folded before Flop (didn't bet)
Seat 2: leeroy818 (small blind) showed [Ah 2d] and won ($0.19) with a pair of Deuces
Seat 3: Lekcey05 (big blind) mucked [Ad Jc]
Seat 4: Scaaalll folded before Flop (didn't bet)
Seat 5: plmanuelpl folded before Flop (didn't bet)
Seat 6: Healthys07 folded before Flop (didn't bet)



PokerStars Zoom Hand #229233669006:  Hold'em No Limit ($0.01/$0.02) - 2021/08/21 23:39:07 CET [2021/08/21 17:39:07 ET]
Table 'Halley' 6-max Seat #1 is the button
Seat 1: Sadikson ($2.47 in chips) 
Seat 2: PEDACIT0 ($2 in chips) 
Seat 3: Scaaalll ($3.56 in chips) 
Seat 4: tisadaisy ($2 in chips) 
Seat 5: Ruben-M. PY ($3.27 in chips) 
Seat 6: lucksuckdonk ($9.29 in chips) 
PEDACIT0: posts small blind $0.01
Scaaalll: posts big blind $0.02
*** HOLE CARDS ***
Dealt to Scaaalll [Qs Ts]
Sadikson is disconnected 
tisadaisy: folds 
Ruben-M. PY: raises $0.04 to $0.06
lucksuckdonk: raises $0.18 to $0.24
Sadikson: folds 
PEDACIT0: folds 
Scaaalll: folds 
Ruben-M. PY: calls $0.18
*** FLOP *** [5h Td 7s]
Ruben-M. PY: checks 
lucksuckdonk: bets $0.16
Ruben-M. PY: calls $0.16
*** TURN *** [5h Td 7s] [Ac]
Ruben-M. PY: checks 
lucksuckdonk: bets $0.54
Ruben-M. PY: folds 
Uncalled bet ($0.54) returned to lucksuckdonk
lucksuckdonk collected $0.80 from pot
lucksuckdonk: doesn't show hand 
*** SUMMARY ***
Total pot $0.83 | Rake $0.03 
Board [5h Td 7s Ac]
Seat 1: Sadikson (button) folded before Flop (didn't bet)
Seat 2: PEDACIT0 (small blind) folded before Flop
Seat 3: Scaaalll (big blind) folded before Flop
Seat 4: tisadaisy folded before Flop (didn't bet)
Seat 5: Ruben-M. PY folded on the Turn
Seat 6: lucksuckdonk collected ($0.80)



PokerStars Zoom Hand #229233674328:  Hold'em No Limit ($0.01/$0.02) - 2021/08/21 23:39:20 CET [2021/08/21 17:39:20 ET]
Table 'Halley' 6-max Seat #1 is the button
Seat 1: Scaaalll ($3.54 in chips) 
Seat 2: adrianh2002 ($4.64 in chips) 
Seat 3: STE1NBERG ($2.08 in chips) 
Seat 4: Bol'tazar111 ($2.21 in chips) 
Seat 5: Feyqdoi ($2 in chips) 
Seat 6: hairy navel ($2.35 in chips) 
adrianh2002: posts small blind $0.01
STE1NBERG: posts big blind $0.02
*** HOLE CARDS ***
Dealt to Scaaalll [Jd Td]
Bol'tazar111: raises $0.04 to $0.06
Feyqdoi: folds 
hairy navel: folds 
Scaaalll: calls $0.06
adrianh2002: folds 
STE1NBERG: folds 
*** FLOP *** [Qs Tc 5c]
Bol'tazar111: bets $0.06
Scaaalll: calls $0.06
*** TURN *** [Qs Tc 5c] [Th]
Bol'tazar111: bets $0.08
Scaaalll: calls $0.08
*** RIVER *** [Qs Tc 5c Th] [Ks]
Bol'tazar111: bets $0.08
Scaaalll: raises $0.28 to $0.36
Bol'tazar111: calls $0.28
*** SHOW DOWN ***
Scaaalll: shows [Jd Td] (three of a kind, Tens)
Bol'tazar111: shows [Ah Ts] (three of a kind, Tens - Ace kicker)
Bol'tazar111 collected $1.11 from pot
*** SUMMARY ***
Total pot $1.15 | Rake $0.04 
Board [Qs Tc 5c Th Ks]
Seat 1: Scaaalll (button) showed [Jd Td] and lost with three of a kind, Tens
Seat 2: adrianh2002 (small blind) folded before Flop
Seat 3: STE1NBERG (big blind) folded before Flop
Seat 4: Bol'tazar111 showed [Ah Ts] and won ($1.11) with three of a kind, Tens
Seat 5: Feyqdoi folded before Flop (didn't bet)
Seat 6: hairy navel folded before Flop (didn't bet)



PokerStars Zoom Hand #229233690873:  Hold'em No Limit ($0.01/$0.02) - 2021/08/21 23:40:01 CET [2021/08/21 17:40:01 ET]
Table 'Halley' 6-max Seat #1 is the button
Seat 1: FrancoOlmedo ($2.54 in chips) 
Seat 2: Scaaalll ($2.98 in chips) 
Seat 3: Merlin_Arg ($2.61 in chips) 
Seat 4: Finderra ($3.90 in chips) 
Seat 5: NetoFLX ($2 in chips) 
Seat 6: lucky1529 ($0.98 in chips) 
Scaaalll: posts small blind $0.01
Merlin_Arg: posts big blind $0.02
*** HOLE CARDS ***
Dealt to Scaaalll [7h 7d]
Finderra: raises $0.04 to $0.06
NetoFLX: folds 
lucky1529: folds 
FrancoOlmedo: folds 
Scaaalll: calls $0.05
Merlin_Arg: folds 
*** FLOP *** [2h Ac Jc]
Scaaalll: checks 
Finderra: bets $0.06
Scaaalll: folds 
Uncalled bet ($0.06) returned to Finderra
Finderra collected $0.14 from pot
Finderra: doesn't show hand 
*** SUMMARY ***
Total pot $0.14 | Rake $0 
Board [2h Ac Jc]
Seat 1: FrancoOlmedo (button) folded before Flop (didn't bet)
Seat 2: Scaaalll (small blind) folded on the Flop
Seat 3: Merlin_Arg (big blind) folded before Flop
Seat 4: Finderra collected ($0.14)
Seat 5: NetoFLX folded before Flop (didn't bet)
Seat 6: lucky1529 folded before Flop (didn't bet)



PokerStars Zoom Hand #229233702105:  Hold'em No Limit ($0.01/$0.02) - 2021/08/21 23:40:29 CET [2021/08/21 17:40:29 ET]
Table 'Halley' 6-max Seat #1 is the button
Seat 1: Scaaalll ($2.92 in chips) 
Seat 2: 0ofreeo0 ($2.12 in chips) 
Seat 3: WITKOW_AV ($2.33 in chips) 
Seat 4: vovan100157 ($5.30 in chips) 
Seat 5: OneFaw ($2.20 in chips) 
Seat 6: BossTH4 ($4.77 in chips) 
0ofreeo0: posts small blind $0.01
WITKOW_AV: posts big blind $0.02
*** HOLE CARDS ***
Dealt to Scaaalll [As Kc]
OneFaw is disconnected 
vovan100157: folds 
OneFaw: folds 
BossTH4: folds 
Scaaalll: raises $0.03 to $0.05
0ofreeo0: folds 
WITKOW_AV: folds 
Uncalled bet ($0.03) returned to Scaaalll
Scaaalll collected $0.05 from pot
Scaaalll: doesn't show hand 
*** SUMMARY ***
Total pot $0.05 | Rake $0 
Seat 1: Scaaalll (button) collected ($0.05)
Seat 2: 0ofreeo0 (small blind) folded before Flop
Seat 3: WITKOW_AV (big blind) folded before Flop
Seat 4: vovan100157 folded before Flop (didn't bet)
Seat 5: OneFaw folded before Flop (didn't bet)
Seat 6: BossTH4 folded before Flop (didn't bet)



PokerStars Zoom Hand #229233699353:  Hold'em No Limit ($0.01/$0.02) - 2021/08/21 23:40:22 CET [2021/08/21 17:40:22 ET]
Table 'Halley' 6-max Seat #1 is the button
Seat 1: so0love ($4.38 in chips) 
Seat 2: BeMyATMplz ($1.98 in chips) 
Seat 3: BeastBoy18 ($2 in chips) 
Seat 4: BIITRU ($2.35 in chips) 
Seat 5: cutter2468 ($6.98 in chips) 
Seat 6: Scaaalll ($2.92 in chips) 
BeMyATMplz: posts small blind $0.01
BeastBoy18: posts big blind $0.02
*** HOLE CARDS ***
Dealt to Scaaalll [7h Qh]
BIITRU: folds 
cutter2468: folds 
Scaaalll: folds 
so0love: folds 
BeMyATMplz: raises $0.04 to $0.06
BeastBoy18: calls $0.04
*** FLOP *** [5d Jd Kd]
BeMyATMplz: bets $0.06
BeastBoy18: calls $0.06
*** TURN *** [5d Jd Kd] [5h]
BeMyATMplz: bets $0.18
BeastBoy18: calls $0.18
*** RIVER *** [5d Jd Kd 5h] [5s]
BeMyATMplz: bets $0.50
BeastBoy18: folds 
Uncalled bet ($0.50) returned to BeMyATMplz
BeMyATMplz collected $0.58 from pot
BeMyATMplz: doesn't show hand 
*** SUMMARY ***
Total pot $0.60 | Rake $0.02 
Board [5d Jd Kd 5h 5s]
Seat 1: so0love (button) folded before Flop (didn't bet)
Seat 2: BeMyATMplz (small blind) collected ($0.58)
Seat 3: BeastBoy18 (big blind) folded on the River
Seat 4: BIITRU folded before Flop (didn't bet)
Seat 5: cutter2468 folded before Flop (didn't bet)
Seat 6: Scaaalll folded before Flop (didn't bet)



PokerStars Zoom Hand #229233717982:  Hold'em No Limit ($0.01/$0.02) - 2021/08/21 23:41:08 CET [2021/08/21 17:41:08 ET]
Table 'Halley' 6-max Seat #1 is the button
Seat 1: Doktor Yes ($2.01 in chips) 
Seat 2: gizum17 ($3.10 in chips) 
Seat 3: BIITRU ($2 in chips) 
Seat 4: Hejpåre ($2 in chips) 
Seat 5: Scaaalll ($2.95 in chips) 
Seat 6: Luisit0_aqp ($0.91 in chips) 
gizum17: posts small blind $0.01
BIITRU: posts big blind $0.02
*** HOLE CARDS ***
Dealt to Scaaalll [As 6d]
Hejpåre: raises $0.04 to $0.06
Scaaalll: folds 
Luisit0_aqp: folds 
Doktor Yes: folds 
gizum17: folds 
BIITRU: folds 
Uncalled bet ($0.04) returned to Hejpåre
Hejpåre collected $0.05 from pot
Hejpåre: doesn't show hand 
*** SUMMARY ***
Total pot $0.05 | Rake $0 
Seat 1: Doktor Yes (button) folded before Flop (didn't bet)
Seat 2: gizum17 (small blind) folded before Flop
Seat 3: BIITRU (big blind) folded before Flop
Seat 4: Hejpåre collected ($0.05)
Seat 5: Scaaalll folded before Flop (didn't bet)
Seat 6: Luisit0_aqp folded before Flop (didn't bet)



PokerStars Zoom Hand #229233712714:  Hold'em No Limit ($0.01/$0.02) - 2021/08/21 23:40:55 CET [2021/08/21 17:40:55 ET]
Table 'Halley' 6-max Seat #1 is the button
Seat 1: giselerebelo ($1.40 in chips) 
Seat 2: orlovac1995 ($2.45 in chips) 
Seat 3: Nihility77 ($5.94 in chips) 
Seat 4: deldanlee ($1.87 in chips) 
Seat 5: Scaaalll ($2.95 in chips) 
Seat 6: Hallyson_23 ($3.63 in chips) 
orlovac1995: posts small blind $0.01
Nihility77: posts big blind $0.02
*** HOLE CARDS ***
Dealt to Scaaalll [3h Th]
deldanlee: calls $0.02
Scaaalll: folds 
Hallyson_23: folds 
giselerebelo: folds 
orlovac1995: raises $0.04 to $0.06
Nihility77: folds 
deldanlee: calls $0.04
*** FLOP *** [9c Kd 5c]
orlovac1995: bets $0.11
deldanlee: calls $0.11
*** TURN *** [9c Kd 5c] [9d]
orlovac1995: bets $0.26
deldanlee: raises $0.26 to $0.52
orlovac1995: raises $0.26 to $0.78
deldanlee: calls $0.26
*** RIVER *** [9c Kd 5c 9d] [2c]
orlovac1995: checks 
deldanlee: checks 
*** SHOW DOWN ***
orlovac1995: shows [9h 9s] (four of a kind, Nines)
deldanlee: mucks hand 
orlovac1995 collected $1.85 from pot
*** SUMMARY ***
Total pot $1.92 | Rake $0.07 
Board [9c Kd 5c 9d 2c]
Seat 1: giselerebelo (button) folded before Flop (didn't bet)
Seat 2: orlovac1995 (small blind) showed [9h 9s] and won ($1.85) with four of a kind, Nines
Seat 3: Nihility77 (big blind) folded before Flop
Seat 4: deldanlee mucked [Ac Ah]
Seat 5: Scaaalll folded before Flop (didn't bet)
Seat 6: Hallyson_23 folded before Flop (didn't bet)



PokerStars Zoom Hand #229233725680:  Hold'em No Limit ($0.01/$0.02) - 2021/08/21 23:41:27 CET [2021/08/21 17:41:27 ET]
Table 'Halley' 6-max Seat #1 is the button
Seat 1: ofalkeid ($1.59 in chips) 
Seat 2: STE1NBERG ($2.03 in chips) 
Seat 3: Scaaalll ($2.95 in chips) 
Seat 4: Ne0net ($2.14 in chips) 
Seat 5: vovan100157 ($5.35 in chips) 
Seat 6: BeMyATMplz ($1.92 in chips) 
STE1NBERG: posts small blind $0.01
Scaaalll: posts big blind $0.02
*** HOLE CARDS ***
Dealt to Scaaalll [8h Js]
Ne0net: folds 
vovan100157: folds 
BeMyATMplz: raises $0.03 to $0.05
ofalkeid: folds 
STE1NBERG: folds 
Scaaalll: folds 
Uncalled bet ($0.03) returned to BeMyATMplz
BeMyATMplz collected $0.05 from pot
BeMyATMplz: doesn't show hand 
*** SUMMARY ***
Total pot $0.05 | Rake $0 
Seat 1: ofalkeid (button) folded before Flop (didn't bet)
Seat 2: STE1NBERG (small blind) folded before Flop
Seat 3: Scaaalll (big blind) folded before Flop
Seat 4: Ne0net folded before Flop (didn't bet)
Seat 5: vovan100157 folded before Flop (didn't bet)
Seat 6: BeMyATMplz collected ($0.05)



PokerStars Zoom Hand #229233722834:  Hold'em No Limit ($0.01/$0.02) - 2021/08/21 23:41:20 CET [2021/08/21 17:41:20 ET]
Table 'Halley' 6-max Seat #1 is the button
Seat 1: lauti214 ($2.01 in chips) 
Seat 2: 888lifeIS ($2.20 in chips) 
Seat 3: bart8612 ($3.14 in chips) 
Seat 4: AXXILLES ($4.80 in chips) 
Seat 5: clay070 ($1.32 in chips) 
Seat 6: Scaaalll ($2.95 in chips) 
888lifeIS: posts small blind $0.01
bart8612: posts big blind $0.02
*** HOLE CARDS ***
Dealt to Scaaalll [7h Qd]
AXXILLES: folds 
clay070: folds 
Scaaalll: folds 
lauti214: folds 
888lifeIS: raises $0.02 to $0.04
bart8612: calls $0.02
*** FLOP *** [Ts Qs 4d]
888lifeIS: checks 
bart8612: bets $0.06
888lifeIS: folds 
Uncalled bet ($0.06) returned to bart8612
bart8612 collected $0.08 from pot
bart8612: doesn't show hand 
*** SUMMARY ***
Total pot $0.08 | Rake $0 
Board [Ts Qs 4d]
Seat 1: lauti214 (button) folded before Flop (didn't bet)
Seat 2: 888lifeIS (small blind) folded on the Flop
Seat 3: bart8612 (big blind) collected ($0.08)
Seat 4: AXXILLES folded before Flop (didn't bet)
Seat 5: clay070 folded before Flop (didn't bet)
Seat 6: Scaaalll folded before Flop (didn't bet)



PokerStars Zoom Hand #229233716331:  Hold'em No Limit ($0.01/$0.02) - 2021/08/21 23:41:04 CET [2021/08/21 17:41:04 ET]
Table 'Halley' 6-max Seat #1 is the button
Seat 1: Iv3rson18 ($2.28 in chips) 
Seat 2: kidninja888 ($2.22 in chips) 
Seat 3: Chapaev136 ($2.58 in chips) 
Seat 4: Scaaalll ($2.95 in chips) 
Seat 5: ctaceo ($2 in chips) 
Seat 6: artur9124 ($1.12 in chips) 
kidninja888: posts small blind $0.01
Chapaev136: posts big blind $0.02
*** HOLE CARDS ***
Dealt to Scaaalll [3s 2c]
Scaaalll: folds 
ctaceo: folds 
artur9124: folds 
artur9124 is disconnected 
Iv3rson18: folds 
kidninja888: raises $0.03 to $0.05
Chapaev136: calls $0.03
*** FLOP *** [8h 7c 9c]
kidninja888: checks 
Chapaev136: checks 
*** TURN *** [8h 7c 9c] [2s]
kidninja888: checks 
Chapaev136: bets $0.05
kidninja888: calls $0.05
*** RIVER *** [8h 7c 9c 2s] [6d]
kidninja888: bets $0.11
Chapaev136: folds 
Uncalled bet ($0.11) returned to kidninja888
kidninja888 collected $0.19 from pot
kidninja888: doesn't show hand 
*** SUMMARY ***
Total pot $0.20 | Rake $0.01 
Board [8h 7c 9c 2s 6d]
Seat 1: Iv3rson18 (button) folded before Flop (didn't bet)
Seat 2: kidninja888 (small blind) collected ($0.19)
Seat 3: Chapaev136 (big blind) folded on the River
Seat 4: Scaaalll folded before Flop (didn't bet)
Seat 5: ctaceo folded before Flop (didn't bet)
Seat 6: artur9124 folded before Flop (didn't bet)



PokerStars Zoom Hand #229233730472:  Hold'em No Limit ($0.01/$0.02) - 2021/08/21 23:41:39 CET [2021/08/21 17:41:39 ET]
Table 'Halley' 6-max Seat #1 is the button
Seat 1: 3rian cARc ($2.07 in chips) 
Seat 2: gaturamard ($3.65 in chips) 
Seat 3: nbarreiro021 ($2 in chips) 
Seat 4: Scaaalll ($2.93 in chips) 
Seat 5: gasmar_29 ($2.27 in chips) 
Seat 6: Feliciano16 ($7.73 in chips) 
gaturamard: posts small blind $0.01
nbarreiro021: posts big blind $0.02
*** HOLE CARDS ***
Dealt to Scaaalll [4d Qh]
Scaaalll: folds 
gasmar_29: folds 
Feliciano16: folds 
3rian cARc: folds 
gaturamard: folds 
Uncalled bet ($0.01) returned to nbarreiro021
nbarreiro021 collected $0.02 from pot
nbarreiro021: doesn't show hand 
*** SUMMARY ***
Total pot $0.02 | Rake $0 
Seat 1: 3rian cARc (button) folded before Flop (didn't bet)
Seat 2: gaturamard (small blind) folded before Flop
Seat 3: nbarreiro021 (big blind) collected ($0.02)
Seat 4: Scaaalll folded before Flop (didn't bet)
Seat 5: gasmar_29 folded before Flop (didn't bet)
Seat 6: Feliciano16 folded before Flop (didn't bet)



PokerStars Zoom Hand #229233732877:  Hold'em No Limit ($0.01/$0.02) - 2021/08/21 23:41:45 CET [2021/08/21 17:41:45 ET]
Table 'Halley' 6-max Seat #1 is the button
Seat 1: fabor1303 ($2 in chips) 
Seat 2: PEDACIT0 ($2.12 in chips) 
Seat 3: Gamer577 ($3.64 in chips) 
Seat 4: Cineva81 ($2.11 in chips) 
Seat 5: gasmar_29 ($2.53 in chips) 
Seat 6: Scaaalll ($2.93 in chips) 
PEDACIT0: posts small blind $0.01
Gamer577: posts big blind $0.02
*** HOLE CARDS ***
Dealt to Scaaalll [5c Qd]
Cineva81: folds 
gasmar_29: folds 
Scaaalll: folds 
fabor1303: folds 
PEDACIT0: folds 
Uncalled bet ($0.01) returned to Gamer577
Gamer577 collected $0.02 from pot
Gamer577: doesn't show hand 
*** SUMMARY ***
Total pot $0.02 | Rake $0 
Seat 1: fabor1303 (button) folded before Flop (didn't bet)
Seat 2: PEDACIT0 (small blind) folded before Flop
Seat 3: Gamer577 (big blind) collected ($0.02)
Seat 4: Cineva81 folded before Flop (didn't bet)
Seat 5: gasmar_29 folded before Flop (didn't bet)
Seat 6: Scaaalll folded before Flop (didn't bet)



PokerStars Zoom Hand #229233735315:  Hold'em No Limit ($0.01/$0.02) - 2021/08/21 23:41:51 CET [2021/08/21 17:41:51 ET]
Table 'Halley' 6-max Seat #1 is the button
Seat 1: ctaceo ($3.89 in chips) 
Seat 2: Scaaalll ($2.93 in chips) 
Seat 3: Rafa13brr ($1.32 in chips) 
Seat 4: 365p2eva ($2.25 in chips) 
Seat 5: clay070 ($1.32 in chips) 
Seat 6: Recasia ($1.04 in chips) 
Scaaalll: posts small blind $0.01
Rafa13brr: posts big blind $0.02
*** HOLE CARDS ***
Dealt to Scaaalll [Kd Tc]
365p2eva: folds 
clay070: folds 
Recasia: folds 
ctaceo: folds 
Scaaalll: raises $0.04 to $0.06
Rafa13brr: folds 
Uncalled bet ($0.04) returned to Scaaalll
Scaaalll collected $0.04 from pot
Scaaalll: doesn't show hand 
*** SUMMARY ***
Total pot $0.04 | Rake $0 
Seat 1: ctaceo (button) folded before Flop (didn't bet)
Seat 2: Scaaalll (small blind) collected ($0.04)
Seat 3: Rafa13brr (big blind) folded before Flop
Seat 4: 365p2eva folded before Flop (didn't bet)
Seat 5: clay070 folded before Flop (didn't bet)
Seat 6: Recasia folded before Flop (didn't bet)



PokerStars Zoom Hand #229233741386:  Hold'em No Limit ($0.01/$0.02) - 2021/08/21 23:42:06 CET [2021/08/21 17:42:06 ET]
Table 'Halley' 6-max Seat #1 is the button
Seat 1: Scaaalll ($2.95 in chips) 
Seat 2: fabor1303 ($10.30 in chips) 
Seat 3: Bol'tazar111 ($2.94 in chips) 
Seat 4: Jimor Marlow ($2.17 in chips) 
Seat 5: H0mmer99 ($2.84 in chips) 
Seat 6: ulisessoria ($4.07 in chips) 
fabor1303: posts small blind $0.01
Bol'tazar111: posts big blind $0.02
*** HOLE CARDS ***
Dealt to Scaaalll [Qh 7h]
Jimor Marlow: folds 
Jimor Marlow is disconnected 
H0mmer99: raises $0.02 to $0.04
ulisessoria: folds 
Scaaalll: folds 
fabor1303: folds 
Bol'tazar111: folds 
Uncalled bet ($0.02) returned to H0mmer99
H0mmer99 collected $0.05 from pot
H0mmer99: doesn't show hand 
*** SUMMARY ***
Total pot $0.05 | Rake $0 
Seat 1: Scaaalll (button) folded before Flop (didn't bet)
Seat 2: fabor1303 (small blind) folded before Flop
Seat 3: Bol'tazar111 (big blind) folded before Flop
Seat 4: Jimor Marlow folded before Flop (didn't bet)
Seat 5: H0mmer99 collected ($0.05)
Seat 6: ulisessoria folded before Flop (didn't bet)



PokerStars Zoom Hand #229233744673:  Hold'em No Limit ($0.01/$0.02) - 2021/08/21 23:42:14 CET [2021/08/21 17:42:14 ET]
Table 'Halley' 6-max Seat #1 is the button
Seat 1: ohsimoron ($2.61 in chips) 
Seat 2: Z0omer_420 ($3.60 in chips) 
Seat 3: BIITRU ($2 in chips) 
Seat 4: Koldun 2636 ($3.60 in chips) 
Seat 5: Scaaalll ($2.95 in chips) 
Seat 6: MattieBOZ ($2.15 in chips) 
Z0omer_420: posts small blind $0.01
BIITRU: posts big blind $0.02
*** HOLE CARDS ***
Dealt to Scaaalll [3s 5h]
Koldun 2636: folds 
Scaaalll: folds 
MattieBOZ: folds 
MattieBOZ is disconnected 
ohsimoron: raises $0.04 to $0.06
Z0omer_420: folds 
BIITRU: folds 
Uncalled bet ($0.04) returned to ohsimoron
ohsimoron collected $0.05 from pot
ohsimoron: doesn't show hand 
*** SUMMARY ***
Total pot $0.05 | Rake $0 
Seat 1: ohsimoron (button) collected ($0.05)
Seat 2: Z0omer_420 (small blind) folded before Flop
Seat 3: BIITRU (big blind) folded before Flop
Seat 4: Koldun 2636 folded before Flop (didn't bet)
Seat 5: Scaaalll folded before Flop (didn't bet)
Seat 6: MattieBOZ folded before Flop (didn't bet)



PokerStars Zoom Hand #229233751933:  Hold'em No Limit ($0.01/$0.02) - 2021/08/21 23:42:32 CET [2021/08/21 17:42:32 ET]
Table 'Halley' 6-max Seat #1 is the button
Seat 1: Xpokerfreak ($1.38 in chips) 
Seat 2: Vladimir1954 ($2.14 in chips) 
Seat 3: 1nTeresT ($2.13 in chips) 
Seat 4: jaamonra ($2.32 in chips) 
Seat 5: Scaaalll ($2.93 in chips) 
Seat 6: rekopo203 ($8.55 in chips) 
Vladimir1954: posts small blind $0.01
1nTeresT: posts big blind $0.02
*** HOLE CARDS ***
Dealt to Scaaalll [9s Qd]
jaamonra: folds 
Scaaalll: folds 
rekopo203: folds 
Xpokerfreak: folds 
Vladimir1954: folds 
Uncalled bet ($0.01) returned to 1nTeresT
1nTeresT collected $0.02 from pot
1nTeresT: doesn't show hand 
*** SUMMARY ***
Total pot $0.02 | Rake $0 
Seat 1: Xpokerfreak (button) folded before Flop (didn't bet)
Seat 2: Vladimir1954 (small blind) folded before Flop
Seat 3: 1nTeresT (big blind) collected ($0.02)
Seat 4: jaamonra folded before Flop (didn't bet)
Seat 5: Scaaalll folded before Flop (didn't bet)
Seat 6: rekopo203 folded before Flop (didn't bet)



PokerStars Zoom Hand #229233758453:  Hold'em No Limit ($0.01/$0.02) - 2021/08/21 23:42:48 CET [2021/08/21 17:42:48 ET]
Table 'Halley' 6-max Seat #1 is the button
Seat 1: maressen ($3.19 in chips) 
Seat 2: babuin72 ($1.85 in chips) 
Seat 3: isaeg ($2.65 in chips) 
Seat 4: OmahaWheels ($3.56 in chips) 
Seat 5: Scaaalll ($2.92 in chips) 
Seat 6: alphabeta1d ($2 in chips) 
babuin72: posts small blind $0.01
isaeg: posts big blind $0.02
*** HOLE CARDS ***
Dealt to Scaaalll [4d 2c]
OmahaWheels: folds 
Scaaalll: folds 
alphabeta1d: folds 
maressen: raises $0.03 to $0.05
babuin72: folds 
isaeg: folds 
Uncalled bet ($0.03) returned to maressen
maressen collected $0.05 from pot
maressen: doesn't show hand 
isaeg is disconnected 
*** SUMMARY ***
Total pot $0.05 | Rake $0 
Seat 1: maressen (button) collected ($0.05)
Seat 2: babuin72 (small blind) folded before Flop
Seat 3: isaeg (big blind) folded before Flop
Seat 4: OmahaWheels folded before Flop (didn't bet)
Seat 5: Scaaalll folded before Flop (didn't bet)
Seat 6: alphabeta1d folded before Flop (didn't bet)



PokerStars Zoom Hand #229233756029:  Hold'em No Limit ($0.01/$0.02) - 2021/08/21 23:42:42 CET [2021/08/21 17:42:42 ET]
Table 'Halley' 6-max Seat #1 is the button
Seat 1: orlovac1995 ($5.45 in chips) 
Seat 2: Scaaalll ($2.93 in chips) 
Seat 3: rodrigoasor ($3.61 in chips) 
Seat 4: OFSHOR ($5.34 in chips) 
Seat 5: leeroy818 ($2.52 in chips) 
Seat 6: fabor1303 ($2.93 in chips) 
Scaaalll: posts small blind $0.01
rodrigoasor: posts big blind $0.02
*** HOLE CARDS ***
Dealt to Scaaalll [2c 5c]
OFSHOR has timed out
OFSHOR: folds 
leeroy818: folds 
fabor1303: folds 
orlovac1995: folds 
Scaaalll: folds 
Uncalled bet ($0.01) returned to rodrigoasor
rodrigoasor collected $0.02 from pot
rodrigoasor: doesn't show hand 
*** SUMMARY ***
Total pot $0.02 | Rake $0 
Seat 1: orlovac1995 (button) folded before Flop (didn't bet)
Seat 2: Scaaalll (small blind) folded before Flop
Seat 3: rodrigoasor (big blind) collected ($0.02)
Seat 4: OFSHOR folded before Flop (didn't bet)
Seat 5: leeroy818 folded before Flop (didn't bet)
Seat 6: fabor1303 folded before Flop (didn't bet)



PokerStars Zoom Hand #229233760503:  Hold'em No Limit ($0.01/$0.02) - 2021/08/21 23:42:53 CET [2021/08/21 17:42:53 ET]
Table 'Halley' 6-max Seat #1 is the button
Seat 1: ibstah ($6.87 in chips) 
Seat 2: H0mmer99 ($2.88 in chips) 
Seat 3: Gamer577 ($3.67 in chips) 
Seat 4: Scaaalll ($2.92 in chips) 
Seat 5: Bol'tazar111 ($2.19 in chips) 
Seat 6: i.m.bluffing002 ($1.76 in chips) 
H0mmer99: posts small blind $0.01
Gamer577: posts big blind $0.02
*** HOLE CARDS ***
Dealt to Scaaalll [6c 8s]
Scaaalll: folds 
Bol'tazar111: folds 
i.m.bluffing002: raises $1.74 to $1.76 and is all-in
ibstah: folds 
H0mmer99: folds 
Gamer577: folds 
Uncalled bet ($1.74) returned to i.m.bluffing002
i.m.bluffing002 collected $0.05 from pot
i.m.bluffing002: doesn't show hand 
*** SUMMARY ***
Total pot $0.05 | Rake $0 
Seat 1: ibstah (button) folded before Flop (didn't bet)
Seat 2: H0mmer99 (small blind) folded before Flop
Seat 3: Gamer577 (big blind) folded before Flop
Seat 4: Scaaalll folded before Flop (didn't bet)
Seat 5: Bol'tazar111 folded before Flop (didn't bet)
Seat 6: i.m.bluffing002 collected ($0.05)



PokerStars Zoom Hand #229233746315:  Hold'em No Limit ($0.01/$0.02) - 2021/08/21 23:42:18 CET [2021/08/21 17:42:18 ET]
Table 'Halley' 6-max Seat #1 is the button
Seat 1: slipknot956 ($3.22 in chips) 
Seat 2: Mikeloko182 ($3.05 in chips) 
Seat 3: Scaaalll ($2.95 in chips) 
Seat 4: 0ofreeo0 ($2 in chips) 
Seat 5: Luchazo103 ($2.35 in chips) 
Seat 6: QuienEsDezzed ($2.05 in chips) 
Mikeloko182: posts small blind $0.01
Scaaalll: posts big blind $0.02
*** HOLE CARDS ***
Dealt to Scaaalll [Js 7s]
0ofreeo0: folds 
Luchazo103: folds 
QuienEsDezzed: raises $0.02 to $0.04
slipknot956: raises $0.11 to $0.15
Mikeloko182: folds 
Scaaalll: folds 
QuienEsDezzed: raises $0.11 to $0.26
slipknot956: calls $0.11
*** FLOP *** [Ah 5s 6c]
QuienEsDezzed: checks 
slipknot956: checks 
*** TURN *** [Ah 5s 6c] [6h]
QuienEsDezzed: bets $0.10
slipknot956: raises $0.37 to $0.47
QuienEsDezzed: raises $0.37 to $0.84
slipknot956: folds 
Uncalled bet ($0.37) returned to QuienEsDezzed
QuienEsDezzed collected $1.44 from pot
QuienEsDezzed: doesn't show hand 
*** SUMMARY ***
Total pot $1.49 | Rake $0.05 
Board [Ah 5s 6c 6h]
Seat 1: slipknot956 (button) folded on the Turn
Seat 2: Mikeloko182 (small blind) folded before Flop
Seat 3: Scaaalll (big blind) folded before Flop
Seat 4: 0ofreeo0 folded before Flop (didn't bet)
Seat 5: Luchazo103 folded before Flop (didn't bet)
Seat 6: QuienEsDezzed collected ($1.44)



PokerStars Zoom Hand #229233753527:  Hold'em No Limit ($0.01/$0.02) - 2021/08/21 23:42:36 CET [2021/08/21 17:42:36 ET]
Table 'Halley' 6-max Seat #1 is the button
Seat 1: Scaaalll ($2.93 in chips) 
Seat 2: jaamonra ($2.32 in chips) 
Seat 3: NetoFLX ($2 in chips) 
Seat 4: orlovac1995 ($3.33 in chips) 
Seat 5: SKV_1985 ($2.12 in chips) 
Seat 6: Holmie111 ($3.98 in chips) 
jaamonra: posts small blind $0.01
NetoFLX: posts big blind $0.02
*** HOLE CARDS ***
Dealt to Scaaalll [4s 7d]
Holmie111 is disconnected 
orlovac1995: raises $0.03 to $0.05
SKV_1985: folds 
Holmie111: folds 
Scaaalll: folds 
jaamonra: folds 
NetoFLX: calls $0.03
*** FLOP *** [4d 8d 2h]
NetoFLX: checks 
orlovac1995: checks 
*** TURN *** [4d 8d 2h] [Ah]
NetoFLX: checks 
orlovac1995: checks 
*** RIVER *** [4d 8d 2h Ah] [5h]
NetoFLX: bets $0.10
orlovac1995: calls $0.10
*** SHOW DOWN ***
NetoFLX: shows [7h 6c] (a straight, Four to Eight)
orlovac1995: shows [Js Ad] (a pair of Aces)
NetoFLX collected $0.30 from pot
*** SUMMARY ***
Total pot $0.31 | Rake $0.01 
Board [4d 8d 2h Ah 5h]
Seat 1: Scaaalll (button) folded before Flop (didn't bet)
Seat 2: jaamonra (small blind) folded before Flop
Seat 3: NetoFLX (big blind) showed [7h 6c] and won ($0.30) with a straight, Four to Eight
Seat 4: orlovac1995 showed [Js Ad] and lost with a pair of Aces
Seat 5: SKV_1985 folded before Flop (didn't bet)
Seat 6: Holmie111 folded before Flop (didn't bet)



PokerStars Zoom Hand #229233762137:  Hold'em No Limit ($0.01/$0.02) - 2021/08/21 23:42:57 CET [2021/08/21 17:42:57 ET]
Table 'Halley' 6-max Seat #1 is the button
Seat 1: EzukoChan ($3.14 in chips) 
Seat 2: fabor1303 ($10.30 in chips) 
Seat 3: Scaaalll ($2.92 in chips) 
Seat 4: ash1448 ($6.39 in chips) 
Seat 5: squidy4 ($2.14 in chips) 
Seat 6: clay070 ($1.26 in chips) 
fabor1303: posts small blind $0.01
Scaaalll: posts big blind $0.02
*** HOLE CARDS ***
Dealt to Scaaalll [Th Kc]
ash1448: raises $0.02 to $0.04
squidy4: folds 
clay070: raises $0.02 to $0.06
EzukoChan: folds 
fabor1303: folds 
Scaaalll: folds 
ash1448: calls $0.02
*** FLOP *** [8c 4h Ah]
ash1448: checks 
clay070: checks 
*** TURN *** [8c 4h Ah] [2h]
ash1448: checks 
clay070: checks 
*** RIVER *** [8c 4h Ah 2h] [4d]
ash1448: checks 
clay070: checks 
*** SHOW DOWN ***
ash1448: shows [Qs Ks] (a pair of Fours)
clay070: shows [9c Ac] (two pair, Aces and Fours)
clay070 collected $0.14 from pot
*** SUMMARY ***
Total pot $0.15 | Rake $0.01 
Board [8c 4h Ah 2h 4d]
Seat 1: EzukoChan (button) folded before Flop (didn't bet)
Seat 2: fabor1303 (small blind) folded before Flop
Seat 3: Scaaalll (big blind) folded before Flop
Seat 4: ash1448 showed [Qs Ks] and lost with a pair of Fours
Seat 5: squidy4 folded before Flop (didn't bet)
Seat 6: clay070 showed [9c Ac] and won ($0.14) with two pair, Aces and Fours



PokerStars Zoom Hand #229233768897:  Hold'em No Limit ($0.01/$0.02) - 2021/08/21 23:43:14 CET [2021/08/21 17:43:14 ET]
Table 'Halley' 6-max Seat #1 is the button
Seat 1: Scaaalll ($2.90 in chips) 
Seat 2: jaamonra ($2.30 in chips) 
Seat 3: Sul07 ($0.99 in chips) 
Seat 4: EdwardF95 ($2.04 in chips) 
Seat 5: ash1448 ($7.02 in chips) 
Seat 6: RuazGross ($2.04 in chips) 
jaamonra: posts small blind $0.01
Sul07: posts big blind $0.02
*** HOLE CARDS ***
Dealt to Scaaalll [Qd Ac]
EdwardF95: folds 
ash1448: folds 
RuazGross: raises $0.02 to $0.04
Scaaalll: raises $0.12 to $0.16
jaamonra: folds 
Sul07: folds 
RuazGross: raises $0.12 to $0.28
Scaaalll: calls $0.12
*** FLOP *** [7h 6h 3d]
RuazGross: bets $0.28
Scaaalll: folds 
Uncalled bet ($0.28) returned to RuazGross
RuazGross collected $0.57 from pot
RuazGross: doesn't show hand 
*** SUMMARY ***
Total pot $0.59 | Rake $0.02 
Board [7h 6h 3d]
Seat 1: Scaaalll (button) folded on the Flop
Seat 2: jaamonra (small blind) folded before Flop
Seat 3: Sul07 (big blind) folded before Flop
Seat 4: EdwardF95 folded before Flop (didn't bet)
Seat 5: ash1448 folded before Flop (didn't bet)
Seat 6: RuazGross collected ($0.57)



PokerStars Zoom Hand #229233785750:  Hold'em No Limit ($0.01/$0.02) - 2021/08/21 23:43:56 CET [2021/08/21 17:43:56 ET]
Table 'Halley' 6-max Seat #1 is the button
Seat 1: FreddyFlips ($1.83 in chips) 
Seat 2: Scaaalll ($2.62 in chips) 
Seat 3: A.Khodyakov ($2.10 in chips) 
Seat 4: Sul07 ($0.96 in chips) 
Seat 5: polymorhp ($3.95 in chips) 
Seat 6: BlackhawKK's ($2.03 in chips) 
Scaaalll: posts small blind $0.01
A.Khodyakov: posts big blind $0.02
*** HOLE CARDS ***
Dealt to Scaaalll [5h Ad]
FreddyFlips is disconnected 
Sul07: raises $0.04 to $0.06
polymorhp: folds 
BlackhawKK's: folds 
FreddyFlips: folds 
Scaaalll: folds 
A.Khodyakov: folds 
Uncalled bet ($0.04) returned to Sul07
Sul07 collected $0.05 from pot
Sul07: doesn't show hand 
*** SUMMARY ***
Total pot $0.05 | Rake $0 
Seat 1: FreddyFlips (button) folded before Flop (didn't bet)
Seat 2: Scaaalll (small blind) folded before Flop
Seat 3: A.Khodyakov (big blind) folded before Flop
Seat 4: Sul07 collected ($0.05)
Seat 5: polymorhp folded before Flop (didn't bet)
Seat 6: BlackhawKK's folded before Flop (didn't bet)



PokerStars Zoom Hand #229233789753:  Hold'em No Limit ($0.01/$0.02) - 2021/08/21 23:44:06 CET [2021/08/21 17:44:06 ET]
Table 'Halley' 6-max Seat #1 is the button
Seat 1: fabor1303 ($2 in chips) 
Seat 2: Ck@tih@ ($1.74 in chips) 
Seat 3: YgovAndrey ($2.56 in chips) 
Seat 4: Mikeloko182 ($2.01 in chips) 
Seat 5: 888lifeIS ($2.33 in chips) 
Seat 6: Scaaalll ($2.61 in chips) 
Ck@tih@: posts small blind $0.01
YgovAndrey: posts big blind $0.02
*** HOLE CARDS ***
Dealt to Scaaalll [Jc 4c]
Mikeloko182: folds 
888lifeIS: folds 
Scaaalll: folds 
fabor1303: folds 
Ck@tih@: folds 
Uncalled bet ($0.01) returned to YgovAndrey
YgovAndrey collected $0.02 from pot
YgovAndrey: doesn't show hand 
*** SUMMARY ***
Total pot $0.02 | Rake $0 
Seat 1: fabor1303 (button) folded before Flop (didn't bet)
Seat 2: Ck@tih@ (small blind) folded before Flop
Seat 3: YgovAndrey (big blind) collected ($0.02)
Seat 4: Mikeloko182 folded before Flop (didn't bet)
Seat 5: 888lifeIS folded before Flop (didn't bet)
Seat 6: Scaaalll folded before Flop (didn't bet)



PokerStars Zoom Hand #229233794568:  Hold'em No Limit ($0.01/$0.02) - 2021/08/21 23:44:18 CET [2021/08/21 17:44:18 ET]
Table 'Halley' 6-max Seat #1 is the button
Seat 1: Scaaalll ($2.61 in chips) 
Seat 2: rancing87 ($2.37 in chips) 
Seat 3: Agneobr ($1.58 in chips) 
Seat 4: cheddarspreada ($1.61 in chips) 
Seat 5: levachok ($5.15 in chips) 
Seat 6: Xlavariable ($6.73 in chips) 
rancing87: posts small blind $0.01
Agneobr: posts big blind $0.02
*** HOLE CARDS ***
Dealt to Scaaalll [9c 5d]
cheddarspreada: folds 
levachok: folds 
cheddarspreada is disconnected 
Xlavariable: folds 
Scaaalll: folds 
rancing87: folds 
Uncalled bet ($0.01) returned to Agneobr
Agneobr collected $0.02 from pot
Agneobr: doesn't show hand 
*** SUMMARY ***
Total pot $0.02 | Rake $0 
Seat 1: Scaaalll (button) folded before Flop (didn't bet)
Seat 2: rancing87 (small blind) folded before Flop
Seat 3: Agneobr (big blind) collected ($0.02)
Seat 4: cheddarspreada folded before Flop (didn't bet)
Seat 5: levachok folded before Flop (didn't bet)
Seat 6: Xlavariable folded before Flop (didn't bet)



PokerStars Zoom Hand #229233792162:  Hold'em No Limit ($0.01/$0.02) - 2021/08/21 23:44:12 CET [2021/08/21 17:44:12 ET]
Table 'Halley' 6-max Seat #1 is the button
Seat 1: STE1NBERG ($2.13 in chips) 
Seat 2: Razmenchic ($4.76 in chips) 
Seat 3: Xpokerfreak ($1.27 in chips) 
Seat 4: Scaaalll ($2.61 in chips) 
Seat 5: spirosz1000 ($1.99 in chips) 
Seat 6: so0love ($6.58 in chips) 
Razmenchic: posts small blind $0.01
Xpokerfreak: posts big blind $0.02
*** HOLE CARDS ***
Dealt to Scaaalll [8d 6d]
Scaaalll: folds 
spirosz1000: raises $0.02 to $0.04
so0love: raises $0.02 to $0.06
STE1NBERG: calls $0.06
Razmenchic: folds 
Xpokerfreak: folds 
spirosz1000: calls $0.02
*** FLOP *** [3d 3c 4d]
spirosz1000: checks 
so0love: checks 
STE1NBERG: checks 
*** TURN *** [3d 3c 4d] [5c]
spirosz1000: checks 
so0love: checks 
STE1NBERG: checks 
*** RIVER *** [3d 3c 4d 5c] [2h]
spirosz1000: checks 
so0love: checks 
STE1NBERG: checks 
*** SHOW DOWN ***
spirosz1000: shows [Kh Jc] (a pair of Threes)
so0love: mucks hand 
STE1NBERG: mucks hand 
spirosz1000 collected $0.20 from pot
*** SUMMARY ***
Total pot $0.21 | Rake $0.01 
Board [3d 3c 4d 5c 2h]
Seat 1: STE1NBERG (button) mucked [Qh Td]
Seat 2: Razmenchic (small blind) folded before Flop
Seat 3: Xpokerfreak (big blind) folded before Flop
Seat 4: Scaaalll folded before Flop (didn't bet)
Seat 5: spirosz1000 showed [Kh Jc] and won ($0.20) with a pair of Threes
Seat 6: so0love mucked [9h Kd]



PokerStars Zoom Hand #229233798645:  Hold'em No Limit ($0.01/$0.02) - 2021/08/21 23:44:28 CET [2021/08/21 17:44:28 ET]
Table 'Halley' 6-max Seat #1 is the button
Seat 1: zergmiky ($4.87 in chips) 
Seat 2: gizum17 ($3.12 in chips) 
Seat 3: Scaaalll ($2.61 in chips) 
Seat 4: BeastBoy18 ($2.17 in chips) 
Seat 5: OmahaWheels ($3.61 in chips) 
Seat 6: Agneobr ($1.84 in chips) 
gizum17: posts small blind $0.01
Scaaalll: posts big blind $0.02
*** HOLE CARDS ***
Dealt to Scaaalll [6h Qs]
BeastBoy18: folds 
OmahaWheels: raises $0.04 to $0.06
Agneobr: raises $0.08 to $0.14
zergmiky: folds 
gizum17: folds 
Scaaalll: folds 
OmahaWheels: calls $0.08
*** FLOP *** [7c 6c 2c]
OmahaWheels: checks 
Agneobr: bets $0.15
OmahaWheels: folds 
Uncalled bet ($0.15) returned to Agneobr
Agneobr collected $0.30 from pot
Agneobr: doesn't show hand 
*** SUMMARY ***
Total pot $0.31 | Rake $0.01 
Board [7c 6c 2c]
Seat 1: zergmiky (button) folded before Flop (didn't bet)
Seat 2: gizum17 (small blind) folded before Flop
Seat 3: Scaaalll (big blind) folded before Flop
Seat 4: BeastBoy18 folded before Flop (didn't bet)
Seat 5: OmahaWheels folded on the Flop
Seat 6: Agneobr collected ($0.30)



PokerStars Zoom Hand #229233802740:  Hold'em No Limit ($0.01/$0.02) - 2021/08/21 23:44:38 CET [2021/08/21 17:44:38 ET]
Table 'Halley' 6-max Seat #1 is the button
Seat 1: Recasia ($0.69 in chips) 
Seat 2: Scaaalll ($2.59 in chips) 
Seat 3: Ape$apiens ($1.20 in chips) 
Seat 4: Doktor Yes ($2.08 in chips) 
Seat 5: JacekSoplica ($2.02 in chips) 
Seat 6: lucksuckdonk ($7.57 in chips) 
Scaaalll: posts small blind $0.01
Ape$apiens: posts big blind $0.02
*** HOLE CARDS ***
Dealt to Scaaalll [Jh Js]
JacekSoplica is disconnected 
Doktor Yes: raises $0.04 to $0.06
JacekSoplica: folds 
Ape$apiens is disconnected 
lucksuckdonk: calls $0.06
Recasia: folds 
Scaaalll: calls $0.05
Ape$apiens: folds 
*** FLOP *** [2d 9s 7c]
Scaaalll: checks 
Doktor Yes: bets $0.09
lucksuckdonk: calls $0.09
Scaaalll: calls $0.09
*** TURN *** [2d 9s 7c] [6h]
Scaaalll: checks 
Doktor Yes: checks 
lucksuckdonk: bets $0.25
Scaaalll: calls $0.25
Doktor Yes: folds 
*** RIVER *** [2d 9s 7c 6h] [2c]
Scaaalll: checks 
lucksuckdonk: checks 
*** SHOW DOWN ***
Scaaalll: shows [Jh Js] (two pair, Jacks and Deuces)
lucksuckdonk: mucks hand 
Scaaalll collected $0.93 from pot
*** SUMMARY ***
Total pot $0.97 | Rake $0.04 
Board [2d 9s 7c 6h 2c]
Seat 1: Recasia (button) folded before Flop (didn't bet)
Seat 2: Scaaalll (small blind) showed [Jh Js] and won ($0.93) with two pair, Jacks and Deuces
Seat 3: Ape$apiens (big blind) folded before Flop
Seat 4: Doktor Yes folded on the Turn
Seat 5: JacekSoplica folded before Flop (didn't bet)
Seat 6: lucksuckdonk mucked [8c 8d]



PokerStars Zoom Hand #229233823301:  Hold'em No Limit ($0.01/$0.02) - 2021/08/21 23:45:29 CET [2021/08/21 17:45:29 ET]
Table 'Halley' 6-max Seat #1 is the button
Seat 1: lucksuckdonk ($7.17 in chips) 
Seat 2: jaamonra ($2.35 in chips) 
Seat 3: FreddyFlips ($1.87 in chips) 
Seat 4: owtwilldo ($2.19 in chips) 
Seat 5: Treadero ($1.07 in chips) 
Seat 6: Scaaalll ($3.12 in chips) 
jaamonra: posts small blind $0.01
FreddyFlips: posts big blind $0.02
*** HOLE CARDS ***
Dealt to Scaaalll [8s 9h]
owtwilldo: folds 
Treadero: folds 
Scaaalll: folds 
lucksuckdonk: folds 
jaamonra: raises $0.04 to $0.06
FreddyFlips: calls $0.04
*** FLOP *** [Ks Ts Kc]
jaamonra: bets $0.08
FreddyFlips: folds 
Uncalled bet ($0.08) returned to jaamonra
jaamonra collected $0.12 from pot
jaamonra: doesn't show hand 
FreddyFlips is disconnected 
*** SUMMARY ***
Total pot $0.12 | Rake $0 
Board [Ks Ts Kc]
Seat 1: lucksuckdonk (button) folded before Flop (didn't bet)
Seat 2: jaamonra (small blind) collected ($0.12)
Seat 3: FreddyFlips (big blind) folded on the Flop
Seat 4: owtwilldo folded before Flop (didn't bet)
Seat 5: Treadero folded before Flop (didn't bet)
Seat 6: Scaaalll folded before Flop (didn't bet)



PokerStars Zoom Hand #229233830329:  Hold'em No Limit ($0.01/$0.02) - 2021/08/21 23:45:47 CET [2021/08/21 17:45:47 ET]
Table 'Halley' 6-max Seat #1 is the button
Seat 1: tarogame ($3.73 in chips) 
Seat 2: Mikeloko182 ($3.06 in chips) 
Seat 3: nivesh14 ($1.14 in chips) 
Seat 4: STE1NBERG ($2.60 in chips) 
Seat 5: gilberto98 ($2.36 in chips) 
Seat 6: Scaaalll ($3.12 in chips) 
Mikeloko182: posts small blind $0.01
nivesh14: posts big blind $0.02
*** HOLE CARDS ***
Dealt to Scaaalll [6s 5h]
STE1NBERG: folds 
gilberto98: folds 
Scaaalll: folds 
tarogame: folds 
Mikeloko182: folds 
Uncalled bet ($0.01) returned to nivesh14
nivesh14 collected $0.02 from pot
nivesh14: doesn't show hand 
*** SUMMARY ***
Total pot $0.02 | Rake $0 
Seat 1: tarogame (button) folded before Flop (didn't bet)
Seat 2: Mikeloko182 (small blind) folded before Flop
Seat 3: nivesh14 (big blind) collected ($0.02)
Seat 4: STE1NBERG folded before Flop (didn't bet)
Seat 5: gilberto98 folded before Flop (didn't bet)
Seat 6: Scaaalll folded before Flop (didn't bet)



PokerStars Zoom Hand #229233831917:  Hold'em No Limit ($0.01/$0.02) - 2021/08/21 23:45:51 CET [2021/08/21 17:45:51 ET]
Table 'Halley' 6-max Seat #1 is the button
Seat 1: nbarreiro021 ($2.08 in chips) 
Seat 2: ulisessoria ($2.60 in chips) 
Seat 3: Scaaalll ($3.12 in chips) 
Seat 4: Reipinguimm ($2.48 in chips) 
Seat 5: fatedsuperior ($0.93 in chips) 
Seat 6: Merlin_Arg ($2.76 in chips) 
ulisessoria: posts small blind $0.01
Scaaalll: posts big blind $0.02
*** HOLE CARDS ***
Dealt to Scaaalll [Qs 9h]
fatedsuperior is disconnected 
Reipinguimm: raises $0.03 to $0.05
fatedsuperior: folds 
Merlin_Arg: folds 
nbarreiro021: folds 
ulisessoria: folds 
Scaaalll: folds 
Uncalled bet ($0.03) returned to Reipinguimm
Reipinguimm collected $0.05 from pot
Reipinguimm: doesn't show hand 
*** SUMMARY ***
Total pot $0.05 | Rake $0 
Seat 1: nbarreiro021 (button) folded before Flop (didn't bet)
Seat 2: ulisessoria (small blind) folded before Flop
Seat 3: Scaaalll (big blind) folded before Flop
Seat 4: Reipinguimm collected ($0.05)
Seat 5: fatedsuperior folded before Flop (didn't bet)
Seat 6: Merlin_Arg folded before Flop (didn't bet)



PokerStars Zoom Hand #229233825591:  Hold'em No Limit ($0.01/$0.02) - 2021/08/21 23:45:35 CET [2021/08/21 17:45:35 ET]
Table 'Halley' 6-max Seat #1 is the button
Seat 1: NetoFLX ($2.05 in chips) 
Seat 2: Alexasha78 ($2.57 in chips) 
Seat 3: fishh_play ($5.71 in chips) 
Seat 4: thfc12325 ($1.37 in chips) 
Seat 5: Scaaalll ($3.12 in chips) 
Seat 6: EdwardF95 ($2 in chips) 
Alexasha78: posts small blind $0.01
fishh_play: posts big blind $0.02
*** HOLE CARDS ***
Dealt to Scaaalll [4s Kh]
thfc12325: folds 
thfc12325 is disconnected 
Scaaalll: folds 
EdwardF95: raises $0.04 to $0.06
NetoFLX: calls $0.06
Alexasha78: calls $0.05
fishh_play: calls $0.04
*** FLOP *** [8c 5s Jd]
Alexasha78: checks 
fishh_play: checks 
EdwardF95: bets $0.12
NetoFLX: folds 
Alexasha78: calls $0.12
fishh_play: folds 
*** TURN *** [8c 5s Jd] [3c]
Alexasha78: checks 
EdwardF95: bets $0.20
Alexasha78: calls $0.20
*** RIVER *** [8c 5s Jd 3c] [As]
Alexasha78: checks 
EdwardF95: checks 
*** SHOW DOWN ***
Alexasha78: shows [9h Qh] (high card Ace)
EdwardF95: shows [Js Ts] (a pair of Jacks)
EdwardF95 collected $0.85 from pot
*** SUMMARY ***
Total pot $0.88 | Rake $0.03 
Board [8c 5s Jd 3c As]
Seat 1: NetoFLX (button) folded on the Flop
Seat 2: Alexasha78 (small blind) showed [9h Qh] and lost with high card Ace
Seat 3: fishh_play (big blind) folded on the Flop
Seat 4: thfc12325 folded before Flop (didn't bet)
Seat 5: Scaaalll folded before Flop (didn't bet)
Seat 6: EdwardF95 showed [Js Ts] and won ($0.85) with a pair of Jacks



PokerStars Zoom Hand #229233828326:  Hold'em No Limit ($0.01/$0.02) - 2021/08/21 23:45:42 CET [2021/08/21 17:45:42 ET]
Table 'Halley' 6-max Seat #1 is the button
Seat 1: RrriotGrrrl ($3.56 in chips) 
Seat 2: h3cTics ($1.32 in chips) 
Seat 3: Nikalians ($1.06 in chips) 
Seat 4: Scaaalll ($3.12 in chips) 
Seat 5: ofalkeid ($1.74 in chips) 
Seat 6: Jones278 ($2.60 in chips) 
h3cTics: posts small blind $0.01
Nikalians: posts big blind $0.02
*** HOLE CARDS ***
Dealt to Scaaalll [3h 4d]
Scaaalll: folds 
ofalkeid: raises $0.04 to $0.06
Jones278: folds 
RrriotGrrrl: calls $0.06
h3cTics: calls $0.05
Nikalians: folds 
*** FLOP *** [Jd 5h 8h]
h3cTics: checks 
ofalkeid: bets $0.10
RrriotGrrrl: calls $0.10
h3cTics: calls $0.10
*** TURN *** [Jd 5h 8h] [Kd]
h3cTics: bets $0.10
ofalkeid: calls $0.10
RrriotGrrrl: calls $0.10
*** RIVER *** [Jd 5h 8h Kd] [5c]
h3cTics: bets $0.34
ofalkeid: calls $0.34
RrriotGrrrl: folds 
*** SHOW DOWN ***
h3cTics: shows [Ad 7d] (a pair of Fives)
ofalkeid: shows [Qc Jc] (two pair, Jacks and Fives)
ofalkeid collected $1.43 from pot
*** SUMMARY ***
Total pot $1.48 | Rake $0.05 
Board [Jd 5h 8h Kd 5c]
Seat 1: RrriotGrrrl (button) folded on the River
Seat 2: h3cTics (small blind) showed [Ad 7d] and lost with a pair of Fives
Seat 3: Nikalians (big blind) folded before Flop
Seat 4: Scaaalll folded before Flop (didn't bet)
Seat 5: ofalkeid showed [Qc Jc] and won ($1.43) with two pair, Jacks and Fives
Seat 6: Jones278 folded before Flop (didn't bet)



PokerStars Zoom Hand #229233841154:  Hold'em No Limit ($0.01/$0.02) - 2021/08/21 23:46:14 CET [2021/08/21 17:46:14 ET]
Table 'Halley' 6-max Seat #1 is the button
Seat 1: Scaaalll ($3.10 in chips) 
Seat 2: kahzura ($2 in chips) 
Seat 3: Doktor Yes ($2.07 in chips) 
Seat 4: 21041956 ($1.11 in chips) 
Seat 5: Ilya_Skobelev ($1.69 in chips) 
Seat 6: ulisessoria ($2.59 in chips) 
kahzura: posts small blind $0.01
Doktor Yes: posts big blind $0.02
*** HOLE CARDS ***
Dealt to Scaaalll [Js 5c]
21041956: folds 
Ilya_Skobelev: calls $0.02
ulisessoria: folds 
Scaaalll: folds 
kahzura: folds 
Doktor Yes: checks 
*** FLOP *** [Kc 7s 9h]
Doktor Yes: bets $0.02
Ilya_Skobelev: folds 
Uncalled bet ($0.02) returned to Doktor Yes
Doktor Yes collected $0.05 from pot
Doktor Yes: doesn't show hand 
Ilya_Skobelev is disconnected 
*** SUMMARY ***
Total pot $0.05 | Rake $0 
Board [Kc 7s 9h]
Seat 1: Scaaalll (button) folded before Flop (didn't bet)
Seat 2: kahzura (small blind) folded before Flop
Seat 3: Doktor Yes (big blind) collected ($0.05)
Seat 4: 21041956 folded before Flop (didn't bet)
Seat 5: Ilya_Skobelev folded on the Flop
Seat 6: ulisessoria folded before Flop (didn't bet)



PokerStars Zoom Hand #229233842825:  Hold'em No Limit ($0.01/$0.02) - 2021/08/21 23:46:18 CET [2021/08/21 17:46:18 ET]
Table 'Halley' 6-max Seat #1 is the button
Seat 1: BautiMang ($2.13 in chips) 
Seat 2: Scaaalll ($3.10 in chips) 
Seat 3: Merlin_Arg ($2.34 in chips) 
Seat 4: AXXILLES ($5.28 in chips) 
Seat 5: Kainick ($1.73 in chips) 
Seat 6: SaLoMaN4iK ($2.06 in chips) 
Scaaalll: posts small blind $0.01
Merlin_Arg: posts big blind $0.02
*** HOLE CARDS ***
Dealt to Scaaalll [Jc Ks]
AXXILLES: folds 
Kainick: calls $0.02
SaLoMaN4iK: folds 
SaLoMaN4iK is disconnected 
BautiMang: folds 
Scaaalll: raises $0.06 to $0.08
Merlin_Arg: folds 
Kainick: calls $0.06
*** FLOP *** [Jh 8s 2c]
Scaaalll: bets $0.11
Kainick: calls $0.11
*** TURN *** [Jh 8s 2c] [8c]
Scaaalll: bets $0.23
Kainick: folds 
Uncalled bet ($0.23) returned to Scaaalll
Scaaalll collected $0.39 from pot
Scaaalll: doesn't show hand 
*** SUMMARY ***
Total pot $0.40 | Rake $0.01 
Board [Jh 8s 2c 8c]
Seat 1: BautiMang (button) folded before Flop (didn't bet)
Seat 2: Scaaalll (small blind) collected ($0.39)
Seat 3: Merlin_Arg (big blind) folded before Flop
Seat 4: AXXILLES folded before Flop (didn't bet)
Seat 5: Kainick folded on the Turn
Seat 6: SaLoMaN4iK folded before Flop (didn't bet)



PokerStars Zoom Hand #229233839525:  Hold'em No Limit ($0.01/$0.02) - 2021/08/21 23:46:10 CET [2021/08/21 17:46:10 ET]
Table 'Halley' 6-max Seat #1 is the button
Seat 1: hansantiago ($2.28 in chips) 
Seat 2: max-101219 ($2.07 in chips) 
Seat 3: Finderra ($3.45 in chips) 
Seat 4: Nikalians ($1.03 in chips) 
Seat 5: Scaaalll ($3.10 in chips) 
Seat 6: cutter2468 ($2.84 in chips) 
max-101219: posts small blind $0.01
Finderra: posts big blind $0.02
*** HOLE CARDS ***
Dealt to Scaaalll [Ad 8c]
Nikalians: raises $0.03 to $0.05
Scaaalll: folds 
cutter2468: folds 
hansantiago: calls $0.05
max-101219: calls $0.04
Finderra: folds 
*** FLOP *** [5h 4s Jc]
max-101219: checks 
Nikalians: checks 
hansantiago: checks 
*** TURN *** [5h 4s Jc] [4h]
max-101219: bets $0.04
Nikalians: raises $0.12 to $0.16
hansantiago: calls $0.16
max-101219: calls $0.12
*** RIVER *** [5h 4s Jc 4h] [Th]
max-101219: checks 
Nikalians: bets $0.82 and is all-in
hansantiago: calls $0.82
max-101219: raises $1.04 to $1.86 and is all-in
hansantiago: calls $1.04
*** SHOW DOWN ***
max-101219: shows [6h Ah] (a flush, Ace high)
hansantiago: shows [6s 4d] (three of a kind, Fours)
max-101219 collected $2.01 from side pot
Nikalians: shows [Jh Js] (a full house, Jacks full of Fours)
Nikalians collected $3 from main pot
*** SUMMARY ***
Total pot $5.19 Main pot $3. Side pot $2.01. | Rake $0.18 
Board [5h 4s Jc 4h Th]
Seat 1: hansantiago (button) showed [6s 4d] and lost with three of a kind, Fours
Seat 2: max-101219 (small blind) showed [6h Ah] and won ($2.01) with a flush, Ace high
Seat 3: Finderra (big blind) folded before Flop
Seat 4: Nikalians showed [Jh Js] and won ($3) with a full house, Jacks full of Fours
Seat 5: Scaaalll folded before Flop (didn't bet)
Seat 6: cutter2468 folded before Flop (didn't bet)



PokerStars Zoom Hand #229233859802:  Hold'em No Limit ($0.01/$0.02) - 2021/08/21 23:47:01 CET [2021/08/21 17:47:01 ET]
Table 'Halley' 6-max Seat #1 is the button
Seat 1: BexleyBoy ($3.25 in chips) 
Seat 2: nbarreiro021 ($2.03 in chips) 
Seat 3: tisadaisy ($2 in chips) 
Seat 4: Scaaalll ($3.30 in chips) 
Seat 5: Posaunengodi ($5.24 in chips) 
Seat 6: ctaceo ($2.07 in chips) 
nbarreiro021: posts small blind $0.01
tisadaisy: posts big blind $0.02
*** HOLE CARDS ***
Dealt to Scaaalll [8c Qs]
Scaaalll: folds 
Posaunengodi: folds 
ctaceo: raises $0.03 to $0.05
BexleyBoy: folds 
nbarreiro021: folds 
tisadaisy: folds 
Uncalled bet ($0.03) returned to ctaceo
ctaceo collected $0.05 from pot
ctaceo: doesn't show hand 
*** SUMMARY ***
Total pot $0.05 | Rake $0 
Seat 1: BexleyBoy (button) folded before Flop (didn't bet)
Seat 2: nbarreiro021 (small blind) folded before Flop
Seat 3: tisadaisy (big blind) folded before Flop
Seat 4: Scaaalll folded before Flop (didn't bet)
Seat 5: Posaunengodi folded before Flop (didn't bet)
Seat 6: ctaceo collected ($0.05)



PokerStars Zoom Hand #229233861351:  Hold'em No Limit ($0.01/$0.02) - 2021/08/21 23:47:05 CET [2021/08/21 17:47:05 ET]
Table 'Halley' 6-max Seat #1 is the button
Seat 1: JacekSoplica ($2.26 in chips) 
Seat 2: disanddowny ($2.97 in chips) 
Seat 3: fishh_play ($7.31 in chips) 
Seat 4: Scaaalll ($3.30 in chips) 
Seat 5: Merlin_Arg ($3.86 in chips) 
Seat 6: didiclavi777 ($2.56 in chips) 
disanddowny: posts small blind $0.01
fishh_play: posts big blind $0.02
*** HOLE CARDS ***
Dealt to Scaaalll [Ac Qh]
Scaaalll: raises $0.04 to $0.06
JacekSoplica is disconnected 
Merlin_Arg: folds 
didiclavi777: folds 
JacekSoplica: folds 
disanddowny: folds 
fishh_play: folds 
Uncalled bet ($0.04) returned to Scaaalll
Scaaalll collected $0.05 from pot
Scaaalll: doesn't show hand 
*** SUMMARY ***
Total pot $0.05 | Rake $0 
Seat 1: JacekSoplica (button) folded before Flop (didn't bet)
Seat 2: disanddowny (small blind) folded before Flop
Seat 3: fishh_play (big blind) folded before Flop
Seat 4: Scaaalll collected ($0.05)
Seat 5: Merlin_Arg folded before Flop (didn't bet)
Seat 6: didiclavi777 folded before Flop (didn't bet)



PokerStars Zoom Hand #229233868004:  Hold'em No Limit ($0.01/$0.02) - 2021/08/21 23:47:22 CET [2021/08/21 17:47:22 ET]
Table 'Halley' 6-max Seat #1 is the button
Seat 1: Mikeloko182 ($2 in chips) 
Seat 2: fabor1303 ($5.72 in chips) 
Seat 3: NoEff0rt2w1n ($2.56 in chips) 
Seat 4: bt710 ($5.61 in chips) 
Seat 5: 365p2eva ($2.83 in chips) 
Seat 6: Scaaalll ($3.33 in chips) 
fabor1303: posts small blind $0.01
NoEff0rt2w1n: posts big blind $0.02
*** HOLE CARDS ***
Dealt to Scaaalll [3s Qh]
bt710: folds 
365p2eva: folds 
Scaaalll: folds 
Mikeloko182: folds 
fabor1303: raises $0.04 to $0.06
NoEff0rt2w1n: raises $0.12 to $0.18
fabor1303: folds 
Uncalled bet ($0.12) returned to NoEff0rt2w1n
NoEff0rt2w1n collected $0.12 from pot
NoEff0rt2w1n: doesn't show hand 
*** SUMMARY ***
Total pot $0.12 | Rake $0 
Seat 1: Mikeloko182 (button) folded before Flop (didn't bet)
Seat 2: fabor1303 (small blind) folded before Flop
Seat 3: NoEff0rt2w1n (big blind) collected ($0.12)
Seat 4: bt710 folded before Flop (didn't bet)
Seat 5: 365p2eva folded before Flop (didn't bet)
Seat 6: Scaaalll folded before Flop (didn't bet)



PokerStars Zoom Hand #229233869995:  Hold'em No Limit ($0.01/$0.02) - 2021/08/21 23:47:27 CET [2021/08/21 17:47:27 ET]
Table 'Halley' 6-max Seat #1 is the button
Seat 1: Zamin Khan ($2.18 in chips) 
Seat 2: Lekcey05 ($2.10 in chips) 
Seat 3: Scaaalll ($3.33 in chips) 
Seat 4: pavlo8855 ($2.05 in chips) 
Seat 5: osantos401 ($9.76 in chips) 
Seat 6: bt710 ($5.61 in chips) 
Lekcey05: posts small blind $0.01
Scaaalll: posts big blind $0.02
*** HOLE CARDS ***
Dealt to Scaaalll [4d 4c]
pavlo8855: folds 
osantos401: folds 
bt710: folds 
Zamin Khan: raises $0.02 to $0.04
Lekcey05: folds 
Scaaalll: calls $0.02
*** FLOP *** [9c Ah 4s]
Scaaalll: checks 
Zamin Khan: bets $0.04
Scaaalll: raises $0.08 to $0.12
Zamin Khan: calls $0.08
*** TURN *** [9c Ah 4s] [Tc]
Scaaalll: bets $0.22
Zamin Khan: calls $0.22
*** RIVER *** [9c Ah 4s Tc] [As]
Scaaalll: checks 
Zamin Khan: bets $0.20
Scaaalll: raises $0.66 to $0.86
Zamin Khan: calls $0.66
*** SHOW DOWN ***
Scaaalll: shows [4d 4c] (a full house, Fours full of Aces)
Zamin Khan: mucks hand 
Scaaalll collected $2.38 from pot
*** SUMMARY ***
Total pot $2.49 | Rake $0.11 
Board [9c Ah 4s Tc As]
Seat 1: Zamin Khan (button) mucked [Jh Ac]
Seat 2: Lekcey05 (small blind) folded before Flop
Seat 3: Scaaalll (big blind) showed [4d 4c] and won ($2.38) with a full house, Fours full of Aces
Seat 4: pavlo8855 folded before Flop (didn't bet)
Seat 5: osantos401 folded before Flop (didn't bet)
Seat 6: bt710 folded before Flop (didn't bet)



PokerStars Zoom Hand #229233904052:  Hold'em No Limit ($0.01/$0.02) - 2021/08/21 23:48:54 CET [2021/08/21 17:48:54 ET]
Table 'Halley' 6-max Seat #1 is the button
Seat 1: WITKOW_AV ($2.15 in chips) 
Seat 2: Scaaalll ($4.47 in chips) 
Seat 3: DmitriyXXL66 ($0.74 in chips) 
Seat 4: HirasawaYuiP ($1.16 in chips) 
Seat 5: CYBOPOB66 ($2.15 in chips) 
Seat 6: xoen ($2.02 in chips) 
Scaaalll: posts small blind $0.01
DmitriyXXL66: posts big blind $0.02
*** HOLE CARDS ***
Dealt to Scaaalll [4h Jc]
HirasawaYuiP: folds 
CYBOPOB66: folds 
xoen: folds 
WITKOW_AV: folds 
Scaaalll: folds 
Uncalled bet ($0.01) returned to DmitriyXXL66
DmitriyXXL66 collected $0.02 from pot
DmitriyXXL66: doesn't show hand 
*** SUMMARY ***
Total pot $0.02 | Rake $0 
Seat 1: WITKOW_AV (button) folded before Flop (didn't bet)
Seat 2: Scaaalll (small blind) folded before Flop
Seat 3: DmitriyXXL66 (big blind) collected ($0.02)
Seat 4: HirasawaYuiP folded before Flop (didn't bet)
Seat 5: CYBOPOB66 folded before Flop (didn't bet)
Seat 6: xoen folded before Flop (didn't bet)



PokerStars Zoom Hand #229233909120:  Hold'em No Limit ($0.01/$0.02) - 2021/08/21 23:49:07 CET [2021/08/21 17:49:07 ET]
Table 'Halley' 6-max Seat #1 is the button
Seat 1: polymorhp ($1.31 in chips) 
Seat 2: Merlin_Arg ($3.58 in chips) 
Seat 3: ussr246 ($2.78 in chips) 
Seat 4: josealfredonino ($2.95 in chips) 
Seat 5: gasmar_29 ($2.79 in chips) 
Seat 6: Scaaalll ($4.46 in chips) 
Merlin_Arg: posts small blind $0.01
ussr246: posts big blind $0.02
*** HOLE CARDS ***
Dealt to Scaaalll [Qd 4h]
josealfredonino: folds 
gasmar_29: folds 
Scaaalll: folds 
polymorhp has timed out
polymorhp: folds 
Merlin_Arg: folds 
Uncalled bet ($0.01) returned to ussr246
ussr246 collected $0.02 from pot
ussr246: doesn't show hand 
*** SUMMARY ***
Total pot $0.02 | Rake $0 
Seat 1: polymorhp (button) folded before Flop (didn't bet)
Seat 2: Merlin_Arg (small blind) folded before Flop
Seat 3: ussr246 (big blind) collected ($0.02)
Seat 4: josealfredonino folded before Flop (didn't bet)
Seat 5: gasmar_29 folded before Flop (didn't bet)
Seat 6: Scaaalll folded before Flop (didn't bet)



PokerStars Zoom Hand #229233921666:  Hold'em No Limit ($0.01/$0.02) - 2021/08/21 23:49:39 CET [2021/08/21 17:49:39 ET]
Table 'Halley' 6-max Seat #1 is the button
Seat 1: rodrigoasor ($5.65 in chips) 
Seat 2: lucksuckdonk ($5.34 in chips) 
Seat 3: pipecmolodec ($2.10 in chips) 
Seat 4: ctaceo ($2 in chips) 
Seat 5: Scaaalll ($4.46 in chips) 
Seat 6: vot-tebe888 ($2.76 in chips) 
lucksuckdonk: posts small blind $0.01
pipecmolodec: posts big blind $0.02
*** HOLE CARDS ***
Dealt to Scaaalll [Qh Jd]
ctaceo: folds 
Scaaalll: folds 
vot-tebe888: folds 
rodrigoasor: folds 
lucksuckdonk: raises $0.04 to $0.06
pipecmolodec: folds 
Uncalled bet ($0.04) returned to lucksuckdonk
lucksuckdonk collected $0.04 from pot
lucksuckdonk: doesn't show hand 
*** SUMMARY ***
Total pot $0.04 | Rake $0 
Seat 1: rodrigoasor (button) folded before Flop (didn't bet)
Seat 2: lucksuckdonk (small blind) collected ($0.04)
Seat 3: pipecmolodec (big blind) folded before Flop
Seat 4: ctaceo folded before Flop (didn't bet)
Seat 5: Scaaalll folded before Flop (didn't bet)
Seat 6: vot-tebe888 folded before Flop (didn't bet)



PokerStars Zoom Hand #229233913762:  Hold'em No Limit ($0.01/$0.02) - 2021/08/21 23:49:19 CET [2021/08/21 17:49:19 ET]
Table 'Halley' 6-max Seat #1 is the button
Seat 1: Scaaalll ($4.46 in chips) 
Seat 2: menba47 ($0.98 in chips) 
Seat 3: Ck@tih@ ($2.20 in chips) 
Seat 4: maliniak75 ($1.94 in chips) 
Seat 5: alphabeta1d ($2.29 in chips) 
Seat 6: CYBOPOB66 ($2.39 in chips) 
menba47: posts small blind $0.01
Ck@tih@: posts big blind $0.02
*** HOLE CARDS ***
Dealt to Scaaalll [5s 5h]
maliniak75: calls $0.02
alphabeta1d: folds 
CYBOPOB66: folds 
Scaaalll has timed out
Scaaalll: folds 
menba47: folds 
Ck@tih@: checks 
*** FLOP *** [Kh As 6h]
Ck@tih@: checks 
maliniak75: bets $0.05
Ck@tih@: folds 
Uncalled bet ($0.05) returned to maliniak75
maliniak75 collected $0.05 from pot
maliniak75: doesn't show hand 
*** SUMMARY ***
Total pot $0.05 | Rake $0 
Board [Kh As 6h]
Seat 1: Scaaalll (button) folded before Flop (didn't bet)
Seat 2: menba47 (small blind) folded before Flop
Seat 3: Ck@tih@ (big blind) folded on the Flop
Seat 4: maliniak75 collected ($0.05)
Seat 5: alphabeta1d folded before Flop (didn't bet)
Seat 6: CYBOPOB66 folded before Flop (didn't bet)



PokerStars Zoom Hand #229233927450:  Hold'em No Limit ($0.01/$0.02) - 2021/08/21 23:49:54 CET [2021/08/21 17:49:54 ET]
Table 'Halley' 6-max Seat #1 is the button
Seat 1: hallowed_0 ($2.01 in chips) 
Seat 2: arex194 ($1.54 in chips) 
Seat 3: franek369 ($6.57 in chips) 
Seat 4: jeroninho ($0.88 in chips) 
Seat 5: lucksuckdonk ($7.22 in chips) 
Seat 6: Scaaalll ($4.46 in chips) 
arex194: posts small blind $0.01
franek369: posts big blind $0.02
*** HOLE CARDS ***
Dealt to Scaaalll [6s 8s]
jeroninho: folds 
lucksuckdonk: raises $0.04 to $0.06
Scaaalll: folds 
hallowed_0: folds 
arex194: raises $0.04 to $0.10
franek369: folds 
lucksuckdonk: calls $0.04
*** FLOP *** [2c 3c Qd]
arex194: bets $0.02
lucksuckdonk: calls $0.02
*** TURN *** [2c 3c Qd] [Qc]
arex194: bets $0.02
lucksuckdonk: calls $0.02
*** RIVER *** [2c 3c Qd Qc] [Th]
arex194: bets $0.02
lucksuckdonk: calls $0.02
*** SHOW DOWN ***
arex194: shows [7d Td] (two pair, Queens and Tens)
lucksuckdonk: mucks hand 
arex194 collected $0.33 from pot
*** SUMMARY ***
Total pot $0.34 | Rake $0.01 
Board [2c 3c Qd Qc Th]
Seat 1: hallowed_0 (button) folded before Flop (didn't bet)
Seat 2: arex194 (small blind) showed [7d Td] and won ($0.33) with two pair, Queens and Tens
Seat 3: franek369 (big blind) folded before Flop
Seat 4: jeroninho folded before Flop (didn't bet)
Seat 5: lucksuckdonk mucked [Ah 7h]
Seat 6: Scaaalll folded before Flop (didn't bet)



PokerStars Zoom Hand #229233925439:  Hold'em No Limit ($0.01/$0.02) - 2021/08/21 23:49:49 CET [2021/08/21 17:49:49 ET]
Table 'Halley' 6-max Seat #1 is the button
Seat 1: EstiBan18 ($2 in chips) 
Seat 2: jaamonra ($2.59 in chips) 
Seat 3: BlackhawKK's ($2.12 in chips) 
Seat 4: Scaaalll ($4.46 in chips) 
Seat 5: Jacon2905 ($2.47 in chips) 
Seat 6: Merlin_Arg ($3.61 in chips) 
jaamonra: posts small blind $0.01
BlackhawKK's: posts big blind $0.02
*** HOLE CARDS ***
Dealt to Scaaalll [5h Jc]
Scaaalll: folds 
Jacon2905: raises $0.04 to $0.06
Merlin_Arg: folds 
EstiBan18: folds 
jaamonra: folds 
BlackhawKK's: calls $0.04
*** FLOP *** [7h Th 3d]
BlackhawKK's: checks 
Jacon2905: bets $0.08
BlackhawKK's: calls $0.08
*** TURN *** [7h Th 3d] [Qd]
BlackhawKK's: checks 
Jacon2905: bets $0.14
BlackhawKK's: calls $0.14
*** RIVER *** [7h Th 3d Qd] [6d]
BlackhawKK's: checks 
Jacon2905: checks 
*** SHOW DOWN ***
BlackhawKK's: shows [Ts 9h] (a pair of Tens)
Jacon2905: shows [Ad Qs] (a pair of Queens)
Jacon2905 collected $0.55 from pot
*** SUMMARY ***
Total pot $0.57 | Rake $0.02 
Board [7h Th 3d Qd 6d]
Seat 1: EstiBan18 (button) folded before Flop (didn't bet)
Seat 2: jaamonra (small blind) folded before Flop
Seat 3: BlackhawKK's (big blind) showed [Ts 9h] and lost with a pair of Tens
Seat 4: Scaaalll folded before Flop (didn't bet)
Seat 5: Jacon2905 showed [Ad Qs] and won ($0.55) with a pair of Queens
Seat 6: Merlin_Arg folded before Flop (didn't bet)



PokerStars Zoom Hand #229233930519:  Hold'em No Limit ($0.01/$0.02) - 2021/08/21 23:50:02 CET [2021/08/21 17:50:02 ET]
Table 'Halley' 6-max Seat #1 is the button
Seat 1: Hiury5 ($1.90 in chips) 
Seat 2: rpycmbEM ($5.69 in chips) 
Seat 3: Scaaalll ($4.46 in chips) 
Seat 4: adilsonjunioryt ($2.55 in chips) 
Seat 5: m3ssy34 ($0.89 in chips) 
Seat 6: medyza111 ($3.19 in chips) 
rpycmbEM: posts small blind $0.01
Scaaalll: posts big blind $0.02
*** HOLE CARDS ***
Dealt to Scaaalll [6d Qh]
adilsonjunioryt: folds 
m3ssy34: calls $0.02
medyza111: folds 
Hiury5: folds 
rpycmbEM: folds 
Scaaalll: checks 
*** FLOP *** [5s As Qd]
Scaaalll: checks 
m3ssy34: checks 
*** TURN *** [5s As Qd] [4h]
Scaaalll: checks 
m3ssy34: checks 
*** RIVER *** [5s As Qd 4h] [7d]
Scaaalll: checks 
m3ssy34: checks 
*** SHOW DOWN ***
Scaaalll: shows [6d Qh] (a pair of Queens)
m3ssy34: mucks hand 
Scaaalll collected $0.05 from pot
*** SUMMARY ***
Total pot $0.05 | Rake $0 
Board [5s As Qd 4h 7d]
Seat 1: Hiury5 (button) folded before Flop (didn't bet)
Seat 2: rpycmbEM (small blind) folded before Flop
Seat 3: Scaaalll (big blind) showed [6d Qh] and won ($0.05) with a pair of Queens
Seat 4: adilsonjunioryt folded before Flop (didn't bet)
Seat 5: m3ssy34 mucked [2s 9d]
Seat 6: medyza111 folded before Flop (didn't bet)



PokerStars Zoom Hand #229233945258:  Hold'em No Limit ($0.01/$0.02) - 2021/08/21 23:50:40 CET [2021/08/21 17:50:40 ET]
Table 'Halley' 6-max Seat #1 is the button
Seat 1: Scaaalll ($4.49 in chips) 
Seat 2: adrianh2002 ($4.07 in chips) 
Seat 3: egroj1700 ($2.01 in chips) 
Seat 4: m3ssy34 ($0.87 in chips) 
Seat 5: maressen ($5.10 in chips) 
Seat 6: pavlo8855 ($2.16 in chips) 
adrianh2002: posts small blind $0.01
egroj1700: posts big blind $0.02
*** HOLE CARDS ***
Dealt to Scaaalll [6h 8s]
m3ssy34: folds 
m3ssy34 is disconnected 
maressen: raises $0.03 to $0.05
pavlo8855: folds 
Scaaalll: folds 
adrianh2002: raises $0.15 to $0.20
egroj1700: folds 
maressen: folds 
Uncalled bet ($0.15) returned to adrianh2002
adrianh2002 collected $0.12 from pot
adrianh2002: doesn't show hand 
*** SUMMARY ***
Total pot $0.12 | Rake $0 
Seat 1: Scaaalll (button) folded before Flop (didn't bet)
Seat 2: adrianh2002 (small blind) collected ($0.12)
Seat 3: egroj1700 (big blind) folded before Flop
Seat 4: m3ssy34 folded before Flop (didn't bet)
Seat 5: maressen folded before Flop
Seat 6: pavlo8855 folded before Flop (didn't bet)



PokerStars Zoom Hand #229233950976:  Hold'em No Limit ($0.01/$0.02) - 2021/08/21 23:50:44 CET [2021/08/21 17:50:44 ET]
Table 'Halley' 6-max Seat #1 is the button
Seat 1: so0love ($2.55 in chips) 
Seat 2: Scaaalll ($4.49 in chips) 
Seat 3: PapiMik3 ($9.03 in chips) 
Seat 4: pavlo8855 ($2.16 in chips) 
Seat 5: Holmie111 ($3.84 in chips) 
Seat 6: ernmic ($2.30 in chips) 
Scaaalll: posts small blind $0.01
PapiMik3: posts big blind $0.02
*** HOLE CARDS ***
Dealt to Scaaalll [5s Kh]
pavlo8855: folds 
Holmie111: raises $0.05 to $0.07
ernmic: folds 
so0love: folds 
Scaaalll: folds 
PapiMik3: folds 
Uncalled bet ($0.05) returned to Holmie111
Holmie111 collected $0.05 from pot
Holmie111: doesn't show hand 
*** SUMMARY ***
Total pot $0.05 | Rake $0 
Seat 1: so0love (button) folded before Flop (didn't bet)
Seat 2: Scaaalll (small blind) folded before Flop
Seat 3: PapiMik3 (big blind) folded before Flop
Seat 4: pavlo8855 folded before Flop (didn't bet)
Seat 5: Holmie111 collected ($0.05)
Seat 6: ernmic folded before Flop (didn't bet)



PokerStars Zoom Hand #229233957979:  Hold'em No Limit ($0.01/$0.02) - 2021/08/21 23:51:02 CET [2021/08/21 17:51:02 ET]
Table 'Halley' 6-max Seat #1 is the button
Seat 1: Chrisisxzor ($2 in chips) 
Seat 2: woetieman ($0.49 in chips) 
Seat 3: Mac9Monty2 ($3.08 in chips) 
Seat 4: $w4y ($2.36 in chips) 
Seat 5: Scaaalll ($4.48 in chips) 
Seat 6: rodrigoasor ($3.14 in chips) 
woetieman: posts small blind $0.01
Mac9Monty2: posts big blind $0.02
*** HOLE CARDS ***
Dealt to Scaaalll [6c 5h]
$w4y: folds 
$w4y is disconnected 
Scaaalll: folds 
rodrigoasor: folds 
Chrisisxzor: folds 
woetieman: raises $0.02 to $0.04
Mac9Monty2: folds 
Uncalled bet ($0.02) returned to woetieman
woetieman collected $0.04 from pot
woetieman: doesn't show hand 
*** SUMMARY ***
Total pot $0.04 | Rake $0 
Seat 1: Chrisisxzor (button) folded before Flop (didn't bet)
Seat 2: woetieman (small blind) collected ($0.04)
Seat 3: Mac9Monty2 (big blind) folded before Flop
Seat 4: $w4y folded before Flop (didn't bet)
Seat 5: Scaaalll folded before Flop (didn't bet)
Seat 6: rodrigoasor folded before Flop (didn't bet)



PokerStars Zoom Hand #229233961504:  Hold'em No Limit ($0.01/$0.02) - 2021/08/21 23:51:11 CET [2021/08/21 17:51:11 ET]
Table 'Halley' 6-max Seat #1 is the button
Seat 1: Scaaalll ($4.48 in chips) 
Seat 2: 888lifeIS ($2 in chips) 
Seat 3: pokerfan3999 ($2.22 in chips) 
Seat 4: Razmenchic ($4.57 in chips) 
Seat 5: Gerar NB ($3.13 in chips) 
Seat 6: AtZ3899 ($1.98 in chips) 
888lifeIS: posts small blind $0.01
pokerfan3999: posts big blind $0.02
*** HOLE CARDS ***
Dealt to Scaaalll [Qc 8h]
Razmenchic: folds 
Gerar NB: folds 
AtZ3899: raises $0.02 to $0.04
Scaaalll: folds 
888lifeIS: folds 
pokerfan3999: folds 
Uncalled bet ($0.02) returned to AtZ3899
AtZ3899 collected $0.05 from pot
AtZ3899: doesn't show hand 
*** SUMMARY ***
Total pot $0.05 | Rake $0 
Seat 1: Scaaalll (button) folded before Flop (didn't bet)
Seat 2: 888lifeIS (small blind) folded before Flop
Seat 3: pokerfan3999 (big blind) folded before Flop
Seat 4: Razmenchic folded before Flop (didn't bet)
Seat 5: Gerar NB folded before Flop (didn't bet)
Seat 6: AtZ3899 collected ($0.05)



PokerStars Zoom Hand #229233967669:  Hold'em No Limit ($0.01/$0.02) - 2021/08/21 23:51:27 CET [2021/08/21 17:51:27 ET]
Table 'Halley' 6-max Seat #1 is the button
Seat 1: Merlin_Arg ($2.11 in chips) 
Seat 2: ibstah ($9.78 in chips) 
Seat 3: Scaaalll ($4.48 in chips) 
Seat 4: nivesh14 ($0.91 in chips) 
Seat 5: Lekcey05 ($2 in chips) 
Seat 6: acierrr ($2 in chips) 
ibstah: posts small blind $0.01
Scaaalll: posts big blind $0.02
*** HOLE CARDS ***
Dealt to Scaaalll [3h 4d]
nivesh14: raises $0.04 to $0.06
Lekcey05: folds 
acierrr: folds 
Merlin_Arg: folds 
ibstah: calls $0.05
Scaaalll: folds 
*** FLOP *** [6h Qd Jh]
ibstah: bets $0.14
nivesh14: folds 
Uncalled bet ($0.14) returned to ibstah
ibstah collected $0.14 from pot
ibstah: doesn't show hand 
nivesh14 is disconnected 
*** SUMMARY ***
Total pot $0.14 | Rake $0 
Board [6h Qd Jh]
Seat 1: Merlin_Arg (button) folded before Flop (didn't bet)
Seat 2: ibstah (small blind) collected ($0.14)
Seat 3: Scaaalll (big blind) folded before Flop
Seat 4: nivesh14 folded on the Flop
Seat 5: Lekcey05 folded before Flop (didn't bet)
Seat 6: acierrr folded before Flop (didn't bet)



PokerStars Zoom Hand #229233959892:  Hold'em No Limit ($0.01/$0.02) - 2021/08/21 23:51:07 CET [2021/08/21 17:51:07 ET]
Table 'Halley' 6-max Seat #1 is the button
Seat 1: SHALOMandKAT ($0.51 in chips) 
Seat 2: rodrigoasor ($3.14 in chips) 
Seat 3: Feyqdoi ($2 in chips) 
Seat 4: Scaaalll ($4.48 in chips) 
Seat 5: kukulagosleep ($6.85 in chips) 
Seat 6: isurusa ($5.10 in chips) 
rodrigoasor: posts small blind $0.01
Feyqdoi: posts big blind $0.02
*** HOLE CARDS ***
Dealt to Scaaalll [Jh 7h]
Scaaalll: folds 
kukulagosleep: folds 
isurusa: raises $0.04 to $0.06
SHALOMandKAT: folds 
rodrigoasor: folds 
Feyqdoi: raises $0.18 to $0.24
isurusa: calls $0.18
*** FLOP *** [6s 5d 8c]
Feyqdoi: bets $0.24
isurusa: calls $0.24
*** TURN *** [6s 5d 8c] [5h]
Feyqdoi: bets $0.50
isurusa: calls $0.50
*** RIVER *** [6s 5d 8c 5h] [Kc]
Feyqdoi: checks 
isurusa: checks 
*** SHOW DOWN ***
Feyqdoi: shows [Qh Qd] (two pair, Queens and Fives)
isurusa: mucks hand 
Feyqdoi collected $1.90 from pot
*** SUMMARY ***
Total pot $1.97 | Rake $0.07 
Board [6s 5d 8c 5h Kc]
Seat 1: SHALOMandKAT (button) folded before Flop (didn't bet)
Seat 2: rodrigoasor (small blind) folded before Flop
Seat 3: Feyqdoi (big blind) showed [Qh Qd] and won ($1.90) with two pair, Queens and Fives
Seat 4: Scaaalll folded before Flop (didn't bet)
Seat 5: kukulagosleep folded before Flop (didn't bet)
Seat 6: isurusa mucked [8h 9s]



PokerStars Zoom Hand #229233971169:  Hold'em No Limit ($0.01/$0.02) - 2021/08/21 23:51:36 CET [2021/08/21 17:51:36 ET]
Table 'Halley' 6-max Seat #1 is the button
Seat 1: Ne0net ($2.65 in chips) 
Seat 2: Scaaalll ($4.46 in chips) 
Seat 3: KKARMELO ($2.51 in chips) 
Seat 4: Ck@tih@ ($1.50 in chips) 
Seat 5: Dr.stromg ($4.85 in chips) 
Seat 6: nbarreiro021 ($2.29 in chips) 
Scaaalll: posts small blind $0.01
KKARMELO: posts big blind $0.02
*** HOLE CARDS ***
Dealt to Scaaalll [Ac 8c]
Ck@tih@: folds 
Dr.stromg: raises $0.03 to $0.05
nbarreiro021: folds 
Ne0net: folds 
Scaaalll: calls $0.04
KKARMELO: calls $0.03
*** FLOP *** [Ah 8s Js]
Scaaalll: bets $0.09
KKARMELO: calls $0.09
Dr.stromg: folds 
*** TURN *** [Ah 8s Js] [9c]
Scaaalll: checks 
KKARMELO: checks 
*** RIVER *** [Ah 8s Js 9c] [Ts]
Scaaalll: checks 
KKARMELO: checks 
*** SHOW DOWN ***
Scaaalll: shows [Ac 8c] (two pair, Aces and Eights)
KKARMELO: mucks hand 
Scaaalll collected $0.32 from pot
*** SUMMARY ***
Total pot $0.33 | Rake $0.01 
Board [Ah 8s Js 9c Ts]
Seat 1: Ne0net (button) folded before Flop (didn't bet)
Seat 2: Scaaalll (small blind) showed [Ac 8c] and won ($0.32) with two pair, Aces and Eights
Seat 3: KKARMELO (big blind) mucked [9h Th]
Seat 4: Ck@tih@ folded before Flop (didn't bet)
Seat 5: Dr.stromg folded on the Flop
Seat 6: nbarreiro021 folded before Flop (didn't bet)



PokerStars Zoom Hand #229233996631:  Hold'em No Limit ($0.01/$0.02) - 2021/08/21 23:52:42 CET [2021/08/21 17:52:42 ET]
Table 'Halley' 6-max Seat #1 is the button
Seat 1: hallowed_0 ($2.25 in chips) 
Seat 2: PapiMik3 ($10.54 in chips) 
Seat 3: vovan100157 ($1.75 in chips) 
Seat 4: Buka1224 ($2.03 in chips) 
Seat 5: Doktor Yes ($2 in chips) 
Seat 6: Scaaalll ($4.64 in chips) 
PapiMik3: posts small blind $0.01
vovan100157: posts big blind $0.02
*** HOLE CARDS ***
Dealt to Scaaalll [4d 8s]
Buka1224: raises $0.04 to $0.06
Doktor Yes: folds 
Scaaalll: folds 
hallowed_0: folds 
PapiMik3: folds 
vovan100157: folds 
Uncalled bet ($0.04) returned to Buka1224
Buka1224 collected $0.05 from pot
Buka1224: doesn't show hand 
*** SUMMARY ***
Total pot $0.05 | Rake $0 
Seat 1: hallowed_0 (button) folded before Flop (didn't bet)
Seat 2: PapiMik3 (small blind) folded before Flop
Seat 3: vovan100157 (big blind) folded before Flop
Seat 4: Buka1224 collected ($0.05)
Seat 5: Doktor Yes folded before Flop (didn't bet)
Seat 6: Scaaalll folded before Flop (didn't bet)



PokerStars Zoom Hand #229234007348:  Hold'em No Limit ($0.01/$0.02) - 2021/08/21 23:53:10 CET [2021/08/21 17:53:10 ET]
Table 'Halley' 6-max Seat #1 is the button
Seat 1: xxVanquishxx ($18.64 in chips) 
Seat 2: Scaaalll ($4.64 in chips) 
Seat 3: NFPrates ($0.72 in chips) 
Seat 4: johnpa89 ($2.43 in chips) 
Seat 5: Demidov V.S. ($2.71 in chips) 
Seat 6: spirosz1000 ($2.48 in chips) 
Scaaalll: posts small blind $0.01
NFPrates: posts big blind $0.02
*** HOLE CARDS ***
Dealt to Scaaalll [Ac Ah]
Demidov V.S. is disconnected 
johnpa89: folds 
Demidov V.S.: folds 
spirosz1000: folds 
xxVanquishxx: folds 
Scaaalll: raises $0.04 to $0.06
NFPrates: folds 
Uncalled bet ($0.04) returned to Scaaalll
Scaaalll collected $0.04 from pot
Scaaalll: doesn't show hand 
*** SUMMARY ***
Total pot $0.04 | Rake $0 
Seat 1: xxVanquishxx (button) folded before Flop (didn't bet)
Seat 2: Scaaalll (small blind) collected ($0.04)
Seat 3: NFPrates (big blind) folded before Flop
Seat 4: johnpa89 folded before Flop (didn't bet)
Seat 5: Demidov V.S. folded before Flop (didn't bet)
Seat 6: spirosz1000 folded before Flop (didn't bet)



PokerStars Zoom Hand #229234003155:  Hold'em No Limit ($0.01/$0.02) - 2021/08/21 23:52:59 CET [2021/08/21 17:52:59 ET]
Table 'Halley' 6-max Seat #1 is the button
Seat 1: samn102 ($2.18 in chips) 
Seat 2: MATIdf365 ($3.15 in chips) 
Seat 3: Gerar NB ($3.13 in chips) 
Seat 4: nbarreiro021 ($2.02 in chips) 
Seat 5: Iv3rson18 ($2.37 in chips) 
Seat 6: Scaaalll ($4.64 in chips) 
MATIdf365: posts small blind $0.01
Gerar NB: posts big blind $0.02
*** HOLE CARDS ***
Dealt to Scaaalll [7s Ts]
nbarreiro021: folds 
Iv3rson18: folds 
Scaaalll: folds 
samn102: raises $0.04 to $0.06
MATIdf365: folds 
Gerar NB: calls $0.04
*** FLOP *** [Kd 6s 6d]
Gerar NB: checks 
samn102: bets $0.09
Gerar NB: folds 
Uncalled bet ($0.09) returned to samn102
samn102 collected $0.13 from pot
samn102: doesn't show hand 
*** SUMMARY ***
Total pot $0.13 | Rake $0 
Board [Kd 6s 6d]
Seat 1: samn102 (button) collected ($0.13)
Seat 2: MATIdf365 (small blind) folded before Flop
Seat 3: Gerar NB (big blind) folded on the Flop
Seat 4: nbarreiro021 folded before Flop (didn't bet)
Seat 5: Iv3rson18 folded before Flop (didn't bet)
Seat 6: Scaaalll folded before Flop (didn't bet)



PokerStars Zoom Hand #229234000108:  Hold'em No Limit ($0.01/$0.02) - 2021/08/21 23:52:51 CET [2021/08/21 17:52:51 ET]
Table 'Halley' 6-max Seat #1 is the button
Seat 1: fabianhn504 ($1 in chips) 
Seat 2: Bizonovich ($0.20 in chips) 
Seat 3: Luis Rdz25 ($1.02 in chips) 
Seat 4: Agneobr ($1.82 in chips) 
Seat 5: Scaaalll ($4.64 in chips) 
Seat 6: Doktor Yes ($3.99 in chips) 
Bizonovich: posts small blind $0.01
Luis Rdz25: posts big blind $0.02
*** HOLE CARDS ***
Dealt to Scaaalll [Ts 6s]
Agneobr: folds 
Scaaalll: folds 
Doktor Yes: folds 
fabianhn504: folds 
Bizonovich: calls $0.01
Luis Rdz25: checks 
*** FLOP *** [Ah 2d Tc]
Bizonovich: checks 
Luis Rdz25: bets $0.04
Bizonovich: raises $0.14 to $0.18 and is all-in
Luis Rdz25: folds 
Uncalled bet ($0.14) returned to Bizonovich
Bizonovich collected $0.12 from pot
Bizonovich: doesn't show hand 
Luis Rdz25 is disconnected 
*** SUMMARY ***
Total pot $0.12 | Rake $0 
Board [Ah 2d Tc]
Seat 1: fabianhn504 (button) folded before Flop (didn't bet)
Seat 2: Bizonovich (small blind) collected ($0.12)
Seat 3: Luis Rdz25 (big blind) folded on the Flop
Seat 4: Agneobr folded before Flop (didn't bet)
Seat 5: Scaaalll folded before Flop (didn't bet)
Seat 6: Doktor Yes folded before Flop (didn't bet)



PokerStars Zoom Hand #229234014240:  Hold'em No Limit ($0.01/$0.02) - 2021/08/21 23:53:28 CET [2021/08/21 17:53:28 ET]
Table 'Halley' 6-max Seat #1 is the button
Seat 1: Nihility77 ($3.92 in chips) 
Seat 2: AtZ3899 ($1.26 in chips) 
Seat 3: Scaaalll ($4.66 in chips) 
Seat 4: jancsi321 ($1.42 in chips) 
Seat 5: PaddyPoland ($2.07 in chips) 
Seat 6: RageReaperf ($2 in chips) 
AtZ3899: posts small blind $0.01
Scaaalll: posts big blind $0.02
*** HOLE CARDS ***
Dealt to Scaaalll [As Qc]
jancsi321 has timed out
jancsi321: folds 
PaddyPoland: raises $0.03 to $0.05
RageReaperf: folds 
Nihility77: folds 
AtZ3899: calls $0.04
Scaaalll: raises $0.16 to $0.21
PaddyPoland: folds 
AtZ3899: calls $0.16
*** FLOP *** [3c 8c Kh]
AtZ3899: checks 
Scaaalll: bets $0.23
AtZ3899: raises $0.82 to $1.05 and is all-in
Scaaalll: folds 
Uncalled bet ($0.82) returned to AtZ3899
AtZ3899 collected $0.89 from pot
AtZ3899: doesn't show hand 
*** SUMMARY ***
Total pot $0.93 | Rake $0.04 
Board [3c 8c Kh]
Seat 1: Nihility77 (button) folded before Flop (didn't bet)
Seat 2: AtZ3899 (small blind) collected ($0.89)
Seat 3: Scaaalll (big blind) folded on the Flop
Seat 4: jancsi321 folded before Flop (didn't bet)
Seat 5: PaddyPoland folded before Flop
Seat 6: RageReaperf folded before Flop (didn't bet)



PokerStars Zoom Hand #229234032619:  Hold'em No Limit ($0.01/$0.02) - 2021/08/21 23:54:16 CET [2021/08/21 17:54:16 ET]
Table 'Halley' 6-max Seat #1 is the button
Seat 1: Scaaalll ($4.22 in chips) 
Seat 2: 3rian cARc ($2.34 in chips) 
Seat 3: ctaceo ($2.32 in chips) 
Seat 4: fishh_play ($8.54 in chips) 
Seat 5: LucasLMdS ($3.94 in chips) 
Seat 6: nagibatorali ($1.12 in chips) 
3rian cARc: posts small blind $0.01
ctaceo: posts big blind $0.02
*** HOLE CARDS ***
Dealt to Scaaalll [4h 5h]
fishh_play: folds 
LucasLMdS has timed out
LucasLMdS: folds 
nagibatorali: raises $0.06 to $0.08
Scaaalll: folds 
3rian cARc: folds 
ctaceo: raises $0.16 to $0.24
nagibatorali: folds 
Uncalled bet ($0.16) returned to ctaceo
ctaceo collected $0.17 from pot
ctaceo: doesn't show hand 
nagibatorali is disconnected 
*** SUMMARY ***
Total pot $0.17 | Rake $0 
Seat 1: Scaaalll (button) folded before Flop (didn't bet)
Seat 2: 3rian cARc (small blind) folded before Flop
Seat 3: ctaceo (big blind) collected ($0.17)
Seat 4: fishh_play folded before Flop (didn't bet)
Seat 5: LucasLMdS folded before Flop (didn't bet)
Seat 6: nagibatorali folded before Flop



PokerStars Zoom Hand #229234043718:  Hold'em No Limit ($0.01/$0.02) - 2021/08/21 23:54:45 CET [2021/08/21 17:54:45 ET]
Table 'Halley' 6-max Seat #1 is the button
Seat 1: Razmenchic ($4.71 in chips) 
Seat 2: ibstah ($9.91 in chips) 
Seat 3: GGopenBet ($1.15 in chips) 
Seat 4: Scaaalll ($4.22 in chips) 
Seat 5: baileyduck ($2.32 in chips) 
Seat 6: Sadikson ($2.51 in chips) 
ibstah: posts small blind $0.01
GGopenBet: posts big blind $0.02
*** HOLE CARDS ***
Dealt to Scaaalll [As Qh]
Sadikson is disconnected 
Scaaalll: raises $0.04 to $0.06
baileyduck: folds 
Sadikson: folds 
GGopenBet is disconnected 
baileyduck is disconnected 
Razmenchic: folds 
ibstah: folds 
GGopenBet: folds 
Uncalled bet ($0.04) returned to Scaaalll
Scaaalll collected $0.05 from pot
Scaaalll: doesn't show hand 
*** SUMMARY ***
Total pot $0.05 | Rake $0 
Seat 1: Razmenchic (button) folded before Flop (didn't bet)
Seat 2: ibstah (small blind) folded before Flop
Seat 3: GGopenBet (big blind) folded before Flop
Seat 4: Scaaalll collected ($0.05)
Seat 5: baileyduck folded before Flop (didn't bet)
Seat 6: Sadikson folded before Flop (didn't bet)



PokerStars Zoom Hand #229234041093:  Hold'em No Limit ($0.01/$0.02) - 2021/08/21 23:54:38 CET [2021/08/21 17:54:38 ET]
Table 'Halley' 6-max Seat #1 is the button
Seat 1: elmex886 ($2 in chips) 
Seat 2: JacekSoplica ($2 in chips) 
Seat 3: Gerar NB ($2.03 in chips) 
Seat 4: rpycmbEM ($5.72 in chips) 
Seat 5: Scaaalll ($4.22 in chips) 
Seat 6: Sasha_Sweg ($0.81 in chips) 
JacekSoplica: posts small blind $0.01
Gerar NB: posts big blind $0.02
*** HOLE CARDS ***
Dealt to Scaaalll [Jh 5h]
JacekSoplica is disconnected 
rpycmbEM: folds 
Scaaalll: folds 
Sasha_Sweg: raises $0.02 to $0.04
elmex886: folds 
JacekSoplica: folds 
Gerar NB: folds 
Uncalled bet ($0.02) returned to Sasha_Sweg
Sasha_Sweg collected $0.05 from pot
Sasha_Sweg: doesn't show hand 
*** SUMMARY ***
Total pot $0.05 | Rake $0 
Seat 1: elmex886 (button) folded before Flop (didn't bet)
Seat 2: JacekSoplica (small blind) folded before Flop
Seat 3: Gerar NB (big blind) folded before Flop
Seat 4: rpycmbEM folded before Flop (didn't bet)
Seat 5: Scaaalll folded before Flop (didn't bet)
Seat 6: Sasha_Sweg collected ($0.05)



PokerStars Zoom Hand #229234051204:  Hold'em No Limit ($0.01/$0.02) - 2021/08/21 23:55:05 CET [2021/08/21 17:55:05 ET]
Table 'Halley' 6-max Seat #1 is the button
Seat 1: Araj Moon ($2 in chips) 
Seat 2: xoen ($2.07 in chips) 
Seat 3: Scaaalll ($4.25 in chips) 
Seat 4: Feyqdoi ($2.23 in chips) 
Seat 5: Carlos_glaza ($2 in chips) 
Seat 6: nbarreiro021 ($2.15 in chips) 
xoen: posts small blind $0.01
Scaaalll: posts big blind $0.02
*** HOLE CARDS ***
Dealt to Scaaalll [Th 8s]
Feyqdoi: folds 
Carlos_glaza: folds 
nbarreiro021: folds 
Araj Moon: raises $0.04 to $0.06
xoen: folds 
Scaaalll: folds 
Uncalled bet ($0.04) returned to Araj Moon
Araj Moon collected $0.05 from pot
Araj Moon: doesn't show hand 
*** SUMMARY ***
Total pot $0.05 | Rake $0 
Seat 1: Araj Moon (button) collected ($0.05)
Seat 2: xoen (small blind) folded before Flop
Seat 3: Scaaalll (big blind) folded before Flop
Seat 4: Feyqdoi folded before Flop (didn't bet)
Seat 5: Carlos_glaza folded before Flop (didn't bet)
Seat 6: nbarreiro021 folded before Flop (didn't bet)



PokerStars Zoom Hand #229234047547:  Hold'em No Limit ($0.01/$0.02) - 2021/08/21 23:54:55 CET [2021/08/21 17:54:55 ET]
Table 'Halley' 6-max Seat #1 is the button
Seat 1: Spinatstrudel ($2.20 in chips) 
Seat 2: Sha.Le.Ol. ($1.58 in chips) 
Seat 3: nbarreiro021 ($2.69 in chips) 
Seat 4: Scaaalll ($4.25 in chips) 
Seat 5: NickAlex18 ($2.42 in chips) 
Seat 6: keldh ($4.49 in chips) 
Sha.Le.Ol.: posts small blind $0.01
nbarreiro021: posts big blind $0.02
*** HOLE CARDS ***
Dealt to Scaaalll [Tc As]
Scaaalll: folds 
NickAlex18: folds 
keldh: folds 
Spinatstrudel: folds 
Sha.Le.Ol.: raises $0.02 to $0.04
nbarreiro021: calls $0.02
*** FLOP *** [Ad 5s Td]
Sha.Le.Ol.: bets $0.05
nbarreiro021: folds 
Uncalled bet ($0.05) returned to Sha.Le.Ol.
Sha.Le.Ol. collected $0.08 from pot
Sha.Le.Ol.: doesn't show hand 
*** SUMMARY ***
Total pot $0.08 | Rake $0 
Board [Ad 5s Td]
Seat 1: Spinatstrudel (button) folded before Flop (didn't bet)
Seat 2: Sha.Le.Ol. (small blind) collected ($0.08)
Seat 3: nbarreiro021 (big blind) folded on the Flop
Seat 4: Scaaalll folded before Flop (didn't bet)
Seat 5: NickAlex18 folded before Flop (didn't bet)
Seat 6: keldh folded before Flop (didn't bet)



PokerStars Zoom Hand #229234058355:  Hold'em No Limit ($0.01/$0.02) - 2021/08/21 23:55:29 CET [2021/08/21 17:55:29 ET]
Table 'Halley' 6-max Seat #1 is the button
Seat 1: Scaaalll ($4.23 in chips) 
Seat 2: ulisessoria ($2 in chips) 
Seat 3: roukoun1984 ($1.92 in chips) 
Seat 4: Bol'tazar111 ($1.87 in chips) 
Seat 5: Gerar NB ($2.01 in chips) 
Seat 6: Luchazo103 ($6.73 in chips) 
ulisessoria: posts small blind $0.01
roukoun1984: posts big blind $0.02
*** HOLE CARDS ***
Dealt to Scaaalll [Js 3h]
Bol'tazar111: folds 
Gerar NB: folds 
Luchazo103: folds 
Scaaalll has timed out
Scaaalll: folds 
ulisessoria: raises $0.04 to $0.06
roukoun1984: folds 
Uncalled bet ($0.04) returned to ulisessoria
ulisessoria collected $0.04 from pot
ulisessoria: doesn't show hand 
roukoun1984 is disconnected 
*** SUMMARY ***
Total pot $0.04 | Rake $0 
Seat 1: Scaaalll (button) folded before Flop (didn't bet)
Seat 2: ulisessoria (small blind) collected ($0.04)
Seat 3: roukoun1984 (big blind) folded before Flop
Seat 4: Bol'tazar111 folded before Flop (didn't bet)
Seat 5: Gerar NB folded before Flop (didn't bet)
Seat 6: Luchazo103 folded before Flop (didn't bet)



PokerStars Zoom Hand #229234063959:  Hold'em No Limit ($0.01/$0.02) - 2021/08/21 23:55:48 CET [2021/08/21 17:55:48 ET]
Table 'Halley' 6-max Seat #1 is the button
Seat 1: estelionat171 ($1.22 in chips) 
Seat 2: Scaaalll ($4.23 in chips) 
Seat 3: Cavaldini ($2 in chips) 
Seat 4: bRt 85 ($5.58 in chips) 
Seat 5: nagibatorali ($1.06 in chips) 
Seat 6: gasmar_29 ($2.51 in chips) 
Scaaalll: posts small blind $0.01
Cavaldini: posts big blind $0.02
*** HOLE CARDS ***
Dealt to Scaaalll [4d 8s]
bRt 85: folds 
nagibatorali: raises $0.04 to $0.06
gasmar_29: folds 
estelionat171: folds 
Scaaalll: folds 
Cavaldini: calls $0.04
*** FLOP *** [7s Kd 4c]
Cavaldini: bets $0.02
nagibatorali: calls $0.02
*** TURN *** [7s Kd 4c] [4s]
Cavaldini: bets $0.02
nagibatorali: calls $0.02
*** RIVER *** [7s Kd 4c 4s] [4h]
Cavaldini: bets $0.02
nagibatorali: calls $0.02
*** SHOW DOWN ***
Cavaldini: shows [9h Js] (three of a kind, Fours)
nagibatorali: shows [As 2c] (three of a kind, Fours - Ace kicker)
nagibatorali collected $0.24 from pot
*** SUMMARY ***
Total pot $0.25 | Rake $0.01 
Board [7s Kd 4c 4s 4h]
Seat 1: estelionat171 (button) folded before Flop (didn't bet)
Seat 2: Scaaalll (small blind) folded before Flop
Seat 3: Cavaldini (big blind) showed [9h Js] and lost with three of a kind, Fours
Seat 4: bRt 85 folded before Flop (didn't bet)
Seat 5: nagibatorali showed [As 2c] and won ($0.24) with three of a kind, Fours
Seat 6: gasmar_29 folded before Flop (didn't bet)



PokerStars Zoom Hand #229234068267:  Hold'em No Limit ($0.01/$0.02) - 2021/08/21 23:56:03 CET [2021/08/21 17:56:03 ET]
Table 'Halley' 6-max Seat #1 is the button
Seat 1: Jimor Marlow ($2.16 in chips) 
Seat 2: Scaaalll ($4.22 in chips) 
Seat 3: Gamer577 ($3.96 in chips) 
Seat 4: YgovAndrey ($1.33 in chips) 
Seat 5: lalon22 ($2.26 in chips) 
Seat 6: Xpokerfreak ($2.71 in chips) 
Scaaalll: posts small blind $0.01
Gamer577: posts big blind $0.02
*** HOLE CARDS ***
Dealt to Scaaalll [Jd Ad]
Jimor Marlow is disconnected 
YgovAndrey: folds 
lalon22: folds 
Xpokerfreak: folds 
Jimor Marlow: folds 
Scaaalll: raises $0.04 to $0.06
Gamer577: folds 
Uncalled bet ($0.04) returned to Scaaalll
Scaaalll collected $0.04 from pot
Scaaalll: doesn't show hand 
*** SUMMARY ***
Total pot $0.04 | Rake $0 
Seat 1: Jimor Marlow (button) folded before Flop (didn't bet)
Seat 2: Scaaalll (small blind) collected ($0.04)
Seat 3: Gamer577 (big blind) folded before Flop
Seat 4: YgovAndrey folded before Flop (didn't bet)
Seat 5: lalon22 folded before Flop (didn't bet)
Seat 6: Xpokerfreak folded before Flop (didn't bet)



PokerStars Zoom Hand #229234073384:  Hold'em No Limit ($0.01/$0.02) - 2021/08/21 23:56:20 CET [2021/08/21 17:56:20 ET]
Table 'Halley' 6-max Seat #1 is the button
Seat 1: BautiMang ($2.09 in chips) 
Seat 2: elmex886 ($2.01 in chips) 
Seat 3: isurusa ($6.04 in chips) 
Seat 4: ash1448 ($6.10 in chips) 
Seat 5: Scaaalll ($4.24 in chips) 
Seat 6: morpheus206 ($2.23 in chips) 
elmex886: posts small blind $0.01
isurusa: posts big blind $0.02
*** HOLE CARDS ***
Dealt to Scaaalll [8s 9h]
morpheus206 is disconnected 
ash1448: folds 
Scaaalll: folds 
morpheus206: folds 
BautiMang: folds 
elmex886: raises $0.04 to $0.06
isurusa: folds 
Uncalled bet ($0.04) returned to elmex886
elmex886 collected $0.04 from pot
elmex886: doesn't show hand 
*** SUMMARY ***
Total pot $0.04 | Rake $0 
Seat 1: BautiMang (button) folded before Flop (didn't bet)
Seat 2: elmex886 (small blind) collected ($0.04)
Seat 3: isurusa (big blind) folded before Flop
Seat 4: ash1448 folded before Flop (didn't bet)
Seat 5: Scaaalll folded before Flop (didn't bet)
Seat 6: morpheus206 folded before Flop (didn't bet)



PokerStars Zoom Hand #229234076003:  Hold'em No Limit ($0.01/$0.02) - 2021/08/21 23:56:29 CET [2021/08/21 17:56:29 ET]
Table 'Halley' 6-max Seat #1 is the button
Seat 1: thfc12325 ($2.89 in chips) 
Seat 2: gabgordula ($2.14 in chips) 
Seat 3: Scaaalll ($4.24 in chips) 
Seat 4: ash1448 ($6.10 in chips) 
Seat 5: Merlin_Arg ($2.63 in chips) 
Seat 6: ussr246 ($2.57 in chips) 
gabgordula: posts small blind $0.01
Scaaalll: posts big blind $0.02
*** HOLE CARDS ***
Dealt to Scaaalll [Td 8s]
thfc12325 is disconnected 
ash1448: raises $0.02 to $0.04
Merlin_Arg: folds 
ussr246: folds 
thfc12325: folds 
gabgordula: folds 
Scaaalll: folds 
Uncalled bet ($0.02) returned to ash1448
ash1448 collected $0.05 from pot
ash1448: doesn't show hand 
*** SUMMARY ***
Total pot $0.05 | Rake $0 
Seat 1: thfc12325 (button) folded before Flop (didn't bet)
Seat 2: gabgordula (small blind) folded before Flop
Seat 3: Scaaalll (big blind) folded before Flop
Seat 4: ash1448 collected ($0.05)
Seat 5: Merlin_Arg folded before Flop (didn't bet)
Seat 6: ussr246 folded before Flop (didn't bet)



PokerStars Zoom Hand #229234066596:  Hold'em No Limit ($0.01/$0.02) - 2021/08/21 23:55:57 CET [2021/08/21 17:55:57 ET]
Table 'Halley' 6-max Seat #1 is the button
Seat 1: Espartacus5222 ($2 in chips) 
Seat 2: 3@RAZZA.BLR ($3.43 in chips) 
Seat 3: Misteltje ($0.79 in chips) 
Seat 4: LucasLMdS ($3.58 in chips) 
Seat 5: Araj Moon ($2.24 in chips) 
Seat 6: Scaaalll ($4.22 in chips) 
3@RAZZA.BLR: posts small blind $0.01
Misteltje: posts big blind $0.02
*** HOLE CARDS ***
Dealt to Scaaalll [2d Js]
LucasLMdS: raises $0.04 to $0.06
Araj Moon: folds 
Scaaalll: folds 
Espartacus5222: folds 
3@RAZZA.BLR: folds 
Misteltje: calls $0.04
*** FLOP *** [6c Jd 7c]
Misteltje: bets $0.04
LucasLMdS: calls $0.04
*** TURN *** [6c Jd 7c] [5s]
Misteltje: bets $0.04
LucasLMdS: folds 
Uncalled bet ($0.04) returned to Misteltje
Misteltje collected $0.20 from pot
Misteltje: doesn't show hand 
*** SUMMARY ***
Total pot $0.21 | Rake $0.01 
Board [6c Jd 7c 5s]
Seat 1: Espartacus5222 (button) folded before Flop (didn't bet)
Seat 2: 3@RAZZA.BLR (small blind) folded before Flop
Seat 3: Misteltje (big blind) collected ($0.20)
Seat 4: LucasLMdS folded on the Turn
Seat 5: Araj Moon folded before Flop (didn't bet)
Seat 6: Scaaalll folded before Flop (didn't bet)



PokerStars Zoom Hand #229234077763:  Hold'em No Limit ($0.01/$0.02) - 2021/08/21 23:56:35 CET [2021/08/21 17:56:35 ET]
Table 'Halley' 6-max Seat #1 is the button
Seat 1: Demidov V.S. ($2.83 in chips) 
Seat 2: hexi107 ($4.32 in chips) 
Seat 3: Lekcey05 ($3.84 in chips) 
Seat 4: kingdieter1 ($2.10 in chips) 
Seat 5: Scaaalll ($4.22 in chips) 
Seat 6: Dr.stromg ($6.85 in chips) 
hexi107: posts small blind $0.01
Lekcey05: posts big blind $0.02
*** HOLE CARDS ***
Dealt to Scaaalll [9h Tc]
kingdieter1: folds 
kingdieter1 is disconnected 
Scaaalll: folds 
Dr.stromg: folds 
Demidov V.S.: raises $0.04 to $0.06
hexi107: folds 
Lekcey05: folds 
Uncalled bet ($0.04) returned to Demidov V.S.
Demidov V.S. collected $0.05 from pot
Demidov V.S.: doesn't show hand 
*** SUMMARY ***
Total pot $0.05 | Rake $0 
Seat 1: Demidov V.S. (button) collected ($0.05)
Seat 2: hexi107 (small blind) folded before Flop
Seat 3: Lekcey05 (big blind) folded before Flop
Seat 4: kingdieter1 folded before Flop (didn't bet)
Seat 5: Scaaalll folded before Flop (didn't bet)
Seat 6: Dr.stromg folded before Flop (didn't bet)



PokerStars Zoom Hand #229234074507:  Hold'em No Limit ($0.01/$0.02) - 2021/08/21 23:56:24 CET [2021/08/21 17:56:24 ET]
Table 'Halley' 6-max Seat #1 is the button
Seat 1: DaniilF43 ($1.06 in chips) 
Seat 2: tarogame ($3.83 in chips) 
Seat 3: 888lifeIS ($2.10 in chips) 
Seat 4: Scaaalll ($4.24 in chips) 
Seat 5: TM 69 UIE ($2.19 in chips) 
Seat 6: MATIdf365 ($3.05 in chips) 
tarogame: posts small blind $0.01
888lifeIS: posts big blind $0.02
*** HOLE CARDS ***
Dealt to Scaaalll [8h Kc]
TM 69 UIE is disconnected 
Scaaalll: folds 
TM 69 UIE: folds 
MATIdf365: folds 
DaniilF43: folds 
tarogame: raises $0.04 to $0.06
888lifeIS: calls $0.04
*** FLOP *** [Jc 3s 8s]
tarogame: checks 
888lifeIS: bets $0.08
tarogame: calls $0.08
*** TURN *** [Jc 3s 8s] [Ah]
tarogame: checks 
888lifeIS: bets $0.18
tarogame: folds 
Uncalled bet ($0.18) returned to 888lifeIS
888lifeIS collected $0.27 from pot
888lifeIS: doesn't show hand 
*** SUMMARY ***
Total pot $0.28 | Rake $0.01 
Board [Jc 3s 8s Ah]
Seat 1: DaniilF43 (button) folded before Flop (didn't bet)
Seat 2: tarogame (small blind) folded on the Turn
Seat 3: 888lifeIS (big blind) collected ($0.27)
Seat 4: Scaaalll folded before Flop (didn't bet)
Seat 5: TM 69 UIE folded before Flop (didn't bet)
Seat 6: MATIdf365 folded before Flop (didn't bet)



PokerStars Zoom Hand #229234083593:  Hold'em No Limit ($0.01/$0.02) - 2021/08/21 23:56:55 CET [2021/08/21 17:56:55 ET]
Table 'Halley' 6-max Seat #1 is the button
Seat 1: gilberto98 ($2.22 in chips) 
Seat 2: Scaaalll ($4.22 in chips) 
Seat 3: MattieBOZ ($0.80 in chips) 
Seat 4: MATIdf365 ($2.96 in chips) 
Seat 5: 365p2eva ($5.19 in chips) 
Seat 6: SKV_1985 ($3.25 in chips) 
Scaaalll: posts small blind $0.01
MattieBOZ: posts big blind $0.02
*** HOLE CARDS ***
Dealt to Scaaalll [3c Kd]
MATIdf365: folds 
365p2eva: folds 
SKV_1985: raises $0.04 to $0.06
gilberto98: folds 
Scaaalll: folds 
MattieBOZ: folds 
Uncalled bet ($0.04) returned to SKV_1985
SKV_1985 collected $0.05 from pot
SKV_1985: doesn't show hand 
MattieBOZ is disconnected 
*** SUMMARY ***
Total pot $0.05 | Rake $0 
Seat 1: gilberto98 (button) folded before Flop (didn't bet)
Seat 2: Scaaalll (small blind) folded before Flop
Seat 3: MattieBOZ (big blind) folded before Flop
Seat 4: MATIdf365 folded before Flop (didn't bet)
Seat 5: 365p2eva folded before Flop (didn't bet)
Seat 6: SKV_1985 collected ($0.05)



PokerStars Zoom Hand #229234079789:  Hold'em No Limit ($0.01/$0.02) - 2021/08/21 23:56:42 CET [2021/08/21 17:56:42 ET]
Table 'Halley' 6-max Seat #1 is the button
Seat 1: Scaaalll ($4.22 in chips) 
Seat 2: Razmenchic ($4.75 in chips) 
Seat 3: so0love ($5.18 in chips) 
Seat 4: 888lifeIS ($2.07 in chips) 
Seat 5: byakuda ($2.29 in chips) 
Seat 6: nikos803 ($2.16 in chips) 
Razmenchic: posts small blind $0.01
so0love: posts big blind $0.02
*** HOLE CARDS ***
Dealt to Scaaalll [7c 5c]
888lifeIS: folds 
byakuda: raises $0.04 to $0.06
nikos803: folds 
Scaaalll: folds 
Razmenchic: calls $0.05
so0love: folds 
*** FLOP *** [2h 9d 7d]
Razmenchic: checks 
byakuda: checks 
*** TURN *** [2h 9d 7d] [Td]
Razmenchic: checks 
byakuda: checks 
*** RIVER *** [2h 9d 7d Td] [Jc]
Razmenchic: checks 
byakuda: checks 
*** SHOW DOWN ***
Razmenchic: shows [5h 7h] (a pair of Sevens)
byakuda: mucks hand 
Razmenchic collected $0.14 from pot
*** SUMMARY ***
Total pot $0.14 | Rake $0 
Board [2h 9d 7d Td Jc]
Seat 1: Scaaalll (button) folded before Flop (didn't bet)
Seat 2: Razmenchic (small blind) showed [5h 7h] and won ($0.14) with a pair of Sevens
Seat 3: so0love (big blind) folded before Flop
Seat 4: 888lifeIS folded before Flop (didn't bet)
Seat 5: byakuda mucked [Ah Qh]
Seat 6: nikos803 folded before Flop (didn't bet)



PokerStars Zoom Hand #229234085423:  Hold'em No Limit ($0.01/$0.02) - 2021/08/21 23:57:01 CET [2021/08/21 17:57:01 ET]
Table 'Halley' 6-max Seat #1 is the button
Seat 1: AtZ3899 ($2.20 in chips) 
Seat 2: BIITRU ($2.21 in chips) 
Seat 3: kcyxa ($3.79 in chips) 
Seat 4: Scaaalll ($4.21 in chips) 
Seat 5: yorkoss ($3.12 in chips) 
Seat 6: karkal1990 ($0.30 in chips) 
BIITRU: posts small blind $0.01
kcyxa: posts big blind $0.02
*** HOLE CARDS ***
Dealt to Scaaalll [8h 7h]
Scaaalll: folds 
yorkoss: folds 
karkal1990: raises $0.28 to $0.30 and is all-in
AtZ3899: folds 
BIITRU: folds 
kcyxa: folds 
Uncalled bet ($0.28) returned to karkal1990
karkal1990 collected $0.05 from pot
karkal1990: doesn't show hand 
kcyxa is disconnected 
*** SUMMARY ***
Total pot $0.05 | Rake $0 
Seat 1: AtZ3899 (button) folded before Flop (didn't bet)
Seat 2: BIITRU (small blind) folded before Flop
Seat 3: kcyxa (big blind) folded before Flop
Seat 4: Scaaalll folded before Flop (didn't bet)
Seat 5: yorkoss folded before Flop (didn't bet)
Seat 6: karkal1990 collected ($0.05)



PokerStars Zoom Hand #229234087816:  Hold'em No Limit ($0.01/$0.02) - 2021/08/21 23:57:09 CET [2021/08/21 17:57:09 ET]
Table 'Halley' 6-max Seat #1 is the button
Seat 1: MattieBOZ ($2.23 in chips) 
Seat 2: Feyqdoi ($2 in chips) 
Seat 3: Scaaalll ($4.21 in chips) 
Seat 4: baddbeat4fun ($2.07 in chips) 
Seat 5: EdwardF95 ($2.34 in chips) 
Seat 6: ctaceo ($2.36 in chips) 
Feyqdoi: posts small blind $0.01
Scaaalll: posts big blind $0.02
*** HOLE CARDS ***
Dealt to Scaaalll [4h Qc]
baddbeat4fun: folds 
EdwardF95: folds 
ctaceo: folds 
MattieBOZ: folds 
Feyqdoi: folds 
Uncalled bet ($0.01) returned to Scaaalll
MattieBOZ is disconnected 
Scaaalll collected $0.02 from pot
Scaaalll: doesn't show hand 
*** SUMMARY ***
Total pot $0.02 | Rake $0 
Seat 1: MattieBOZ (button) folded before Flop (didn't bet)
Seat 2: Feyqdoi (small blind) folded before Flop
Seat 3: Scaaalll (big blind) collected ($0.02)
Seat 4: baddbeat4fun folded before Flop (didn't bet)
Seat 5: EdwardF95 folded before Flop (didn't bet)
Seat 6: ctaceo folded before Flop (didn't bet)



PokerStars Zoom Hand #229234082461:  Hold'em No Limit ($0.01/$0.02) - 2021/08/21 23:56:51 CET [2021/08/21 17:56:51 ET]
Table 'Halley' 6-max Seat #1 is the button
Seat 1: pavlo8855 ($2 in chips) 
Seat 2: RaulacateFolds ($2 in chips) 
Seat 3: OFSHOR ($3.66 in chips) 
Seat 4: PaddyPoland ($2.36 in chips) 
Seat 5: kcyxa ($3.79 in chips) 
Seat 6: Scaaalll ($4.22 in chips) 
RaulacateFolds: posts small blind $0.01
OFSHOR: posts big blind $0.02
*** HOLE CARDS ***
Dealt to Scaaalll [6h 9c]
kcyxa is disconnected 
PaddyPoland has timed out
PaddyPoland: folds 
kcyxa: folds 
Scaaalll: folds 
pavlo8855: folds 
RaulacateFolds: raises $0.04 to $0.06
OFSHOR: calls $0.04
*** FLOP *** [Qd Ks 9h]
RaulacateFolds: checks 
OFSHOR: checks 
*** TURN *** [Qd Ks 9h] [5s]
RaulacateFolds: checks 
OFSHOR: bets $0.10
RaulacateFolds: folds 
Uncalled bet ($0.10) returned to OFSHOR
OFSHOR collected $0.12 from pot
OFSHOR: doesn't show hand 
*** SUMMARY ***
Total pot $0.12 | Rake $0 
Board [Qd Ks 9h 5s]
Seat 1: pavlo8855 (button) folded before Flop (didn't bet)
Seat 2: RaulacateFolds (small blind) folded on the Turn
Seat 3: OFSHOR (big blind) collected ($0.12)
Seat 4: PaddyPoland folded before Flop (didn't bet)
Seat 5: kcyxa folded before Flop (didn't bet)
Seat 6: Scaaalll folded before Flop (didn't bet)



PokerStars Zoom Hand #229234090484:  Hold'em No Limit ($0.01/$0.02) - 2021/08/21 23:57:18 CET [2021/08/21 17:57:18 ET]
Table 'Halley' 6-max Seat #1 is the button
Seat 1: Scaaalll ($4.22 in chips) 
Seat 2: Merlin_Arg ($2.41 in chips) 
Seat 3: estelionat171 ($0.40 in chips) 
Seat 4: hustlehero ($3.20 in chips) 
Seat 5: gasmar_29 ($4.30 in chips) 
Seat 6: jancsi321 ($1.31 in chips) 
Merlin_Arg: posts small blind $0.01
estelionat171: posts big blind $0.02
*** HOLE CARDS ***
Dealt to Scaaalll [8d Qd]
hustlehero: folds 
gasmar_29: folds 
jancsi321: calls $0.02
Scaaalll: raises $0.06 to $0.08
Merlin_Arg: folds 
estelionat171: folds 
jancsi321: calls $0.06
*** FLOP *** [4c Qh 2h]
jancsi321: checks 
Scaaalll: bets $0.12
jancsi321: calls $0.12
*** TURN *** [4c Qh 2h] [Ah]
jancsi321: bets $0.21
Scaaalll: folds 
Uncalled bet ($0.21) returned to jancsi321
jancsi321 collected $0.41 from pot
jancsi321: doesn't show hand 
*** SUMMARY ***
Total pot $0.43 | Rake $0.02 
Board [4c Qh 2h Ah]
Seat 1: Scaaalll (button) folded on the Turn
Seat 2: Merlin_Arg (small blind) folded before Flop
Seat 3: estelionat171 (big blind) folded before Flop
Seat 4: hustlehero folded before Flop (didn't bet)
Seat 5: gasmar_29 folded before Flop (didn't bet)
Seat 6: jancsi321 collected ($0.41)



PokerStars Zoom Hand #229234115223:  Hold'em No Limit ($0.01/$0.02) - 2021/08/21 23:58:41 CET [2021/08/21 17:58:41 ET]
Table 'Halley' 6-max Seat #1 is the button
Seat 1: maressen ($4.31 in chips) 
Seat 2: BTEK5889 ($2.55 in chips) 
Seat 3: rpycmbEM ($3.19 in chips) 
Seat 4: SKV_1985 ($2 in chips) 
Seat 5: nbarreiro021 ($2 in chips) 
Seat 6: Scaaalll ($4.02 in chips) 
BTEK5889: posts small blind $0.01
rpycmbEM: posts big blind $0.02
*** HOLE CARDS ***
Dealt to Scaaalll [2c 3s]
SKV_1985: folds 
nbarreiro021: folds 
Scaaalll: folds 
maressen: folds 
BTEK5889: raises $0.04 to $0.06
rpycmbEM: folds 
Uncalled bet ($0.04) returned to BTEK5889
BTEK5889 collected $0.04 from pot
BTEK5889: doesn't show hand 
*** SUMMARY ***
Total pot $0.04 | Rake $0 
Seat 1: maressen (button) folded before Flop (didn't bet)
Seat 2: BTEK5889 (small blind) collected ($0.04)
Seat 3: rpycmbEM (big blind) folded before Flop
Seat 4: SKV_1985 folded before Flop (didn't bet)
Seat 5: nbarreiro021 folded before Flop (didn't bet)
Seat 6: Scaaalll folded before Flop (didn't bet)



PokerStars Zoom Hand #229234116452:  Hold'em No Limit ($0.01/$0.02) - 2021/08/21 23:58:45 CET [2021/08/21 17:58:45 ET]
Table 'Halley' 6-max Seat #1 is the button
Seat 1: 888lifeIS ($2.36 in chips) 
Seat 2: vovan100157 ($3.09 in chips) 
Seat 3: mthurner97 ($1.69 in chips) 
Seat 4: Scaaalll ($4.02 in chips) 
Seat 5: hexi107 ($4.10 in chips) 
Seat 6: Hejpåre ($3.74 in chips) 
vovan100157: posts small blind $0.01
mthurner97: posts big blind $0.02
*** HOLE CARDS ***
Dealt to Scaaalll [Th Qs]
Scaaalll: folds 
hexi107: folds 
Hejpåre: folds 
888lifeIS: raises $0.02 to $0.04
vovan100157: folds 
mthurner97: calls $0.02
*** FLOP *** [7d Jh 5d]
mthurner97: checks 
888lifeIS: bets $0.06
mthurner97: folds 
Uncalled bet ($0.06) returned to 888lifeIS
888lifeIS collected $0.09 from pot
888lifeIS: doesn't show hand 
mthurner97 is disconnected 
*** SUMMARY ***
Total pot $0.09 | Rake $0 
Board [7d Jh 5d]
Seat 1: 888lifeIS (button) collected ($0.09)
Seat 2: vovan100157 (small blind) folded before Flop
Seat 3: mthurner97 (big blind) folded on the Flop
Seat 4: Scaaalll folded before Flop (didn't bet)
Seat 5: hexi107 folded before Flop (didn't bet)
Seat 6: Hejpåre folded before Flop (didn't bet)



PokerStars Zoom Hand #229234127585:  Hold'em No Limit ($0.01/$0.02) - 2021/08/21 23:59:14 CET [2021/08/21 17:59:14 ET]
Table 'Halley' 6-max Seat #1 is the button
Seat 1: Xlavariable ($2 in chips) 
Seat 2: Scaaalll ($4.02 in chips) 
Seat 3: STE1NBERG ($2.22 in chips) 
Seat 4: Mikeloko182 ($2.01 in chips) 
Seat 5: so0love ($5.20 in chips) 
Seat 6: Gamer577 ($4.68 in chips) 
Scaaalll: posts small blind $0.01
STE1NBERG: posts big blind $0.02
*** HOLE CARDS ***
Dealt to Scaaalll [6d Jd]
Mikeloko182: folds 
so0love: folds 
Gamer577: folds 
Xlavariable: folds 
Scaaalll: folds 
Uncalled bet ($0.01) returned to STE1NBERG
STE1NBERG collected $0.02 from pot
STE1NBERG: doesn't show hand 
*** SUMMARY ***
Total pot $0.02 | Rake $0 
Seat 1: Xlavariable (button) folded before Flop (didn't bet)
Seat 2: Scaaalll (small blind) folded before Flop
Seat 3: STE1NBERG (big blind) collected ($0.02)
Seat 4: Mikeloko182 folded before Flop (didn't bet)
Seat 5: so0love folded before Flop (didn't bet)
Seat 6: Gamer577 folded before Flop (didn't bet)



PokerStars Zoom Hand #229234120402:  Hold'em No Limit ($0.01/$0.02) - 2021/08/21 23:58:50 CET [2021/08/21 17:58:50 ET]
Table 'Halley' 6-max Seat #1 is the button
Seat 1: Scaaalll ($4.02 in chips) 
Seat 2: KissingTheSun ($2 in chips) 
Seat 3: Nihility77 ($3.39 in chips) 
Seat 4: KonopDima ($2.42 in chips) 
Seat 5: AXXILLES ($4.77 in chips) 
Seat 6: Mikmaq Caper ($1.43 in chips) 
KissingTheSun: posts small blind $0.01
Nihility77: posts big blind $0.02
*** HOLE CARDS ***
Dealt to Scaaalll [8c Qd]
KonopDima: folds 
AXXILLES: folds 
Mikmaq Caper: calls $0.02
Scaaalll: folds 
KissingTheSun: folds 
Nihility77: checks 
*** FLOP *** [4s 2h Ac]
Nihility77: checks 
Mikmaq Caper: checks 
*** TURN *** [4s 2h Ac] [4h]
Nihility77: checks 
Mikmaq Caper: bets $0.02
Nihility77: folds 
Uncalled bet ($0.02) returned to Mikmaq Caper
Mikmaq Caper collected $0.05 from pot
Mikmaq Caper: doesn't show hand 
*** SUMMARY ***
Total pot $0.05 | Rake $0 
Board [4s 2h Ac 4h]
Seat 1: Scaaalll (button) folded before Flop (didn't bet)
Seat 2: KissingTheSun (small blind) folded before Flop
Seat 3: Nihility77 (big blind) folded on the Turn
Seat 4: KonopDima folded before Flop (didn't bet)
Seat 5: AXXILLES folded before Flop (didn't bet)
Seat 6: Mikmaq Caper collected ($0.05)



PokerStars Zoom Hand #229234125528:  Hold'em No Limit ($0.01/$0.02) - 2021/08/21 23:59:07 CET [2021/08/21 17:59:07 ET]
Table 'Halley' 6-max Seat #1 is the button
Seat 1: DocAcid ($1 in chips) 
Seat 2: El Chicha.CL ($2.01 in chips) 
Seat 3: OmahaWheels ($3.63 in chips) 
Seat 4: Doktor Yes ($3.96 in chips) 
Seat 5: estelionat171 ($0.82 in chips) 
Seat 6: Scaaalll ($4.02 in chips) 
El Chicha.CL: posts small blind $0.01
OmahaWheels: posts big blind $0.02
*** HOLE CARDS ***
Dealt to Scaaalll [3d Ts]
DocAcid is disconnected 
Doktor Yes: folds 
estelionat171: folds 
Scaaalll: folds 
DocAcid: folds 
El Chicha.CL: calls $0.01
OmahaWheels: checks 
*** FLOP *** [Ks Kd 2s]
El Chicha.CL: checks 
OmahaWheels: checks 
*** TURN *** [Ks Kd 2s] [As]
El Chicha.CL: checks 
OmahaWheels: bets $0.04
El Chicha.CL: folds 
Uncalled bet ($0.04) returned to OmahaWheels
OmahaWheels collected $0.04 from pot
OmahaWheels: doesn't show hand 
*** SUMMARY ***
Total pot $0.04 | Rake $0 
Board [Ks Kd 2s As]
Seat 1: DocAcid (button) folded before Flop (didn't bet)
Seat 2: El Chicha.CL (small blind) folded on the Turn
Seat 3: OmahaWheels (big blind) collected ($0.04)
Seat 4: Doktor Yes folded before Flop (didn't bet)
Seat 5: estelionat171 folded before Flop (didn't bet)
Seat 6: Scaaalll folded before Flop (didn't bet)



PokerStars Zoom Hand #229234113201:  Hold'em No Limit ($0.01/$0.02) - 2021/08/21 23:58:34 CET [2021/08/21 17:58:34 ET]
Table 'Halley' 6-max Seat #1 is the button
Seat 1: elmex886 ($2 in chips) 
Seat 2: NoEff0rt2w1n ($2.06 in chips) 
Seat 3: Iv3rson18 ($3.19 in chips) 
Seat 4: Busya777 ($4.81 in chips) 
Seat 5: Scaaalll ($4.02 in chips) 
Seat 6: fabor1303 ($4.15 in chips) 
NoEff0rt2w1n: posts small blind $0.01
Iv3rson18: posts big blind $0.02
*** HOLE CARDS ***
Dealt to Scaaalll [8h Qs]
Busya777: folds 
Busya777 is disconnected 
Scaaalll: folds 
fabor1303: raises $0.03 to $0.05
elmex886: folds 
NoEff0rt2w1n: calls $0.04
Iv3rson18: folds 
*** FLOP *** [4h 8c 9d]
NoEff0rt2w1n: checks 
fabor1303: checks 
*** TURN *** [4h 8c 9d] [Qd]
NoEff0rt2w1n: bets $0.07
fabor1303: calls $0.07
*** RIVER *** [4h 8c 9d Qd] [7h]
NoEff0rt2w1n: checks 
fabor1303: checks 
*** SHOW DOWN ***
NoEff0rt2w1n: shows [3d 3c] (a pair of Threes)
fabor1303: shows [Ad 9c] (a pair of Nines)
fabor1303 collected $0.25 from pot
*** SUMMARY ***
Total pot $0.26 | Rake $0.01 
Board [4h 8c 9d Qd 7h]
Seat 1: elmex886 (button) folded before Flop (didn't bet)
Seat 2: NoEff0rt2w1n (small blind) showed [3d 3c] and lost with a pair of Threes
Seat 3: Iv3rson18 (big blind) folded before Flop
Seat 4: Busya777 folded before Flop (didn't bet)
Seat 5: Scaaalll folded before Flop (didn't bet)
Seat 6: fabor1303 showed [Ad 9c] and won ($0.25) with a pair of Nines



PokerStars Zoom Hand #229234131755:  Hold'em No Limit ($0.01/$0.02) - 2021/08/21 23:59:28 CET [2021/08/21 17:59:28 ET]
Table 'Halley' 6-max Seat #1 is the button
Seat 1: tuolau ($4.41 in chips) 
Seat 2: 888lifeIS ($2.41 in chips) 
Seat 3: Scaaalll ($4.01 in chips) 
Seat 4: Araj Moon ($2.32 in chips) 
Seat 5: Hejpåre ($2.16 in chips) 
Seat 6: Luben_76 ($2 in chips) 
888lifeIS: posts small blind $0.01
Scaaalll: posts big blind $0.02
*** HOLE CARDS ***
Dealt to Scaaalll [6h 6c]
Araj Moon: raises $0.04 to $0.06
Hejpåre: folds 
Luben_76: raises $0.12 to $0.18
tuolau: calls $0.18
888lifeIS: calls $0.17
Scaaalll: calls $0.16
Araj Moon: calls $0.12
*** FLOP *** [Ts 9s 8d]
888lifeIS: checks 
Scaaalll: checks 
Araj Moon: checks 
Luben_76: checks 
tuolau: checks 
*** TURN *** [Ts 9s 8d] [Js]
888lifeIS: bets $2.23 and is all-in
Scaaalll: folds 
Araj Moon: folds 
Luben_76: folds 
tuolau: calls $2.23
*** RIVER *** [Ts 9s 8d Js] [2s]
*** SHOW DOWN ***
888lifeIS: shows [Kc Qc] (a straight, Nine to King)
tuolau: shows [Qh As] (a flush, Ace high)
tuolau collected $5.17 from pot
888lifeIS cashed out the hand for $3.84 | Cash Out Fee $0.04
*** SUMMARY ***
Total pot $5.36 | Rake $0.19 
Board [Ts 9s 8d Js 2s]
Seat 1: tuolau (button) showed [Qh As] and won ($5.17) with a flush, Ace high
Seat 2: 888lifeIS (small blind) showed [Kc Qc] and lost with a straight, Nine to King (cashed out).
Seat 3: Scaaalll (big blind) folded on the Turn
Seat 4: Araj Moon folded on the Turn
Seat 5: Hejpåre folded before Flop (didn't bet)
Seat 6: Luben_76 folded on the Turn



PokerStars Zoom Hand #229234147564:  Hold'em No Limit ($0.01/$0.02) - 2021/08/22 0:00:19 CET [2021/08/21 18:00:19 ET]
Table 'Halley' 6-max Seat #1 is the button
Seat 1: menba47 ($1.54 in chips) 
Seat 2: Bol'tazar111 ($2.45 in chips) 
Seat 3: NoEff0rt2w1n ($2 in chips) 
Seat 4: Gamer577 ($4.61 in chips) 
Seat 5: Scaaalll ($3.83 in chips) 
Seat 6: wina447 ($1.99 in chips) 
Bol'tazar111: posts small blind $0.01
NoEff0rt2w1n: posts big blind $0.02
*** HOLE CARDS ***
Dealt to Scaaalll [9c 6h]
Gamer577: folds 
Scaaalll: folds 
wina447: calls $0.02
menba47: folds 
Bol'tazar111: folds 
NoEff0rt2w1n: checks 
*** FLOP *** [Th Qs 8h]
NoEff0rt2w1n: checks 
wina447: bets $0.06
NoEff0rt2w1n: calls $0.06
*** TURN *** [Th Qs 8h] [Js]
NoEff0rt2w1n: checks 
wina447: bets $0.06
NoEff0rt2w1n: folds 
Uncalled bet ($0.06) returned to wina447
wina447 collected $0.16 from pot
wina447: doesn't show hand 
*** SUMMARY ***
Total pot $0.17 | Rake $0.01 
Board [Th Qs 8h Js]
Seat 1: menba47 (button) folded before Flop (didn't bet)
Seat 2: Bol'tazar111 (small blind) folded before Flop
Seat 3: NoEff0rt2w1n (big blind) folded on the Turn
Seat 4: Gamer577 folded before Flop (didn't bet)
Seat 5: Scaaalll folded before Flop (didn't bet)
Seat 6: wina447 collected ($0.16)



PokerStars Zoom Hand #229234151085:  Hold'em No Limit ($0.01/$0.02) - 2021/08/22 0:00:30 CET [2021/08/21 18:00:30 ET]
Table 'Halley' 6-max Seat #1 is the button
Seat 1: Scaaalll ($3.83 in chips) 
Seat 2: estelionat171 ($0.91 in chips) 
Seat 3: STE1NBERG ($5.25 in chips) 
Seat 4: Craitastrophe ($5.46 in chips) 
Seat 5: gabgordula ($2.13 in chips) 
Seat 6: AtZ3899 ($1.68 in chips) 
estelionat171: posts small blind $0.01
STE1NBERG: posts big blind $0.02
*** HOLE CARDS ***
Dealt to Scaaalll [5s Kc]
Craitastrophe: raises $0.04 to $0.06
gabgordula: calls $0.06
AtZ3899: folds 
Scaaalll: folds 
estelionat171: folds 
STE1NBERG: folds 
*** FLOP *** [2c Qs Js]
Craitastrophe: checks 
gabgordula: checks 
*** TURN *** [2c Qs Js] [2h]
Craitastrophe: checks 
gabgordula: checks 
*** RIVER *** [2c Qs Js 2h] [7h]
Craitastrophe: checks 
gabgordula: checks 
*** SHOW DOWN ***
Craitastrophe: shows [8c 8h] (two pair, Eights and Deuces)
gabgordula: mucks hand 
Craitastrophe collected $0.14 from pot
*** SUMMARY ***
Total pot $0.15 | Rake $0.01 
Board [2c Qs Js 2h 7h]
Seat 1: Scaaalll (button) folded before Flop (didn't bet)
Seat 2: estelionat171 (small blind) folded before Flop
Seat 3: STE1NBERG (big blind) folded before Flop
Seat 4: Craitastrophe showed [8c 8h] and won ($0.14) with two pair, Eights and Deuces
Seat 5: gabgordula mucked [3d 3h]
Seat 6: AtZ3899 folded before Flop (didn't bet)



PokerStars Zoom Hand #229234157082:  Hold'em No Limit ($0.01/$0.02) - 2021/08/22 0:00:48 CET [2021/08/21 18:00:48 ET]
Table 'Halley' 6-max Seat #1 is the button
Seat 1: adrianh2002 ($2.26 in chips) 
Seat 2: Scaaalll ($3.83 in chips) 
Seat 3: hsavastano6 ($1.14 in chips) 
Seat 4: Nihility77 ($3.39 in chips) 
Seat 5: BasTidChiken ($2.55 in chips) 
Seat 6: Pechorin.G ($3.67 in chips) 
Scaaalll: posts small blind $0.01
hsavastano6: posts big blind $0.02
*** HOLE CARDS ***
Dealt to Scaaalll [9c 5s]
Nihility77: folds 
BasTidChiken: folds 
Pechorin.G: raises $0.03 to $0.05
adrianh2002: folds 
Scaaalll: folds 
hsavastano6: calls $0.03
*** FLOP *** [5c As 3h]
hsavastano6: checks 
Pechorin.G: checks 
*** TURN *** [5c As 3h] [Js]
hsavastano6: bets $0.11
Pechorin.G: folds 
Uncalled bet ($0.11) returned to hsavastano6
hsavastano6 collected $0.11 from pot
hsavastano6: doesn't show hand 
*** SUMMARY ***
Total pot $0.11 | Rake $0 
Board [5c As 3h Js]
Seat 1: adrianh2002 (button) folded before Flop (didn't bet)
Seat 2: Scaaalll (small blind) folded before Flop
Seat 3: hsavastano6 (big blind) collected ($0.11)
Seat 4: Nihility77 folded before Flop (didn't bet)
Seat 5: BasTidChiken folded before Flop (didn't bet)
Seat 6: Pechorin.G folded on the Turn



PokerStars Zoom Hand #229234161221:  Hold'em No Limit ($0.01/$0.02) - 2021/08/22 0:01:00 CET [2021/08/21 18:01:00 ET]
Table 'Halley' 6-max Seat #1 is the button
Seat 1: egroj1700 ($2.39 in chips) 
Seat 2: MattieBOZ ($1.62 in chips) 
Seat 3: Ck@tih@ ($1.61 in chips) 
Seat 4: Scaaalll ($3.82 in chips) 
Seat 5: Carlos_glaza ($2 in chips) 
Seat 6: ctaceo ($2 in chips) 
MattieBOZ: posts small blind $0.01
Ck@tih@: posts big blind $0.02
*** HOLE CARDS ***
Dealt to Scaaalll [Td Tc]
Scaaalll: raises $0.04 to $0.06
Carlos_glaza: folds 
MattieBOZ is disconnected 
ctaceo: calls $0.06
egroj1700: folds 
MattieBOZ: folds 
Ck@tih@: folds 
*** FLOP *** [Qd Jd Js]
Scaaalll: checks 
ctaceo: checks 
*** TURN *** [Qd Jd Js] [8s]
Scaaalll: checks 
ctaceo: bets $0.11
Scaaalll: calls $0.11
*** RIVER *** [Qd Jd Js 8s] [7c]
Scaaalll: checks 
ctaceo: bets $0.12
Scaaalll: calls $0.12
*** SHOW DOWN ***
ctaceo: shows [8c 8h] (a full house, Eights full of Jacks)
Scaaalll: mucks hand 
ctaceo collected $0.59 from pot
*** SUMMARY ***
Total pot $0.61 | Rake $0.02 
Board [Qd Jd Js 8s 7c]
Seat 1: egroj1700 (button) folded before Flop (didn't bet)
Seat 2: MattieBOZ (small blind) folded before Flop
Seat 3: Ck@tih@ (big blind) folded before Flop
Seat 4: Scaaalll mucked [Td Tc]
Seat 5: Carlos_glaza folded before Flop (didn't bet)
Seat 6: ctaceo showed [8c 8h] and won ($0.59) with a full house, Eights full of Jacks



PokerStars Zoom Hand #229234178871:  Hold'em No Limit ($0.01/$0.02) - 2021/08/22 0:01:49 CET [2021/08/21 18:01:49 ET]
Table 'Halley' 6-max Seat #1 is the button
Seat 1: squidy4 ($2.34 in chips) 
Seat 2: rpycmbEM ($2.92 in chips) 
Seat 3: adrianh2002 ($2.29 in chips) 
Seat 4: Xlavariable ($2.06 in chips) 
Seat 5: Jacon2905 ($2.39 in chips) 
Seat 6: Scaaalll ($3.53 in chips) 
rpycmbEM: posts small blind $0.01
adrianh2002: posts big blind $0.02
*** HOLE CARDS ***
Dealt to Scaaalll [Ks Qh]
Xlavariable: folds 
Jacon2905: folds 
Scaaalll: raises $0.04 to $0.06
squidy4: calls $0.06
rpycmbEM: calls $0.05
adrianh2002: folds 
*** FLOP *** [3h 9s 7h]
rpycmbEM: checks 
Scaaalll: checks 
squidy4: bets $0.07
rpycmbEM: calls $0.07
Scaaalll: folds 
*** TURN *** [3h 9s 7h] [Ad]
rpycmbEM: checks 
squidy4: checks 
*** RIVER *** [3h 9s 7h Ad] [Jh]
rpycmbEM: checks 
squidy4: checks 
*** SHOW DOWN ***
rpycmbEM: shows [Jd Td] (a pair of Jacks)
squidy4: mucks hand 
rpycmbEM collected $0.33 from pot
*** SUMMARY ***
Total pot $0.34 | Rake $0.01 
Board [3h 9s 7h Ad Jh]
Seat 1: squidy4 (button) mucked [5s 5d]
Seat 2: rpycmbEM (small blind) showed [Jd Td] and won ($0.33) with a pair of Jacks
Seat 3: adrianh2002 (big blind) folded before Flop
Seat 4: Xlavariable folded before Flop (didn't bet)
Seat 5: Jacon2905 folded before Flop (didn't bet)
Seat 6: Scaaalll folded on the Flop



