PokerStars Zoom Hand #229229075998:  Hold'em No Limit ($0.01/$0.02) - 2021/08/21 20:45:25 CET [2021/08/21 14:45:25 ET]
Table 'Halley' 6-max Seat #1 is the button
Seat 1: Alcoléa ($2.04 in chips) 
Seat 2: Kb013497 ($4.50 in chips) 
Seat 3: Scaaalll ($2 in chips) 
Seat 4: Kergie ($6.23 in chips) 
Seat 5: thiagohbueno ($3.60 in chips) 
Seat 6: AligatorsBlood ($3.57 in chips) 
Kb013497: posts small blind $0.01
Scaaalll: posts big blind $0.02
*** HOLE CARDS ***
Dealt to Scaaalll [Tc 8h]
Kergie: folds 
thiagohbueno: folds 
AligatorsBlood: raises $0.03 to $0.05
Alcoléa: folds 
Kb013497: folds 
Scaaalll: folds 
Uncalled bet ($0.03) returned to AligatorsBlood
AligatorsBlood collected $0.05 from pot
AligatorsBlood: doesn't show hand 
*** SUMMARY ***
Total pot $0.05 | Rake $0 
Seat 1: Alcoléa (button) folded before Flop (didn't bet)
Seat 2: Kb013497 (small blind) folded before Flop
Seat 3: Scaaalll (big blind) folded before Flop
Seat 4: Kergie folded before Flop (didn't bet)
Seat 5: thiagohbueno folded before Flop (didn't bet)
Seat 6: AligatorsBlood collected ($0.05)



PokerStars Zoom Hand #229229085326:  Hold'em No Limit ($0.01/$0.02) - 2021/08/21 20:45:47 CET [2021/08/21 14:45:47 ET]
Table 'Halley' 6-max Seat #1 is the button
Seat 1: Scaaalll ($2 in chips) 
Seat 2: andreydgk ($4.22 in chips) 
Seat 3: CMNilsson ($2.01 in chips) 
Seat 4: ancqPRO ($2.04 in chips) 
Seat 5: Berti281 ($2.17 in chips) 
Seat 6: ash1448 ($3.10 in chips) 
andreydgk: posts small blind $0.01
CMNilsson: posts big blind $0.02
*** HOLE CARDS ***
Dealt to Scaaalll [9d 8h]
ancqPRO: folds 
Berti281: folds 
ash1448: raises $0.02 to $0.04
Scaaalll: folds 
andreydgk: folds 
CMNilsson: folds 
Uncalled bet ($0.02) returned to ash1448
ash1448 collected $0.05 from pot
ash1448: doesn't show hand 
*** SUMMARY ***
Total pot $0.05 | Rake $0 
Seat 1: Scaaalll (button) folded before Flop (didn't bet)
Seat 2: andreydgk (small blind) folded before Flop
Seat 3: CMNilsson (big blind) folded before Flop
Seat 4: ancqPRO folded before Flop (didn't bet)
Seat 5: Berti281 folded before Flop (didn't bet)
Seat 6: ash1448 collected ($0.05)



PokerStars Zoom Hand #229229090436:  Hold'em No Limit ($0.01/$0.02) - 2021/08/21 20:45:59 CET [2021/08/21 14:45:59 ET]
Table 'Halley' 6-max Seat #1 is the button
Seat 1: fabor1303 ($2.40 in chips) 
Seat 2: Scaaalll ($2 in chips) 
Seat 3: G1olight ($2.36 in chips) 
Seat 4: senorseldeng ($2.36 in chips) 
Seat 5: pavlo8855 ($2 in chips) 
Seat 6: KRITAYA ($1.23 in chips) 
Scaaalll: posts small blind $0.01
G1olight: posts big blind $0.02
*** HOLE CARDS ***
Dealt to Scaaalll [2s Kh]
senorseldeng: folds 
pavlo8855: folds 
KRITAYA: raises $0.04 to $0.06
fabor1303: folds 
Scaaalll: folds 
G1olight: folds 
Uncalled bet ($0.04) returned to KRITAYA
KRITAYA collected $0.05 from pot
KRITAYA: doesn't show hand 
*** SUMMARY ***
Total pot $0.05 | Rake $0 
Seat 1: fabor1303 (button) folded before Flop (didn't bet)
Seat 2: Scaaalll (small blind) folded before Flop
Seat 3: G1olight (big blind) folded before Flop
Seat 4: senorseldeng folded before Flop (didn't bet)
Seat 5: pavlo8855 folded before Flop (didn't bet)
Seat 6: KRITAYA collected ($0.05)



PokerStars Zoom Hand #229229095983:  Hold'em No Limit ($0.01/$0.02) - 2021/08/21 20:46:12 CET [2021/08/21 14:46:12 ET]
Table 'Halley' 6-max Seat #1 is the button
Seat 1: Loto70 ($2.04 in chips) 
Seat 2: Halbschatten ($2.83 in chips) 
Seat 3: vsegda_takoy ($2.35 in chips) 
Seat 4: musirov ($1.50 in chips) 
Seat 5: FrssRodriguesr ($0.71 in chips) 
Seat 6: Scaaalll ($2 in chips) 
Halbschatten: posts small blind $0.01
vsegda_takoy: posts big blind $0.02
*** HOLE CARDS ***
Dealt to Scaaalll [Qs 4s]
musirov: folds 
FrssRodriguesr: folds 
Scaaalll: folds 
Loto70: raises $0.03 to $0.05
Halbschatten: folds 
vsegda_takoy: folds 
Uncalled bet ($0.03) returned to Loto70
Loto70 collected $0.05 from pot
Loto70: doesn't show hand 
*** SUMMARY ***
Total pot $0.05 | Rake $0 
Seat 1: Loto70 (button) collected ($0.05)
Seat 2: Halbschatten (small blind) folded before Flop
Seat 3: vsegda_takoy (big blind) folded before Flop
Seat 4: musirov folded before Flop (didn't bet)
Seat 5: FrssRodriguesr folded before Flop (didn't bet)
Seat 6: Scaaalll folded before Flop (didn't bet)



PokerStars Zoom Hand #229229103123:  Hold'em No Limit ($0.01/$0.02) - 2021/08/21 20:46:29 CET [2021/08/21 14:46:29 ET]
Table 'Halley' 6-max Seat #1 is the button
Seat 1: senorseldeng ($2.33 in chips) 
Seat 2: Boris_Garich ($4.54 in chips) 
Seat 3: Scaaalll ($2 in chips) 
Seat 4: kickBrain ($5.74 in chips) 
Seat 5: pavlo8855 ($2 in chips) 
Seat 6: ancqPRO ($2.01 in chips) 
Boris_Garich: posts small blind $0.01
Scaaalll: posts big blind $0.02
*** HOLE CARDS ***
Dealt to Scaaalll [8d Qs]
kickBrain: folds 
pavlo8855: raises $0.04 to $0.06
ancqPRO: folds 
senorseldeng: calls $0.06
Boris_Garich: folds 
Scaaalll: folds 
*** FLOP *** [5c 7s Kh]
pavlo8855: bets $0.07
senorseldeng: folds 
Uncalled bet ($0.07) returned to pavlo8855
pavlo8855 collected $0.14 from pot
pavlo8855: doesn't show hand 
*** SUMMARY ***
Total pot $0.15 | Rake $0.01 
Board [5c 7s Kh]
Seat 1: senorseldeng (button) folded on the Flop
Seat 2: Boris_Garich (small blind) folded before Flop
Seat 3: Scaaalll (big blind) folded before Flop
Seat 4: kickBrain folded before Flop (didn't bet)
Seat 5: pavlo8855 collected ($0.14)
Seat 6: ancqPRO folded before Flop (didn't bet)



PokerStars Zoom Hand #229229108311:  Hold'em No Limit ($0.01/$0.02) - 2021/08/21 20:46:41 CET [2021/08/21 14:46:41 ET]
Table 'Halley' 6-max Seat #1 is the button
Seat 1: roland11131 ($2.79 in chips) 
Seat 2: renova0813 ($11.30 in chips) 
Seat 3: bigthereal ($2.57 in chips) 
Seat 4: Scaaalll ($2 in chips) 
Seat 5: pollovaari ($2.03 in chips) 
Seat 6: kickBrain ($3.74 in chips) 
renova0813: posts small blind $0.01
bigthereal: posts big blind $0.02
*** HOLE CARDS ***
Dealt to Scaaalll [6s 5h]
Scaaalll: folds 
pollovaari: folds 
kickBrain: folds 
pollovaari is disconnected 
roland11131: raises $0.03 to $0.05
renova0813: raises $0.15 to $0.20
bigthereal: folds 
roland11131: folds 
Uncalled bet ($0.15) returned to renova0813
renova0813 collected $0.12 from pot
renova0813: doesn't show hand 
*** SUMMARY ***
Total pot $0.12 | Rake $0 
Seat 1: roland11131 (button) folded before Flop
Seat 2: renova0813 (small blind) collected ($0.12)
Seat 3: bigthereal (big blind) folded before Flop
Seat 4: Scaaalll folded before Flop (didn't bet)
Seat 5: pollovaari folded before Flop (didn't bet)
Seat 6: kickBrain folded before Flop (didn't bet)



PokerStars Zoom Hand #229229097668:  Hold'em No Limit ($0.01/$0.02) - 2021/08/21 20:46:16 CET [2021/08/21 14:46:16 ET]
Table 'Halley' 6-max Seat #1 is the button
Seat 1: QuieroPollo84 ($2.36 in chips) 
Seat 2: arturtsutsaev ($1.40 in chips) 
Seat 3: cruisinjack ($2 in chips) 
Seat 4: tanya51 ($1.03 in chips) 
Seat 5: Scaaalll ($2 in chips) 
Seat 6: jojocadillac ($2.22 in chips) 
arturtsutsaev: posts small blind $0.01
cruisinjack: posts big blind $0.02
*** HOLE CARDS ***
Dealt to Scaaalll [2c As]
tanya51: folds 
tanya51 is disconnected 
Scaaalll: folds 
jojocadillac: calls $0.02
QuieroPollo84: raises $0.06 to $0.08
arturtsutsaev: folds 
arturtsutsaev is disconnected 
cruisinjack: folds 
jojocadillac: calls $0.06
*** FLOP *** [8s 7s Kd]
jojocadillac: bets $0.22
QuieroPollo84: calls $0.22
*** TURN *** [8s 7s Kd] [5d]
jojocadillac: checks 
QuieroPollo84: checks 
*** RIVER *** [8s 7s Kd 5d] [3d]
jojocadillac: bets $0.28
QuieroPollo84: calls $0.28
*** SHOW DOWN ***
jojocadillac: shows [Td Ks] (a pair of Kings)
QuieroPollo84: shows [Kh Tc] (a pair of Kings)
jojocadillac collected $0.58 from pot
QuieroPollo84 collected $0.57 from pot
*** SUMMARY ***
Total pot $1.19 | Rake $0.04 
Board [8s 7s Kd 5d 3d]
Seat 1: QuieroPollo84 (button) showed [Kh Tc] and won ($0.57) with a pair of Kings
Seat 2: arturtsutsaev (small blind) folded before Flop
Seat 3: cruisinjack (big blind) folded before Flop
Seat 4: tanya51 folded before Flop (didn't bet)
Seat 5: Scaaalll folded before Flop (didn't bet)
Seat 6: jojocadillac showed [Td Ks] and won ($0.58) with a pair of Kings



PokerStars Zoom Hand #229229101470:  Hold'em No Limit ($0.01/$0.02) - 2021/08/21 20:46:25 CET [2021/08/21 14:46:25 ET]
Table 'Halley' 6-max Seat #1 is the button
Seat 1: 77omsk ($5.17 in chips) 
Seat 2: rekopo203 ($3.19 in chips) 
Seat 3: Alex_pro4747 ($1.39 in chips) 
Seat 4: Scaaalll ($2 in chips) 
Seat 5: yannikdaehne ($7.59 in chips) 
Seat 6: Pechorin.G ($2.08 in chips) 
rekopo203: posts small blind $0.01
Alex_pro4747: posts big blind $0.02
*** HOLE CARDS ***
Dealt to Scaaalll [Ad 8s]
Scaaalll: folds 
yannikdaehne: raises $0.03 to $0.05
Pechorin.G: folds 
77omsk: raises $0.10 to $0.15
rekopo203: folds 
Alex_pro4747: folds 
yannikdaehne: folds 
Uncalled bet ($0.10) returned to 77omsk
77omsk collected $0.13 from pot
77omsk: doesn't show hand 
*** SUMMARY ***
Total pot $0.13 | Rake $0 
Seat 1: 77omsk (button) collected ($0.13)
Seat 2: rekopo203 (small blind) folded before Flop
Seat 3: Alex_pro4747 (big blind) folded before Flop
Seat 4: Scaaalll folded before Flop (didn't bet)
Seat 5: yannikdaehne folded before Flop
Seat 6: Pechorin.G folded before Flop (didn't bet)



PokerStars Zoom Hand #229229109983:  Hold'em No Limit ($0.01/$0.02) - 2021/08/21 20:46:45 CET [2021/08/21 14:46:45 ET]
Table 'Halley' 6-max Seat #1 is the button
Seat 1: Natali172737 ($2 in chips) 
Seat 2: Scaaalll ($2 in chips) 
Seat 3: xxRoseIloveu ($1.66 in chips) 
Seat 4: majo_74 ($3 in chips) 
Seat 5: Armando.Bordi ($2.57 in chips) 
Seat 6: MEUZZO ($3.83 in chips) 
Scaaalll: posts small blind $0.01
xxRoseIloveu: posts big blind $0.02
*** HOLE CARDS ***
Dealt to Scaaalll [Td Ac]
majo_74: folds 
Armando.Bordi: raises $0.04 to $0.06
MEUZZO: folds 
Natali172737: folds 
Scaaalll: folds 
xxRoseIloveu: calls $0.04
*** FLOP *** [Th 9h 9d]
xxRoseIloveu: checks 
Armando.Bordi: bets $0.07
xxRoseIloveu: raises $0.14 to $0.21
Armando.Bordi: folds 
Uncalled bet ($0.14) returned to xxRoseIloveu
xxRoseIloveu collected $0.26 from pot
xxRoseIloveu: doesn't show hand 
*** SUMMARY ***
Total pot $0.27 | Rake $0.01 
Board [Th 9h 9d]
Seat 1: Natali172737 (button) folded before Flop (didn't bet)
Seat 2: Scaaalll (small blind) folded before Flop
Seat 3: xxRoseIloveu (big blind) collected ($0.26)
Seat 4: majo_74 folded before Flop (didn't bet)
Seat 5: Armando.Bordi folded on the Flop
Seat 6: MEUZZO folded before Flop (didn't bet)



PokerStars Zoom Hand #229229117539:  Hold'em No Limit ($0.01/$0.02) - 2021/08/21 20:47:03 CET [2021/08/21 14:47:03 ET]
Table 'Halley' 6-max Seat #1 is the button
Seat 1: Scaaalll ($2 in chips) 
Seat 2: 888lifeIS ($2.33 in chips) 
Seat 3: rpycmbEM ($3.88 in chips) 
Seat 4: no way yo ($0.91 in chips) 
Seat 5: pavlo8855 ($2.09 in chips) 
Seat 6: satti1337 ($4.11 in chips) 
888lifeIS: posts small blind $0.01
rpycmbEM: posts big blind $0.02
*** HOLE CARDS ***
Dealt to Scaaalll [3d Kd]
no way yo: folds 
pavlo8855: folds 
satti1337: folds 
Scaaalll: raises $0.02 to $0.04
888lifeIS: folds 
rpycmbEM: folds 
Uncalled bet ($0.02) returned to Scaaalll
Scaaalll collected $0.05 from pot
Scaaalll: doesn't show hand 
*** SUMMARY ***
Total pot $0.05 | Rake $0 
Seat 1: Scaaalll (button) collected ($0.05)
Seat 2: 888lifeIS (small blind) folded before Flop
Seat 3: rpycmbEM (big blind) folded before Flop
Seat 4: no way yo folded before Flop (didn't bet)
Seat 5: pavlo8855 folded before Flop (didn't bet)
Seat 6: satti1337 folded before Flop (didn't bet)



PokerStars Zoom Hand #229229125618:  Hold'em No Limit ($0.01/$0.02) - 2021/08/21 20:47:22 CET [2021/08/21 14:47:22 ET]
Table 'Halley' 6-max Seat #1 is the button
Seat 1: dorro61966 ($2.53 in chips) 
Seat 2: JAQUEPOKER ($2 in chips) 
Seat 3: Fedor_Gar ($2.29 in chips) 
Seat 4: Quantum771 ($2 in chips) 
Seat 5: arseniomarecos ($5.17 in chips) 
Seat 6: Scaaalll ($2.03 in chips) 
JAQUEPOKER: posts small blind $0.01
Fedor_Gar: posts big blind $0.02
*** HOLE CARDS ***
Dealt to Scaaalll [8s 5s]
Quantum771: folds 
arseniomarecos: raises $0.05 to $0.07
Scaaalll: folds 
dorro61966: folds 
JAQUEPOKER: folds 
Fedor_Gar: folds 
Uncalled bet ($0.05) returned to arseniomarecos
arseniomarecos collected $0.05 from pot
arseniomarecos: doesn't show hand 
*** SUMMARY ***
Total pot $0.05 | Rake $0 
Seat 1: dorro61966 (button) folded before Flop (didn't bet)
Seat 2: JAQUEPOKER (small blind) folded before Flop
Seat 3: Fedor_Gar (big blind) folded before Flop
Seat 4: Quantum771 folded before Flop (didn't bet)
Seat 5: arseniomarecos collected ($0.05)
Seat 6: Scaaalll folded before Flop (didn't bet)



PokerStars Zoom Hand #229229130336:  Hold'em No Limit ($0.01/$0.02) - 2021/08/21 20:47:33 CET [2021/08/21 14:47:33 ET]
Table 'Halley' 6-max Seat #1 is the button
Seat 1: majk350 ($1.06 in chips) 
Seat 2: Syd Wright ($1.98 in chips) 
Seat 3: Scaaalll ($2.03 in chips) 
Seat 4: beber_1613 ($2 in chips) 
Seat 5: RodRuenRus ($2.62 in chips) 
Seat 6: so0love ($2.99 in chips) 
Syd Wright: posts small blind $0.01
Scaaalll: posts big blind $0.02
*** HOLE CARDS ***
Dealt to Scaaalll [Qd 9h]
beber_1613: raises $0.04 to $0.06
RodRuenRus: calls $0.06
so0love: folds 
majk350: calls $0.06
Syd Wright: folds 
Scaaalll: folds 
*** FLOP *** [6d 3c Qs]
beber_1613: checks 
RodRuenRus: bets $0.10
majk350: calls $0.10
beber_1613: folds 
*** TURN *** [6d 3c Qs] [2s]
RodRuenRus: bets $0.20
majk350: folds 
Uncalled bet ($0.20) returned to RodRuenRus
RodRuenRus collected $0.40 from pot
RodRuenRus: doesn't show hand 
*** SUMMARY ***
Total pot $0.41 | Rake $0.01 
Board [6d 3c Qs 2s]
Seat 1: majk350 (button) folded on the Turn
Seat 2: Syd Wright (small blind) folded before Flop
Seat 3: Scaaalll (big blind) folded before Flop
Seat 4: beber_1613 folded on the Flop
Seat 5: RodRuenRus collected ($0.40)
Seat 6: so0love folded before Flop (didn't bet)



PokerStars Zoom Hand #229229128184:  Hold'em No Limit ($0.01/$0.02) - 2021/08/21 20:47:28 CET [2021/08/21 14:47:28 ET]
Table 'Halley' 6-max Seat #1 is the button
Seat 1: thiagohbueno ($3.57 in chips) 
Seat 2: aimar20006 ($2.18 in chips) 
Seat 3: mMartie ($1.39 in chips) 
Seat 4: renova0813 ($11.37 in chips) 
Seat 5: Scaaalll ($2.03 in chips) 
Seat 6: Vitalyi1970 ($4.33 in chips) 
aimar20006: posts small blind $0.01
mMartie: posts big blind $0.02
*** HOLE CARDS ***
Dealt to Scaaalll [3d Kh]
renova0813: folds 
Scaaalll: folds 
Vitalyi1970: raises $0.02 to $0.04
thiagohbueno: folds 
aimar20006: folds 
mMartie: calls $0.02
*** FLOP *** [8c 4s 9c]
mMartie: checks 
Vitalyi1970: bets $0.08
mMartie: calls $0.08
*** TURN *** [8c 4s 9c] [Qc]
mMartie: checks 
Vitalyi1970: bets $0.06
mMartie: calls $0.06
*** RIVER *** [8c 4s 9c Qc] [9h]
mMartie: checks 
Vitalyi1970: bets $0.14
mMartie: raises $0.32 to $0.46
Vitalyi1970: calls $0.32
*** SHOW DOWN ***
mMartie: shows [6s 7h] (a pair of Nines)
Vitalyi1970: shows [Ac 9d] (three of a kind, Nines)
Vitalyi1970 collected $1.24 from pot
*** SUMMARY ***
Total pot $1.29 | Rake $0.05 
Board [8c 4s 9c Qc 9h]
Seat 1: thiagohbueno (button) folded before Flop (didn't bet)
Seat 2: aimar20006 (small blind) folded before Flop
Seat 3: mMartie (big blind) showed [6s 7h] and lost with a pair of Nines
Seat 4: renova0813 folded before Flop (didn't bet)
Seat 5: Scaaalll folded before Flop (didn't bet)
Seat 6: Vitalyi1970 showed [Ac 9d] and won ($1.24) with three of a kind, Nines



PokerStars Zoom Hand #229229136134:  Hold'em No Limit ($0.01/$0.02) - 2021/08/21 20:47:47 CET [2021/08/21 14:47:47 ET]
Table 'Halley' 6-max Seat #1 is the button
Seat 1: rassew ($2.04 in chips) 
Seat 2: Scaaalll ($2.01 in chips) 
Seat 3: Mad_Clock ($1.95 in chips) 
Seat 4: rekopo203 ($3.18 in chips) 
Seat 5: agusdecarca ($2 in chips) 
Seat 6: curyurzeda ($2.17 in chips) 
Scaaalll: posts small blind $0.01
Mad_Clock: posts big blind $0.02
*** HOLE CARDS ***
Dealt to Scaaalll [Kd Ah]
rekopo203: folds 
agusdecarca: raises $0.04 to $0.06
curyurzeda: raises $0.04 to $0.10
rassew: folds 
Scaaalll: calls $0.09
Mad_Clock: folds 
agusdecarca: raises $0.20 to $0.30
curyurzeda: folds 
curyurzeda is disconnected 
Scaaalll: calls $0.20
*** FLOP *** [8d 2c Kc]
Scaaalll: checks 
agusdecarca: bets $0.23
Scaaalll: raises $0.37 to $0.60
agusdecarca: calls $0.37
*** TURN *** [8d 2c Kc] [3h]
Scaaalll: bets $1.11 and is all-in
agusdecarca: calls $1.10 and is all-in
Uncalled bet ($0.01) returned to Scaaalll
*** RIVER *** [8d 2c Kc 3h] [6c]
*** SHOW DOWN ***
Scaaalll: shows [Kd Ah] (a pair of Kings)
agusdecarca: shows [Ad Kh] (a pair of Kings)
Scaaalll collected $1.97 from pot
agusdecarca collected $1.99 from pot
*** SUMMARY ***
Total pot $4.12 | Rake $0.16 
Board [8d 2c Kc 3h 6c]
Seat 1: rassew (button) folded before Flop (didn't bet)
Seat 2: Scaaalll (small blind) showed [Kd Ah] and won ($1.97) with a pair of Kings
Seat 3: Mad_Clock (big blind) folded before Flop
Seat 4: rekopo203 folded before Flop (didn't bet)
Seat 5: agusdecarca showed [Ad Kh] and won ($1.99) with a pair of Kings
Seat 6: curyurzeda folded before Flop



PokerStars Zoom Hand #229229173446:  Hold'em No Limit ($0.01/$0.02) - 2021/08/21 20:49:11 CET [2021/08/21 14:49:11 ET]
Table 'Halley' 6-max Seat #1 is the button
Seat 1: Sarmatrus79 ($2 in chips) 
Seat 2: LancerR20 ($2.21 in chips) 
Seat 3: iberieli ($2.19 in chips) 
Seat 4: lyapis75 ($3.98 in chips) 
Seat 5: Quantum771 ($2.07 in chips) 
Seat 6: Scaaalll ($2 in chips) 
LancerR20: posts small blind $0.01
iberieli: posts big blind $0.02
*** HOLE CARDS ***
Dealt to Scaaalll [Td 6d]
lyapis75: folds 
Quantum771: folds 
Scaaalll: folds 
Sarmatrus79: raises $0.04 to $0.06
LancerR20: folds 
iberieli: folds 
Uncalled bet ($0.04) returned to Sarmatrus79
Sarmatrus79 collected $0.05 from pot
Sarmatrus79: doesn't show hand 
*** SUMMARY ***
Total pot $0.05 | Rake $0 
Seat 1: Sarmatrus79 (button) collected ($0.05)
Seat 2: LancerR20 (small blind) folded before Flop
Seat 3: iberieli (big blind) folded before Flop
Seat 4: lyapis75 folded before Flop (didn't bet)
Seat 5: Quantum771 folded before Flop (didn't bet)
Seat 6: Scaaalll folded before Flop (didn't bet)



PokerStars Zoom Hand #229229181576:  Hold'em No Limit ($0.01/$0.02) - 2021/08/21 20:49:22 CET [2021/08/21 14:49:22 ET]
Table 'Halley' 6-max Seat #1 is the button
Seat 1: Scaaalll ($2 in chips) 
Seat 2: rasmas80 ($2.19 in chips) 
Seat 3: Goose Of Poker ($3.40 in chips) 
Seat 4: arsad725 ($8.38 in chips) 
Seat 5: Addon289174 ($1.60 in chips) 
Seat 6: beber_1613 ($2 in chips) 
rasmas80: posts small blind $0.01
Goose Of Poker: posts big blind $0.02
*** HOLE CARDS ***
Dealt to Scaaalll [6s 2d]
arsad725: folds 
Addon289174: folds 
beber_1613: folds 
Scaaalll: folds 
rasmas80: raises $0.06 to $0.08
Goose Of Poker: folds 
Uncalled bet ($0.06) returned to rasmas80
rasmas80 collected $0.04 from pot
rasmas80: doesn't show hand 
*** SUMMARY ***
Total pot $0.04 | Rake $0 
Seat 1: Scaaalll (button) folded before Flop (didn't bet)
Seat 2: rasmas80 (small blind) collected ($0.04)
Seat 3: Goose Of Poker (big blind) folded before Flop
Seat 4: arsad725 folded before Flop (didn't bet)
Seat 5: Addon289174 folded before Flop (didn't bet)
Seat 6: beber_1613 folded before Flop (didn't bet)



PokerStars Zoom Hand #229229187005:  Hold'em No Limit ($0.01/$0.02) - 2021/08/21 20:49:35 CET [2021/08/21 14:49:35 ET]
Table 'Halley' 6-max Seat #1 is the button
Seat 1: timasblemba ($2 in chips) 
Seat 2: gasmar_29 ($2.39 in chips) 
Seat 3: amergedon ($4.66 in chips) 
Seat 4: sorinysu ($0.91 in chips) 
Seat 5: Scaaalll ($2 in chips) 
Seat 6: AligatorsBlood ($2 in chips) 
gasmar_29: posts small blind $0.01
amergedon: posts big blind $0.02
*** HOLE CARDS ***
Dealt to Scaaalll [Qh Ac]
sorinysu: folds 
sorinysu is disconnected 
Scaaalll: raises $0.04 to $0.06
AligatorsBlood: folds 
timasblemba: folds 
gasmar_29: folds 
amergedon: folds 
Uncalled bet ($0.04) returned to Scaaalll
Scaaalll collected $0.05 from pot
Scaaalll: doesn't show hand 
amergedon is disconnected 
*** SUMMARY ***
Total pot $0.05 | Rake $0 
Seat 1: timasblemba (button) folded before Flop (didn't bet)
Seat 2: gasmar_29 (small blind) folded before Flop
Seat 3: amergedon (big blind) folded before Flop
Seat 4: sorinysu folded before Flop (didn't bet)
Seat 5: Scaaalll collected ($0.05)
Seat 6: AligatorsBlood folded before Flop (didn't bet)



PokerStars Zoom Hand #229229194127:  Hold'em No Limit ($0.01/$0.02) - 2021/08/21 20:49:52 CET [2021/08/21 14:49:52 ET]
Table 'Halley' 6-max Seat #1 is the button
Seat 1: ffffj ($1.09 in chips) 
Seat 2: Koldun 2636 ($2.12 in chips) 
Seat 3: Scaaalll ($2.03 in chips) 
Seat 4: 888lifeIS ($2 in chips) 
Seat 5: Akrobat94 ($3.05 in chips) 
Seat 6: jaamonra ($4.58 in chips) 
Koldun 2636: posts small blind $0.01
Scaaalll: posts big blind $0.02
*** HOLE CARDS ***
Dealt to Scaaalll [4c 3s]
888lifeIS: folds 
Akrobat94: calls $0.02
jaamonra: folds 
ffffj: folds 
Koldun 2636: folds 
Scaaalll: checks 
*** FLOP *** [9h 2d 2h]
Scaaalll: checks 
Akrobat94: bets $0.02
Scaaalll: folds 
Uncalled bet ($0.02) returned to Akrobat94
Akrobat94 collected $0.05 from pot
Akrobat94: doesn't show hand 
*** SUMMARY ***
Total pot $0.05 | Rake $0 
Board [9h 2d 2h]
Seat 1: ffffj (button) folded before Flop (didn't bet)
Seat 2: Koldun 2636 (small blind) folded before Flop
Seat 3: Scaaalll (big blind) folded on the Flop
Seat 4: 888lifeIS folded before Flop (didn't bet)
Seat 5: Akrobat94 collected ($0.05)
Seat 6: jaamonra folded before Flop (didn't bet)



PokerStars Zoom Hand #229229192003:  Hold'em No Limit ($0.01/$0.02) - 2021/08/21 20:49:47 CET [2021/08/21 14:49:47 ET]
Table 'Halley' 6-max Seat #1 is the button
Seat 1: arseniomarecos ($5.14 in chips) 
Seat 2: Armando.Bordi ($2.14 in chips) 
Seat 3: michoman987 ($2.02 in chips) 
Seat 4: Scaaalll ($2.03 in chips) 
Seat 5: Denisov V. ($1.99 in chips) 
Seat 6: RodRuenRus ($2.05 in chips) 
Armando.Bordi: posts small blind $0.01
michoman987: posts big blind $0.02
*** HOLE CARDS ***
Dealt to Scaaalll [4c Ts]
Scaaalll: folds 
Denisov V.: folds 
RodRuenRus: folds 
Denisov V. is disconnected 
arseniomarecos: raises $0.05 to $0.07
Armando.Bordi: folds 
michoman987: calls $0.05
*** FLOP *** [6c Ad 8s]
michoman987: checks 
arseniomarecos: bets $0.14
michoman987: raises $0.38 to $0.52
arseniomarecos: calls $0.38
*** TURN *** [6c Ad 8s] [Th]
michoman987: bets $1.43 and is all-in
arseniomarecos: folds 
Uncalled bet ($1.43) returned to michoman987
michoman987 collected $1.15 from pot
michoman987: doesn't show hand 
arseniomarecos is disconnected 
*** SUMMARY ***
Total pot $1.19 | Rake $0.04 
Board [6c Ad 8s Th]
Seat 1: arseniomarecos (button) folded on the Turn
Seat 2: Armando.Bordi (small blind) folded before Flop
Seat 3: michoman987 (big blind) collected ($1.15)
Seat 4: Scaaalll folded before Flop (didn't bet)
Seat 5: Denisov V. folded before Flop (didn't bet)
Seat 6: RodRuenRus folded before Flop (didn't bet)



PokerStars Zoom Hand #229229183232:  Hold'em No Limit ($0.01/$0.02) - 2021/08/21 20:49:26 CET [2021/08/21 14:49:26 ET]
Table 'Halley' 6-max Seat #1 is the button
Seat 1: curyurzeda ($2.26 in chips) 
Seat 2: Ruslan076 ($1.37 in chips) 
Seat 3: rAxt24 ($1.96 in chips) 
Seat 4: Addon289174 ($1.60 in chips) 
Seat 5: Scaaalll ($2 in chips) 
Seat 6: klarskov84 ($1.66 in chips) 
Ruslan076: posts small blind $0.01
rAxt24: posts big blind $0.02
*** HOLE CARDS ***
Dealt to Scaaalll [6d 9d]
Addon289174: folds 
Scaaalll: folds 
klarskov84: folds 
curyurzeda: raises $0.08 to $0.10
Ruslan076: folds 
Ruslan076 is disconnected 
rAxt24: calls $0.08
*** FLOP *** [Jh Ts 4h]
rAxt24: checks 
curyurzeda: bets $0.16
rAxt24: calls $0.16
*** TURN *** [Jh Ts 4h] [Ks]
rAxt24: checks 
curyurzeda: bets $0.14
rAxt24: calls $0.14
*** RIVER *** [Jh Ts 4h Ks] [2d]
rAxt24: checks 
curyurzeda: bets $0.08
rAxt24: raises $1.48 to $1.56 and is all-in
curyurzeda: folds 
Uncalled bet ($1.48) returned to rAxt24
rAxt24 collected $0.94 from pot
rAxt24: doesn't show hand 
curyurzeda is disconnected 
*** SUMMARY ***
Total pot $0.97 | Rake $0.03 
Board [Jh Ts 4h Ks 2d]
Seat 1: curyurzeda (button) folded on the River
Seat 2: Ruslan076 (small blind) folded before Flop
Seat 3: rAxt24 (big blind) collected ($0.94)
Seat 4: Addon289174 folded before Flop (didn't bet)
Seat 5: Scaaalll folded before Flop (didn't bet)
Seat 6: klarskov84 folded before Flop (didn't bet)



PokerStars Zoom Hand #229229204231:  Hold'em No Limit ($0.01/$0.02) - 2021/08/21 20:50:16 CET [2021/08/21 14:50:16 ET]
Table 'Halley' 6-max Seat #1 is the button
Seat 1: Finderra ($3.53 in chips) 
Seat 2: Zhyla95 ($4.08 in chips) 
Seat 3: CaptainPkr X ($2.95 in chips) 
Seat 4: Scaaalll ($2.01 in chips) 
Seat 5: hallowed_0 ($2.35 in chips) 
Seat 6: elcuchu168 ($2 in chips) 
Zhyla95: posts small blind $0.01
CaptainPkr X: posts big blind $0.02
*** HOLE CARDS ***
Dealt to Scaaalll [2s Qd]
Scaaalll: folds 
hallowed_0: folds 
elcuchu168: folds 
Finderra: folds 
Zhyla95: raises $0.03 to $0.05
CaptainPkr X: folds 
Uncalled bet ($0.03) returned to Zhyla95
Zhyla95 collected $0.04 from pot
Zhyla95: doesn't show hand 
*** SUMMARY ***
Total pot $0.04 | Rake $0 
Seat 1: Finderra (button) folded before Flop (didn't bet)
Seat 2: Zhyla95 (small blind) collected ($0.04)
Seat 3: CaptainPkr X (big blind) folded before Flop
Seat 4: Scaaalll folded before Flop (didn't bet)
Seat 5: hallowed_0 folded before Flop (didn't bet)
Seat 6: elcuchu168 folded before Flop (didn't bet)



PokerStars Zoom Hand #229229213856:  Hold'em No Limit ($0.01/$0.02) - 2021/08/21 20:50:39 CET [2021/08/21 14:50:39 ET]
Table 'Halley' 6-max Seat #1 is the button
Seat 1: Scaaalll ($2 in chips) 
Seat 2: sewq55 ($0.98 in chips) 
Seat 3: 365p2eva ($2.96 in chips) 
Seat 4: hi1209 ($2.02 in chips) 
Seat 5: FrssRodriguesr ($1.45 in chips) 
Seat 6: Kb013497 ($1.84 in chips) 
sewq55: posts small blind $0.01
365p2eva: posts big blind $0.02
*** HOLE CARDS ***
Dealt to Scaaalll [6d Ks]
hi1209: folds 
FrssRodriguesr: raises $0.02 to $0.04
Kb013497: folds 
Scaaalll: folds 
sewq55: folds 
365p2eva: folds 
Uncalled bet ($0.02) returned to FrssRodriguesr
FrssRodriguesr collected $0.05 from pot
FrssRodriguesr: doesn't show hand 
*** SUMMARY ***
Total pot $0.05 | Rake $0 
Seat 1: Scaaalll (button) folded before Flop (didn't bet)
Seat 2: sewq55 (small blind) folded before Flop
Seat 3: 365p2eva (big blind) folded before Flop
Seat 4: hi1209 folded before Flop (didn't bet)
Seat 5: FrssRodriguesr collected ($0.05)
Seat 6: Kb013497 folded before Flop (didn't bet)



PokerStars Zoom Hand #229229215608:  Hold'em No Limit ($0.01/$0.02) - 2021/08/21 20:50:43 CET [2021/08/21 14:50:43 ET]
Table 'Halley' 6-max Seat #1 is the button
Seat 1: vps3 ($1.02 in chips) 
Seat 2: so0love ($2.88 in chips) 
Seat 3: BexleyBoy ($5.44 in chips) 
Seat 4: slaweksen ($2 in chips) 
Seat 5: Ketsudan ($2.05 in chips) 
Seat 6: Scaaalll ($2 in chips) 
so0love: posts small blind $0.01
BexleyBoy: posts big blind $0.02
*** HOLE CARDS ***
Dealt to Scaaalll [Qh 7s]
slaweksen: folds 
vps3 is disconnected 
Ketsudan: folds 
Scaaalll: folds 
vps3: folds 
so0love: folds 
Uncalled bet ($0.01) returned to BexleyBoy
BexleyBoy collected $0.02 from pot
BexleyBoy: doesn't show hand 
*** SUMMARY ***
Total pot $0.02 | Rake $0 
Seat 1: vps3 (button) folded before Flop (didn't bet)
Seat 2: so0love (small blind) folded before Flop
Seat 3: BexleyBoy (big blind) collected ($0.02)
Seat 4: slaweksen folded before Flop (didn't bet)
Seat 5: Ketsudan folded before Flop (didn't bet)
Seat 6: Scaaalll folded before Flop (didn't bet)



PokerStars Zoom Hand #229229205883:  Hold'em No Limit ($0.01/$0.02) - 2021/08/21 20:50:20 CET [2021/08/21 14:50:20 ET]
Table 'Halley' 6-max Seat #1 is the button
Seat 1: Pechorin.G ($2 in chips) 
Seat 2: Scaaalll ($2.01 in chips) 
Seat 3: Xdanielo666X ($0.31 in chips) 
Seat 4: Loto70 ($2.42 in chips) 
Seat 5: Xlavariable ($2.04 in chips) 
Seat 6: pavlo8855 ($2 in chips) 
Scaaalll: posts small blind $0.01
Xdanielo666X: posts big blind $0.02
*** HOLE CARDS ***
Dealt to Scaaalll [Kc 9c]
Loto70: folds 
Xlavariable: folds 
pavlo8855: folds 
Pechorin.G: raises $0.03 to $0.05
Scaaalll: folds 
Xdanielo666X: calls $0.03
*** FLOP *** [Qd Kd 4c]
Xdanielo666X: checks 
Pechorin.G: bets $0.06
Xdanielo666X: raises $0.06 to $0.12
Pechorin.G: folds 
Uncalled bet ($0.06) returned to Xdanielo666X
Xdanielo666X collected $0.22 from pot
Xdanielo666X: doesn't show hand 
*** SUMMARY ***
Total pot $0.23 | Rake $0.01 
Board [Qd Kd 4c]
Seat 1: Pechorin.G (button) folded on the Flop
Seat 2: Scaaalll (small blind) folded before Flop
Seat 3: Xdanielo666X (big blind) collected ($0.22)
Seat 4: Loto70 folded before Flop (didn't bet)
Seat 5: Xlavariable folded before Flop (didn't bet)
Seat 6: pavlo8855 folded before Flop (didn't bet)



PokerStars Zoom Hand #229229218952:  Hold'em No Limit ($0.01/$0.02) - 2021/08/21 20:50:51 CET [2021/08/21 14:50:51 ET]
Table 'Halley' 6-max Seat #1 is the button
Seat 1: Mad_Clock ($2.02 in chips) 
Seat 2: Fanatspartak ($1.40 in chips) 
Seat 3: Scaaalll ($2 in chips) 
Seat 4: lyapis75 ($4.89 in chips) 
Seat 5: Hallyson_23 ($2.08 in chips) 
Seat 6: 888lifeIS ($2 in chips) 
Fanatspartak: posts small blind $0.01
Scaaalll: posts big blind $0.02
*** HOLE CARDS ***
Dealt to Scaaalll [8d 7h]
lyapis75: raises $0.03 to $0.05
Hallyson_23: folds 
888lifeIS: folds 
Mad_Clock: folds 
Fanatspartak: folds 
Scaaalll: folds 
Uncalled bet ($0.03) returned to lyapis75
lyapis75 collected $0.05 from pot
lyapis75: doesn't show hand 
*** SUMMARY ***
Total pot $0.05 | Rake $0 
Seat 1: Mad_Clock (button) folded before Flop (didn't bet)
Seat 2: Fanatspartak (small blind) folded before Flop
Seat 3: Scaaalll (big blind) folded before Flop
Seat 4: lyapis75 collected ($0.05)
Seat 5: Hallyson_23 folded before Flop (didn't bet)
Seat 6: 888lifeIS folded before Flop (didn't bet)



PokerStars Zoom Hand #229229225290:  Hold'em No Limit ($0.01/$0.02) - 2021/08/21 20:51:06 CET [2021/08/21 14:51:06 ET]
Table 'Halley' 6-max Seat #1 is the button
Seat 1: Janey44 ($2.51 in chips) 
Seat 2: BlueMoon2050 ($2.75 in chips) 
Seat 3: pavlo8855 ($2.03 in chips) 
Seat 4: Scaaalll ($2 in chips) 
Seat 5: Pogled ($1.98 in chips) 
Seat 6: ffffj ($1.20 in chips) 
BlueMoon2050: posts small blind $0.01
pavlo8855: posts big blind $0.02
*** HOLE CARDS ***
Dealt to Scaaalll [Th 6d]
Scaaalll: folds 
Pogled: folds 
ffffj: folds 
Janey44: calls $0.02
BlueMoon2050: folds 
pavlo8855: checks 
*** FLOP *** [3h As Qd]
pavlo8855: checks 
Janey44: checks 
*** TURN *** [3h As Qd] [3s]
pavlo8855: checks 
Janey44: checks 
*** RIVER *** [3h As Qd 3s] [5h]
pavlo8855: checks 
Janey44: checks 
*** SHOW DOWN ***
pavlo8855: shows [Qs 4c] (two pair, Queens and Threes)
Janey44: shows [8d Ah] (two pair, Aces and Threes)
Janey44 collected $0.05 from pot
*** SUMMARY ***
Total pot $0.05 | Rake $0 
Board [3h As Qd 3s 5h]
Seat 1: Janey44 (button) showed [8d Ah] and won ($0.05) with two pair, Aces and Threes
Seat 2: BlueMoon2050 (small blind) folded before Flop
Seat 3: pavlo8855 (big blind) showed [Qs 4c] and lost with two pair, Queens and Threes
Seat 4: Scaaalll folded before Flop (didn't bet)
Seat 5: Pogled folded before Flop (didn't bet)
Seat 6: ffffj folded before Flop (didn't bet)



PokerStars Zoom Hand #229229217277:  Hold'em No Limit ($0.01/$0.02) - 2021/08/21 20:50:47 CET [2021/08/21 14:50:47 ET]
Table 'Halley' 6-max Seat #1 is the button
Seat 1: CordiPS ($2 in chips) 
Seat 2: BIITRU ($4.52 in chips) 
Seat 3: Finderra ($3.99 in chips) 
Seat 4: Syd Wright ($2.04 in chips) 
Seat 5: Scaaalll ($2 in chips) 
Seat 6: JAQUEPOKER ($2.33 in chips) 
BIITRU: posts small blind $0.01
Finderra: posts big blind $0.02
*** HOLE CARDS ***
Dealt to Scaaalll [Ts 2d]
Syd Wright: folds 
Scaaalll: folds 
JAQUEPOKER: raises $0.04 to $0.06
CordiPS: folds 
BIITRU: folds 
Finderra: calls $0.04
*** FLOP *** [8s 3s 6c]
Finderra: checks 
JAQUEPOKER: checks 
*** TURN *** [8s 3s 6c] [7h]
Finderra: bets $0.10
JAQUEPOKER: folds 
Uncalled bet ($0.10) returned to Finderra
Finderra collected $0.13 from pot
Finderra: doesn't show hand 
*** SUMMARY ***
Total pot $0.13 | Rake $0 
Board [8s 3s 6c 7h]
Seat 1: CordiPS (button) folded before Flop (didn't bet)
Seat 2: BIITRU (small blind) folded before Flop
Seat 3: Finderra (big blind) collected ($0.13)
Seat 4: Syd Wright folded before Flop (didn't bet)
Seat 5: Scaaalll folded before Flop (didn't bet)
Seat 6: JAQUEPOKER folded on the Turn



PokerStars Zoom Hand #229229232896:  Hold'em No Limit ($0.01/$0.02) - 2021/08/21 20:51:24 CET [2021/08/21 14:51:24 ET]
Table 'Halley' 6-max Seat #1 is the button
Seat 1: KIraMan ($2.49 in chips) 
Seat 2: Tony-Broke ($2.12 in chips) 
Seat 3: shingo594 ($2.43 in chips) 
Seat 4: lyapis75 ($2.65 in chips) 
Seat 5: BlueMoon2050 ($0.59 in chips) 
Seat 6: Scaaalll ($2 in chips) 
Tony-Broke: posts small blind $0.01
shingo594: posts big blind $0.02
*** HOLE CARDS ***
Dealt to Scaaalll [8d 6d]
lyapis75: folds 
BlueMoon2050: folds 
Scaaalll: raises $0.04 to $0.06
KIraMan: folds 
shingo594 is disconnected 
Tony-Broke: raises $0.14 to $0.20
shingo594: folds 
Scaaalll: folds 
Uncalled bet ($0.14) returned to Tony-Broke
Tony-Broke collected $0.14 from pot
Tony-Broke: doesn't show hand 
*** SUMMARY ***
Total pot $0.14 | Rake $0 
Seat 1: KIraMan (button) folded before Flop (didn't bet)
Seat 2: Tony-Broke (small blind) collected ($0.14)
Seat 3: shingo594 (big blind) folded before Flop
Seat 4: lyapis75 folded before Flop (didn't bet)
Seat 5: BlueMoon2050 folded before Flop (didn't bet)
Seat 6: Scaaalll folded before Flop



PokerStars Zoom Hand #229229228228:  Hold'em No Limit ($0.01/$0.02) - 2021/08/21 20:51:13 CET [2021/08/21 14:51:13 ET]
Table 'Halley' 6-max Seat #1 is the button
Seat 1: snowy_96 ($2 in chips) 
Seat 2: Scaaalll ($2 in chips) 
Seat 3: derry,me ($3.57 in chips) 
Seat 4: rekopo203 ($3.46 in chips) 
Seat 5: kykareky32 ($2 in chips) 
Seat 6: GorillaMode369 ($2.15 in chips) 
Scaaalll: posts small blind $0.01
derry,me: posts big blind $0.02
*** HOLE CARDS ***
Dealt to Scaaalll [8c 5d]
rekopo203: raises $0.03 to $0.05
kykareky32: folds 
GorillaMode369: folds 
snowy_96: folds 
Scaaalll: folds 
derry,me: calls $0.03
*** FLOP *** [9h 4d 2h]
derry,me: checks 
rekopo203: checks 
*** TURN *** [9h 4d 2h] [Ad]
derry,me: checks 
rekopo203: checks 
*** RIVER *** [9h 4d 2h Ad] [2c]
derry,me: checks 
rekopo203: checks 
*** SHOW DOWN ***
derry,me: shows [Qs 9c] (two pair, Nines and Deuces)
rekopo203: mucks hand 
derry,me collected $0.11 from pot
*** SUMMARY ***
Total pot $0.11 | Rake $0 
Board [9h 4d 2h Ad 2c]
Seat 1: snowy_96 (button) folded before Flop (didn't bet)
Seat 2: Scaaalll (small blind) folded before Flop
Seat 3: derry,me (big blind) showed [Qs 9c] and won ($0.11) with two pair, Nines and Deuces
Seat 4: rekopo203 mucked [Qc Kd]
Seat 5: kykareky32 folded before Flop (didn't bet)
Seat 6: GorillaMode369 folded before Flop (didn't bet)



PokerStars Zoom Hand #229229230772:  Hold'em No Limit ($0.01/$0.02) - 2021/08/21 20:51:19 CET [2021/08/21 14:51:19 ET]
Table 'Halley' 6-max Seat #1 is the button
Seat 1: Scaaalll ($2 in chips) 
Seat 2: rpycmbEM ($3.74 in chips) 
Seat 3: sashok510 ($1.02 in chips) 
Seat 4: cord86 ($2.06 in chips) 
Seat 5: Natali172737 ($4.80 in chips) 
Seat 6: AndreaBsAs ($2.23 in chips) 
rpycmbEM: posts small blind $0.01
sashok510: posts big blind $0.02
*** HOLE CARDS ***
Dealt to Scaaalll [9d Jc]
cord86: folds 
Natali172737: folds 
AndreaBsAs: folds 
Scaaalll: folds 
rpycmbEM: raises $0.02 to $0.04
sashok510: calls $0.02
*** FLOP *** [4c Qs 9c]
rpycmbEM: checks 
sashok510: bets $0.06
rpycmbEM: calls $0.06
*** TURN *** [4c Qs 9c] [Qc]
rpycmbEM: checks 
sashok510: checks 
*** RIVER *** [4c Qs 9c Qc] [5d]
rpycmbEM: bets $0.19
sashok510: folds 
Uncalled bet ($0.19) returned to rpycmbEM
rpycmbEM collected $0.19 from pot
rpycmbEM: doesn't show hand 
*** SUMMARY ***
Total pot $0.20 | Rake $0.01 
Board [4c Qs 9c Qc 5d]
Seat 1: Scaaalll (button) folded before Flop (didn't bet)
Seat 2: rpycmbEM (small blind) collected ($0.19)
Seat 3: sashok510 (big blind) folded on the River
Seat 4: cord86 folded before Flop (didn't bet)
Seat 5: Natali172737 folded before Flop (didn't bet)
Seat 6: AndreaBsAs folded before Flop (didn't bet)



PokerStars Zoom Hand #229229242028:  Hold'em No Limit ($0.01/$0.02) - 2021/08/21 20:51:46 CET [2021/08/21 14:51:46 ET]
Table 'Halley' 6-max Seat #1 is the button
Seat 1: CordiPS ($2 in chips) 
Seat 2: KIraMan ($2.50 in chips) 
Seat 3: Scaaalll ($2 in chips) 
Seat 4: Finkey99 ($2 in chips) 
Seat 5: BOSS1989111 ($0.68 in chips) 
Seat 6: emte1kaa ($2 in chips) 
KIraMan: posts small blind $0.01
Scaaalll: posts big blind $0.02
*** HOLE CARDS ***
Dealt to Scaaalll [Kh 8c]
Finkey99: folds 
BOSS1989111: calls $0.02
emte1kaa: folds 
CordiPS: folds 
KIraMan: folds 
Scaaalll: checks 
*** FLOP *** [9h 7d 6c]
Scaaalll: bets $0.04
BOSS1989111: calls $0.04
*** TURN *** [9h 7d 6c] [6d]
Scaaalll: checks 
BOSS1989111: checks 
*** RIVER *** [9h 7d 6c 6d] [2d]
Scaaalll: checks 
BOSS1989111: checks 
*** SHOW DOWN ***
Scaaalll: shows [Kh 8c] (a pair of Sixes)
BOSS1989111: shows [7s Ad] (two pair, Sevens and Sixes)
BOSS1989111 collected $0.13 from pot
*** SUMMARY ***
Total pot $0.13 | Rake $0 
Board [9h 7d 6c 6d 2d]
Seat 1: CordiPS (button) folded before Flop (didn't bet)
Seat 2: KIraMan (small blind) folded before Flop
Seat 3: Scaaalll (big blind) showed [Kh 8c] and lost with a pair of Sixes
Seat 4: Finkey99 folded before Flop (didn't bet)
Seat 5: BOSS1989111 showed [7s Ad] and won ($0.13) with two pair, Sevens and Sixes
Seat 6: emte1kaa folded before Flop (didn't bet)



PokerStars Zoom Hand #229229257084:  Hold'em No Limit ($0.01/$0.02) - 2021/08/21 20:52:22 CET [2021/08/21 14:52:22 ET]
Table 'Halley' 6-max Seat #1 is the button
Seat 1: maliniak75 ($1.49 in chips) 
Seat 2: sewq55 ($0.81 in chips) 
Seat 3: petit-145 ($2.80 in chips) 
Seat 4: yannikdaehne ($7.38 in chips) 
Seat 5: Scaaalll ($2 in chips) 
Seat 6: Armando.Bordi ($2.11 in chips) 
sewq55: posts small blind $0.01
petit-145: posts big blind $0.02
*** HOLE CARDS ***
Dealt to Scaaalll [Ah 7c]
yannikdaehne: raises $0.03 to $0.05
Scaaalll: folds 
Armando.Bordi: folds 
maliniak75: folds 
sewq55: folds 
petit-145: folds 
Uncalled bet ($0.03) returned to yannikdaehne
yannikdaehne collected $0.05 from pot
yannikdaehne: doesn't show hand 
petit-145 is disconnected 
*** SUMMARY ***
Total pot $0.05 | Rake $0 
Seat 1: maliniak75 (button) folded before Flop (didn't bet)
Seat 2: sewq55 (small blind) folded before Flop
Seat 3: petit-145 (big blind) folded before Flop
Seat 4: yannikdaehne collected ($0.05)
Seat 5: Scaaalll folded before Flop (didn't bet)
Seat 6: Armando.Bordi folded before Flop (didn't bet)



PokerStars Zoom Hand #229229259620:  Hold'em No Limit ($0.01/$0.02) - 2021/08/21 20:52:28 CET [2021/08/21 14:52:28 ET]
Table 'Halley' 6-max Seat #1 is the button
Seat 1: Scaaalll ($2 in chips) 
Seat 2: Armando.Bordi ($2.02 in chips) 
Seat 3: KKARMELO ($2 in chips) 
Seat 4: Finderra ($3.08 in chips) 
Seat 5: Berti281 ($2.27 in chips) 
Seat 6: Fedor_Gar ($3.94 in chips) 
Armando.Bordi: posts small blind $0.01
KKARMELO: posts big blind $0.02
*** HOLE CARDS ***
Dealt to Scaaalll [9c Kc]
Finderra: folds 
Berti281: raises $0.04 to $0.06
Fedor_Gar: folds 
Scaaalll: folds 
Armando.Bordi: folds 
KKARMELO: folds 
Uncalled bet ($0.04) returned to Berti281
Berti281 collected $0.05 from pot
Berti281: doesn't show hand 
*** SUMMARY ***
Total pot $0.05 | Rake $0 
Seat 1: Scaaalll (button) folded before Flop (didn't bet)
Seat 2: Armando.Bordi (small blind) folded before Flop
Seat 3: KKARMELO (big blind) folded before Flop
Seat 4: Finderra folded before Flop (didn't bet)
Seat 5: Berti281 collected ($0.05)
Seat 6: Fedor_Gar folded before Flop (didn't bet)



PokerStars Zoom Hand #229229267115:  Hold'em No Limit ($0.01/$0.02) - 2021/08/21 20:52:46 CET [2021/08/21 14:52:46 ET]
Table 'Halley' 6-max Seat #1 is the button
Seat 1: YPAXAPA555 ($2 in chips) 
Seat 2: z.tank.71 ($1.47 in chips) 
Seat 3: MicroLocoNL ($2 in chips) 
Seat 4: Natali172737 ($3.13 in chips) 
Seat 5: hallowed_0 ($3.84 in chips) 
Seat 6: Scaaalll ($2 in chips) 
z.tank.71: posts small blind $0.01
MicroLocoNL: posts big blind $0.02
*** HOLE CARDS ***
Dealt to Scaaalll [Tc 5s]
Natali172737: folds 
hallowed_0: folds 
Scaaalll: folds 
YPAXAPA555: folds 
z.tank.71: folds 
Uncalled bet ($0.01) returned to MicroLocoNL
MicroLocoNL collected $0.02 from pot
MicroLocoNL: doesn't show hand 
*** SUMMARY ***
Total pot $0.02 | Rake $0 
Seat 1: YPAXAPA555 (button) folded before Flop (didn't bet)
Seat 2: z.tank.71 (small blind) folded before Flop
Seat 3: MicroLocoNL (big blind) collected ($0.02)
Seat 4: Natali172737 folded before Flop (didn't bet)
Seat 5: hallowed_0 folded before Flop (didn't bet)
Seat 6: Scaaalll folded before Flop (didn't bet)



PokerStars Zoom Hand #229229271325:  Hold'em No Limit ($0.01/$0.02) - 2021/08/21 20:52:56 CET [2021/08/21 14:52:56 ET]
Table 'Halley' 6-max Seat #1 is the button
Seat 1: 77omsk ($4.96 in chips) 
Seat 2: Pechorin.G ($2.01 in chips) 
Seat 3: Scaaalll ($2 in chips) 
Seat 4: Slirey ($2.01 in chips) 
Seat 5: PokerKots ($0.10 in chips) 
Seat 6: rassew ($2.06 in chips) 
Pechorin.G: posts small blind $0.01
Scaaalll: posts big blind $0.02
*** HOLE CARDS ***
Dealt to Scaaalll [8s 9d]
Slirey: folds 
Slirey is disconnected 
PokerKots: raises $0.08 to $0.10 and is all-in
rassew: folds 
77omsk: folds 
Pechorin.G: folds 
Scaaalll: folds 
Uncalled bet ($0.08) returned to PokerKots
PokerKots collected $0.05 from pot
PokerKots: doesn't show hand 
*** SUMMARY ***
Total pot $0.05 | Rake $0 
Seat 1: 77omsk (button) folded before Flop (didn't bet)
Seat 2: Pechorin.G (small blind) folded before Flop
Seat 3: Scaaalll (big blind) folded before Flop
Seat 4: Slirey folded before Flop (didn't bet)
Seat 5: PokerKots collected ($0.05)
Seat 6: rassew folded before Flop (didn't bet)



PokerStars Zoom Hand #229229269621:  Hold'em No Limit ($0.01/$0.02) - 2021/08/21 20:52:52 CET [2021/08/21 14:52:52 ET]
Table 'Halley' 6-max Seat #1 is the button
Seat 1: 365p2eva ($2.99 in chips) 
Seat 2: Iv3rson18 ($2.22 in chips) 
Seat 3: johnjohnson11 ($1.77 in chips) 
Seat 4: Scaaalll ($2 in chips) 
Seat 5: sashok510 ($1.32 in chips) 
Seat 6: Runway26 ($2 in chips) 
Iv3rson18: posts small blind $0.01
johnjohnson11: posts big blind $0.02
*** HOLE CARDS ***
Dealt to Scaaalll [3c As]
Scaaalll: folds 
sashok510: raises $0.04 to $0.06
Runway26: folds 
365p2eva: folds 
Iv3rson18: folds 
johnjohnson11: folds 
Uncalled bet ($0.04) returned to sashok510
sashok510 collected $0.05 from pot
sashok510: doesn't show hand 
johnjohnson11 is disconnected 
*** SUMMARY ***
Total pot $0.05 | Rake $0 
Seat 1: 365p2eva (button) folded before Flop (didn't bet)
Seat 2: Iv3rson18 (small blind) folded before Flop
Seat 3: johnjohnson11 (big blind) folded before Flop
Seat 4: Scaaalll folded before Flop (didn't bet)
Seat 5: sashok510 collected ($0.05)
Seat 6: Runway26 folded before Flop (didn't bet)



PokerStars Zoom Hand #229229265041:  Hold'em No Limit ($0.01/$0.02) - 2021/08/21 20:52:41 CET [2021/08/21 14:52:41 ET]
Table 'Halley' 6-max Seat #1 is the button
Seat 1: cacomaz ($1.49 in chips) 
Seat 2: Scaaalll ($2 in chips) 
Seat 3: choli0000 ($0.90 in chips) 
Seat 4: pphit ($2.18 in chips) 
Seat 5: Pechorin.G ($2.09 in chips) 
Seat 6: Hallyson_23 ($2.06 in chips) 
Scaaalll: posts small blind $0.01
choli0000: posts big blind $0.02
*** HOLE CARDS ***
Dealt to Scaaalll [Th 7d]
pphit: folds 
Pechorin.G: folds 
Hallyson_23: folds 
cacomaz: calls $0.02
Scaaalll: folds 
choli0000: checks 
*** FLOP *** [5h 9d Ks]
choli0000: checks 
cacomaz: bets $0.02
choli0000: calls $0.02
*** TURN *** [5h 9d Ks] [9c]
choli0000: checks 
cacomaz: checks 
*** RIVER *** [5h 9d Ks 9c] [Ac]
choli0000: bets $0.02
cacomaz: calls $0.02
*** SHOW DOWN ***
choli0000: shows [6d 6h] (two pair, Nines and Sixes)
cacomaz: shows [Tc Ad] (two pair, Aces and Nines)
cacomaz collected $0.13 from pot
*** SUMMARY ***
Total pot $0.13 | Rake $0 
Board [5h 9d Ks 9c Ac]
Seat 1: cacomaz (button) showed [Tc Ad] and won ($0.13) with two pair, Aces and Nines
Seat 2: Scaaalll (small blind) folded before Flop
Seat 3: choli0000 (big blind) showed [6d 6h] and lost with two pair, Nines and Sixes
Seat 4: pphit folded before Flop (didn't bet)
Seat 5: Pechorin.G folded before Flop (didn't bet)
Seat 6: Hallyson_23 folded before Flop (didn't bet)



PokerStars Zoom Hand #229229255351:  Hold'em No Limit ($0.01/$0.02) - 2021/08/21 20:52:18 CET [2021/08/21 14:52:18 ET]
Table 'Halley' 6-max Seat #1 is the button
Seat 1: the.fire71 ($3.09 in chips) 
Seat 2: Mrkevver97 ($1.98 in chips) 
Seat 3: tsantanapoker ($3.12 in chips) 
Seat 4: MicroLocoNL ($2.02 in chips) 
Seat 5: Scaaalll ($2 in chips) 
Seat 6: kite1966 ($2 in chips) 
Mrkevver97: posts small blind $0.01
tsantanapoker: posts big blind $0.02
*** HOLE CARDS ***
Dealt to Scaaalll [7d 5d]
MicroLocoNL: folds 
Scaaalll: folds 
kite1966: raises $0.03 to $0.05
the.fire71: raises $0.11 to $0.16
tsantanapoker is disconnected 
Mrkevver97: folds 
tsantanapoker has timed out while disconnected
tsantanapoker: folds 
kite1966: folds 
Uncalled bet ($0.11) returned to the.fire71
the.fire71 collected $0.13 from pot
the.fire71: doesn't show hand 
*** SUMMARY ***
Total pot $0.13 | Rake $0 
Seat 1: the.fire71 (button) collected ($0.13)
Seat 2: Mrkevver97 (small blind) folded before Flop
Seat 3: tsantanapoker (big blind) folded before Flop
Seat 4: MicroLocoNL folded before Flop (didn't bet)
Seat 5: Scaaalll folded before Flop (didn't bet)
Seat 6: kite1966 folded before Flop



PokerStars Zoom Hand #229229277229:  Hold'em No Limit ($0.01/$0.02) - 2021/08/21 20:53:10 CET [2021/08/21 14:53:10 ET]
Table 'Halley' 6-max Seat #1 is the button
Seat 1: lelik710905 ($1.18 in chips) 
Seat 2: Scaaalll ($2 in chips) 
Seat 3: MIT_PKR ($3.47 in chips) 
Seat 4: alevniki ($0.81 in chips) 
Seat 5: HellNative ($3.26 in chips) 
Seat 6: NIK1973 23 ($2.04 in chips) 
Scaaalll: posts small blind $0.01
MIT_PKR: posts big blind $0.02
*** HOLE CARDS ***
Dealt to Scaaalll [5h Qc]
lelik710905 is disconnected 
alevniki: folds 
HellNative: folds 
alevniki is disconnected 
NIK1973 23: raises $0.04 to $0.06
lelik710905: folds 
Scaaalll: folds 
MIT_PKR: calls $0.04
*** FLOP *** [2d 3s Qs]
MIT_PKR: checks 
NIK1973 23: bets $0.07
MIT_PKR: folds 
Uncalled bet ($0.07) returned to NIK1973 23
NIK1973 23 collected $0.13 from pot
NIK1973 23: doesn't show hand 
*** SUMMARY ***
Total pot $0.13 | Rake $0 
Board [2d 3s Qs]
Seat 1: lelik710905 (button) folded before Flop (didn't bet)
Seat 2: Scaaalll (small blind) folded before Flop
Seat 3: MIT_PKR (big blind) folded on the Flop
Seat 4: alevniki folded before Flop (didn't bet)
Seat 5: HellNative folded before Flop (didn't bet)
Seat 6: NIK1973 23 collected ($0.13)



PokerStars Zoom Hand #229229275590:  Hold'em No Limit ($0.01/$0.02) - 2021/08/21 20:53:06 CET [2021/08/21 14:53:06 ET]
Table 'Halley' 6-max Seat #1 is the button
Seat 1: Scaaalll ($2 in chips) 
Seat 2: martuska88 ($2 in chips) 
Seat 3: bigthereal ($2.85 in chips) 
Seat 4: rekopo203 ($2.85 in chips) 
Seat 5: kahzura ($2 in chips) 
Seat 6: TESTGOSHI ($1.31 in chips) 
martuska88: posts small blind $0.01
bigthereal: posts big blind $0.02
*** HOLE CARDS ***
Dealt to Scaaalll [8h 9d]
rekopo203: raises $0.03 to $0.05
kahzura: folds 
TESTGOSHI: calls $0.05
Scaaalll: folds 
martuska88: folds 
bigthereal: calls $0.03
*** FLOP *** [4h Kh 5s]
bigthereal: checks 
rekopo203: checks 
TESTGOSHI: bets $0.08
bigthereal: calls $0.08
rekopo203: folds 
*** TURN *** [4h Kh 5s] [Kc]
bigthereal: checks 
TESTGOSHI: checks 
*** RIVER *** [4h Kh 5s Kc] [3s]
bigthereal: bets $0.16
TESTGOSHI: raises $1.02 to $1.18 and is all-in
bigthereal: folds 
Uncalled bet ($1.02) returned to TESTGOSHI
TESTGOSHI collected $0.62 from pot
TESTGOSHI: doesn't show hand 
*** SUMMARY ***
Total pot $0.64 | Rake $0.02 
Board [4h Kh 5s Kc 3s]
Seat 1: Scaaalll (button) folded before Flop (didn't bet)
Seat 2: martuska88 (small blind) folded before Flop
Seat 3: bigthereal (big blind) folded on the River
Seat 4: rekopo203 folded on the Flop
Seat 5: kahzura folded before Flop (didn't bet)
Seat 6: TESTGOSHI collected ($0.62)



PokerStars Zoom Hand #229229281465:  Hold'em No Limit ($0.01/$0.02) - 2021/08/21 20:53:20 CET [2021/08/21 14:53:20 ET]
Table 'Halley' 6-max Seat #1 is the button
Seat 1: Ichverdammt ($0.81 in chips) 
Seat 2: 1000xp ($2 in chips) 
Seat 3: KKARMELO ($2 in chips) 
Seat 4: cvrcak5 ($2.76 in chips) 
Seat 5: Scaaalll ($2 in chips) 
Seat 6: yannikdaehne ($7.41 in chips) 
1000xp: posts small blind $0.01
KKARMELO: posts big blind $0.02
*** HOLE CARDS ***
Dealt to Scaaalll [As Ts]
cvrcak5: raises $0.04 to $0.06
Scaaalll: calls $0.06
yannikdaehne: folds 
Ichverdammt: folds 
1000xp: folds 
KKARMELO: folds 
*** FLOP *** [9h 8s Ks]
cvrcak5: bets $0.10
Scaaalll: calls $0.10
*** TURN *** [9h 8s Ks] [7h]
cvrcak5: bets $0.24
Scaaalll: raises $0.44 to $0.68
cvrcak5: raises $1.92 to $2.60 and is all-in
Scaaalll: calls $1.16 and is all-in
Uncalled bet ($0.76) returned to cvrcak5
*** RIVER *** [9h 8s Ks 7h] [Td]
*** SHOW DOWN ***
cvrcak5: shows [8d 8h] (three of a kind, Eights)
Scaaalll: shows [As Ts] (a pair of Tens)
cvrcak5 cashed out the hand for $2.72 | Cash Out Fee $0.03
*** SUMMARY ***
Total pot $4.03 | Rake $0.14 
Board [9h 8s Ks 7h Td]
Seat 1: Ichverdammt (button) folded before Flop (didn't bet)
Seat 2: 1000xp (small blind) folded before Flop
Seat 3: KKARMELO (big blind) folded before Flop
Seat 4: cvrcak5 showed [8d 8h] and won ($3.89) with three of a kind, Eights (pot not awarded as player cashed out)
Seat 5: Scaaalll showed [As Ts] and lost with a pair of Tens
Seat 6: yannikdaehne folded before Flop (didn't bet)



PokerStars Zoom Hand #229229306086:  Hold'em No Limit ($0.01/$0.02) - 2021/08/21 20:54:19 CET [2021/08/21 14:54:19 ET]
Table 'Halley' 6-max Seat #1 is the button
Seat 1: the.fire71 ($3.16 in chips) 
Seat 2: yositoas ($2.08 in chips) 
Seat 3: arsad725 ($3.98 in chips) 
Seat 4: Scaaalll ($2 in chips) 
Seat 5: Adekvat.ua ($1.35 in chips) 
Seat 6: Iv3rson18 ($2.57 in chips) 
yositoas: posts small blind $0.01
arsad725: posts big blind $0.02
*** HOLE CARDS ***
Dealt to Scaaalll [9d 6d]
Scaaalll: folds 
Adekvat.ua: folds 
Iv3rson18: folds 
the.fire71: raises $0.03 to $0.05
yositoas: folds 
arsad725: folds 
Uncalled bet ($0.03) returned to the.fire71
the.fire71 collected $0.05 from pot
the.fire71: doesn't show hand 
*** SUMMARY ***
Total pot $0.05 | Rake $0 
Seat 1: the.fire71 (button) collected ($0.05)
Seat 2: yositoas (small blind) folded before Flop
Seat 3: arsad725 (big blind) folded before Flop
Seat 4: Scaaalll folded before Flop (didn't bet)
Seat 5: Adekvat.ua folded before Flop (didn't bet)
Seat 6: Iv3rson18 folded before Flop (didn't bet)



PokerStars Zoom Hand #229229307767:  Hold'em No Limit ($0.01/$0.02) - 2021/08/21 20:54:24 CET [2021/08/21 14:54:24 ET]
Table 'Halley' 6-max Seat #1 is the button
Seat 1: KRITAYA ($1.70 in chips) 
Seat 2: CASSIE21462 ($5.98 in chips) 
Seat 3: Scaaalll ($2 in chips) 
Seat 4: PlayPokerHappy1 ($3.24 in chips) 
Seat 5: BDFather ($2.97 in chips) 
Seat 6: johnjohnson11 ($1.85 in chips) 
CASSIE21462: posts small blind $0.01
Scaaalll: posts big blind $0.02
*** HOLE CARDS ***
Dealt to Scaaalll [Tc 8h]
PlayPokerHappy1: folds 
johnjohnson11 is disconnected 
BDFather: folds 
johnjohnson11: folds 
KRITAYA: folds 
CASSIE21462: calls $0.01
Scaaalll: checks 
*** FLOP *** [Qd Kd 6d]
CASSIE21462: checks 
Scaaalll: checks 
*** TURN *** [Qd Kd 6d] [Ts]
CASSIE21462: checks 
Scaaalll: checks 
*** RIVER *** [Qd Kd 6d Ts] [4d]
CASSIE21462: bets $0.04
Scaaalll: folds 
Uncalled bet ($0.04) returned to CASSIE21462
CASSIE21462 collected $0.04 from pot
CASSIE21462: doesn't show hand 
*** SUMMARY ***
Total pot $0.04 | Rake $0 
Board [Qd Kd 6d Ts 4d]
Seat 1: KRITAYA (button) folded before Flop (didn't bet)
Seat 2: CASSIE21462 (small blind) collected ($0.04)
Seat 3: Scaaalll (big blind) folded on the River
Seat 4: PlayPokerHappy1 folded before Flop (didn't bet)
Seat 5: BDFather folded before Flop (didn't bet)
Seat 6: johnjohnson11 folded before Flop (didn't bet)



PokerStars Zoom Hand #229229320683:  Hold'em No Limit ($0.01/$0.02) - 2021/08/21 20:54:54 CET [2021/08/21 14:54:54 ET]
Table 'Halley' 6-max Seat #1 is the button
Seat 1: egroj1700 ($2.05 in chips) 
Seat 2: Scaaalll ($2 in chips) 
Seat 3: apadis ($1 in chips) 
Seat 4: Quantum771 ($2.44 in chips) 
Seat 5: Shoxuzb ($6.57 in chips) 
Seat 6: MicroLocoNL ($2.22 in chips) 
Scaaalll: posts small blind $0.01
apadis: posts big blind $0.02
*** HOLE CARDS ***
Dealt to Scaaalll [8d 2c]
Quantum771: folds 
Shoxuzb: folds 
Shoxuzb is disconnected 
MicroLocoNL: folds 
egroj1700: raises $0.03 to $0.05
Scaaalll: folds 
apadis: folds 
Uncalled bet ($0.03) returned to egroj1700
egroj1700 collected $0.05 from pot
egroj1700: doesn't show hand 
apadis is disconnected 
*** SUMMARY ***
Total pot $0.05 | Rake $0 
Seat 1: egroj1700 (button) collected ($0.05)
Seat 2: Scaaalll (small blind) folded before Flop
Seat 3: apadis (big blind) folded before Flop
Seat 4: Quantum771 folded before Flop (didn't bet)
Seat 5: Shoxuzb folded before Flop (didn't bet)
Seat 6: MicroLocoNL folded before Flop (didn't bet)



PokerStars Zoom Hand #229229304414:  Hold'em No Limit ($0.01/$0.02) - 2021/08/21 20:54:15 CET [2021/08/21 14:54:15 ET]
Table 'Halley' 6-max Seat #1 is the button
Seat 1: cvrcak5 ($3.48 in chips) 
Seat 2: vindoffree ($1.72 in chips) 
Seat 3: Ne0net ($2.37 in chips) 
Seat 4: vovo4kapooh ($2.10 in chips) 
Seat 5: YPAXAPA555 ($2.07 in chips) 
Seat 6: Scaaalll ($2 in chips) 
vindoffree: posts small blind $0.01
Ne0net: posts big blind $0.02
*** HOLE CARDS ***
Dealt to Scaaalll [6d 8s]
vovo4kapooh: raises $0.04 to $0.06
YPAXAPA555: calls $0.06
Scaaalll: folds 
cvrcak5: calls $0.06
vindoffree: folds 
Ne0net: folds 
*** FLOP *** [Js 8c Th]
vovo4kapooh: bets $0.09
YPAXAPA555: calls $0.09
cvrcak5: calls $0.09
*** TURN *** [Js 8c Th] [Jc]
vovo4kapooh: checks 
YPAXAPA555: bets $0.30
cvrcak5: calls $0.30
vovo4kapooh: folds 
*** RIVER *** [Js 8c Th Jc] [8d]
YPAXAPA555: bets $0.74
cvrcak5: calls $0.74
*** SHOW DOWN ***
YPAXAPA555: shows [Jh Qh] (a full house, Jacks full of Eights)
cvrcak5: shows [Jd 9d] (a full house, Jacks full of Eights)
YPAXAPA555 collected $1.24 from pot
cvrcak5 collected $1.23 from pot
*** SUMMARY ***
Total pot $2.56 | Rake $0.09 
Board [Js 8c Th Jc 8d]
Seat 1: cvrcak5 (button) showed [Jd 9d] and won ($1.23) with a full house, Jacks full of Eights
Seat 2: vindoffree (small blind) folded before Flop
Seat 3: Ne0net (big blind) folded before Flop
Seat 4: vovo4kapooh folded on the Turn
Seat 5: YPAXAPA555 showed [Jh Qh] and won ($1.24) with a full house, Jacks full of Eights
Seat 6: Scaaalll folded before Flop (didn't bet)



PokerStars Zoom Hand #229229322718:  Hold'em No Limit ($0.01/$0.02) - 2021/08/21 20:54:59 CET [2021/08/21 14:54:59 ET]
Table 'Halley' 6-max Seat #1 is the button
Seat 1: Scaaalll ($2 in chips) 
Seat 2: JAQUEPOKER ($2.45 in chips) 
Seat 3: zairyoku ($2.15 in chips) 
Seat 4: alecha11 ($2 in chips) 
Seat 5: bt710 ($2.06 in chips) 
Seat 6: delaemdelo ($5.54 in chips) 
JAQUEPOKER: posts small blind $0.01
zairyoku: posts big blind $0.02
*** HOLE CARDS ***
Dealt to Scaaalll [3c 5c]
delaemdelo is disconnected 
alecha11: folds 
bt710: folds 
delaemdelo: folds 
Scaaalll: raises $0.02 to $0.04
JAQUEPOKER: folds 
zairyoku: calls $0.02
*** FLOP *** [2c 3s 9c]
zairyoku: checks 
Scaaalll: bets $0.06
zairyoku: folds 
Uncalled bet ($0.06) returned to Scaaalll
Scaaalll collected $0.09 from pot
Scaaalll: doesn't show hand 
*** SUMMARY ***
Total pot $0.09 | Rake $0 
Board [2c 3s 9c]
Seat 1: Scaaalll (button) collected ($0.09)
Seat 2: JAQUEPOKER (small blind) folded before Flop
Seat 3: zairyoku (big blind) folded on the Flop
Seat 4: alecha11 folded before Flop (didn't bet)
Seat 5: bt710 folded before Flop (didn't bet)
Seat 6: delaemdelo folded before Flop (didn't bet)



PokerStars Zoom Hand #229229333399:  Hold'em No Limit ($0.01/$0.02) - 2021/08/21 20:55:34 CET [2021/08/21 14:55:34 ET]
Table 'Halley' 6-max Seat #1 is the button
Seat 1: S.B.O190 ($2.48 in chips) 
Seat 2: cvrcak5 ($3.50 in chips) 
Seat 3: Sul07 ($1.39 in chips) 
Seat 4: mMartie ($0.85 in chips) 
Seat 5: 1000xp ($2.06 in chips) 
Seat 6: Scaaalll ($2.05 in chips) 
cvrcak5: posts small blind $0.01
Sul07: posts big blind $0.02
*** HOLE CARDS ***
Dealt to Scaaalll [Qc 9h]
mMartie: folds 
1000xp: folds 
Scaaalll: raises $0.04 to $0.06
S.B.O190: raises $0.12 to $0.18
cvrcak5: folds 
Sul07: folds 
Scaaalll: folds 
Uncalled bet ($0.12) returned to S.B.O190
S.B.O190 collected $0.15 from pot
S.B.O190: doesn't show hand 
*** SUMMARY ***
Total pot $0.15 | Rake $0 
Seat 1: S.B.O190 (button) collected ($0.15)
Seat 2: cvrcak5 (small blind) folded before Flop
Seat 3: Sul07 (big blind) folded before Flop
Seat 4: mMartie folded before Flop (didn't bet)
Seat 5: 1000xp folded before Flop (didn't bet)
Seat 6: Scaaalll folded before Flop



PokerStars Zoom Hand #229229338919:  Hold'em No Limit ($0.01/$0.02) - 2021/08/21 20:55:53 CET [2021/08/21 14:55:53 ET]
Table 'Halley' 6-max Seat #1 is the button
Seat 1: S.B.O190 ($2.92 in chips) 
Seat 2: roland11131 ($2.96 in chips) 
Seat 3: TESTGOSHI ($1.81 in chips) 
Seat 4: QuieroPollo84 ($2.65 in chips) 
Seat 5: Scaaalll ($2 in chips) 
Seat 6: Berti281 ($2 in chips) 
roland11131: posts small blind $0.01
TESTGOSHI: posts big blind $0.02
*** HOLE CARDS ***
Dealt to Scaaalll [8s Kd]
QuieroPollo84: folds 
Scaaalll: folds 
Berti281: folds 
S.B.O190: folds 
roland11131: raises $0.03 to $0.05
TESTGOSHI: calls $0.03
*** FLOP *** [Ts 3c Qh]
roland11131: checks 
TESTGOSHI: checks 
*** TURN *** [Ts 3c Qh] [8h]
roland11131: checks 
TESTGOSHI: checks 
*** RIVER *** [Ts 3c Qh 8h] [3d]
roland11131: checks 
TESTGOSHI: checks 
*** SHOW DOWN ***
roland11131: shows [8d 7s] (two pair, Eights and Threes)
TESTGOSHI: mucks hand 
roland11131 collected $0.10 from pot
*** SUMMARY ***
Total pot $0.10 | Rake $0 
Board [Ts 3c Qh 8h 3d]
Seat 1: S.B.O190 (button) folded before Flop (didn't bet)
Seat 2: roland11131 (small blind) showed [8d 7s] and won ($0.10) with two pair, Eights and Threes
Seat 3: TESTGOSHI (big blind) mucked [6d 6s]
Seat 4: QuieroPollo84 folded before Flop (didn't bet)
Seat 5: Scaaalll folded before Flop (didn't bet)
Seat 6: Berti281 folded before Flop (didn't bet)



PokerStars Zoom Hand #229229347822:  Hold'em No Limit ($0.01/$0.02) - 2021/08/21 20:56:23 CET [2021/08/21 14:56:23 ET]
Table 'Halley' 6-max Seat #1 is the button
Seat 1: ash1448 ($3.44 in chips) 
Seat 2: Alex Koshva1 ($1.61 in chips) 
Seat 3: Zazill ($2.40 in chips) 
Seat 4: Scaaalll ($2 in chips) 
Seat 5: zeus11983 ($2.08 in chips) 
Seat 6: derry,me ($3.45 in chips) 
Alex Koshva1: posts small blind $0.01
Zazill: posts big blind $0.02
*** HOLE CARDS ***
Dealt to Scaaalll [Kc 6h]
Scaaalll: folds 
zeus11983: raises $0.03 to $0.05
derry,me: folds 
derry,me is disconnected 
ash1448: folds 
Alex Koshva1: folds 
Zazill: folds 
Uncalled bet ($0.03) returned to zeus11983
zeus11983 collected $0.05 from pot
zeus11983: doesn't show hand 
*** SUMMARY ***
Total pot $0.05 | Rake $0 
Seat 1: ash1448 (button) folded before Flop (didn't bet)
Seat 2: Alex Koshva1 (small blind) folded before Flop
Seat 3: Zazill (big blind) folded before Flop
Seat 4: Scaaalll folded before Flop (didn't bet)
Seat 5: zeus11983 collected ($0.05)
Seat 6: derry,me folded before Flop (didn't bet)



PokerStars Zoom Hand #229229340682:  Hold'em No Limit ($0.01/$0.02) - 2021/08/21 20:56:00 CET [2021/08/21 14:56:00 ET]
Table 'Halley' 6-max Seat #1 is the button
Seat 1: cruisinjack ($4.39 in chips) 
Seat 2: kykareky32 ($2.01 in chips) 
Seat 3: majo_74 ($2.11 in chips) 
Seat 4: Scaaalll ($2 in chips) 
Seat 5: Dominykas ($2.60 in chips) 
Seat 6: KoAlRy ($2 in chips) 
kykareky32: posts small blind $0.01
majo_74: posts big blind $0.02
*** HOLE CARDS ***
Dealt to Scaaalll [7c 5c]
Scaaalll: folds 
Dominykas: folds 
KoAlRy: raises $0.03 to $0.05
cruisinjack: calls $0.05
kykareky32: calls $0.04
majo_74: folds 
*** FLOP *** [Qh 3c 9h]
kykareky32: checks 
KoAlRy: checks 
cruisinjack: checks 
*** TURN *** [Qh 3c 9h] [5h]
kykareky32: checks 
KoAlRy: checks 
cruisinjack: checks 
*** RIVER *** [Qh 3c 9h 5h] [8s]
kykareky32: bets $0.08
KoAlRy: folds 
cruisinjack: folds 
Uncalled bet ($0.08) returned to kykareky32
kykareky32 collected $0.16 from pot
kykareky32: doesn't show hand 
*** SUMMARY ***
Total pot $0.17 | Rake $0.01 
Board [Qh 3c 9h 5h 8s]
Seat 1: cruisinjack (button) folded on the River
Seat 2: kykareky32 (small blind) collected ($0.16)
Seat 3: majo_74 (big blind) folded before Flop
Seat 4: Scaaalll folded before Flop (didn't bet)
Seat 5: Dominykas folded before Flop (didn't bet)
Seat 6: KoAlRy folded on the River



PokerStars Zoom Hand #229229350538:  Hold'em No Limit ($0.01/$0.02) - 2021/08/21 20:56:28 CET [2021/08/21 14:56:28 ET]
Table 'Halley' 6-max Seat #1 is the button
Seat 1: Scaaalll ($2 in chips) 
Seat 2: MicroLocoNL ($2.39 in chips) 
Seat 3: tballin ($2.93 in chips) 
Seat 4: pavlo8855 ($2.03 in chips) 
Seat 5: SaRCh_Ale ($2.08 in chips) 
Seat 6: Pechorin.G ($2.13 in chips) 
MicroLocoNL: posts small blind $0.01
tballin: posts big blind $0.02
*** HOLE CARDS ***
Dealt to Scaaalll [Tc 5h]
pavlo8855: folds 
SaRCh_Ale: folds 
Pechorin.G: folds 
Scaaalll: folds 
MicroLocoNL: raises $0.04 to $0.06
tballin: calls $0.04
*** FLOP *** [4c 8h 4h]
MicroLocoNL: bets $0.10
tballin: folds 
Uncalled bet ($0.10) returned to MicroLocoNL
MicroLocoNL collected $0.12 from pot
MicroLocoNL: doesn't show hand 
tballin is disconnected 
*** SUMMARY ***
Total pot $0.12 | Rake $0 
Board [4c 8h 4h]
Seat 1: Scaaalll (button) folded before Flop (didn't bet)
Seat 2: MicroLocoNL (small blind) collected ($0.12)
Seat 3: tballin (big blind) folded on the Flop
Seat 4: pavlo8855 folded before Flop (didn't bet)
Seat 5: SaRCh_Ale folded before Flop (didn't bet)
Seat 6: Pechorin.G folded before Flop (didn't bet)



PokerStars Zoom Hand #229229356193:  Hold'em No Limit ($0.01/$0.02) - 2021/08/21 20:56:48 CET [2021/08/21 14:56:48 ET]
Table 'Halley' 6-max Seat #1 is the button
Seat 1: martuska88 ($2.07 in chips) 
Seat 2: AndreaBsAs ($2 in chips) 
Seat 3: choli0000 ($0.98 in chips) 
Seat 4: YPAXAPA555 ($2.82 in chips) 
Seat 5: estelionat171 ($1.13 in chips) 
Seat 6: Scaaalll ($2 in chips) 
AndreaBsAs: posts small blind $0.01
choli0000: posts big blind $0.02
*** HOLE CARDS ***
Dealt to Scaaalll [Tc 6c]
YPAXAPA555: folds 
estelionat171: folds 
Scaaalll: folds 
martuska88: folds 
AndreaBsAs: raises $0.06 to $0.08
choli0000: folds 
Uncalled bet ($0.06) returned to AndreaBsAs
AndreaBsAs collected $0.04 from pot
AndreaBsAs: doesn't show hand 
*** SUMMARY ***
Total pot $0.04 | Rake $0 
Seat 1: martuska88 (button) folded before Flop (didn't bet)
Seat 2: AndreaBsAs (small blind) collected ($0.04)
Seat 3: choli0000 (big blind) folded before Flop
Seat 4: YPAXAPA555 folded before Flop (didn't bet)
Seat 5: estelionat171 folded before Flop (didn't bet)
Seat 6: Scaaalll folded before Flop (didn't bet)



PokerStars Zoom Hand #229229342127:  Hold'em No Limit ($0.01/$0.02) - 2021/08/21 20:56:04 CET [2021/08/21 14:56:04 ET]
Table 'Halley' 6-max Seat #1 is the button
Seat 1: PlayPokerHappy1 ($4.61 in chips) 
Seat 2: Victor151886 ($3.11 in chips) 
Seat 3: Scaaalll ($2 in chips) 
Seat 4: Fanatspartak ($2.09 in chips) 
Seat 5: ARTMVSLV ($2 in chips) 
Seat 6: rassew ($2.15 in chips) 
Victor151886: posts small blind $0.01
Scaaalll: posts big blind $0.02
*** HOLE CARDS ***
Dealt to Scaaalll [Js 8d]
Fanatspartak: folds 
ARTMVSLV: folds 
rassew: folds 
PlayPokerHappy1: raises $0.04 to $0.06
Victor151886: calls $0.05
Scaaalll: folds 
*** FLOP *** [Ks 6c 2s]
Victor151886: checks 
PlayPokerHappy1: bets $0.09
Victor151886: calls $0.09
*** TURN *** [Ks 6c 2s] [5h]
Victor151886: checks 
PlayPokerHappy1: checks 
*** RIVER *** [Ks 6c 2s 5h] [Qh]
Victor151886: bets $0.16
PlayPokerHappy1: folds 
Uncalled bet ($0.16) returned to Victor151886
Victor151886 collected $0.31 from pot
Victor151886: doesn't show hand 
*** SUMMARY ***
Total pot $0.32 | Rake $0.01 
Board [Ks 6c 2s 5h Qh]
Seat 1: PlayPokerHappy1 (button) folded on the River
Seat 2: Victor151886 (small blind) collected ($0.31)
Seat 3: Scaaalll (big blind) folded before Flop
Seat 4: Fanatspartak folded before Flop (didn't bet)
Seat 5: ARTMVSLV folded before Flop (didn't bet)
Seat 6: rassew folded before Flop (didn't bet)



PokerStars Zoom Hand #229229353179:  Hold'em No Limit ($0.01/$0.02) - 2021/08/21 20:56:37 CET [2021/08/21 14:56:37 ET]
Table 'Halley' 6-max Seat #1 is the button
Seat 1: the.fire71 ($2.88 in chips) 
Seat 2: Scaaalll ($2 in chips) 
Seat 3: flexitunes ($1.38 in chips) 
Seat 4: Xlavariable ($2.07 in chips) 
Seat 5: WithMyWalker ($2.32 in chips) 
Seat 6: XHerrTUMNUSX ($6.95 in chips) 
Scaaalll: posts small blind $0.01
flexitunes: posts big blind $0.02
*** HOLE CARDS ***
Dealt to Scaaalll [8s Ac]
Xlavariable: raises $0.04 to $0.06
WithMyWalker: folds 
XHerrTUMNUSX: folds 
the.fire71: folds 
Scaaalll: folds 
flexitunes: calls $0.04
*** FLOP *** [Kd 2c 5h]
flexitunes: checks 
Xlavariable: bets $0.07
flexitunes: calls $0.07
*** TURN *** [Kd 2c 5h] [4h]
flexitunes: checks 
Xlavariable: bets $0.20
flexitunes: calls $0.20
*** RIVER *** [Kd 2c 5h 4h] [5s]
flexitunes: bets $0.20
Xlavariable: calls $0.20
*** SHOW DOWN ***
flexitunes: shows [8c Ah] (a pair of Fives)
Xlavariable: shows [Kh As] (two pair, Kings and Fives)
Xlavariable collected $1.03 from pot
*** SUMMARY ***
Total pot $1.07 | Rake $0.04 
Board [Kd 2c 5h 4h 5s]
Seat 1: the.fire71 (button) folded before Flop (didn't bet)
Seat 2: Scaaalll (small blind) folded before Flop
Seat 3: flexitunes (big blind) showed [8c Ah] and lost with a pair of Fives
Seat 4: Xlavariable showed [Kh As] and won ($1.03) with two pair, Kings and Fives
Seat 5: WithMyWalker folded before Flop (didn't bet)
Seat 6: XHerrTUMNUSX folded before Flop (didn't bet)



PokerStars Zoom Hand #229229359059:  Hold'em No Limit ($0.01/$0.02) - 2021/08/21 20:56:57 CET [2021/08/21 14:56:57 ET]
Table 'Halley' 6-max Seat #1 is the button
Seat 1: PlayPokerHappy1 ($3.84 in chips) 
Seat 2: BossTH4 ($2.01 in chips) 
Seat 3: estelionat171 ($0.96 in chips) 
Seat 4: zeus11983 ($2.06 in chips) 
Seat 5: Scaaalll ($2 in chips) 
Seat 6: Red Sky 15 ($2.73 in chips) 
BossTH4: posts small blind $0.01
estelionat171: posts big blind $0.02
*** HOLE CARDS ***
Dealt to Scaaalll [Jh 8h]
zeus11983: folds 
Scaaalll: folds 
Red Sky 15: raises $0.04 to $0.06
PlayPokerHappy1: folds 
BossTH4: folds 
estelionat171: folds 
Uncalled bet ($0.04) returned to Red Sky 15
Red Sky 15 collected $0.05 from pot
Red Sky 15: doesn't show hand 
*** SUMMARY ***
Total pot $0.05 | Rake $0 
Seat 1: PlayPokerHappy1 (button) folded before Flop (didn't bet)
Seat 2: BossTH4 (small blind) folded before Flop
Seat 3: estelionat171 (big blind) folded before Flop
Seat 4: zeus11983 folded before Flop (didn't bet)
Seat 5: Scaaalll folded before Flop (didn't bet)
Seat 6: Red Sky 15 collected ($0.05)



PokerStars Zoom Hand #229229363393:  Hold'em No Limit ($0.01/$0.02) - 2021/08/21 20:57:12 CET [2021/08/21 14:57:12 ET]
Table 'Halley' 6-max Seat #1 is the button
Seat 1: Gyapszi958 ($1.94 in chips) 
Seat 2: Stepanovap52 ($5.26 in chips) 
Seat 3: Scaaalll ($2 in chips) 
Seat 4: CréééW!!! ($1 in chips) 
Seat 5: so0love ($3.54 in chips) 
Seat 6: Taallt ($2.94 in chips) 
Stepanovap52: posts small blind $0.01
Scaaalll: posts big blind $0.02
*** HOLE CARDS ***
Dealt to Scaaalll [Tc 4s]
CréééW!!!: folds 
so0love: folds 
Taallt: raises $0.03 to $0.05
Gyapszi958: folds 
Stepanovap52: folds 
Scaaalll: folds 
Uncalled bet ($0.03) returned to Taallt
Taallt collected $0.05 from pot
Taallt: doesn't show hand 
*** SUMMARY ***
Total pot $0.05 | Rake $0 
Seat 1: Gyapszi958 (button) folded before Flop (didn't bet)
Seat 2: Stepanovap52 (small blind) folded before Flop
Seat 3: Scaaalll (big blind) folded before Flop
Seat 4: CréééW!!! folded before Flop (didn't bet)
Seat 5: so0love folded before Flop (didn't bet)
Seat 6: Taallt collected ($0.05)



PokerStars Zoom Hand #229229370226:  Hold'em No Limit ($0.01/$0.02) - 2021/08/21 20:57:35 CET [2021/08/21 14:57:35 ET]
Table 'Halley' 6-max Seat #1 is the button
Seat 1: Scaaalll ($2 in chips) 
Seat 2: SpartanRace1 ($9.41 in chips) 
Seat 3: borges692 ($2.01 in chips) 
Seat 4: amergedon ($2.05 in chips) 
Seat 5: Munavili ($4.37 in chips) 
Seat 6: alevniki ($1.90 in chips) 
SpartanRace1: posts small blind $0.01
borges692: posts big blind $0.02
*** HOLE CARDS ***
Dealt to Scaaalll [2s As]
amergedon: folds 
Munavili: folds 
amergedon is disconnected 
alevniki: folds 
alevniki is disconnected 
Scaaalll: raises $0.02 to $0.04
SpartanRace1: folds 
borges692: raises $0.10 to $0.14
Scaaalll: folds 
Uncalled bet ($0.10) returned to borges692
borges692 collected $0.09 from pot
borges692: doesn't show hand 
*** SUMMARY ***
Total pot $0.09 | Rake $0 
Seat 1: Scaaalll (button) folded before Flop
Seat 2: SpartanRace1 (small blind) folded before Flop
Seat 3: borges692 (big blind) collected ($0.09)
Seat 4: amergedon folded before Flop (didn't bet)
Seat 5: Munavili folded before Flop (didn't bet)
Seat 6: alevniki folded before Flop (didn't bet)



PokerStars Zoom Hand #229229362002:  Hold'em No Limit ($0.01/$0.02) - 2021/08/21 20:57:07 CET [2021/08/21 14:57:07 ET]
Table 'Halley' 6-max Seat #1 is the button
Seat 1: SaRCh_Ale ($2 in chips) 
Seat 2: cruisinjack ($1.71 in chips) 
Seat 3: Ne0net ($2.09 in chips) 
Seat 4: Scaaalll ($2 in chips) 
Seat 5: pphit ($2.07 in chips) 
Seat 6: sewq55 ($1.42 in chips) 
cruisinjack: posts small blind $0.01
Ne0net: posts big blind $0.02
*** HOLE CARDS ***
Dealt to Scaaalll [7c Tc]
Scaaalll: folds 
pphit: raises $0.03 to $0.05
sewq55: calls $0.05
SaRCh_Ale: folds 
cruisinjack: folds 
Ne0net: folds 
*** FLOP *** [Ad 2h Js]
pphit: bets $0.05
sewq55: calls $0.05
*** TURN *** [Ad 2h Js] [8h]
pphit: checks 
sewq55: bets $0.06
pphit: folds 
Uncalled bet ($0.06) returned to sewq55
sewq55 collected $0.22 from pot
sewq55: doesn't show hand 
*** SUMMARY ***
Total pot $0.23 | Rake $0.01 
Board [Ad 2h Js 8h]
Seat 1: SaRCh_Ale (button) folded before Flop (didn't bet)
Seat 2: cruisinjack (small blind) folded before Flop
Seat 3: Ne0net (big blind) folded before Flop
Seat 4: Scaaalll folded before Flop (didn't bet)
Seat 5: pphit folded on the Turn
Seat 6: sewq55 collected ($0.22)



PokerStars Zoom Hand #229229376437:  Hold'em No Limit ($0.01/$0.02) - 2021/08/21 20:57:56 CET [2021/08/21 14:57:56 ET]
Table 'Halley' 6-max Seat #1 is the button
Seat 1: arsad725 ($4.02 in chips) 
Seat 2: estelionat171 ($1.08 in chips) 
Seat 3: Zazill ($3.89 in chips) 
Seat 4: KRITAYA ($0.96 in chips) 
Seat 5: Scaaalll ($2 in chips) 
Seat 6: kahzura ($2.01 in chips) 
estelionat171: posts small blind $0.01
Zazill: posts big blind $0.02
*** HOLE CARDS ***
Dealt to Scaaalll [Jh Qh]
KRITAYA: folds 
Scaaalll: raises $0.04 to $0.06
kahzura: folds 
arsad725: folds 
estelionat171: folds 
Zazill: calls $0.04
*** FLOP *** [Qs 3s 3d]
Zazill: checks 
Scaaalll: bets $0.08
Zazill: folds 
Uncalled bet ($0.08) returned to Scaaalll
Scaaalll collected $0.13 from pot
Scaaalll: doesn't show hand 
*** SUMMARY ***
Total pot $0.13 | Rake $0 
Board [Qs 3s 3d]
Seat 1: arsad725 (button) folded before Flop (didn't bet)
Seat 2: estelionat171 (small blind) folded before Flop
Seat 3: Zazill (big blind) folded on the Flop
Seat 4: KRITAYA folded before Flop (didn't bet)
Seat 5: Scaaalll collected ($0.13)
Seat 6: kahzura folded before Flop (didn't bet)



PokerStars Zoom Hand #229229367266:  Hold'em No Limit ($0.01/$0.02) - 2021/08/21 20:57:25 CET [2021/08/21 14:57:25 ET]
Table 'Halley' 6-max Seat #1 is the button
Seat 1: JAQUEPOKER ($2.50 in chips) 
Seat 2: Scaaalll ($2 in chips) 
Seat 3: ckooistra36 ($1 in chips) 
Seat 4: PlayPokerHappy1 ($2.20 in chips) 
Seat 5: Laonikos ($2 in chips) 
Seat 6: Tj741 ($2.74 in chips) 
Scaaalll: posts small blind $0.01
ckooistra36: posts big blind $0.02
*** HOLE CARDS ***
Dealt to Scaaalll [7c 4s]
PlayPokerHappy1: folds 
Laonikos: raises $0.03 to $0.05
Tj741: folds 
JAQUEPOKER: folds 
Scaaalll: folds 
ckooistra36: calls $0.03
*** FLOP *** [3d 8s 9c]
ckooistra36: bets $0.06
Laonikos: raises $0.12 to $0.18
ckooistra36: calls $0.12
*** TURN *** [3d 8s 9c] [Qc]
ckooistra36: bets $0.08
Laonikos: calls $0.08
*** RIVER *** [3d 8s 9c Qc] [Th]
ckooistra36: bets $0.31
Laonikos: raises $0.90 to $1.21
ckooistra36: calls $0.38 and is all-in
Uncalled bet ($0.52) returned to Laonikos
*** SHOW DOWN ***
Laonikos: shows [Qd Jc] (a straight, Eight to Queen)
ckooistra36: shows [Jh 8c] (a straight, Eight to Queen)
ckooistra36 collected $0.97 from pot
Laonikos collected $0.97 from pot
*** SUMMARY ***
Total pot $2.01 | Rake $0.07 
Board [3d 8s 9c Qc Th]
Seat 1: JAQUEPOKER (button) folded before Flop (didn't bet)
Seat 2: Scaaalll (small blind) folded before Flop
Seat 3: ckooistra36 (big blind) showed [Jh 8c] and won ($0.97) with a straight, Eight to Queen
Seat 4: PlayPokerHappy1 folded before Flop (didn't bet)
Seat 5: Laonikos showed [Qd Jc] and won ($0.97) with a straight, Eight to Queen
Seat 6: Tj741 folded before Flop (didn't bet)



PokerStars Zoom Hand #229229388051:  Hold'em No Limit ($0.01/$0.02) - 2021/08/21 20:58:35 CET [2021/08/21 14:58:35 ET]
Table 'Halley' 6-max Seat #1 is the button
Seat 1: Syd Wright ($2.03 in chips) 
Seat 2: cord86 ($2 in chips) 
Seat 3: Scaaalll ($2.07 in chips) 
Seat 4: fishh_play ($2 in chips) 
Seat 5: *88VIC88* ($2.30 in chips) 
Seat 6: iPitbull1 ($2.88 in chips) 
cord86: posts small blind $0.01
Scaaalll: posts big blind $0.02
*** HOLE CARDS ***
Dealt to Scaaalll [7h 9d]
fishh_play: folds 
*88VIC88*: folds 
iPitbull1: raises $0.04 to $0.06
Syd Wright: folds 
cord86: folds 
Scaaalll: folds 
Uncalled bet ($0.04) returned to iPitbull1
iPitbull1 collected $0.05 from pot
iPitbull1: doesn't show hand 
*** SUMMARY ***
Total pot $0.05 | Rake $0 
Seat 1: Syd Wright (button) folded before Flop (didn't bet)
Seat 2: cord86 (small blind) folded before Flop
Seat 3: Scaaalll (big blind) folded before Flop
Seat 4: fishh_play folded before Flop (didn't bet)
Seat 5: *88VIC88* folded before Flop (didn't bet)
Seat 6: iPitbull1 collected ($0.05)



PokerStars Zoom Hand #229229386845:  Hold'em No Limit ($0.01/$0.02) - 2021/08/21 20:58:31 CET [2021/08/21 14:58:31 ET]
Table 'Halley' 6-max Seat #1 is the button
Seat 1: Scaaalll ($2.07 in chips) 
Seat 2: NikosGr1991 ($1.05 in chips) 
Seat 3: Wegezin ($1.96 in chips) 
Seat 4: Esskeetit420/69 ($1.85 in chips) 
Seat 5: rideofpoker ($1.97 in chips) 
Seat 6: Pulp Hands ($1.54 in chips) 
NikosGr1991: posts small blind $0.01
Wegezin: posts big blind $0.02
*** HOLE CARDS ***
Dealt to Scaaalll [Qh 4c]
Esskeetit420/69: folds 
rideofpoker: folds 
Pulp Hands: raises $0.02 to $0.04
Scaaalll: folds 
NikosGr1991: folds 
Wegezin: folds 
Uncalled bet ($0.02) returned to Pulp Hands
Pulp Hands collected $0.05 from pot
Pulp Hands: doesn't show hand 
*** SUMMARY ***
Total pot $0.05 | Rake $0 
Seat 1: Scaaalll (button) folded before Flop (didn't bet)
Seat 2: NikosGr1991 (small blind) folded before Flop
Seat 3: Wegezin (big blind) folded before Flop
Seat 4: Esskeetit420/69 folded before Flop (didn't bet)
Seat 5: rideofpoker folded before Flop (didn't bet)
Seat 6: Pulp Hands collected ($0.05)



PokerStars Zoom Hand #229229384169:  Hold'em No Limit ($0.01/$0.02) - 2021/08/21 20:58:23 CET [2021/08/21 14:58:23 ET]
Table 'Halley' 6-max Seat #1 is the button
Seat 1: majk350 ($0.94 in chips) 
Seat 2: pozt15 ($1.92 in chips) 
Seat 3: andreydgk ($2.03 in chips) 
Seat 4: Scaaalll ($2.07 in chips) 
Seat 5: senorseldeng ($2.35 in chips) 
Seat 6: xmaksimus ($6.72 in chips) 
pozt15: posts small blind $0.01
andreydgk: posts big blind $0.02
*** HOLE CARDS ***
Dealt to Scaaalll [5c 6h]
pozt15 is disconnected 
Scaaalll: folds 
senorseldeng: raises $0.04 to $0.06
xmaksimus: folds 
majk350: folds 
pozt15: folds 
andreydgk: calls $0.04
*** FLOP *** [3c 9h 2s]
andreydgk: checks 
senorseldeng: bets $0.09
andreydgk: folds 
Uncalled bet ($0.09) returned to senorseldeng
senorseldeng collected $0.13 from pot
senorseldeng: doesn't show hand 
*** SUMMARY ***
Total pot $0.13 | Rake $0 
Board [3c 9h 2s]
Seat 1: majk350 (button) folded before Flop (didn't bet)
Seat 2: pozt15 (small blind) folded before Flop
Seat 3: andreydgk (big blind) folded on the Flop
Seat 4: Scaaalll folded before Flop (didn't bet)
Seat 5: senorseldeng collected ($0.13)
Seat 6: xmaksimus folded before Flop (didn't bet)



PokerStars Zoom Hand #229229390728:  Hold'em No Limit ($0.01/$0.02) - 2021/08/21 20:58:44 CET [2021/08/21 14:58:44 ET]
Table 'Halley' 6-max Seat #1 is the button
Seat 1: cruisinjack ($1.49 in chips) 
Seat 2: Scaaalll ($2.05 in chips) 
Seat 3: so0love ($2.68 in chips) 
Seat 4: Adekvat.ua ($1.33 in chips) 
Seat 5: kickBrain ($5.73 in chips) 
Seat 6: sanko1980 ($0.78 in chips) 
Scaaalll: posts small blind $0.01
so0love: posts big blind $0.02
*** HOLE CARDS ***
Dealt to Scaaalll [5h Ah]
Adekvat.ua: folds 
kickBrain: folds 
sanko1980: raises $0.02 to $0.04
cruisinjack: folds 
Scaaalll: calls $0.03
so0love: folds 
*** FLOP *** [Td Jh 8s]
Scaaalll: checks 
sanko1980: bets $0.02
Scaaalll: folds 
Uncalled bet ($0.02) returned to sanko1980
sanko1980 collected $0.10 from pot
sanko1980: doesn't show hand 
*** SUMMARY ***
Total pot $0.10 | Rake $0 
Board [Td Jh 8s]
Seat 1: cruisinjack (button) folded before Flop (didn't bet)
Seat 2: Scaaalll (small blind) folded on the Flop
Seat 3: so0love (big blind) folded before Flop
Seat 4: Adekvat.ua folded before Flop (didn't bet)
Seat 5: kickBrain folded before Flop (didn't bet)
Seat 6: sanko1980 collected ($0.10)



PokerStars Zoom Hand #229229382972:  Hold'em No Limit ($0.01/$0.02) - 2021/08/21 20:58:18 CET [2021/08/21 14:58:18 ET]
Table 'Halley' 6-max Seat #1 is the button
Seat 1: BIITRU ($3.63 in chips) 
Seat 2: 888lifeIS ($2.38 in chips) 
Seat 3: Zhyla95 ($2.12 in chips) 
Seat 4: diegohgmelo ($1.53 in chips) 
Seat 5: ser313131 ($2.22 in chips) 
Seat 6: Scaaalll ($2.07 in chips) 
888lifeIS: posts small blind $0.01
Zhyla95: posts big blind $0.02
*** HOLE CARDS ***
Dealt to Scaaalll [8s Qc]
diegohgmelo: folds 
diegohgmelo is disconnected 
ser313131: calls $0.02
Scaaalll: folds 
BIITRU: raises $0.05 to $0.07
888lifeIS: calls $0.06
Zhyla95: folds 
ser313131: calls $0.05
*** FLOP *** [As Ts Td]
888lifeIS: checks 
ser313131: checks 
BIITRU: bets $0.06
888lifeIS: folds 
ser313131: raises $0.06 to $0.12
BIITRU: folds 
Uncalled bet ($0.06) returned to ser313131
ser313131 collected $0.34 from pot
ser313131: doesn't show hand 
*** SUMMARY ***
Total pot $0.35 | Rake $0.01 
Board [As Ts Td]
Seat 1: BIITRU (button) folded on the Flop
Seat 2: 888lifeIS (small blind) folded on the Flop
Seat 3: Zhyla95 (big blind) folded before Flop
Seat 4: diegohgmelo folded before Flop (didn't bet)
Seat 5: ser313131 collected ($0.34)
Seat 6: Scaaalll folded before Flop (didn't bet)



PokerStars Zoom Hand #229229399174:  Hold'em No Limit ($0.01/$0.02) - 2021/08/21 20:59:13 CET [2021/08/21 14:59:13 ET]
Table 'Halley' 6-max Seat #1 is the button
Seat 1: Fastidium ($0.94 in chips) 
Seat 2: 7LEV77 ($0.62 in chips) 
Seat 3: YPAXAPA555 ($2.11 in chips) 
Seat 4: Goose Of Poker ($2.02 in chips) 
Seat 5: Scaaalll ($2.01 in chips) 
Seat 6: Xlavariable ($2.51 in chips) 
7LEV77: posts small blind $0.01
YPAXAPA555: posts big blind $0.02
*** HOLE CARDS ***
Dealt to Scaaalll [5c Ac]
Goose Of Poker has timed out
Goose Of Poker: folds 
Scaaalll: raises $0.04 to $0.06
Xlavariable: folds 
Fastidium: folds 
7LEV77: folds 
YPAXAPA555: calls $0.04
*** FLOP *** [As 9s Ks]
YPAXAPA555: checks 
Scaaalll: bets $0.08
YPAXAPA555: raises $0.16 to $0.24
Scaaalll: folds 
Uncalled bet ($0.16) returned to YPAXAPA555
YPAXAPA555 collected $0.28 from pot
YPAXAPA555: doesn't show hand 
*** SUMMARY ***
Total pot $0.29 | Rake $0.01 
Board [As 9s Ks]
Seat 1: Fastidium (button) folded before Flop (didn't bet)
Seat 2: 7LEV77 (small blind) folded before Flop
Seat 3: YPAXAPA555 (big blind) collected ($0.28)
Seat 4: Goose Of Poker folded before Flop (didn't bet)
Seat 5: Scaaalll folded on the Flop
Seat 6: Xlavariable folded before Flop (didn't bet)



PokerStars Zoom Hand #229229411164:  Hold'em No Limit ($0.01/$0.02) - 2021/08/21 20:59:52 CET [2021/08/21 14:59:52 ET]
Table 'Halley' 6-max Seat #1 is the button
Seat 1: Sergio14b ($2 in chips) 
Seat 2: HellNative ($3.11 in chips) 
Seat 3: Stormzilla ($2 in chips) 
Seat 4: CordiPS ($2.61 in chips) 
Seat 5: cacomaz ($1.67 in chips) 
Seat 6: Scaaalll ($2 in chips) 
HellNative: posts small blind $0.01
Stormzilla: posts big blind $0.02
*** HOLE CARDS ***
Dealt to Scaaalll [Ts 8h]
CordiPS: folds 
cacomaz: calls $0.02
Scaaalll: folds 
Sergio14b: folds 
HellNative: folds 
Stormzilla: checks 
*** FLOP *** [Jc Kc 5s]
Stormzilla: checks 
cacomaz: bets $0.02
Stormzilla: calls $0.02
*** TURN *** [Jc Kc 5s] [Js]
Stormzilla: checks 
cacomaz: bets $0.02
Stormzilla: raises $0.08 to $0.10
cacomaz: calls $0.08
*** RIVER *** [Jc Kc 5s Js] [4d]
Stormzilla: bets $0.18
cacomaz: calls $0.18
*** SHOW DOWN ***
Stormzilla: shows [3h Jh] (three of a kind, Jacks)
cacomaz: shows [5h 5d] (a full house, Fives full of Jacks)
cacomaz collected $0.63 from pot
*** SUMMARY ***
Total pot $0.65 | Rake $0.02 
Board [Jc Kc 5s Js 4d]
Seat 1: Sergio14b (button) folded before Flop (didn't bet)
Seat 2: HellNative (small blind) folded before Flop
Seat 3: Stormzilla (big blind) showed [3h Jh] and lost with three of a kind, Jacks
Seat 4: CordiPS folded before Flop (didn't bet)
Seat 5: cacomaz showed [5h 5d] and won ($0.63) with a full house, Fives full of Jacks
Seat 6: Scaaalll folded before Flop (didn't bet)



PokerStars Zoom Hand #229229414518:  Hold'em No Limit ($0.01/$0.02) - 2021/08/21 21:00:03 CET [2021/08/21 15:00:03 ET]
Table 'Halley' 6-max Seat #1 is the button
Seat 1: Scaaalll ($2 in chips) 
Seat 2: Plinko05 ($3.07 in chips) 
Seat 3: RonilsonCosta ($2.17 in chips) 
Seat 4: estelionat171 ($0.60 in chips) 
Seat 5: senorseldeng ($2.03 in chips) 
Seat 6: andreydgk ($4.79 in chips) 
Plinko05: posts small blind $0.01
RonilsonCosta: posts big blind $0.02
*** HOLE CARDS ***
Dealt to Scaaalll [2c Kh]
estelionat171: folds 
senorseldeng: folds 
andreydgk: folds 
Scaaalll: raises $0.02 to $0.04
Plinko05: folds 
RonilsonCosta: calls $0.02
*** FLOP *** [Th 5s 3c]
RonilsonCosta: checks 
Scaaalll: bets $0.06
RonilsonCosta: folds 
Uncalled bet ($0.06) returned to Scaaalll
Scaaalll collected $0.09 from pot
Scaaalll: doesn't show hand 
*** SUMMARY ***
Total pot $0.09 | Rake $0 
Board [Th 5s 3c]
Seat 1: Scaaalll (button) collected ($0.09)
Seat 2: Plinko05 (small blind) folded before Flop
Seat 3: RonilsonCosta (big blind) folded on the Flop
Seat 4: estelionat171 folded before Flop (didn't bet)
Seat 5: senorseldeng folded before Flop (didn't bet)
Seat 6: andreydgk folded before Flop (didn't bet)



PokerStars Zoom Hand #229229413287:  Hold'em No Limit ($0.01/$0.02) - 2021/08/21 20:59:59 CET [2021/08/21 14:59:59 ET]
Table 'Halley' 6-max Seat #1 is the button
Seat 1: In2win26 ($2.04 in chips) 
Seat 2: ckooistra36 ($0.77 in chips) 
Seat 3: no way yo ($3.33 in chips) 
Seat 4: Scaaalll ($2 in chips) 
Seat 5: medbxl1971 ($1.97 in chips) 
Seat 6: AndreaBsAs ($2.09 in chips) 
ckooistra36: posts small blind $0.01
no way yo: posts big blind $0.02
*** HOLE CARDS ***
Dealt to Scaaalll [5h 8h]
Scaaalll: folds 
In2win26 is disconnected 
medbxl1971: folds 
medbxl1971 is disconnected 
AndreaBsAs: folds 
In2win26: folds 
ckooistra36: calls $0.01
no way yo: checks 
*** FLOP *** [7s Qs Jc]
ckooistra36: bets $0.02
no way yo: calls $0.02
*** TURN *** [7s Qs Jc] [Kd]
ckooistra36: checks 
no way yo: checks 
*** RIVER *** [7s Qs Jc Kd] [9s]
ckooistra36: bets $0.08
no way yo: folds 
Uncalled bet ($0.08) returned to ckooistra36
ckooistra36 collected $0.08 from pot
ckooistra36: doesn't show hand 
*** SUMMARY ***
Total pot $0.08 | Rake $0 
Board [7s Qs Jc Kd 9s]
Seat 1: In2win26 (button) folded before Flop (didn't bet)
Seat 2: ckooistra36 (small blind) collected ($0.08)
Seat 3: no way yo (big blind) folded on the River
Seat 4: Scaaalll folded before Flop (didn't bet)
Seat 5: medbxl1971 folded before Flop (didn't bet)
Seat 6: AndreaBsAs folded before Flop (didn't bet)



PokerStars Zoom Hand #229229427275:  Hold'em No Limit ($0.01/$0.02) - 2021/08/21 21:00:42 CET [2021/08/21 15:00:42 ET]
Table 'Halley' 6-max Seat #1 is the button
Seat 1: Shumayloff ($1.28 in chips) 
Seat 2: HellNative ($3.87 in chips) 
Seat 3: Scaaalll ($2.05 in chips) 
Seat 4: fishh_play ($2.03 in chips) 
Seat 5: YPAXAPA555 ($2.71 in chips) 
Seat 6: ezequielgss ($1.95 in chips) 
HellNative: posts small blind $0.01
Scaaalll: posts big blind $0.02
*** HOLE CARDS ***
Dealt to Scaaalll [8s 4d]
fishh_play: folds 
YPAXAPA555: folds 
ezequielgss: folds 
Shumayloff: raises $0.22 to $0.24
HellNative: folds 
Scaaalll: folds 
Uncalled bet ($0.22) returned to Shumayloff
Shumayloff collected $0.05 from pot
Shumayloff: doesn't show hand 
*** SUMMARY ***
Total pot $0.05 | Rake $0 
Seat 1: Shumayloff (button) collected ($0.05)
Seat 2: HellNative (small blind) folded before Flop
Seat 3: Scaaalll (big blind) folded before Flop
Seat 4: fishh_play folded before Flop (didn't bet)
Seat 5: YPAXAPA555 folded before Flop (didn't bet)
Seat 6: ezequielgss folded before Flop (didn't bet)



PokerStars Zoom Hand #229229445560:  Hold'em No Limit ($0.01/$0.02) - 2021/08/21 21:01:24 CET [2021/08/21 15:01:24 ET]
Table 'Halley' 6-max Seat #1 is the button
Seat 1: YPAXAPA555 ($2 in chips) 
Seat 2: Akrobat94 ($1.25 in chips) 
Seat 3: Wegezin ($1.90 in chips) 
Seat 4: chrisaras13 ($3.81 in chips) 
Seat 5: Scaaalll ($2.02 in chips) 
Seat 6: Shadi8 ($2 in chips) 
Akrobat94: posts small blind $0.01
Wegezin: posts big blind $0.02
*** HOLE CARDS ***
Dealt to Scaaalll [2d 7h]
Akrobat94 is disconnected 
chrisaras13: folds 
Scaaalll: folds 
Shadi8: folds 
YPAXAPA555: folds 
Akrobat94: folds 
Uncalled bet ($0.01) returned to Wegezin
Wegezin collected $0.02 from pot
Wegezin: doesn't show hand 
*** SUMMARY ***
Total pot $0.02 | Rake $0 
Seat 1: YPAXAPA555 (button) folded before Flop (didn't bet)
Seat 2: Akrobat94 (small blind) folded before Flop
Seat 3: Wegezin (big blind) collected ($0.02)
Seat 4: chrisaras13 folded before Flop (didn't bet)
Seat 5: Scaaalll folded before Flop (didn't bet)
Seat 6: Shadi8 folded before Flop (didn't bet)



PokerStars Zoom Hand #229229438191:  Hold'em No Limit ($0.01/$0.02) - 2021/08/21 21:01:08 CET [2021/08/21 15:01:08 ET]
Table 'Halley' 6-max Seat #1 is the button
Seat 1: Tj741 ($2.48 in chips) 
Seat 2: Scaaalll ($2.03 in chips) 
Seat 3: cabe839 ($2.39 in chips) 
Seat 4: Aroma Iceland ($5.64 in chips) 
Seat 5: officesu ($2.01 in chips) 
Seat 6: MIT_PKR ($4.45 in chips) 
Scaaalll: posts small blind $0.01
cabe839: posts big blind $0.02
*** HOLE CARDS ***
Dealt to Scaaalll [9s Jc]
Aroma Iceland: folds 
officesu: folds 
MIT_PKR: folds 
Tj741: raises $0.02 to $0.04
Scaaalll: folds 
cabe839: calls $0.02
*** FLOP *** [Kh Th 5c]
cabe839: checks 
Tj741: bets $0.03
cabe839: calls $0.03
*** TURN *** [Kh Th 5c] [Ks]
cabe839: checks 
Tj741: bets $0.10
cabe839: folds 
Uncalled bet ($0.10) returned to Tj741
Tj741 collected $0.14 from pot
Tj741: doesn't show hand 
*** SUMMARY ***
Total pot $0.15 | Rake $0.01 
Board [Kh Th 5c Ks]
Seat 1: Tj741 (button) collected ($0.14)
Seat 2: Scaaalll (small blind) folded before Flop
Seat 3: cabe839 (big blind) folded on the Turn
Seat 4: Aroma Iceland folded before Flop (didn't bet)
Seat 5: officesu folded before Flop (didn't bet)
Seat 6: MIT_PKR folded before Flop (didn't bet)



PokerStars Zoom Hand #229229435192:  Hold'em No Limit ($0.01/$0.02) - 2021/08/21 21:01:04 CET [2021/08/21 15:01:04 ET]
Table 'Halley' 6-max Seat #1 is the button
Seat 1: qpsq ($2.12 in chips) 
Seat 2: sigrivas ($4 in chips) 
Seat 3: S.B.O190 ($2.03 in chips) 
Seat 4: Iluvatar922 ($4.96 in chips) 
Seat 5: Loupi20 ($0.11 in chips) 
Seat 6: Scaaalll ($2.03 in chips) 
sigrivas: posts small blind $0.01
S.B.O190: posts big blind $0.02
*** HOLE CARDS ***
Dealt to Scaaalll [Qh 9c]
Iluvatar922: folds 
Loupi20: folds 
Scaaalll: folds 
Loupi20 is disconnected 
qpsq: raises $0.04 to $0.06
sigrivas: folds 
S.B.O190: calls $0.04
*** FLOP *** [8h 4d Jc]
S.B.O190: checks 
qpsq: bets $0.09
S.B.O190: calls $0.09
*** TURN *** [8h 4d Jc] [5d]
S.B.O190: checks 
qpsq: bets $0.20
S.B.O190: calls $0.20
*** RIVER *** [8h 4d Jc 5d] [2d]
S.B.O190: checks 
qpsq: bets $0.46
S.B.O190: folds 
Uncalled bet ($0.46) returned to qpsq
qpsq collected $0.69 from pot
qpsq: doesn't show hand 
*** SUMMARY ***
Total pot $0.71 | Rake $0.02 
Board [8h 4d Jc 5d 2d]
Seat 1: qpsq (button) collected ($0.69)
Seat 2: sigrivas (small blind) folded before Flop
Seat 3: S.B.O190 (big blind) folded on the River
Seat 4: Iluvatar922 folded before Flop (didn't bet)
Seat 5: Loupi20 folded before Flop (didn't bet)
Seat 6: Scaaalll folded before Flop (didn't bet)



PokerStars Zoom Hand #229229449990:  Hold'em No Limit ($0.01/$0.02) - 2021/08/21 21:01:35 CET [2021/08/21 15:01:35 ET]
Table 'Halley' 6-max Seat #1 is the button
Seat 1: syndikkat ($2.03 in chips) 
Seat 2: renova0813 ($13.66 in chips) 
Seat 3: aimar20006 ($2.01 in chips) 
Seat 4: Scaaalll ($2.02 in chips) 
Seat 5: Fanatspartak ($1.99 in chips) 
Seat 6: Pechorin.G ($2.13 in chips) 
renova0813: posts small blind $0.01
aimar20006: posts big blind $0.02
*** HOLE CARDS ***
Dealt to Scaaalll [Tc 8s]
Scaaalll: folds 
Fanatspartak: folds 
Pechorin.G: folds 
syndikkat: folds 
renova0813: raises $0.04 to $0.06
aimar20006: folds 
Uncalled bet ($0.04) returned to renova0813
renova0813 collected $0.04 from pot
renova0813: doesn't show hand 
*** SUMMARY ***
Total pot $0.04 | Rake $0 
Seat 1: syndikkat (button) folded before Flop (didn't bet)
Seat 2: renova0813 (small blind) collected ($0.04)
Seat 3: aimar20006 (big blind) folded before Flop
Seat 4: Scaaalll folded before Flop (didn't bet)
Seat 5: Fanatspartak folded before Flop (didn't bet)
Seat 6: Pechorin.G folded before Flop (didn't bet)



PokerStars Zoom Hand #229229443845:  Hold'em No Limit ($0.01/$0.02) - 2021/08/21 21:01:20 CET [2021/08/21 15:01:20 ET]
Table 'Halley' 6-max Seat #1 is the button
Seat 1: fishh_play ($4.81 in chips) 
Seat 2: Addon289174 ($2.78 in chips) 
Seat 3: Bubobubob ($2.55 in chips) 
Seat 4: Scaaalll ($2.02 in chips) 
Seat 5: Stormzilla ($2.06 in chips) 
Seat 6: Finderra ($2.48 in chips) 
Addon289174: posts small blind $0.01
Bubobubob: posts big blind $0.02
*** HOLE CARDS ***
Dealt to Scaaalll [7d 4h]
Scaaalll: folds 
Stormzilla: raises $0.03 to $0.05
Finderra: folds 
fishh_play: calls $0.05
Addon289174: calls $0.04
Bubobubob: folds 
*** FLOP *** [Ah Js 2c]
Addon289174: checks 
Stormzilla: checks 
fishh_play: bets $0.09
Addon289174: calls $0.09
Stormzilla: folds 
*** TURN *** [Ah Js 2c] [6c]
Addon289174: checks 
fishh_play: bets $0.20
Addon289174: folds 
Uncalled bet ($0.20) returned to fishh_play
fishh_play collected $0.34 from pot
fishh_play: doesn't show hand 
*** SUMMARY ***
Total pot $0.35 | Rake $0.01 
Board [Ah Js 2c 6c]
Seat 1: fishh_play (button) collected ($0.34)
Seat 2: Addon289174 (small blind) folded on the Turn
Seat 3: Bubobubob (big blind) folded before Flop
Seat 4: Scaaalll folded before Flop (didn't bet)
Seat 5: Stormzilla folded on the Flop
Seat 6: Finderra folded before Flop (didn't bet)



PokerStars Zoom Hand #229229451452:  Hold'em No Limit ($0.01/$0.02) - 2021/08/21 21:01:39 CET [2021/08/21 15:01:39 ET]
Table 'Halley' 6-max Seat #1 is the button
Seat 1: Prrrronya ($0.92 in chips) 
Seat 2: beber_1613 ($2.69 in chips) 
Seat 3: Scaaalll ($2.02 in chips) 
Seat 4: 7LEV77 ($1.75 in chips) 
Seat 5: woop333 ($0.53 in chips) 
Seat 6: Ogni ($2.79 in chips) 
beber_1613: posts small blind $0.01
Scaaalll: posts big blind $0.02
*** HOLE CARDS ***
Dealt to Scaaalll [7h Ad]
7LEV77: folds 
woop333: folds 
Ogni: folds 
Prrrronya: folds 
beber_1613: raises $0.03 to $0.05
Scaaalll: raises $0.13 to $0.18
beber_1613: folds 
Uncalled bet ($0.13) returned to Scaaalll
Scaaalll collected $0.10 from pot
Scaaalll: doesn't show hand 
*** SUMMARY ***
Total pot $0.10 | Rake $0 
Seat 1: Prrrronya (button) folded before Flop (didn't bet)
Seat 2: beber_1613 (small blind) folded before Flop
Seat 3: Scaaalll (big blind) collected ($0.10)
Seat 4: 7LEV77 folded before Flop (didn't bet)
Seat 5: woop333 folded before Flop (didn't bet)
Seat 6: Ogni folded before Flop (didn't bet)



PokerStars Zoom Hand #229229447292:  Hold'em No Limit ($0.01/$0.02) - 2021/08/21 21:01:28 CET [2021/08/21 15:01:28 ET]
Table 'Halley' 6-max Seat #1 is the button
Seat 1: MrK_Leuven ($2.48 in chips) 
Seat 2: xxRoseIloveu ($6.06 in chips) 
Seat 3: RonilsonCosta ($2 in chips) 
Seat 4: gasmar_29 ($3.17 in chips) 
Seat 5: Scaaalll ($2.02 in chips) 
Seat 6: sas2001 ($1.94 in chips) 
xxRoseIloveu: posts small blind $0.01
RonilsonCosta: posts big blind $0.02
*** HOLE CARDS ***
Dealt to Scaaalll [9h 3h]
gasmar_29: folds 
Scaaalll: folds 
sas2001: calls $0.02
MrK_Leuven: folds 
xxRoseIloveu: raises $0.04 to $0.06
RonilsonCosta: folds 
sas2001: calls $0.04
*** FLOP *** [Ac Jc Kh]
xxRoseIloveu: checks 
sas2001: bets $0.02
xxRoseIloveu: calls $0.02
*** TURN *** [Ac Jc Kh] [3d]
xxRoseIloveu: checks 
sas2001: checks 
*** RIVER *** [Ac Jc Kh 3d] [4d]
xxRoseIloveu: checks 
sas2001: checks 
*** SHOW DOWN ***
xxRoseIloveu: shows [Jh Qd] (a pair of Jacks)
sas2001: mucks hand 
xxRoseIloveu collected $0.17 from pot
*** SUMMARY ***
Total pot $0.18 | Rake $0.01 
Board [Ac Jc Kh 3d 4d]
Seat 1: MrK_Leuven (button) folded before Flop (didn't bet)
Seat 2: xxRoseIloveu (small blind) showed [Jh Qd] and won ($0.17) with a pair of Jacks
Seat 3: RonilsonCosta (big blind) folded before Flop
Seat 4: gasmar_29 folded before Flop (didn't bet)
Seat 5: Scaaalll folded before Flop (didn't bet)
Seat 6: sas2001 mucked [Js Th]



PokerStars Zoom Hand #229229461112:  Hold'em No Limit ($0.01/$0.02) - 2021/08/21 21:02:03 CET [2021/08/21 15:02:03 ET]
Table 'Halley' 6-max Seat #1 is the button
Seat 1: Scaaalll ($2.07 in chips) 
Seat 2: HellNative ($2.29 in chips) 
Seat 3: estelionat171 ($0.86 in chips) 
Seat 4: danielschuel ($1.87 in chips) 
Seat 5: agusdecarca ($2.68 in chips) 
Seat 6: Red Sky 15 ($4.18 in chips) 
HellNative: posts small blind $0.01
estelionat171: posts big blind $0.02
*** HOLE CARDS ***
Dealt to Scaaalll [5c Qc]
danielschuel: folds 
agusdecarca: folds 
Red Sky 15: raises $0.04 to $0.06
Scaaalll: folds 
HellNative: folds 
estelionat171: folds 
Uncalled bet ($0.04) returned to Red Sky 15
Red Sky 15 collected $0.05 from pot
Red Sky 15: doesn't show hand 
*** SUMMARY ***
Total pot $0.05 | Rake $0 
Seat 1: Scaaalll (button) folded before Flop (didn't bet)
Seat 2: HellNative (small blind) folded before Flop
Seat 3: estelionat171 (big blind) folded before Flop
Seat 4: danielschuel folded before Flop (didn't bet)
Seat 5: agusdecarca folded before Flop (didn't bet)
Seat 6: Red Sky 15 collected ($0.05)



PokerStars Zoom Hand #229229463897:  Hold'em No Limit ($0.01/$0.02) - 2021/08/21 21:02:09 CET [2021/08/21 15:02:09 ET]
Table 'Halley' 6-max Seat #1 is the button
Seat 1: pozt15 ($1.17 in chips) 
Seat 2: kahzura ($2 in chips) 
Seat 3: 1000xp ($3.93 in chips) 
Seat 4: Taallt ($4.48 in chips) 
Seat 5: thiagohbueno ($1.64 in chips) 
Seat 6: Scaaalll ($2.07 in chips) 
kahzura: posts small blind $0.01
1000xp: posts big blind $0.02
*** HOLE CARDS ***
Dealt to Scaaalll [2d 7c]
Taallt: raises $0.04 to $0.06
thiagohbueno: folds 
Scaaalll: folds 
pozt15: raises $0.15 to $0.21
kahzura: folds 
1000xp: folds 
Taallt: raises $4.27 to $4.48 and is all-in
pozt15: calls $0.96 and is all-in
Uncalled bet ($3.31) returned to Taallt
*** FLOP *** [Th Js Kc]
*** TURN *** [Th Js Kc] [7h]
*** RIVER *** [Th Js Kc 7h] [6d]
*** SHOW DOWN ***
Taallt: shows [Ah Kd] (a pair of Kings)
pozt15: shows [Qc Qh] (a pair of Queens)
Taallt collected $2.29 from pot
*** SUMMARY ***
Total pot $2.37 | Rake $0.08 
Board [Th Js Kc 7h 6d]
Seat 1: pozt15 (button) showed [Qc Qh] and lost with a pair of Queens
Seat 2: kahzura (small blind) folded before Flop
Seat 3: 1000xp (big blind) folded before Flop
Seat 4: Taallt showed [Ah Kd] and won ($2.29) with a pair of Kings
Seat 5: thiagohbueno folded before Flop (didn't bet)
Seat 6: Scaaalll folded before Flop (didn't bet)



PokerStars Zoom Hand #229229467779:  Hold'em No Limit ($0.01/$0.02) - 2021/08/21 21:02:17 CET [2021/08/21 15:02:17 ET]
Table 'Halley' 6-max Seat #1 is the button
Seat 1: zergmiky ($2 in chips) 
Seat 2: Scaaalll ($2.07 in chips) 
Seat 3: gasmar_29 ($3.16 in chips) 
Seat 4: PaddyPoland ($2 in chips) 
Seat 5: rpycmbEM ($5.91 in chips) 
Seat 6: JBPY ($0.96 in chips) 
Scaaalll: posts small blind $0.01
gasmar_29: posts big blind $0.02
*** HOLE CARDS ***
Dealt to Scaaalll [6d 4c]
PaddyPoland: folds 
rpycmbEM: folds 
JBPY: folds 
zergmiky: raises $0.02 to $0.04
Scaaalll: folds 
gasmar_29: calls $0.02
*** FLOP *** [8c 7c 7h]
gasmar_29: bets $0.06
zergmiky: folds 
Uncalled bet ($0.06) returned to gasmar_29
gasmar_29 collected $0.09 from pot
gasmar_29: doesn't show hand 
*** SUMMARY ***
Total pot $0.09 | Rake $0 
Board [8c 7c 7h]
Seat 1: zergmiky (button) folded on the Flop
Seat 2: Scaaalll (small blind) folded before Flop
Seat 3: gasmar_29 (big blind) collected ($0.09)
Seat 4: PaddyPoland folded before Flop (didn't bet)
Seat 5: rpycmbEM folded before Flop (didn't bet)
Seat 6: JBPY folded before Flop (didn't bet)



PokerStars Zoom Hand #229229483732:  Hold'em No Limit ($0.01/$0.02) - 2021/08/21 21:02:39 CET [2021/08/21 15:02:39 ET]
Table 'Halley' 6-max Seat #1 is the button
Seat 1: Natali172737 ($2.97 in chips) 
Seat 2: Syd Wright ($1.98 in chips) 
Seat 3: Scaaalll ($2.06 in chips) 
Seat 4: bigthereal ($2.07 in chips) 
Seat 5: Kergie ($8.86 in chips) 
Seat 6: Draat505 ($4.94 in chips) 
Syd Wright: posts small blind $0.01
Scaaalll: posts big blind $0.02
*** HOLE CARDS ***
Dealt to Scaaalll [Qh 6d]
bigthereal: raises $0.08 to $0.10
Kergie: folds 
Draat505: folds 
Natali172737: folds 
Syd Wright: folds 
Scaaalll: folds 
Uncalled bet ($0.08) returned to bigthereal
bigthereal collected $0.05 from pot
bigthereal: doesn't show hand 
*** SUMMARY ***
Total pot $0.05 | Rake $0 
Seat 1: Natali172737 (button) folded before Flop (didn't bet)
Seat 2: Syd Wright (small blind) folded before Flop
Seat 3: Scaaalll (big blind) folded before Flop
Seat 4: bigthereal collected ($0.05)
Seat 5: Kergie folded before Flop (didn't bet)
Seat 6: Draat505 folded before Flop (didn't bet)



PokerStars Zoom Hand #229229490947:  Hold'em No Limit ($0.01/$0.02) - 2021/08/21 21:02:56 CET [2021/08/21 15:02:56 ET]
Table 'Halley' 6-max Seat #1 is the button
Seat 1: beber_1613 ($2.27 in chips) 
Seat 2: Scaaalll ($2.04 in chips) 
Seat 3: sokolik81 ($3.18 in chips) 
Seat 4: Oprichnick90 ($3.27 in chips) 
Seat 5: Hautkunst ($1.70 in chips) 
Seat 6: Berti281 ($2.76 in chips) 
Scaaalll: posts small blind $0.01
sokolik81: posts big blind $0.02
*** HOLE CARDS ***
Dealt to Scaaalll [Ts Qh]
Hautkunst is disconnected 
Oprichnick90: folds 
Hautkunst: folds 
Berti281: folds 
beber_1613: folds 
Scaaalll: raises $0.04 to $0.06
sokolik81: folds 
Uncalled bet ($0.04) returned to Scaaalll
Scaaalll collected $0.04 from pot
Scaaalll: doesn't show hand 
*** SUMMARY ***
Total pot $0.04 | Rake $0 
Seat 1: beber_1613 (button) folded before Flop (didn't bet)
Seat 2: Scaaalll (small blind) collected ($0.04)
Seat 3: sokolik81 (big blind) folded before Flop
Seat 4: Oprichnick90 folded before Flop (didn't bet)
Seat 5: Hautkunst folded before Flop (didn't bet)
Seat 6: Berti281 folded before Flop (didn't bet)



PokerStars Zoom Hand #229229471674:  Hold'em No Limit ($0.01/$0.02) - 2021/08/21 21:02:26 CET [2021/08/21 15:02:26 ET]
Table 'Halley' 6-max Seat #1 is the button
Seat 1: Scaaalll ($2.06 in chips) 
Seat 2: thiagohbueno ($1.64 in chips) 
Seat 3: fabor1303 ($2.45 in chips) 
Seat 4: estelionat171 ($0.99 in chips) 
Seat 5: no way yo ($4.74 in chips) 
Seat 6: lyapis75 ($2 in chips) 
thiagohbueno: posts small blind $0.01
fabor1303: posts big blind $0.02
*** HOLE CARDS ***
Dealt to Scaaalll [6c 5s]
estelionat171: folds 
no way yo: folds 
lyapis75: folds 
Scaaalll: folds 
thiagohbueno: raises $0.02 to $0.04
fabor1303: calls $0.02
*** FLOP *** [Jd Kd Th]
thiagohbueno: bets $0.04
fabor1303: folds 
Uncalled bet ($0.04) returned to thiagohbueno
thiagohbueno collected $0.08 from pot
thiagohbueno: doesn't show hand 
*** SUMMARY ***
Total pot $0.08 | Rake $0 
Board [Jd Kd Th]
Seat 1: Scaaalll (button) folded before Flop (didn't bet)
Seat 2: thiagohbueno (small blind) collected ($0.08)
Seat 3: fabor1303 (big blind) folded on the Flop
Seat 4: estelionat171 folded before Flop (didn't bet)
Seat 5: no way yo folded before Flop (didn't bet)
Seat 6: lyapis75 folded before Flop (didn't bet)



PokerStars Zoom Hand #229229498483:  Hold'em No Limit ($0.01/$0.02) - 2021/08/21 21:03:13 CET [2021/08/21 15:03:13 ET]
Table 'Halley' 6-max Seat #1 is the button
Seat 1: Shadi8 ($3.45 in chips) 
Seat 2: fabor1303 ($2.41 in chips) 
Seat 3: Xlavariable ($4.06 in chips) 
Seat 4: KKARMELO ($2.37 in chips) 
Seat 5: iPitbull1 ($2.38 in chips) 
Seat 6: Scaaalll ($2.06 in chips) 
fabor1303: posts small blind $0.01
Xlavariable: posts big blind $0.02
*** HOLE CARDS ***
Dealt to Scaaalll [As Qh]
KKARMELO: folds 
iPitbull1: folds 
Scaaalll: raises $0.04 to $0.06
Shadi8: folds 
fabor1303: folds 
Xlavariable: folds 
Uncalled bet ($0.04) returned to Scaaalll
Scaaalll collected $0.05 from pot
Scaaalll: doesn't show hand 
*** SUMMARY ***
Total pot $0.05 | Rake $0 
Seat 1: Shadi8 (button) folded before Flop (didn't bet)
Seat 2: fabor1303 (small blind) folded before Flop
Seat 3: Xlavariable (big blind) folded before Flop
Seat 4: KKARMELO folded before Flop (didn't bet)
Seat 5: iPitbull1 folded before Flop (didn't bet)
Seat 6: Scaaalll collected ($0.05)



PokerStars Zoom Hand #229229509947:  Hold'em No Limit ($0.01/$0.02) - 2021/08/21 21:03:39 CET [2021/08/21 15:03:39 ET]
Table 'Halley' 6-max Seat #1 is the button
Seat 1: RoughRafff ($2.58 in chips) 
Seat 2: GorillaMode369 ($2.38 in chips) 
Seat 3: Taallt ($3.17 in chips) 
Seat 4: Scaaalll ($2.09 in chips) 
Seat 5: alfcapone87 ($2.10 in chips) 
Seat 6: Hsekir ($1.67 in chips) 
GorillaMode369: posts small blind $0.01
Taallt: posts big blind $0.02
*** HOLE CARDS ***
Dealt to Scaaalll [Ad 5h]
Scaaalll: folds 
alfcapone87: folds 
Hsekir: calls $0.02
RoughRafff: folds 
GorillaMode369: calls $0.01
Taallt: raises $0.10 to $0.12
Hsekir: folds 
Hsekir is disconnected 
GorillaMode369: folds 
Uncalled bet ($0.10) returned to Taallt
Taallt collected $0.06 from pot
Taallt: doesn't show hand 
*** SUMMARY ***
Total pot $0.06 | Rake $0 
Seat 1: RoughRafff (button) folded before Flop (didn't bet)
Seat 2: GorillaMode369 (small blind) folded before Flop
Seat 3: Taallt (big blind) collected ($0.06)
Seat 4: Scaaalll folded before Flop (didn't bet)
Seat 5: alfcapone87 folded before Flop (didn't bet)
Seat 6: Hsekir folded before Flop



PokerStars Zoom Hand #229229507770:  Hold'em No Limit ($0.01/$0.02) - 2021/08/21 21:03:34 CET [2021/08/21 15:03:34 ET]
Table 'Halley' 6-max Seat #1 is the button
Seat 1: maliniak75 ($1.41 in chips) 
Seat 2: BexleyBoy ($5.85 in chips) 
Seat 3: alecha11 ($2.85 in chips) 
Seat 4: ash1448 ($2.58 in chips) 
Seat 5: Scaaalll ($2.09 in chips) 
Seat 6: Berti281 ($2 in chips) 
BexleyBoy: posts small blind $0.01
alecha11: posts big blind $0.02
*** HOLE CARDS ***
Dealt to Scaaalll [Th Qd]
ash1448: folds 
Scaaalll: folds 
Berti281: folds 
maliniak75: calls $0.02
BexleyBoy: calls $0.01
alecha11: checks 
*** FLOP *** [Jc Qh Ts]
BexleyBoy: checks 
alecha11: checks 
maliniak75: checks 
*** TURN *** [Jc Qh Ts] [5c]
BexleyBoy: checks 
alecha11: checks 
maliniak75: checks 
*** RIVER *** [Jc Qh Ts 5c] [4h]
BexleyBoy: checks 
alecha11: checks 
maliniak75: checks 
*** SHOW DOWN ***
BexleyBoy: shows [Js 8d] (a pair of Jacks)
alecha11: mucks hand 
maliniak75: mucks hand 
BexleyBoy collected $0.06 from pot
*** SUMMARY ***
Total pot $0.06 | Rake $0 
Board [Jc Qh Ts 5c 4h]
Seat 1: maliniak75 (button) mucked [3c 4c]
Seat 2: BexleyBoy (small blind) showed [Js 8d] and won ($0.06) with a pair of Jacks
Seat 3: alecha11 (big blind) mucked [5h Ad]
Seat 4: ash1448 folded before Flop (didn't bet)
Seat 5: Scaaalll folded before Flop (didn't bet)
Seat 6: Berti281 folded before Flop (didn't bet)



PokerStars Zoom Hand #229229530343:  Hold'em No Limit ($0.01/$0.02) - 2021/08/21 21:04:25 CET [2021/08/21 15:04:25 ET]
Table 'Halley' 6-max Seat #1 is the button
Seat 1: RoyaLLRus ($1.64 in chips) 
Seat 2: Scaaalll ($2.07 in chips) 
Seat 3: ponomarinho ($2.45 in chips) 
Seat 4: andreydgk ($4.77 in chips) 
Seat 5: py100ta ($3.84 in chips) 
Seat 6: woop333 ($0.63 in chips) 
Scaaalll: posts small blind $0.01
ponomarinho: posts big blind $0.02
*** HOLE CARDS ***
Dealt to Scaaalll [9d 7c]
andreydgk: folds 
py100ta: folds 
woop333: folds 
RoyaLLRus: folds 
Scaaalll: folds 
Uncalled bet ($0.01) returned to ponomarinho
ponomarinho collected $0.02 from pot
ponomarinho: doesn't show hand 
*** SUMMARY ***
Total pot $0.02 | Rake $0 
Seat 1: RoyaLLRus (button) folded before Flop (didn't bet)
Seat 2: Scaaalll (small blind) folded before Flop
Seat 3: ponomarinho (big blind) collected ($0.02)
Seat 4: andreydgk folded before Flop (didn't bet)
Seat 5: py100ta folded before Flop (didn't bet)
Seat 6: woop333 folded before Flop (didn't bet)



PokerStars Zoom Hand #229229512182:  Hold'em No Limit ($0.01/$0.02) - 2021/08/21 21:03:44 CET [2021/08/21 15:03:44 ET]
Table 'Halley' 6-max Seat #1 is the button
Seat 1: Finderra ($3.72 in chips) 
Seat 2: LeoNik62 ($5.15 in chips) 
Seat 3: Goose Of Poker ($4.20 in chips) 
Seat 4: markzoom6894 ($2.05 in chips) 
Seat 5: Scaaalll ($2.09 in chips) 
Seat 6: FishOnPlate ($2.04 in chips) 
LeoNik62: posts small blind $0.01
Goose Of Poker: posts big blind $0.02
*** HOLE CARDS ***
Dealt to Scaaalll [5h Td]
markzoom6894: raises $0.03 to $0.05
Scaaalll: folds 
FishOnPlate: folds 
Finderra: folds 
LeoNik62: calls $0.04
Goose Of Poker: folds 
*** FLOP *** [8d 2c 3h]
LeoNik62: bets $0.06
markzoom6894: calls $0.06
*** TURN *** [8d 2c 3h] [2h]
LeoNik62: bets $0.12
markzoom6894: raises $0.20 to $0.32
LeoNik62: calls $0.20
*** RIVER *** [8d 2c 3h 2h] [Tc]
LeoNik62: bets $0.06
markzoom6894: calls $0.06
*** SHOW DOWN ***
LeoNik62: shows [6s 3s] (two pair, Threes and Deuces)
markzoom6894: shows [5d 5c] (two pair, Fives and Deuces)
markzoom6894 collected $0.96 from pot
*** SUMMARY ***
Total pot $1 | Rake $0.04 
Board [8d 2c 3h 2h Tc]
Seat 1: Finderra (button) folded before Flop (didn't bet)
Seat 2: LeoNik62 (small blind) showed [6s 3s] and lost with two pair, Threes and Deuces
Seat 3: Goose Of Poker (big blind) folded before Flop
Seat 4: markzoom6894 showed [5d 5c] and won ($0.96) with two pair, Fives and Deuces
Seat 5: Scaaalll folded before Flop (didn't bet)
Seat 6: FishOnPlate folded before Flop (didn't bet)



PokerStars Zoom Hand #229229535240:  Hold'em No Limit ($0.01/$0.02) - 2021/08/21 21:04:36 CET [2021/08/21 15:04:36 ET]
Table 'Halley' 6-max Seat #1 is the button
Seat 1: Scaaalll ($2.06 in chips) 
Seat 2: pavlo8855 ($2.10 in chips) 
Seat 3: cord86 ($2.14 in chips) 
Seat 4: 01527368 ($2 in chips) 
Seat 5: fabor1303 ($2.37 in chips) 
Seat 6: Pechorin.G ($2 in chips) 
pavlo8855: posts small blind $0.01
cord86: posts big blind $0.02
*** HOLE CARDS ***
Dealt to Scaaalll [2c 6d]
01527368: folds 
fabor1303: folds 
Pechorin.G: folds 
Scaaalll: folds 
pavlo8855: folds 
Uncalled bet ($0.01) returned to cord86
cord86 collected $0.02 from pot
cord86: doesn't show hand 
*** SUMMARY ***
Total pot $0.02 | Rake $0 
Seat 1: Scaaalll (button) folded before Flop (didn't bet)
Seat 2: pavlo8855 (small blind) folded before Flop
Seat 3: cord86 (big blind) collected ($0.02)
Seat 4: 01527368 folded before Flop (didn't bet)
Seat 5: fabor1303 folded before Flop (didn't bet)
Seat 6: Pechorin.G folded before Flop (didn't bet)



PokerStars Zoom Hand #229229539637:  Hold'em No Limit ($0.01/$0.02) - 2021/08/21 21:04:46 CET [2021/08/21 15:04:46 ET]
Table 'Halley' 6-max Seat #1 is the button
Seat 1: kamiso0904 ($1.07 in chips) 
Seat 2: Hautkunst ($2.64 in chips) 
Seat 3: no way yo ($4.78 in chips) 
Seat 4: kahzura ($2.15 in chips) 
Seat 5: RonilsonCosta ($2.32 in chips) 
Seat 6: Scaaalll ($2.06 in chips) 
Hautkunst: posts small blind $0.01
no way yo: posts big blind $0.02
*** HOLE CARDS ***
Dealt to Scaaalll [3c Qd]
kahzura: folds 
Hautkunst is disconnected 
RonilsonCosta: folds 
Scaaalll: folds 
kamiso0904: raises $0.04 to $0.06
Hautkunst: folds 
no way yo: calls $0.04
*** FLOP *** [7s 5s 2h]
no way yo: checks 
kamiso0904: bets $0.06
no way yo: folds 
Uncalled bet ($0.06) returned to kamiso0904
kamiso0904 collected $0.13 from pot
kamiso0904: doesn't show hand 
*** SUMMARY ***
Total pot $0.13 | Rake $0 
Board [7s 5s 2h]
Seat 1: kamiso0904 (button) collected ($0.13)
Seat 2: Hautkunst (small blind) folded before Flop
Seat 3: no way yo (big blind) folded on the Flop
Seat 4: kahzura folded before Flop (didn't bet)
Seat 5: RonilsonCosta folded before Flop (didn't bet)
Seat 6: Scaaalll folded before Flop (didn't bet)



PokerStars Zoom Hand #229229544967:  Hold'em No Limit ($0.01/$0.02) - 2021/08/21 21:04:58 CET [2021/08/21 15:04:58 ET]
Table 'Halley' 6-max Seat #1 is the button
Seat 1: rodrigoasor ($1.83 in chips) 
Seat 2: KIraMan ($3.03 in chips) 
Seat 3: Gibsondelux ($1.84 in chips) 
Seat 4: Quantum771 ($2.32 in chips) 
Seat 5: FishOnPlate ($2.12 in chips) 
Seat 6: Scaaalll ($2.06 in chips) 
KIraMan: posts small blind $0.01
Gibsondelux: posts big blind $0.02
*** HOLE CARDS ***
Dealt to Scaaalll [Jc Qc]
Quantum771: folds 
FishOnPlate: folds 
Scaaalll: raises $0.04 to $0.06
rodrigoasor: folds 
KIraMan: folds 
Gibsondelux: folds 
Uncalled bet ($0.04) returned to Scaaalll
Scaaalll collected $0.05 from pot
Scaaalll: doesn't show hand 
Gibsondelux is disconnected 
*** SUMMARY ***
Total pot $0.05 | Rake $0 
Seat 1: rodrigoasor (button) folded before Flop (didn't bet)
Seat 2: KIraMan (small blind) folded before Flop
Seat 3: Gibsondelux (big blind) folded before Flop
Seat 4: Quantum771 folded before Flop (didn't bet)
Seat 5: FishOnPlate folded before Flop (didn't bet)
Seat 6: Scaaalll collected ($0.05)



PokerStars Zoom Hand #229229541903:  Hold'em No Limit ($0.01/$0.02) - 2021/08/21 21:04:51 CET [2021/08/21 15:04:51 ET]
Table 'Halley' 6-max Seat #1 is the button
Seat 1: Scaaalll ($2.06 in chips) 
Seat 2: Superfish I ($2.59 in chips) 
Seat 3: pphit ($2.40 in chips) 
Seat 4: gugamoraes ($2.03 in chips) 
Seat 5: renova0813 ($8.26 in chips) 
Seat 6: ctaceo ($2.30 in chips) 
Superfish I: posts small blind $0.01
pphit: posts big blind $0.02
*** HOLE CARDS ***
Dealt to Scaaalll [8h 6s]
gugamoraes: folds 
renova0813: raises $0.04 to $0.06
ctaceo: folds 
Scaaalll: folds 
Superfish I: folds 
pphit: folds 
Uncalled bet ($0.04) returned to renova0813
renova0813 collected $0.05 from pot
renova0813: doesn't show hand 
*** SUMMARY ***
Total pot $0.05 | Rake $0 
Seat 1: Scaaalll (button) folded before Flop (didn't bet)
Seat 2: Superfish I (small blind) folded before Flop
Seat 3: pphit (big blind) folded before Flop
Seat 4: gugamoraes folded before Flop (didn't bet)
Seat 5: renova0813 collected ($0.05)
Seat 6: ctaceo folded before Flop (didn't bet)



PokerStars Zoom Hand #229229514388:  Hold'em No Limit ($0.01/$0.02) - 2021/08/21 21:03:49 CET [2021/08/21 15:03:49 ET]
Table 'Halley' 6-max Seat #1 is the button
Seat 1: ximik D V ($2.25 in chips) 
Seat 2: WithMyWalker ($2.43 in chips) 
Seat 3: Scaaalll ($2.09 in chips) 
Seat 4: yositoas ($5.54 in chips) 
Seat 5: Shadi8 ($3.38 in chips) 
Seat 6: PlayPokerHappy1 ($2.10 in chips) 
WithMyWalker: posts small blind $0.01
Scaaalll: posts big blind $0.02
*** HOLE CARDS ***
Dealt to Scaaalll [3d 9c]
yositoas: folds 
Shadi8: folds 
PlayPokerHappy1: folds 
ximik D V: raises $0.04 to $0.06
WithMyWalker: calls $0.05
Scaaalll: folds 
*** FLOP *** [Qs Jd 2h]
WithMyWalker: checks 
ximik D V: bets $0.09
WithMyWalker: calls $0.09
*** TURN *** [Qs Jd 2h] [2s]
WithMyWalker: checks 
ximik D V: checks 
*** RIVER *** [Qs Jd 2h 2s] [4s]
WithMyWalker: checks 
ximik D V: checks 
*** SHOW DOWN ***
WithMyWalker: shows [Th 9h] (a pair of Deuces)
ximik D V: shows [Ah 5c] (a pair of Deuces - Ace kicker)
ximik D V collected $0.31 from pot
*** SUMMARY ***
Total pot $0.32 | Rake $0.01 
Board [Qs Jd 2h 2s 4s]
Seat 1: ximik D V (button) showed [Ah 5c] and won ($0.31) with a pair of Deuces
Seat 2: WithMyWalker (small blind) showed [Th 9h] and lost with a pair of Deuces
Seat 3: Scaaalll (big blind) folded before Flop
Seat 4: yositoas folded before Flop (didn't bet)
Seat 5: Shadi8 folded before Flop (didn't bet)
Seat 6: PlayPokerHappy1 folded before Flop (didn't bet)



PokerStars Zoom Hand #229229558891:  Hold'em No Limit ($0.01/$0.02) - 2021/08/21 21:05:29 CET [2021/08/21 15:05:29 ET]
Table 'Halley' 6-max Seat #1 is the button
Seat 1: yositoas ($5.02 in chips) 
Seat 2: der Kater464 ($3.33 in chips) 
Seat 3: Scaaalll ($2.08 in chips) 
Seat 4: Stormzilla ($2.02 in chips) 
Seat 5: cord86 ($2.08 in chips) 
Seat 6: Sarmatrus79 ($2.10 in chips) 
der Kater464: posts small blind $0.01
Scaaalll: posts big blind $0.02
*** HOLE CARDS ***
Dealt to Scaaalll [Kd 6s]
Stormzilla: folds 
cord86: folds 
Sarmatrus79: folds 
yositoas: folds 
der Kater464: raises $0.02 to $0.04
Scaaalll: folds 
Uncalled bet ($0.02) returned to der Kater464
der Kater464 collected $0.04 from pot
der Kater464: doesn't show hand 
*** SUMMARY ***
Total pot $0.04 | Rake $0 
Seat 1: yositoas (button) folded before Flop (didn't bet)
Seat 2: der Kater464 (small blind) collected ($0.04)
Seat 3: Scaaalll (big blind) folded before Flop
Seat 4: Stormzilla folded before Flop (didn't bet)
Seat 5: cord86 folded before Flop (didn't bet)
Seat 6: Sarmatrus79 folded before Flop (didn't bet)



PokerStars Zoom Hand #229229552161:  Hold'em No Limit ($0.01/$0.02) - 2021/08/21 21:05:14 CET [2021/08/21 15:05:14 ET]
Table 'Halley' 6-max Seat #1 is the button
Seat 1: RoughRafff ($2 in chips) 
Seat 2: Scaaalll ($2.09 in chips) 
Seat 3: Mr_gama2019 ($2.39 in chips) 
Seat 4: Allekccc ($2.40 in chips) 
Seat 5: 78joniboy ($3.59 in chips) 
Seat 6: Kb013497 ($2.98 in chips) 
Scaaalll: posts small blind $0.01
Mr_gama2019: posts big blind $0.02
*** HOLE CARDS ***
Dealt to Scaaalll [6h 5s]
Allekccc: folds 
78joniboy: raises $0.04 to $0.06
Kb013497: folds 
RoughRafff: folds 
Scaaalll: folds 
Mr_gama2019: raises $0.04 to $0.10
78joniboy: calls $0.04
*** FLOP *** [Ac 5c 5d]
Mr_gama2019: checks 
78joniboy: checks 
*** TURN *** [Ac 5c 5d] [8h]
Mr_gama2019: checks 
78joniboy: checks 
*** RIVER *** [Ac 5c 5d 8h] [4c]
Mr_gama2019: checks 
78joniboy: bets $0.15
Mr_gama2019: folds 
Uncalled bet ($0.15) returned to 78joniboy
78joniboy collected $0.20 from pot
78joniboy: doesn't show hand 
Mr_gama2019 is disconnected 
*** SUMMARY ***
Total pot $0.21 | Rake $0.01 
Board [Ac 5c 5d 8h 4c]
Seat 1: RoughRafff (button) folded before Flop (didn't bet)
Seat 2: Scaaalll (small blind) folded before Flop
Seat 3: Mr_gama2019 (big blind) folded on the River
Seat 4: Allekccc folded before Flop (didn't bet)
Seat 5: 78joniboy collected ($0.20)
Seat 6: Kb013497 folded before Flop (didn't bet)



PokerStars Zoom Hand #229229557074:  Hold'em No Limit ($0.01/$0.02) - 2021/08/21 21:05:25 CET [2021/08/21 15:05:25 ET]
Table 'Halley' 6-max Seat #1 is the button
Seat 1: Natali172737 ($3.04 in chips) 
Seat 2: Quantum771 ($2.29 in chips) 
Seat 3: S.B.O190 ($2.73 in chips) 
Seat 4: the.fire71 ($2.52 in chips) 
Seat 5: Scaaalll ($2.08 in chips) 
Seat 6: beber_1613 ($2.27 in chips) 
Quantum771: posts small blind $0.01
S.B.O190: posts big blind $0.02
*** HOLE CARDS ***
Dealt to Scaaalll [Kd 2h]
the.fire71: folds 
Scaaalll: folds 
beber_1613: folds 
Natali172737: folds 
Quantum771: raises $0.03 to $0.05
S.B.O190: calls $0.03
*** FLOP *** [7c 7d 5s]
Quantum771: bets $0.04
S.B.O190: calls $0.04
*** TURN *** [7c 7d 5s] [6d]
Quantum771: checks 
S.B.O190: bets $0.08
Quantum771: folds 
Uncalled bet ($0.08) returned to S.B.O190
S.B.O190 collected $0.17 from pot
S.B.O190: doesn't show hand 
*** SUMMARY ***
Total pot $0.18 | Rake $0.01 
Board [7c 7d 5s 6d]
Seat 1: Natali172737 (button) folded before Flop (didn't bet)
Seat 2: Quantum771 (small blind) folded on the Turn
Seat 3: S.B.O190 (big blind) collected ($0.17)
Seat 4: the.fire71 folded before Flop (didn't bet)
Seat 5: Scaaalll folded before Flop (didn't bet)
Seat 6: beber_1613 folded before Flop (didn't bet)



PokerStars Zoom Hand #229229567576:  Hold'em No Limit ($0.01/$0.02) - 2021/08/21 21:05:48 CET [2021/08/21 15:05:48 ET]
Table 'Halley' 6-max Seat #1 is the button
Seat 1: flexitunes ($2.12 in chips) 
Seat 2: lexus00174 ($3.28 in chips) 
Seat 3: MrK_Leuven ($2.81 in chips) 
Seat 4: Scaaalll ($2.06 in chips) 
Seat 5: Sergio14b ($2 in chips) 
Seat 6: hajtukanyar ($1.01 in chips) 
lexus00174: posts small blind $0.01
MrK_Leuven: posts big blind $0.02
*** HOLE CARDS ***
Dealt to Scaaalll [2d 7h]
Scaaalll: folds 
Sergio14b: folds 
hajtukanyar: folds 
flexitunes: folds 
lexus00174: raises $0.04 to $0.06
MrK_Leuven: folds 
Uncalled bet ($0.04) returned to lexus00174
lexus00174 collected $0.04 from pot
lexus00174: doesn't show hand 
*** SUMMARY ***
Total pot $0.04 | Rake $0 
Seat 1: flexitunes (button) folded before Flop (didn't bet)
Seat 2: lexus00174 (small blind) collected ($0.04)
Seat 3: MrK_Leuven (big blind) folded before Flop
Seat 4: Scaaalll folded before Flop (didn't bet)
Seat 5: Sergio14b folded before Flop (didn't bet)
Seat 6: hajtukanyar folded before Flop (didn't bet)



PokerStars Zoom Hand #229229569371:  Hold'em No Limit ($0.01/$0.02) - 2021/08/21 21:05:52 CET [2021/08/21 15:05:52 ET]
Table 'Halley' 6-max Seat #1 is the button
Seat 1: Roubyz ($1.98 in chips) 
Seat 2: Shadi8 ($2.30 in chips) 
Seat 3: jaamonra ($3.94 in chips) 
Seat 4: Scaaalll ($2.06 in chips) 
Seat 5: ctaceo ($2.08 in chips) 
Seat 6: lyapis75 ($2.14 in chips) 
Shadi8: posts small blind $0.01
jaamonra: posts big blind $0.02
*** HOLE CARDS ***
Dealt to Scaaalll [9d 2d]
Roubyz is disconnected 
Scaaalll: folds 
ctaceo: raises $0.03 to $0.05
lyapis75: folds 
Roubyz: folds 
Shadi8: folds 
jaamonra: folds 
Uncalled bet ($0.03) returned to ctaceo
ctaceo collected $0.05 from pot
ctaceo: doesn't show hand 
*** SUMMARY ***
Total pot $0.05 | Rake $0 
Seat 1: Roubyz (button) folded before Flop (didn't bet)
Seat 2: Shadi8 (small blind) folded before Flop
Seat 3: jaamonra (big blind) folded before Flop
Seat 4: Scaaalll folded before Flop (didn't bet)
Seat 5: ctaceo collected ($0.05)
Seat 6: lyapis75 folded before Flop (didn't bet)



PokerStars Zoom Hand #229229602429:  Hold'em No Limit ($0.01/$0.02) - 2021/08/21 21:07:05 CET [2021/08/21 15:07:05 ET]
Table 'Halley' 6-max Seat #1 is the button
Seat 1: Gerar NB ($2 in chips) 
Seat 2: Shadi8 ($2 in chips) 
Seat 3: gepard35 ($2.28 in chips) 
Seat 4: Scaaalll ($2.02 in chips) 
Seat 5: Natali172737 ($2.95 in chips) 
Seat 6: HellNative ($2.64 in chips) 
Shadi8: posts small blind $0.01
gepard35: posts big blind $0.02
*** HOLE CARDS ***
Dealt to Scaaalll [Qd Ts]
Scaaalll: folds 
Natali172737: folds 
HellNative: folds 
Gerar NB: folds 
Shadi8: folds 
Uncalled bet ($0.01) returned to gepard35
gepard35 collected $0.02 from pot
gepard35: doesn't show hand 
*** SUMMARY ***
Total pot $0.02 | Rake $0 
Seat 1: Gerar NB (button) folded before Flop (didn't bet)
Seat 2: Shadi8 (small blind) folded before Flop
Seat 3: gepard35 (big blind) collected ($0.02)
Seat 4: Scaaalll folded before Flop (didn't bet)
Seat 5: Natali172737 folded before Flop (didn't bet)
Seat 6: HellNative folded before Flop (didn't bet)



PokerStars Zoom Hand #229229572500:  Hold'em No Limit ($0.01/$0.02) - 2021/08/21 21:05:59 CET [2021/08/21 15:05:59 ET]
Table 'Halley' 6-max Seat #1 is the button
Seat 1: Scaaalll ($2.06 in chips) 
Seat 2: slime88 ($0.95 in chips) 
Seat 3: Hornet089 ($2.02 in chips) 
Seat 4: officesu ($2.56 in chips) 
Seat 5: KKARMELO ($2.46 in chips) 
Seat 6: bigthereal ($2.16 in chips) 
slime88: posts small blind $0.01
Hornet089: posts big blind $0.02
*** HOLE CARDS ***
Dealt to Scaaalll [6d Ad]
officesu: folds 
KKARMELO: folds 
bigthereal: folds 
Scaaalll: raises $0.02 to $0.04
slime88: calls $0.03
Hornet089: calls $0.02
*** FLOP *** [Kh 7s 5s]
slime88: checks 
Hornet089: checks 
Scaaalll: checks 
*** TURN *** [Kh 7s 5s] [Jd]
slime88: checks 
Hornet089: checks 
Scaaalll: checks 
*** RIVER *** [Kh 7s 5s Jd] [5d]
slime88: checks 
Hornet089: bets $0.02
Scaaalll: folds 
slime88: raises $0.08 to $0.10
Hornet089: folds 
Uncalled bet ($0.08) returned to slime88
slime88 collected $0.15 from pot
slime88: doesn't show hand 
*** SUMMARY ***
Total pot $0.16 | Rake $0.01 
Board [Kh 7s 5s Jd 5d]
Seat 1: Scaaalll (button) folded on the River
Seat 2: slime88 (small blind) collected ($0.15)
Seat 3: Hornet089 (big blind) folded on the River
Seat 4: officesu folded before Flop (didn't bet)
Seat 5: KKARMELO folded before Flop (didn't bet)
Seat 6: bigthereal folded before Flop (didn't bet)



PokerStars Zoom Hand #229229604184:  Hold'em No Limit ($0.01/$0.02) - 2021/08/21 21:07:09 CET [2021/08/21 15:07:09 ET]
Table 'Halley' 6-max Seat #1 is the button
Seat 1: gepard35 ($2 in chips) 
Seat 2: MyWinCash ($2 in chips) 
Seat 3: Scaaalll ($2.02 in chips) 
Seat 4: man070707 ($0.19 in chips) 
Seat 5: rpycmbEM ($2.42 in chips) 
Seat 6: Salazar-MF ($2.10 in chips) 
MyWinCash: posts small blind $0.01
Scaaalll: posts big blind $0.02
*** HOLE CARDS ***
Dealt to Scaaalll [7s As]
man070707: folds 
rpycmbEM: folds 
Salazar-MF: folds 
man070707 is disconnected 
gepard35: raises $0.03 to $0.05
MyWinCash: raises $0.19 to $0.24
Scaaalll: folds 
gepard35: calls $0.19
*** FLOP *** [8d 3h Ah]
MyWinCash: bets $0.16
gepard35: folds 
Uncalled bet ($0.16) returned to MyWinCash
MyWinCash collected $0.48 from pot
MyWinCash: doesn't show hand 
*** SUMMARY ***
Total pot $0.50 | Rake $0.02 
Board [8d 3h Ah]
Seat 1: gepard35 (button) folded on the Flop
Seat 2: MyWinCash (small blind) collected ($0.48)
Seat 3: Scaaalll (big blind) folded before Flop
Seat 4: man070707 folded before Flop (didn't bet)
Seat 5: rpycmbEM folded before Flop (didn't bet)
Seat 6: Salazar-MF folded before Flop (didn't bet)



PokerStars Zoom Hand #229229614721:  Hold'em No Limit ($0.01/$0.02) - 2021/08/21 21:07:32 CET [2021/08/21 15:07:32 ET]
Table 'Halley' 6-max Seat #1 is the button
Seat 1: saul_good246 ($2 in chips) 
Seat 2: Scaaalll ($2 in chips) 
Seat 3: Quad Jacks21 ($2 in chips) 
Seat 4: Dominykas ($1.54 in chips) 
Seat 5: MrK_Leuven ($2.96 in chips) 
Seat 6: iPitbull1 ($2.60 in chips) 
Scaaalll: posts small blind $0.01
Quad Jacks21: posts big blind $0.02
*** HOLE CARDS ***
Dealt to Scaaalll [Jd Ts]
Dominykas: folds 
MrK_Leuven: folds 
iPitbull1: folds 
saul_good246: folds 
Scaaalll: raises $0.04 to $0.06
Quad Jacks21: calls $0.04
*** FLOP *** [2c 9c Ks]
Scaaalll: bets $0.08
Quad Jacks21: calls $0.08
*** TURN *** [2c 9c Ks] [Ah]
Scaaalll: bets $0.18
Quad Jacks21: raises $0.35 to $0.53
Scaaalll: folds 
Uncalled bet ($0.35) returned to Quad Jacks21
Quad Jacks21 collected $0.62 from pot
Quad Jacks21: doesn't show hand 
*** SUMMARY ***
Total pot $0.64 | Rake $0.02 
Board [2c 9c Ks Ah]
Seat 1: saul_good246 (button) folded before Flop (didn't bet)
Seat 2: Scaaalll (small blind) folded on the Turn
Seat 3: Quad Jacks21 (big blind) collected ($0.62)
Seat 4: Dominykas folded before Flop (didn't bet)
Seat 5: MrK_Leuven folded before Flop (didn't bet)
Seat 6: iPitbull1 folded before Flop (didn't bet)



PokerStars Zoom Hand #229229642059:  Hold'em No Limit ($0.01/$0.02) - 2021/08/21 21:08:33 CET [2021/08/21 15:08:33 ET]
Table 'Halley' 6-max Seat #1 is the button
Seat 1: Scaaalll ($2 in chips) 
Seat 2: Haraldo550 ($2.01 in chips) 
Seat 3: Mikalai M. ($0.16 in chips) 
Seat 4: Slirey ($2.03 in chips) 
Seat 5: majo_74 ($2.13 in chips) 
Seat 6: xxRoseIloveu ($1.48 in chips) 
Haraldo550: posts small blind $0.01
Mikalai M.: posts big blind $0.02
*** HOLE CARDS ***
Dealt to Scaaalll [6s Ks]
Slirey: folds 
Slirey is disconnected 
majo_74: folds 
xxRoseIloveu: folds 
Scaaalll: raises $0.02 to $0.04
Haraldo550: folds 
Haraldo550 is disconnected 
Mikalai M.: calls $0.02
*** FLOP *** [2d Ah Jh]
Mikalai M.: checks 
Scaaalll: bets $0.06
Mikalai M.: folds 
Uncalled bet ($0.06) returned to Scaaalll
Scaaalll collected $0.09 from pot
Scaaalll: doesn't show hand 
Mikalai M. is disconnected 
*** SUMMARY ***
Total pot $0.09 | Rake $0 
Board [2d Ah Jh]
Seat 1: Scaaalll (button) collected ($0.09)
Seat 2: Haraldo550 (small blind) folded before Flop
Seat 3: Mikalai M. (big blind) folded on the Flop
Seat 4: Slirey folded before Flop (didn't bet)
Seat 5: majo_74 folded before Flop (didn't bet)
Seat 6: xxRoseIloveu folded before Flop (didn't bet)



PokerStars Zoom Hand #229229659743:  Hold'em No Limit ($0.01/$0.02) - 2021/08/21 21:09:11 CET [2021/08/21 15:09:11 ET]
Table 'Halley' 6-max Seat #1 is the button
Seat 1: arsad725 ($8.22 in chips) 
Seat 2: SideshowPen ($2.13 in chips) 
Seat 3: japinhaguara ($2 in chips) 
Seat 4: ignat-of 777 ($0.76 in chips) 
Seat 5: Scaaalll ($2.05 in chips) 
Seat 6: Roubyz ($1.85 in chips) 
SideshowPen: posts small blind $0.01
japinhaguara: posts big blind $0.02
*** HOLE CARDS ***
Dealt to Scaaalll [7d 7c]
Roubyz is disconnected 
ignat-of 777: folds 
Scaaalll: raises $0.04 to $0.06
Roubyz: folds 
arsad725: folds 
SideshowPen: folds 
japinhaguara: folds 
Uncalled bet ($0.04) returned to Scaaalll
Scaaalll collected $0.05 from pot
Scaaalll: doesn't show hand 
*** SUMMARY ***
Total pot $0.05 | Rake $0 
Seat 1: arsad725 (button) folded before Flop (didn't bet)
Seat 2: SideshowPen (small blind) folded before Flop
Seat 3: japinhaguara (big blind) folded before Flop
Seat 4: ignat-of 777 folded before Flop (didn't bet)
Seat 5: Scaaalll collected ($0.05)
Seat 6: Roubyz folded before Flop (didn't bet)



PokerStars Zoom Hand #229229632983:  Hold'em No Limit ($0.01/$0.02) - 2021/08/21 21:08:13 CET [2021/08/21 15:08:13 ET]
Table 'Halley' 6-max Seat #1 is the button
Seat 1: gresso0756 ($1.99 in chips) 
Seat 2: syndikkat ($2.43 in chips) 
Seat 3: sajd90 ($1 in chips) 
Seat 4: CASSIE21462 ($6.97 in chips) 
Seat 5: Salazar-MF ($2.06 in chips) 
Seat 6: Scaaalll ($2 in chips) 
syndikkat: posts small blind $0.01
sajd90: posts big blind $0.02
*** HOLE CARDS ***
Dealt to Scaaalll [7h Ah]
CASSIE21462: calls $0.02
Salazar-MF: raises $0.08 to $0.10
sajd90 is disconnected 
Scaaalll: folds 
gresso0756: folds 
syndikkat: folds 
sajd90: folds 
CASSIE21462: calls $0.08
*** FLOP *** [5h 8h 7s]
CASSIE21462: checks 
Salazar-MF: checks 
*** TURN *** [5h 8h 7s] [Ts]
CASSIE21462: checks 
Salazar-MF: bets $0.14
CASSIE21462: calls $0.14
*** RIVER *** [5h 8h 7s Ts] [8c]
CASSIE21462: checks 
Salazar-MF: bets $0.49
CASSIE21462: folds 
Uncalled bet ($0.49) returned to Salazar-MF
Salazar-MF collected $0.49 from pot
Salazar-MF: doesn't show hand 
*** SUMMARY ***
Total pot $0.51 | Rake $0.02 
Board [5h 8h 7s Ts 8c]
Seat 1: gresso0756 (button) folded before Flop (didn't bet)
Seat 2: syndikkat (small blind) folded before Flop
Seat 3: sajd90 (big blind) folded before Flop
Seat 4: CASSIE21462 folded on the River
Seat 5: Salazar-MF collected ($0.49)
Seat 6: Scaaalll folded before Flop (didn't bet)



PokerStars Zoom Hand #229229666094:  Hold'em No Limit ($0.01/$0.02) - 2021/08/21 21:09:25 CET [2021/08/21 15:09:25 ET]
Table 'Halley' 6-max Seat #1 is the button
Seat 1: maliniak75 ($2.02 in chips) 
Seat 2: kwant33 ($4.09 in chips) 
Seat 3: squidy4 ($4.62 in chips) 
Seat 4: Scaaalll ($2.08 in chips) 
Seat 5: vaaaala ($7.39 in chips) 
Seat 6: Shadi8 ($2.03 in chips) 
kwant33: posts small blind $0.01
squidy4: posts big blind $0.02
*** HOLE CARDS ***
Dealt to Scaaalll [3s 5h]
Scaaalll: folds 
vaaaala: folds 
Shadi8: raises $0.04 to $0.06
maliniak75: calls $0.06
kwant33: folds 
squidy4: folds 
*** FLOP *** [5c Js 7d]
Shadi8: bets $0.07
maliniak75: folds 
Uncalled bet ($0.07) returned to Shadi8
Shadi8 collected $0.14 from pot
Shadi8: doesn't show hand 
*** SUMMARY ***
Total pot $0.15 | Rake $0.01 
Board [5c Js 7d]
Seat 1: maliniak75 (button) folded on the Flop
Seat 2: kwant33 (small blind) folded before Flop
Seat 3: squidy4 (big blind) folded before Flop
Seat 4: Scaaalll folded before Flop (didn't bet)
Seat 5: vaaaala folded before Flop (didn't bet)
Seat 6: Shadi8 collected ($0.14)



PokerStars Zoom Hand #229229667883:  Hold'em No Limit ($0.01/$0.02) - 2021/08/21 21:09:29 CET [2021/08/21 15:09:29 ET]
Table 'Halley' 6-max Seat #1 is the button
Seat 1: flexitunes ($1.90 in chips) 
Seat 2: SIGREX ($2.06 in chips) 
Seat 3: Scaaalll ($2.08 in chips) 
Seat 4: S1fon4o ($0.92 in chips) 
Seat 5: MKIronCrAAzy ($5.23 in chips) 
Seat 6: Siyah Horoz ($5.13 in chips) 
SIGREX: posts small blind $0.01
Scaaalll: posts big blind $0.02
*** HOLE CARDS ***
Dealt to Scaaalll [Tc 8h]
S1fon4o: folds 
MKIronCrAAzy: folds 
Siyah Horoz: raises $0.04 to $0.06
flexitunes: folds 
SIGREX: folds 
Scaaalll: folds 
Uncalled bet ($0.04) returned to Siyah Horoz
Siyah Horoz collected $0.05 from pot
Siyah Horoz: doesn't show hand 
*** SUMMARY ***
Total pot $0.05 | Rake $0 
Seat 1: flexitunes (button) folded before Flop (didn't bet)
Seat 2: SIGREX (small blind) folded before Flop
Seat 3: Scaaalll (big blind) folded before Flop
Seat 4: S1fon4o folded before Flop (didn't bet)
Seat 5: MKIronCrAAzy folded before Flop (didn't bet)
Seat 6: Siyah Horoz collected ($0.05)



PokerStars Zoom Hand #229229679612:  Hold'em No Limit ($0.01/$0.02) - 2021/08/21 21:09:56 CET [2021/08/21 15:09:56 ET]
Table 'Halley' 6-max Seat #1 is the button
Seat 1: z1z2z315 ($1.06 in chips) 
Seat 2: Jonub ($2.44 in chips) 
Seat 3: Luk Hander ($1.62 in chips) 
Seat 4: kahzura ($2 in chips) 
Seat 5: pphit ($2.02 in chips) 
Seat 6: Scaaalll ($2.06 in chips) 
Jonub: posts small blind $0.01
Luk Hander: posts big blind $0.02
*** HOLE CARDS ***
Dealt to Scaaalll [3d 4h]
kahzura: folds 
pphit: folds 
Scaaalll: folds 
z1z2z315: folds 
Jonub: folds 
Uncalled bet ($0.01) returned to Luk Hander
Luk Hander collected $0.02 from pot
Luk Hander: doesn't show hand 
*** SUMMARY ***
Total pot $0.02 | Rake $0 
Seat 1: z1z2z315 (button) folded before Flop (didn't bet)
Seat 2: Jonub (small blind) folded before Flop
Seat 3: Luk Hander (big blind) collected ($0.02)
Seat 4: kahzura folded before Flop (didn't bet)
Seat 5: pphit folded before Flop (didn't bet)
Seat 6: Scaaalll folded before Flop (didn't bet)



PokerStars Zoom Hand #229229685419:  Hold'em No Limit ($0.01/$0.02) - 2021/08/21 21:10:08 CET [2021/08/21 15:10:08 ET]
Table 'Halley' 6-max Seat #1 is the button
Seat 1: rpycmbEM ($2.45 in chips) 
Seat 2: Ne0net ($2.03 in chips) 
Seat 3: PapaWago888 ($11.19 in chips) 
Seat 4: alecha11 ($3.20 in chips) 
Seat 5: Scaaalll ($2.05 in chips) 
Seat 6: 01527368 ($2.44 in chips) 
Ne0net: posts small blind $0.01
PapaWago888: posts big blind $0.02
*** HOLE CARDS ***
Dealt to Scaaalll [Jd Ah]
alecha11: folds 
Scaaalll: raises $0.04 to $0.06
PapaWago888 is disconnected 
01527368: calls $0.06
rpycmbEM: folds 
Ne0net: folds 
PapaWago888: folds 
*** FLOP *** [Qh 2d 5h]
Scaaalll: bets $0.08
01527368: folds 
Uncalled bet ($0.08) returned to Scaaalll
Scaaalll collected $0.14 from pot
Scaaalll: doesn't show hand 
*** SUMMARY ***
Total pot $0.15 | Rake $0.01 
Board [Qh 2d 5h]
Seat 1: rpycmbEM (button) folded before Flop (didn't bet)
Seat 2: Ne0net (small blind) folded before Flop
Seat 3: PapaWago888 (big blind) folded before Flop
Seat 4: alecha11 folded before Flop (didn't bet)
Seat 5: Scaaalll collected ($0.14)
Seat 6: 01527368 folded on the Flop



PokerStars Zoom Hand #229229682728:  Hold'em No Limit ($0.01/$0.02) - 2021/08/21 21:10:02 CET [2021/08/21 15:10:02 ET]
Table 'Halley' 6-max Seat #1 is the button
Seat 1: Jonub ($2.43 in chips) 
Seat 2: Scaaalll ($2.06 in chips) 
Seat 3: woetieman ($0.77 in chips) 
Seat 4: Henry Chinasky ($6.44 in chips) 
Seat 5: snowy_96 ($2.40 in chips) 
Seat 6: kahzura ($2 in chips) 
Scaaalll: posts small blind $0.01
woetieman: posts big blind $0.02
*** HOLE CARDS ***
Dealt to Scaaalll [8s Qh]
Henry Chinasky: folds 
snowy_96: raises $0.04 to $0.06
kahzura: folds 
Jonub: folds 
Scaaalll: folds 
woetieman: calls $0.04
*** FLOP *** [5s 2c 2s]
woetieman: checks 
snowy_96: checks 
*** TURN *** [5s 2c 2s] [7c]
woetieman: bets $0.04
snowy_96: calls $0.04
*** RIVER *** [5s 2c 2s 7c] [4h]
woetieman: bets $0.08
snowy_96: folds 
Uncalled bet ($0.08) returned to woetieman
woetieman collected $0.20 from pot
woetieman: doesn't show hand 
*** SUMMARY ***
Total pot $0.21 | Rake $0.01 
Board [5s 2c 2s 7c 4h]
Seat 1: Jonub (button) folded before Flop (didn't bet)
Seat 2: Scaaalll (small blind) folded before Flop
Seat 3: woetieman (big blind) collected ($0.20)
Seat 4: Henry Chinasky folded before Flop (didn't bet)
Seat 5: snowy_96 folded on the River
Seat 6: kahzura folded before Flop (didn't bet)



PokerStars Zoom Hand #229229692959:  Hold'em No Limit ($0.01/$0.02) - 2021/08/21 21:10:25 CET [2021/08/21 15:10:25 ET]
Table 'Halley' 6-max Seat #1 is the button
Seat 1: Scaaalll ($2.13 in chips) 
Seat 2: Sinad1302 ($3.19 in chips) 
Seat 3: Alexasha78 ($2.31 in chips) 
Seat 4: rekopo203 ($1.97 in chips) 
Seat 5: Stepanovap52 ($5.10 in chips) 
Seat 6: gresso0756 ($6.50 in chips) 
Sinad1302: posts small blind $0.01
Alexasha78: posts big blind $0.02
*** HOLE CARDS ***
Dealt to Scaaalll [9d Jd]
rekopo203: raises $0.04 to $0.06
Stepanovap52: folds 
Sinad1302 is disconnected 
gresso0756: calls $0.06
Alexasha78 is disconnected 
Scaaalll: calls $0.06
Sinad1302: folds 
Alexasha78: folds 
*** FLOP *** [6d 3d 8c]
rekopo203: bets $0.15
gresso0756: calls $0.15
Scaaalll: calls $0.15
*** TURN *** [6d 3d 8c] [7c]
rekopo203: bets $0.47
gresso0756: raises $0.47 to $0.94
Scaaalll: calls $0.94
rekopo203: raises $0.82 to $1.76 and is all-in
gresso0756: calls $0.82
Scaaalll: calls $0.82
*** RIVER *** [6d 3d 8c 7c] [4h]
gresso0756: checks 
Scaaalll: checks 
*** SHOW DOWN ***
rekopo203: shows [6s 6c] (three of a kind, Sixes)
gresso0756: mucks hand 
Scaaalll: mucks hand 
rekopo203 collected $5.73 from pot
*** SUMMARY ***
Total pot $5.94 | Rake $0.21 
Board [6d 3d 8c 7c 4h]
Seat 1: Scaaalll (button) mucked [9d Jd]
Seat 2: Sinad1302 (small blind) folded before Flop
Seat 3: Alexasha78 (big blind) folded before Flop
Seat 4: rekopo203 showed [6s 6c] and won ($5.73) with three of a kind, Sixes
Seat 5: Stepanovap52 folded before Flop (didn't bet)
Seat 6: gresso0756 mucked [7d 8d]



PokerStars Zoom Hand #229229729553:  Hold'em No Limit ($0.01/$0.02) - 2021/08/21 21:11:46 CET [2021/08/21 15:11:46 ET]
Table 'Halley' 6-max Seat #1 is the button
Seat 1: zergmiky ($2 in chips) 
Seat 2: CrazyyParis ($2.08 in chips) 
Seat 3: pavlo8855 ($2.08 in chips) 
Seat 4: Scaaalll ($2 in chips) 
Seat 5: Sul07 ($1.30 in chips) 
Seat 6: Laonikos ($4.01 in chips) 
CrazyyParis: posts small blind $0.01
pavlo8855: posts big blind $0.02
*** HOLE CARDS ***
Dealt to Scaaalll [Td Kc]
Scaaalll: raises $0.04 to $0.06
Sul07: folds 
Laonikos: folds 
zergmiky: folds 
CrazyyParis: folds 
pavlo8855: calls $0.04
*** FLOP *** [6d 9s 2s]
pavlo8855: checks 
Scaaalll: bets $0.08
pavlo8855: folds 
Uncalled bet ($0.08) returned to Scaaalll
Scaaalll collected $0.13 from pot
Scaaalll: doesn't show hand 
*** SUMMARY ***
Total pot $0.13 | Rake $0 
Board [6d 9s 2s]
Seat 1: zergmiky (button) folded before Flop (didn't bet)
Seat 2: CrazyyParis (small blind) folded before Flop
Seat 3: pavlo8855 (big blind) folded on the Flop
Seat 4: Scaaalll collected ($0.13)
Seat 5: Sul07 folded before Flop (didn't bet)
Seat 6: Laonikos folded before Flop (didn't bet)



PokerStars Zoom Hand #229229742305:  Hold'em No Limit ($0.01/$0.02) - 2021/08/21 21:12:14 CET [2021/08/21 15:12:14 ET]
Table 'Halley' 6-max Seat #1 is the button
Seat 1: jjjj135 ($0.97 in chips) 
Seat 2: miha.3108 ($1.56 in chips) 
Seat 3: Scaaalll ($2.07 in chips) 
Seat 4: bigthereal ($2.16 in chips) 
Seat 5: arsad725 ($3.19 in chips) 
Seat 6: 78joniboy ($2.01 in chips) 
miha.3108: posts small blind $0.01
Scaaalll: posts big blind $0.02
*** HOLE CARDS ***
Dealt to Scaaalll [Qd Kc]
bigthereal: raises $0.06 to $0.08
arsad725: folds 
78joniboy: folds 
jjjj135: folds 
miha.3108: folds 
Scaaalll: folds 
Uncalled bet ($0.06) returned to bigthereal
bigthereal collected $0.05 from pot
bigthereal: doesn't show hand 
*** SUMMARY ***
Total pot $0.05 | Rake $0 
Seat 1: jjjj135 (button) folded before Flop (didn't bet)
Seat 2: miha.3108 (small blind) folded before Flop
Seat 3: Scaaalll (big blind) folded before Flop
Seat 4: bigthereal collected ($0.05)
Seat 5: arsad725 folded before Flop (didn't bet)
Seat 6: 78joniboy folded before Flop (didn't bet)



PokerStars Zoom Hand #229229740410:  Hold'em No Limit ($0.01/$0.02) - 2021/08/21 21:12:11 CET [2021/08/21 15:12:11 ET]
Table 'Halley' 6-max Seat #1 is the button
Seat 1: alex2brok ($1.52 in chips) 
Seat 2: 77omsk ($5.78 in chips) 
Seat 3: PlayPokerHappy1 ($2.26 in chips) 
Seat 4: Jonub ($2.56 in chips) 
Seat 5: Scaaalll ($2.07 in chips) 
Seat 6: zergmiky ($2.17 in chips) 
77omsk: posts small blind $0.01
PlayPokerHappy1: posts big blind $0.02
*** HOLE CARDS ***
Dealt to Scaaalll [6s 3d]
Jonub: raises $0.03 to $0.05
Scaaalll: folds 
zergmiky: folds 
alex2brok: calls $0.05
77omsk: folds 
PlayPokerHappy1: calls $0.03
*** FLOP *** [Kh 9h Jd]
PlayPokerHappy1: checks 
Jonub: checks 
alex2brok: checks 
*** TURN *** [Kh 9h Jd] [9s]
PlayPokerHappy1: checks 
Jonub: checks 
alex2brok: bets $0.15
PlayPokerHappy1: folds 
Jonub: calls $0.15
*** RIVER *** [Kh 9h Jd 9s] [Kc]
Jonub: checks 
alex2brok: checks 
*** SHOW DOWN ***
Jonub: shows [Ah 7h] (two pair, Kings and Nines)
alex2brok: shows [Ac Jh] (two pair, Kings and Jacks)
alex2brok collected $0.44 from pot
*** SUMMARY ***
Total pot $0.46 | Rake $0.02 
Board [Kh 9h Jd 9s Kc]
Seat 1: alex2brok (button) showed [Ac Jh] and won ($0.44) with two pair, Kings and Jacks
Seat 2: 77omsk (small blind) folded before Flop
Seat 3: PlayPokerHappy1 (big blind) folded on the Turn
Seat 4: Jonub showed [Ah 7h] and lost with two pair, Kings and Nines
Seat 5: Scaaalll folded before Flop (didn't bet)
Seat 6: zergmiky folded before Flop (didn't bet)



PokerStars Zoom Hand #229229753165:  Hold'em No Limit ($0.01/$0.02) - 2021/08/21 21:12:38 CET [2021/08/21 15:12:38 ET]
Table 'Halley' 6-max Seat #1 is the button
Seat 1: AligatorsBlood ($2.83 in chips) 
Seat 2: Scaaalll ($2.05 in chips) 
Seat 3: Shadi8 ($3.37 in chips) 
Seat 4: R4DiUS030 ($1.92 in chips) 
Seat 5: Sv1ch ($1 in chips) 
Seat 6: no way yo ($1.97 in chips) 
Scaaalll: posts small blind $0.01
Shadi8: posts big blind $0.02
*** HOLE CARDS ***
Dealt to Scaaalll [Ad Jd]
R4DiUS030: raises $0.03 to $0.05
Sv1ch: raises $0.13 to $0.18
no way yo: folds 
AligatorsBlood: folds 
Scaaalll: folds 
Shadi8: folds 
R4DiUS030: calls $0.13
*** FLOP *** [3d Ks Ac]
R4DiUS030: bets $0.19
Sv1ch: raises $0.63 to $0.82 and is all-in
R4DiUS030: calls $0.63
*** TURN *** [3d Ks Ac] [9h]
*** RIVER *** [3d Ks Ac 9h] [7c]
*** SHOW DOWN ***
R4DiUS030: shows [Kc Ah] (two pair, Aces and Kings)
Sv1ch: shows [Qs Kh] (a pair of Kings)
R4DiUS030 collected $1.94 from pot
*** SUMMARY ***
Total pot $2.03 | Rake $0.09 
Board [3d Ks Ac 9h 7c]
Seat 1: AligatorsBlood (button) folded before Flop (didn't bet)
Seat 2: Scaaalll (small blind) folded before Flop
Seat 3: Shadi8 (big blind) folded before Flop
Seat 4: R4DiUS030 showed [Kc Ah] and won ($1.94) with two pair, Aces and Kings
Seat 5: Sv1ch showed [Qs Kh] and lost with a pair of Kings
Seat 6: no way yo folded before Flop (didn't bet)



PokerStars Zoom Hand #229229758694:  Hold'em No Limit ($0.01/$0.02) - 2021/08/21 21:12:50 CET [2021/08/21 15:12:50 ET]
Table 'Halley' 6-max Seat #1 is the button
Seat 1: EvilMoustache ($2.56 in chips) 
Seat 2: Loto70 ($3.61 in chips) 
Seat 3: belbo888 ($1.93 in chips) 
Seat 4: MyWinCash ($3.92 in chips) 
Seat 5: NecromiconP ($2.03 in chips) 
Seat 6: Scaaalll ($2.04 in chips) 
Loto70: posts small blind $0.01
belbo888: posts big blind $0.02
*** HOLE CARDS ***
Dealt to Scaaalll [4d 4s]
MyWinCash: folds 
NecromiconP: folds 
Scaaalll: raises $0.04 to $0.06
EvilMoustache: calls $0.06
Loto70: folds 
belbo888: folds 
*** FLOP *** [Tc 2d 3s]
Scaaalll: bets $0.08
EvilMoustache: raises $0.08 to $0.16
Scaaalll: folds 
Uncalled bet ($0.08) returned to EvilMoustache
EvilMoustache collected $0.30 from pot
EvilMoustache: doesn't show hand 
*** SUMMARY ***
Total pot $0.31 | Rake $0.01 
Board [Tc 2d 3s]
Seat 1: EvilMoustache (button) collected ($0.30)
Seat 2: Loto70 (small blind) folded before Flop
Seat 3: belbo888 (big blind) folded before Flop
Seat 4: MyWinCash folded before Flop (didn't bet)
Seat 5: NecromiconP folded before Flop (didn't bet)
Seat 6: Scaaalll folded on the Flop



PokerStars Zoom Hand #229229778345:  Hold'em No Limit ($0.01/$0.02) - 2021/08/21 21:13:33 CET [2021/08/21 15:13:33 ET]
Table 'Halley' 6-max Seat #1 is the button
Seat 1: FabOliveira9 ($2 in chips) 
Seat 2: S1fon4o ($0.98 in chips) 
Seat 3: Madaun ($0.44 in chips) 
Seat 4: 77omsk ($1.95 in chips) 
Seat 5: Scaaalll ($2 in chips) 
Seat 6: PaddyPoland ($2.24 in chips) 
S1fon4o: posts small blind $0.01
Madaun: posts big blind $0.02
*** HOLE CARDS ***
Dealt to Scaaalll [3s 6d]
77omsk: raises $0.03 to $0.05
Scaaalll: folds 
PaddyPoland: folds 
FabOliveira9: folds 
S1fon4o: folds 
Madaun: folds 
Uncalled bet ($0.03) returned to 77omsk
77omsk collected $0.05 from pot
77omsk: doesn't show hand 
*** SUMMARY ***
Total pot $0.05 | Rake $0 
Seat 1: FabOliveira9 (button) folded before Flop (didn't bet)
Seat 2: S1fon4o (small blind) folded before Flop
Seat 3: Madaun (big blind) folded before Flop
Seat 4: 77omsk collected ($0.05)
Seat 5: Scaaalll folded before Flop (didn't bet)
Seat 6: PaddyPoland folded before Flop (didn't bet)



PokerStars Zoom Hand #229229786994:  Hold'em No Limit ($0.01/$0.02) - 2021/08/21 21:13:52 CET [2021/08/21 15:13:52 ET]
Table 'Halley' 6-max Seat #1 is the button
Seat 1: SideshowPen ($2.21 in chips) 
Seat 2: Scaaalll ($2 in chips) 
Seat 3: kahzura ($2 in chips) 
Seat 4: Saint_ANBU ($2 in chips) 
Seat 5: Finderra ($3.70 in chips) 
Seat 6: ugi-dugi ($2 in chips) 
Scaaalll: posts small blind $0.01
kahzura: posts big blind $0.02
*** HOLE CARDS ***
Dealt to Scaaalll [7c Ts]
Saint_ANBU: raises $0.04 to $0.06
Finderra: folds 
ugi-dugi: folds 
SideshowPen: folds 
Scaaalll: folds 
kahzura: folds 
Uncalled bet ($0.04) returned to Saint_ANBU
Saint_ANBU collected $0.05 from pot
Saint_ANBU: doesn't show hand 
*** SUMMARY ***
Total pot $0.05 | Rake $0 
Seat 1: SideshowPen (button) folded before Flop (didn't bet)
Seat 2: Scaaalll (small blind) folded before Flop
Seat 3: kahzura (big blind) folded before Flop
Seat 4: Saint_ANBU collected ($0.05)
Seat 5: Finderra folded before Flop (didn't bet)
Seat 6: ugi-dugi folded before Flop (didn't bet)



PokerStars Zoom Hand #229229780539:  Hold'em No Limit ($0.01/$0.02) - 2021/08/21 21:13:38 CET [2021/08/21 15:13:38 ET]
Table 'Halley' 6-max Seat #1 is the button
Seat 1: NecromiconP ($2.48 in chips) 
Seat 2: superanton01 ($4.64 in chips) 
Seat 3: Scaaalll ($2 in chips) 
Seat 4: VisjePaktJe ($4.97 in chips) 
Seat 5: EvilMoustache ($2.72 in chips) 
Seat 6: Cid s2 ($1.01 in chips) 
superanton01: posts small blind $0.01
Scaaalll: posts big blind $0.02
*** HOLE CARDS ***
Dealt to Scaaalll [2s Qd]
VisjePaktJe: folds 
EvilMoustache: calls $0.02
Cid s2: raises $0.02 to $0.04
superanton01 is disconnected 
NecromiconP: calls $0.04
superanton01: folds 
Scaaalll: folds 
EvilMoustache: calls $0.02
*** FLOP *** [8s Qs 4s]
EvilMoustache: checks 
Cid s2: checks 
NecromiconP: bets $0.14
EvilMoustache: folds 
Cid s2: folds 
Uncalled bet ($0.14) returned to NecromiconP
NecromiconP collected $0.14 from pot
NecromiconP: doesn't show hand 
*** SUMMARY ***
Total pot $0.15 | Rake $0.01 
Board [8s Qs 4s]
Seat 1: NecromiconP (button) collected ($0.14)
Seat 2: superanton01 (small blind) folded before Flop
Seat 3: Scaaalll (big blind) folded before Flop
Seat 4: VisjePaktJe folded before Flop (didn't bet)
Seat 5: EvilMoustache folded on the Flop
Seat 6: Cid s2 folded on the Flop



PokerStars Zoom Hand #229229774696:  Hold'em No Limit ($0.01/$0.02) - 2021/08/21 21:13:25 CET [2021/08/21 15:13:25 ET]
Table 'Halley' 6-max Seat #1 is the button
Seat 1: Scaaalll ($2 in chips) 
Seat 2: beber_1613 ($2 in chips) 
Seat 3: Henry Chinasky ($1.72 in chips) 
Seat 4: 1_KoLizeI_1 ($2.39 in chips) 
Seat 5: danielschuel ($0.65 in chips) 
Seat 6: NecromiconP ($2.48 in chips) 
beber_1613: posts small blind $0.01
Henry Chinasky: posts big blind $0.02
*** HOLE CARDS ***
Dealt to Scaaalll [Jc 3c]
1_KoLizeI_1: folds 
danielschuel: raises $0.04 to $0.06
NecromiconP: folds 
Scaaalll: folds 
beber_1613: folds 
Henry Chinasky: calls $0.04
*** FLOP *** [Qh 7h 6s]
Henry Chinasky: bets $0.09
danielschuel: folds 
Uncalled bet ($0.09) returned to Henry Chinasky
Henry Chinasky collected $0.13 from pot
Henry Chinasky: doesn't show hand 
*** SUMMARY ***
Total pot $0.13 | Rake $0 
Board [Qh 7h 6s]
Seat 1: Scaaalll (button) folded before Flop (didn't bet)
Seat 2: beber_1613 (small blind) folded before Flop
Seat 3: Henry Chinasky (big blind) collected ($0.13)
Seat 4: 1_KoLizeI_1 folded before Flop (didn't bet)
Seat 5: danielschuel folded on the Flop
Seat 6: NecromiconP folded before Flop (didn't bet)



PokerStars Zoom Hand #229229785131:  Hold'em No Limit ($0.01/$0.02) - 2021/08/21 21:13:48 CET [2021/08/21 15:13:48 ET]
Table 'Halley' 6-max Seat #1 is the button
Seat 1: lucksuckdonk ($3 in chips) 
Seat 2: arsad725 ($8.21 in chips) 
Seat 3: S1fon4o ($0.97 in chips) 
Seat 4: leedsrounder ($3.70 in chips) 
Seat 5: greenthum33 ($4.32 in chips) 
Seat 6: Scaaalll ($2 in chips) 
arsad725: posts small blind $0.01
S1fon4o: posts big blind $0.02
*** HOLE CARDS ***
Dealt to Scaaalll [4c Td]
leedsrounder: folds 
greenthum33: raises $0.02 to $0.04
Scaaalll: folds 
lucksuckdonk: calls $0.04
arsad725: folds 
S1fon4o: folds 
*** FLOP *** [6c Kh Th]
greenthum33: checks 
lucksuckdonk: bets $0.07
greenthum33: folds 
Uncalled bet ($0.07) returned to lucksuckdonk
lucksuckdonk collected $0.11 from pot
lucksuckdonk: doesn't show hand 
*** SUMMARY ***
Total pot $0.11 | Rake $0 
Board [6c Kh Th]
Seat 1: lucksuckdonk (button) collected ($0.11)
Seat 2: arsad725 (small blind) folded before Flop
Seat 3: S1fon4o (big blind) folded before Flop
Seat 4: leedsrounder folded before Flop (didn't bet)
Seat 5: greenthum33 folded on the Flop
Seat 6: Scaaalll folded before Flop (didn't bet)



PokerStars Zoom Hand #229229788857:  Hold'em No Limit ($0.01/$0.02) - 2021/08/21 21:13:56 CET [2021/08/21 15:13:56 ET]
Table 'Halley' 6-max Seat #1 is the button
Seat 1: Sprot74 ($2 in chips) 
Seat 2: zizu1014 ($2.26 in chips) 
Seat 3: Healthys07 ($3.87 in chips) 
Seat 4: Scaaalll ($2 in chips) 
Seat 5: Tj741 ($2.08 in chips) 
Seat 6: IIDARKROBOTII ($2.46 in chips) 
zizu1014: posts small blind $0.01
Healthys07: posts big blind $0.02
*** HOLE CARDS ***
Dealt to Scaaalll [Ah Kc]
Scaaalll: raises $0.04 to $0.06
Tj741: folds 
IIDARKROBOTII: raises $0.04 to $0.10
Sprot74: folds 
zizu1014: folds 
Healthys07: folds 
Scaaalll: calls $0.04
*** FLOP *** [2d Ks 9h]
Scaaalll: checks 
IIDARKROBOTII: bets $0.11
Scaaalll: calls $0.11
*** TURN *** [2d Ks 9h] [Td]
Scaaalll: checks 
IIDARKROBOTII: checks 
*** RIVER *** [2d Ks 9h Td] [Th]
Scaaalll: bets $0.34
IIDARKROBOTII: folds 
Uncalled bet ($0.34) returned to Scaaalll
Scaaalll collected $0.43 from pot
Scaaalll: doesn't show hand 
IIDARKROBOTII is disconnected 
*** SUMMARY ***
Total pot $0.45 | Rake $0.02 
Board [2d Ks 9h Td Th]
Seat 1: Sprot74 (button) folded before Flop (didn't bet)
Seat 2: zizu1014 (small blind) folded before Flop
Seat 3: Healthys07 (big blind) folded before Flop
Seat 4: Scaaalll collected ($0.43)
Seat 5: Tj741 folded before Flop (didn't bet)
Seat 6: IIDARKROBOTII folded on the River



PokerStars Zoom Hand #229229822071:  Hold'em No Limit ($0.01/$0.02) - 2021/08/21 21:15:08 CET [2021/08/21 15:15:08 ET]
Table 'Halley' 6-max Seat #1 is the button
Seat 1: NecromiconP ($2 in chips) 
Seat 2: 2m4m4 ($0.89 in chips) 
Seat 3: Scaaalll ($2.22 in chips) 
Seat 4: SpartanRace1 ($9.16 in chips) 
Seat 5: egroj1700 ($2.21 in chips) 
Seat 6: Dominykas ($1.71 in chips) 
2m4m4: posts small blind $0.01
Scaaalll: posts big blind $0.02
*** HOLE CARDS ***
Dealt to Scaaalll [5d 9c]
SpartanRace1: folds 
egroj1700: raises $0.04 to $0.06
Dominykas: folds 
NecromiconP: folds 
2m4m4: folds 
Scaaalll: folds 
Uncalled bet ($0.04) returned to egroj1700
egroj1700 collected $0.05 from pot
egroj1700: doesn't show hand 
*** SUMMARY ***
Total pot $0.05 | Rake $0 
Seat 1: NecromiconP (button) folded before Flop (didn't bet)
Seat 2: 2m4m4 (small blind) folded before Flop
Seat 3: Scaaalll (big blind) folded before Flop
Seat 4: SpartanRace1 folded before Flop (didn't bet)
Seat 5: egroj1700 collected ($0.05)
Seat 6: Dominykas folded before Flop (didn't bet)



PokerStars Zoom Hand #229229818845:  Hold'em No Limit ($0.01/$0.02) - 2021/08/21 21:15:02 CET [2021/08/21 15:15:02 ET]
Table 'Halley' 6-max Seat #1 is the button
Seat 1: lyapis75 ($2 in chips) 
Seat 2: Baksit79 ($2.35 in chips) 
Seat 3: maliniak75 ($2.17 in chips) 
Seat 4: MrK_Leuven ($2.48 in chips) 
Seat 5: Scaaalll ($2.22 in chips) 
Seat 6: MyWinCash ($2.03 in chips) 
Baksit79: posts small blind $0.01
maliniak75: posts big blind $0.02
*** HOLE CARDS ***
Dealt to Scaaalll [3h 8h]
MrK_Leuven: folds 
Scaaalll: folds 
MyWinCash: folds 
lyapis75: folds 
Baksit79: raises $0.04 to $0.06
maliniak75: folds 
Uncalled bet ($0.04) returned to Baksit79
Baksit79 collected $0.04 from pot
Baksit79: doesn't show hand 
*** SUMMARY ***
Total pot $0.04 | Rake $0 
Seat 1: lyapis75 (button) folded before Flop (didn't bet)
Seat 2: Baksit79 (small blind) collected ($0.04)
Seat 3: maliniak75 (big blind) folded before Flop
Seat 4: MrK_Leuven folded before Flop (didn't bet)
Seat 5: Scaaalll folded before Flop (didn't bet)
Seat 6: MyWinCash folded before Flop (didn't bet)



PokerStars Zoom Hand #229229810637:  Hold'em No Limit ($0.01/$0.02) - 2021/08/21 21:14:45 CET [2021/08/21 15:14:45 ET]
Table 'Halley' 6-max Seat #1 is the button
Seat 1: Scaaalll ($2.22 in chips) 
Seat 2: 2m4m4 ($1.36 in chips) 
Seat 3: S.B.O190 ($11.75 in chips) 
Seat 4: RChinenov ($2.11 in chips) 
Seat 5: dorro61966 ($1.28 in chips) 
Seat 6: andreydgk ($2.10 in chips) 
2m4m4: posts small blind $0.01
S.B.O190: posts big blind $0.02
*** HOLE CARDS ***
Dealt to Scaaalll [Ts 8c]
RChinenov: folds 
dorro61966: calls $0.02
andreydgk: folds 
Scaaalll: folds 
2m4m4: folds 
S.B.O190: checks 
*** FLOP *** [4c 2h Qs]
S.B.O190: bets $0.03
dorro61966: folds 
Uncalled bet ($0.03) returned to S.B.O190
S.B.O190 collected $0.05 from pot
S.B.O190: doesn't show hand 
*** SUMMARY ***
Total pot $0.05 | Rake $0 
Board [4c 2h Qs]
Seat 1: Scaaalll (button) folded before Flop (didn't bet)
Seat 2: 2m4m4 (small blind) folded before Flop
Seat 3: S.B.O190 (big blind) collected ($0.05)
Seat 4: RChinenov folded before Flop (didn't bet)
Seat 5: dorro61966 folded on the Flop
Seat 6: andreydgk folded before Flop (didn't bet)



PokerStars Zoom Hand #229229826288:  Hold'em No Limit ($0.01/$0.02) - 2021/08/21 21:15:18 CET [2021/08/21 15:15:18 ET]
Table 'Halley' 6-max Seat #1 is the button
Seat 1: HARRY68rus ($1.86 in chips) 
Seat 2: keitho211 ($2 in chips) 
Seat 3: TICTAC06017 ($2.25 in chips) 
Seat 4: Zhyla95 ($1.99 in chips) 
Seat 5: rodrigoaduar ($0.92 in chips) 
Seat 6: Scaaalll ($2.20 in chips) 
keitho211: posts small blind $0.01
TICTAC06017: posts big blind $0.02
*** HOLE CARDS ***
Dealt to Scaaalll [Tc 2h]
Zhyla95: folds 
rodrigoaduar is disconnected 
rodrigoaduar is connected 
rodrigoaduar: folds 
Scaaalll: folds 
HARRY68rus: folds 
keitho211: folds 
Uncalled bet ($0.01) returned to TICTAC06017
rodrigoaduar is disconnected 
TICTAC06017 collected $0.02 from pot
TICTAC06017: doesn't show hand 
*** SUMMARY ***
Total pot $0.02 | Rake $0 
Seat 1: HARRY68rus (button) folded before Flop (didn't bet)
Seat 2: keitho211 (small blind) folded before Flop
Seat 3: TICTAC06017 (big blind) collected ($0.02)
Seat 4: Zhyla95 folded before Flop (didn't bet)
Seat 5: rodrigoaduar folded before Flop (didn't bet)
Seat 6: Scaaalll folded before Flop (didn't bet)



PokerStars Zoom Hand #229229828164:  Hold'em No Limit ($0.01/$0.02) - 2021/08/21 21:15:22 CET [2021/08/21 15:15:22 ET]
Table 'Halley' 6-max Seat #1 is the button
Seat 1: KKARMELO ($3.57 in chips) 
Seat 2: Shadi8 ($2.87 in chips) 
Seat 3: Zhyla95 ($1.99 in chips) 
Seat 4: Scaaalll ($2.20 in chips) 
Seat 5: PaddyPoland ($2.57 in chips) 
Seat 6: Gibsondelux ($1.97 in chips) 
Shadi8: posts small blind $0.01
Zhyla95: posts big blind $0.02
*** HOLE CARDS ***
Dealt to Scaaalll [8d 9c]
Scaaalll: folds 
PaddyPoland: raises $0.03 to $0.05
Gibsondelux: calls $0.05
KKARMELO: raises $0.20 to $0.25
Shadi8: folds 
Gibsondelux is disconnected 
Zhyla95: folds 
PaddyPoland: folds 
Gibsondelux: folds 
Uncalled bet ($0.20) returned to KKARMELO
KKARMELO collected $0.18 from pot
KKARMELO: doesn't show hand 
*** SUMMARY ***
Total pot $0.18 | Rake $0 
Seat 1: KKARMELO (button) collected ($0.18)
Seat 2: Shadi8 (small blind) folded before Flop
Seat 3: Zhyla95 (big blind) folded before Flop
Seat 4: Scaaalll folded before Flop (didn't bet)
Seat 5: PaddyPoland folded before Flop
Seat 6: Gibsondelux folded before Flop



PokerStars Zoom Hand #229229830443:  Hold'em No Limit ($0.01/$0.02) - 2021/08/21 21:15:26 CET [2021/08/21 15:15:26 ET]
Table 'Halley' 6-max Seat #1 is the button
Seat 1: Healthys07 ($6.04 in chips) 
Seat 2: Scaaalll ($2.20 in chips) 
Seat 3: amergedon ($2.99 in chips) 
Seat 4: Freedom176569 ($1.96 in chips) 
Seat 5: estelionat171 ($0.79 in chips) 
Seat 6: DUFFTDOG ($2.54 in chips) 
Scaaalll: posts small blind $0.01
amergedon: posts big blind $0.02
*** HOLE CARDS ***
Dealt to Scaaalll [9h Qd]
Freedom176569: folds 
estelionat171: folds 
DUFFTDOG: raises $0.03 to $0.05
Healthys07: folds 
Scaaalll: folds 
amergedon: raises $0.11 to $0.16
DUFFTDOG: calls $0.11
*** FLOP *** [Kd 9c Ks]
amergedon: checks 
DUFFTDOG: bets $0.24
amergedon: folds 
Uncalled bet ($0.24) returned to DUFFTDOG
DUFFTDOG collected $0.32 from pot
DUFFTDOG: doesn't show hand 
amergedon is disconnected 
*** SUMMARY ***
Total pot $0.33 | Rake $0.01 
Board [Kd 9c Ks]
Seat 1: Healthys07 (button) folded before Flop (didn't bet)
Seat 2: Scaaalll (small blind) folded before Flop
Seat 3: amergedon (big blind) folded on the Flop
Seat 4: Freedom176569 folded before Flop (didn't bet)
Seat 5: estelionat171 folded before Flop (didn't bet)
Seat 6: DUFFTDOG collected ($0.32)



PokerStars Zoom Hand #229229834084:  Hold'em No Limit ($0.01/$0.02) - 2021/08/21 21:15:35 CET [2021/08/21 15:15:35 ET]
Table 'Halley' 6-max Seat #1 is the button
Seat 1: Scaaalll ($2.19 in chips) 
Seat 2: ADWish ($1.22 in chips) 
Seat 3: CrazyyParis ($2.38 in chips) 
Seat 4: Roubyz ($1.97 in chips) 
Seat 5: mikiZGB ($3.60 in chips) 
Seat 6: bananAAbandit ($2.34 in chips) 
ADWish: posts small blind $0.01
CrazyyParis: posts big blind $0.02
*** HOLE CARDS ***
Dealt to Scaaalll [8s 7s]
Roubyz: folds 
Roubyz is disconnected 
mikiZGB: folds 
bananAAbandit: raises $0.04 to $0.06
Scaaalll: raises $0.12 to $0.18
ADWish: folds 
CrazyyParis: folds 
bananAAbandit: folds 
Uncalled bet ($0.12) returned to Scaaalll
Scaaalll collected $0.15 from pot
Scaaalll: doesn't show hand 
*** SUMMARY ***
Total pot $0.15 | Rake $0 
Seat 1: Scaaalll (button) collected ($0.15)
Seat 2: ADWish (small blind) folded before Flop
Seat 3: CrazyyParis (big blind) folded before Flop
Seat 4: Roubyz folded before Flop (didn't bet)
Seat 5: mikiZGB folded before Flop (didn't bet)
Seat 6: bananAAbandit folded before Flop



PokerStars Zoom Hand #229229844700:  Hold'em No Limit ($0.01/$0.02) - 2021/08/21 21:15:57 CET [2021/08/21 15:15:57 ET]
Table 'Halley' 6-max Seat #1 is the button
Seat 1: 77omsk ($5.78 in chips) 
Seat 2: Sinad1302 ($3.71 in chips) 
Seat 3: KoAlRy ($2.02 in chips) 
Seat 4: man070707 ($0.65 in chips) 
Seat 5: Scaaalll ($2.28 in chips) 
Seat 6: lexus00174 ($3.57 in chips) 
Sinad1302: posts small blind $0.01
KoAlRy: posts big blind $0.02
*** HOLE CARDS ***
Dealt to Scaaalll [Ac 2d]
man070707: folds 
man070707 is disconnected 
Scaaalll: folds 
lexus00174: folds 
77omsk: raises $0.03 to $0.05
Sinad1302: folds 
Sinad1302 is disconnected 
KoAlRy: folds 
Uncalled bet ($0.03) returned to 77omsk
77omsk collected $0.05 from pot
77omsk: doesn't show hand 
*** SUMMARY ***
Total pot $0.05 | Rake $0 
Seat 1: 77omsk (button) collected ($0.05)
Seat 2: Sinad1302 (small blind) folded before Flop
Seat 3: KoAlRy (big blind) folded before Flop
Seat 4: man070707 folded before Flop (didn't bet)
Seat 5: Scaaalll folded before Flop (didn't bet)
Seat 6: lexus00174 folded before Flop (didn't bet)



PokerStars Zoom Hand #229229849860:  Hold'em No Limit ($0.01/$0.02) - 2021/08/21 21:16:08 CET [2021/08/21 15:16:08 ET]
Table 'Halley' 6-max Seat #1 is the button
Seat 1: lagesz32 ($1.46 in chips) 
Seat 2: 91Grad ($1.98 in chips) 
Seat 3: Scaaalll ($2.28 in chips) 
Seat 4: Xlavariable ($2.15 in chips) 
Seat 5: HellNative ($4.67 in chips) 
Seat 6: bAttery01 ($2 in chips) 
91Grad: posts small blind $0.01
Scaaalll: posts big blind $0.02
*** HOLE CARDS ***
Dealt to Scaaalll [Js Qs]
Xlavariable: folds 
HellNative: folds 
bAttery01: folds 
lagesz32: raises $0.04 to $0.06
91Grad: calls $0.05
Scaaalll: calls $0.04
*** FLOP *** [3d Ts Jd]
91Grad: bets $0.06
Scaaalll: calls $0.06
lagesz32: folds 
*** TURN *** [3d Ts Jd] [4h]
lagesz32 is disconnected 
91Grad: checks 
Scaaalll: bets $0.18
91Grad: calls $0.18
*** RIVER *** [3d Ts Jd 4h] [4s]
91Grad: checks 
Scaaalll: checks 
*** SHOW DOWN ***
91Grad: shows [Td Ah] (two pair, Tens and Fours)
Scaaalll: shows [Js Qs] (two pair, Jacks and Fours)
Scaaalll collected $0.64 from pot
*** SUMMARY ***
Total pot $0.66 | Rake $0.02 
Board [3d Ts Jd 4h 4s]
Seat 1: lagesz32 (button) folded on the Flop
Seat 2: 91Grad (small blind) showed [Td Ah] and lost with two pair, Tens and Fours
Seat 3: Scaaalll (big blind) showed [Js Qs] and won ($0.64) with two pair, Jacks and Fours
Seat 4: Xlavariable folded before Flop (didn't bet)
Seat 5: HellNative folded before Flop (didn't bet)
Seat 6: bAttery01 folded before Flop (didn't bet)



PokerStars Zoom Hand #229229869495:  Hold'em No Limit ($0.01/$0.02) - 2021/08/21 21:16:51 CET [2021/08/21 15:16:51 ET]
Table 'Halley' 6-max Seat #1 is the button
Seat 1: MyWinCash ($2.07 in chips) 
Seat 2: Dutchie509 ($2.05 in chips) 
Seat 3: estelionat171 ($0.76 in chips) 
Seat 4: Scaaalll ($2.62 in chips) 
Seat 5: Sinad1302 ($3.75 in chips) 
Seat 6: Kergie ($2.09 in chips) 
Dutchie509: posts small blind $0.01
estelionat171: posts big blind $0.02
*** HOLE CARDS ***
Dealt to Scaaalll [Qs 2s]
Scaaalll: folds 
Sinad1302: raises $0.04 to $0.06
Kergie: folds 
MyWinCash: folds 
Dutchie509: folds 
estelionat171: folds 
Uncalled bet ($0.04) returned to Sinad1302
Sinad1302 collected $0.05 from pot
Sinad1302: doesn't show hand 
*** SUMMARY ***
Total pot $0.05 | Rake $0 
Seat 1: MyWinCash (button) folded before Flop (didn't bet)
Seat 2: Dutchie509 (small blind) folded before Flop
Seat 3: estelionat171 (big blind) folded before Flop
Seat 4: Scaaalll folded before Flop (didn't bet)
Seat 5: Sinad1302 collected ($0.05)
Seat 6: Kergie folded before Flop (didn't bet)



PokerStars Zoom Hand #229229871321:  Hold'em No Limit ($0.01/$0.02) - 2021/08/21 21:16:54 CET [2021/08/21 15:16:54 ET]
Table 'Halley' 6-max Seat #1 is the button
Seat 1: Scaaalll ($2.62 in chips) 
Seat 2: beber_1613 ($2 in chips) 
Seat 3: Sergio14b ($2 in chips) 
Seat 4: Hautkunst ($2.21 in chips) 
Seat 5: Nihility77 ($2 in chips) 
Seat 6: bananAAbandit ($5.14 in chips) 
beber_1613: posts small blind $0.01
Sergio14b: posts big blind $0.02
*** HOLE CARDS ***
Dealt to Scaaalll [2h As]
Hautkunst: folds 
Nihility77: folds 
Hautkunst is disconnected 
bananAAbandit: folds 
Scaaalll: folds 
beber_1613: folds 
Uncalled bet ($0.01) returned to Sergio14b
Sergio14b collected $0.02 from pot
Sergio14b: doesn't show hand 
*** SUMMARY ***
Total pot $0.02 | Rake $0 
Seat 1: Scaaalll (button) folded before Flop (didn't bet)
Seat 2: beber_1613 (small blind) folded before Flop
Seat 3: Sergio14b (big blind) collected ($0.02)
Seat 4: Hautkunst folded before Flop (didn't bet)
Seat 5: Nihility77 folded before Flop (didn't bet)
Seat 6: bananAAbandit folded before Flop (didn't bet)



PokerStars Zoom Hand #229229875530:  Hold'em No Limit ($0.01/$0.02) - 2021/08/21 21:17:03 CET [2021/08/21 15:17:03 ET]
Table 'Halley' 6-max Seat #1 is the button
Seat 1: Fedor_Gar ($3.64 in chips) 
Seat 2: Scaaalll ($2.62 in chips) 
Seat 3: loukon579 ($3.23 in chips) 
Seat 4: fishh_play ($2.04 in chips) 
Seat 5: valua976 ($1.30 in chips) 
Seat 6: Player XVII ($1.50 in chips) 
Scaaalll: posts small blind $0.01
loukon579: posts big blind $0.02
*** HOLE CARDS ***
Dealt to Scaaalll [4s 6s]
fishh_play: folds 
valua976: raises $0.03 to $0.05
Player XVII: folds 
Fedor_Gar: folds 
loukon579 is disconnected 
Scaaalll: folds 
loukon579: folds 
Uncalled bet ($0.03) returned to valua976
valua976 collected $0.05 from pot
valua976: doesn't show hand 
*** SUMMARY ***
Total pot $0.05 | Rake $0 
Seat 1: Fedor_Gar (button) folded before Flop (didn't bet)
Seat 2: Scaaalll (small blind) folded before Flop
Seat 3: loukon579 (big blind) folded before Flop
Seat 4: fishh_play folded before Flop (didn't bet)
Seat 5: valua976 collected ($0.05)
Seat 6: Player XVII folded before Flop (didn't bet)



PokerStars Zoom Hand #229229880146:  Hold'em No Limit ($0.01/$0.02) - 2021/08/21 21:17:13 CET [2021/08/21 15:17:13 ET]
Table 'Halley' 6-max Seat #1 is the button
Seat 1: Naraterre1 ($1.77 in chips) 
Seat 2: pers_ikG ($4.43 in chips) 
Seat 3: CrazyyParis ($2.03 in chips) 
Seat 4: vicctorlf ($1.13 in chips) 
Seat 5: wikkers ($2.30 in chips) 
Seat 6: Scaaalll ($2.61 in chips) 
pers_ikG: posts small blind $0.01
CrazyyParis: posts big blind $0.02
*** HOLE CARDS ***
Dealt to Scaaalll [Tc Qs]
Naraterre1 is disconnected 
vicctorlf: folds 
wikkers: folds 
Scaaalll: raises $0.04 to $0.06
Naraterre1: folds 
pers_ikG: folds 
CrazyyParis: folds 
Uncalled bet ($0.04) returned to Scaaalll
Scaaalll collected $0.05 from pot
Scaaalll: doesn't show hand 
*** SUMMARY ***
Total pot $0.05 | Rake $0 
Seat 1: Naraterre1 (button) folded before Flop (didn't bet)
Seat 2: pers_ikG (small blind) folded before Flop
Seat 3: CrazyyParis (big blind) folded before Flop
Seat 4: vicctorlf folded before Flop (didn't bet)
Seat 5: wikkers folded before Flop (didn't bet)
Seat 6: Scaaalll collected ($0.05)



PokerStars Zoom Hand #229229889036:  Hold'em No Limit ($0.01/$0.02) - 2021/08/21 21:17:33 CET [2021/08/21 15:17:33 ET]
Table 'Halley' 6-max Seat #1 is the button
Seat 1: Sprot74 ($2.33 in chips) 
Seat 2: Koldun 2636 ($2 in chips) 
Seat 3: Stormzilla ($2 in chips) 
Seat 4: 78joniboy ($2.88 in chips) 
Seat 5: Scaaalll ($2.64 in chips) 
Seat 6: 77omsk ($6.19 in chips) 
Koldun 2636: posts small blind $0.01
Stormzilla: posts big blind $0.02
*** HOLE CARDS ***
Dealt to Scaaalll [3s Kd]
78joniboy: folds 
Scaaalll: folds 
77omsk: folds 
Sprot74: folds 
Koldun 2636: folds 
Uncalled bet ($0.01) returned to Stormzilla
Stormzilla collected $0.02 from pot
Stormzilla: doesn't show hand 
*** SUMMARY ***
Total pot $0.02 | Rake $0 
Seat 1: Sprot74 (button) folded before Flop (didn't bet)
Seat 2: Koldun 2636 (small blind) folded before Flop
Seat 3: Stormzilla (big blind) collected ($0.02)
Seat 4: 78joniboy folded before Flop (didn't bet)
Seat 5: Scaaalll folded before Flop (didn't bet)
Seat 6: 77omsk folded before Flop (didn't bet)



PokerStars Zoom Hand #229229891378:  Hold'em No Limit ($0.01/$0.02) - 2021/08/21 21:17:37 CET [2021/08/21 15:17:37 ET]
Table 'Halley' 6-max Seat #1 is the button
Seat 1: yannikdaehne ($5.09 in chips) 
Seat 2: Fedor_Gar ($3.62 in chips) 
Seat 3: Scaaalll ($2.64 in chips) 
Seat 4: lsd paper ($0.93 in chips) 
Seat 5: ser313131 ($2 in chips) 
Seat 6: Victor151886 ($3.22 in chips) 
Fedor_Gar: posts small blind $0.01
Scaaalll: posts big blind $0.02
*** HOLE CARDS ***
Dealt to Scaaalll [9d 2h]
lsd paper: folds 
ser313131: folds 
lsd paper is disconnected 
Victor151886: folds 
yannikdaehne: raises $0.03 to $0.05
Fedor_Gar: folds 
Scaaalll: folds 
Uncalled bet ($0.03) returned to yannikdaehne
yannikdaehne collected $0.05 from pot
yannikdaehne: doesn't show hand 
*** SUMMARY ***
Total pot $0.05 | Rake $0 
Seat 1: yannikdaehne (button) collected ($0.05)
Seat 2: Fedor_Gar (small blind) folded before Flop
Seat 3: Scaaalll (big blind) folded before Flop
Seat 4: lsd paper folded before Flop (didn't bet)
Seat 5: ser313131 folded before Flop (didn't bet)
Seat 6: Victor151886 folded before Flop (didn't bet)



PokerStars Zoom Hand #229229914342:  Hold'em No Limit ($0.01/$0.02) - 2021/08/21 21:18:10 CET [2021/08/21 15:18:10 ET]
Table 'Halley' 6-max Seat #1 is the button
Seat 1: markzoom6894 ($3.32 in chips) 
Seat 2: belbo888 ($2.50 in chips) 
Seat 3: Zelebobatyt ($2.09 in chips) 
Seat 4: S.B.O190 ($17.38 in chips) 
Seat 5: Berti281 ($2.34 in chips) 
Seat 6: Scaaalll ($2.61 in chips) 
belbo888: posts small blind $0.01
Zelebobatyt: posts big blind $0.02
*** HOLE CARDS ***
Dealt to Scaaalll [3s 8c]
S.B.O190: folds 
Berti281: folds 
Scaaalll: folds 
markzoom6894: folds 
belbo888: folds 
Uncalled bet ($0.01) returned to Zelebobatyt
Zelebobatyt collected $0.02 from pot
Zelebobatyt: doesn't show hand 
*** SUMMARY ***
Total pot $0.02 | Rake $0 
Seat 1: markzoom6894 (button) folded before Flop (didn't bet)
Seat 2: belbo888 (small blind) folded before Flop
Seat 3: Zelebobatyt (big blind) collected ($0.02)
Seat 4: S.B.O190 folded before Flop (didn't bet)
Seat 5: Berti281 folded before Flop (didn't bet)
Seat 6: Scaaalll folded before Flop (didn't bet)



PokerStars Zoom Hand #229229910645:  Hold'em No Limit ($0.01/$0.02) - 2021/08/21 21:18:03 CET [2021/08/21 15:18:03 ET]
Table 'Halley' 6-max Seat #1 is the button
Seat 1: SIGREX ($3.66 in chips) 
Seat 2: Scaaalll ($2.62 in chips) 
Seat 3: gugamoraes ($2.35 in chips) 
Seat 4: Addon289174 ($2.07 in chips) 
Seat 5: sg.32rus ($0.48 in chips) 
Seat 6: Rooster26396 ($1.66 in chips) 
Scaaalll: posts small blind $0.01
gugamoraes: posts big blind $0.02
*** HOLE CARDS ***
Dealt to Scaaalll [4d 7c]
Addon289174: calls $0.02
sg.32rus: folds 
Rooster26396: folds 
Rooster26396 is disconnected 
SIGREX: raises $0.06 to $0.08
Scaaalll: folds 
gugamoraes: folds 
Addon289174: calls $0.06
*** FLOP *** [5s Td 5h]
Addon289174: checks 
SIGREX: bets $0.05
Addon289174: folds 
Uncalled bet ($0.05) returned to SIGREX
SIGREX collected $0.18 from pot
SIGREX: doesn't show hand 
*** SUMMARY ***
Total pot $0.19 | Rake $0.01 
Board [5s Td 5h]
Seat 1: SIGREX (button) collected ($0.18)
Seat 2: Scaaalll (small blind) folded before Flop
Seat 3: gugamoraes (big blind) folded before Flop
Seat 4: Addon289174 folded on the Flop
Seat 5: sg.32rus folded before Flop (didn't bet)
Seat 6: Rooster26396 folded before Flop (didn't bet)



PokerStars Zoom Hand #229229916704:  Hold'em No Limit ($0.01/$0.02) - 2021/08/21 21:18:15 CET [2021/08/21 15:18:15 ET]
Table 'Halley' 6-max Seat #1 is the button
Seat 1: puratiino ($2 in chips) 
Seat 2: Gerar NB ($2 in chips) 
Seat 3: LeoNik62 ($5.32 in chips) 
Seat 4: Scaaalll ($2.61 in chips) 
Seat 5: maliniak75 ($1.20 in chips) 
Seat 6: alecha11 ($2 in chips) 
Gerar NB: posts small blind $0.01
LeoNik62: posts big blind $0.02
*** HOLE CARDS ***
Dealt to Scaaalll [3s Kc]
Scaaalll: folds 
maliniak75: folds 
alecha11: raises $0.03 to $0.05
puratiino: calls $0.05
Gerar NB: folds 
LeoNik62: calls $0.03
*** FLOP *** [9h Kd Tc]
LeoNik62: bets $0.06
alecha11: folds 
puratiino: folds 
Uncalled bet ($0.06) returned to LeoNik62
LeoNik62 collected $0.15 from pot
LeoNik62: doesn't show hand 
*** SUMMARY ***
Total pot $0.16 | Rake $0.01 
Board [9h Kd Tc]
Seat 1: puratiino (button) folded on the Flop
Seat 2: Gerar NB (small blind) folded before Flop
Seat 3: LeoNik62 (big blind) collected ($0.15)
Seat 4: Scaaalll folded before Flop (didn't bet)
Seat 5: maliniak75 folded before Flop (didn't bet)
Seat 6: alecha11 folded on the Flop



PokerStars Zoom Hand #229229918595:  Hold'em No Limit ($0.01/$0.02) - 2021/08/21 21:18:19 CET [2021/08/21 15:18:19 ET]
Table 'Halley' 6-max Seat #1 is the button
Seat 1: chrisaras13 ($3.26 in chips) 
Seat 2: emte1kaa ($4.09 in chips) 
Seat 3: SpartanRace1 ($6.50 in chips) 
Seat 4: Scaaalll ($2.61 in chips) 
Seat 5: snowy_96 ($2.05 in chips) 
Seat 6: iPitbull1 ($2.26 in chips) 
emte1kaa: posts small blind $0.01
SpartanRace1: posts big blind $0.02
*** HOLE CARDS ***
Dealt to Scaaalll [Ad As]
Scaaalll: raises $0.04 to $0.06
snowy_96: calls $0.06
iPitbull1: folds 
chrisaras13: folds 
emte1kaa: folds 
SpartanRace1: folds 
*** FLOP *** [Qd Qs 8c]
Scaaalll: bets $0.08
snowy_96: calls $0.08
*** TURN *** [Qd Qs 8c] [4h]
Scaaalll: checks 
snowy_96: bets $0.14
Scaaalll: calls $0.14
*** RIVER *** [Qd Qs 8c 4h] [4c]
Scaaalll: checks 
snowy_96: bets $0.36
Scaaalll: calls $0.36
*** SHOW DOWN ***
snowy_96: shows [Ah Qc] (a full house, Queens full of Fours)
Scaaalll: mucks hand 
snowy_96 collected $1.26 from pot
*** SUMMARY ***
Total pot $1.31 | Rake $0.05 
Board [Qd Qs 8c 4h 4c]
Seat 1: chrisaras13 (button) folded before Flop (didn't bet)
Seat 2: emte1kaa (small blind) folded before Flop
Seat 3: SpartanRace1 (big blind) folded before Flop
Seat 4: Scaaalll mucked [Ad As]
Seat 5: snowy_96 showed [Ah Qc] and won ($1.26) with a full house, Queens full of Fours
Seat 6: iPitbull1 folded before Flop (didn't bet)



PokerStars Zoom Hand #229229950779:  Hold'em No Limit ($0.01/$0.02) - 2021/08/21 21:19:07 CET [2021/08/21 15:19:07 ET]
Table 'Halley' 6-max Seat #1 is the button
Seat 1: Scaaalll ($2 in chips) 
Seat 2: so0love ($3.56 in chips) 
Seat 3: lele011292 ($2.22 in chips) 
Seat 4: Jackb9908 ($1 in chips) 
Seat 5: bigbaddaddy9 ($3.78 in chips) 
Seat 6: In2win26 ($0.92 in chips) 
so0love: posts small blind $0.01
lele011292: posts big blind $0.02
*** HOLE CARDS ***
Dealt to Scaaalll [Qc 3c]
Jackb9908: raises $0.03 to $0.05
lele011292 is disconnected 
bigbaddaddy9: calls $0.05
In2win26: calls $0.05
Scaaalll: folds 
so0love: folds 
lele011292: folds 
*** FLOP *** [2d 2c 5s]
Jackb9908: bets $0.09
In2win26 is disconnected 
bigbaddaddy9: folds 
In2win26: folds 
Uncalled bet ($0.09) returned to Jackb9908
Jackb9908 collected $0.17 from pot
Jackb9908: doesn't show hand 
*** SUMMARY ***
Total pot $0.18 | Rake $0.01 
Board [2d 2c 5s]
Seat 1: Scaaalll (button) folded before Flop (didn't bet)
Seat 2: so0love (small blind) folded before Flop
Seat 3: lele011292 (big blind) folded before Flop
Seat 4: Jackb9908 collected ($0.17)
Seat 5: bigbaddaddy9 folded on the Flop
Seat 6: In2win26 folded on the Flop



PokerStars Zoom Hand #229229957304:  Hold'em No Limit ($0.01/$0.02) - 2021/08/21 21:19:22 CET [2021/08/21 15:19:22 ET]
Table 'Halley' 6-max Seat #1 is the button
Seat 1: pavlo8855 ($2.04 in chips) 
Seat 2: markzoom6894 ($3.19 in chips) 
Seat 3: Scaaalll ($2 in chips) 
Seat 4: z3317111711 ($2.94 in chips) 
Seat 5: PapiMik3 ($2 in chips) 
Seat 6: woetieman ($1.69 in chips) 
markzoom6894: posts small blind $0.01
Scaaalll: posts big blind $0.02
*** HOLE CARDS ***
Dealt to Scaaalll [5s Qc]
z3317111711: folds 
woetieman is disconnected 
PapiMik3: folds 
woetieman: folds 
pavlo8855: folds 
markzoom6894: raises $0.03 to $0.05
Scaaalll: folds 
Uncalled bet ($0.03) returned to markzoom6894
markzoom6894 collected $0.04 from pot
markzoom6894: doesn't show hand 
*** SUMMARY ***
Total pot $0.04 | Rake $0 
Seat 1: pavlo8855 (button) folded before Flop (didn't bet)
Seat 2: markzoom6894 (small blind) collected ($0.04)
Seat 3: Scaaalll (big blind) folded before Flop
Seat 4: z3317111711 folded before Flop (didn't bet)
Seat 5: PapiMik3 folded before Flop (didn't bet)
Seat 6: woetieman folded before Flop (didn't bet)



PokerStars Zoom Hand #229229964103:  Hold'em No Limit ($0.01/$0.02) - 2021/08/21 21:19:36 CET [2021/08/21 15:19:36 ET]
Table 'Halley' 6-max Seat #1 is the button
Seat 1: ca$hmeoutsid ($2.89 in chips) 
Seat 2: pavlo590 ($2.01 in chips) 
Seat 3: Sparrovv ($2.07 in chips) 
Seat 4: Scaaalll ($2 in chips) 
Seat 5: Stormzilla ($2.01 in chips) 
Seat 6: Victor151886 ($4.39 in chips) 
pavlo590: posts small blind $0.01
Sparrovv: posts big blind $0.02
*** HOLE CARDS ***
Dealt to Scaaalll [2s 7h]
Scaaalll: folds 
Stormzilla: folds 
Victor151886: folds 
ca$hmeoutsid: folds 
pavlo590: folds 
Uncalled bet ($0.01) returned to Sparrovv
Sparrovv collected $0.02 from pot
Sparrovv: doesn't show hand 
pavlo590 is disconnected 
*** SUMMARY ***
Total pot $0.02 | Rake $0 
Seat 1: ca$hmeoutsid (button) folded before Flop (didn't bet)
Seat 2: pavlo590 (small blind) folded before Flop
Seat 3: Sparrovv (big blind) collected ($0.02)
Seat 4: Scaaalll folded before Flop (didn't bet)
Seat 5: Stormzilla folded before Flop (didn't bet)
Seat 6: Victor151886 folded before Flop (didn't bet)



PokerStars Zoom Hand #229229967818:  Hold'em No Limit ($0.01/$0.02) - 2021/08/21 21:19:44 CET [2021/08/21 15:19:44 ET]
Table 'Halley' 6-max Seat #1 is the button
Seat 1: qpsq ($2 in chips) 
Seat 2: irie-singer ($4.55 in chips) 
Seat 3: pers_ikG ($2.04 in chips) 
Seat 4: FabOliveira9 ($3.15 in chips) 
Seat 5: Scaaalll ($2 in chips) 
Seat 6: BIITRU ($6.10 in chips) 
irie-singer: posts small blind $0.01
pers_ikG: posts big blind $0.02
*** HOLE CARDS ***
Dealt to Scaaalll [9h 3c]
FabOliveira9: folds 
Scaaalll: folds 
BIITRU: folds 
qpsq: raises $0.04 to $0.06
irie-singer: folds 
pers_ikG: folds 
Uncalled bet ($0.04) returned to qpsq
qpsq collected $0.05 from pot
qpsq: doesn't show hand 
*** SUMMARY ***
Total pot $0.05 | Rake $0 
Seat 1: qpsq (button) collected ($0.05)
Seat 2: irie-singer (small blind) folded before Flop
Seat 3: pers_ikG (big blind) folded before Flop
Seat 4: FabOliveira9 folded before Flop (didn't bet)
Seat 5: Scaaalll folded before Flop (didn't bet)
Seat 6: BIITRU folded before Flop (didn't bet)



PokerStars Zoom Hand #229229965927:  Hold'em No Limit ($0.01/$0.02) - 2021/08/21 21:19:40 CET [2021/08/21 15:19:40 ET]
Table 'Halley' 6-max Seat #1 is the button
Seat 1: kahzura ($2 in chips) 
Seat 2: ser313131 ($2.26 in chips) 
Seat 3: Saint_ANBU ($2.67 in chips) 
Seat 4: GoldenRabbit1 ($0.20 in chips) 
Seat 5: NecromiconP ($2.05 in chips) 
Seat 6: Scaaalll ($2 in chips) 
ser313131: posts small blind $0.01
Saint_ANBU: posts big blind $0.02
*** HOLE CARDS ***
Dealt to Scaaalll [5c 4d]
GoldenRabbit1: folds 
NecromiconP: raises $0.04 to $0.06
Scaaalll: folds 
kahzura: folds 
ser313131: folds 
Saint_ANBU: calls $0.04
*** FLOP *** [Jh 5h 9c]
Saint_ANBU: checks 
NecromiconP: bets $0.13
Saint_ANBU: calls $0.13
*** TURN *** [Jh 5h 9c] [7d]
Saint_ANBU: checks 
NecromiconP: bets $0.38
Saint_ANBU: calls $0.38
*** RIVER *** [Jh 5h 9c 7d] [Th]
Saint_ANBU: bets $1.33
NecromiconP: folds 
Uncalled bet ($1.33) returned to Saint_ANBU
Saint_ANBU collected $1.11 from pot
Saint_ANBU: doesn't show hand 
*** SUMMARY ***
Total pot $1.15 | Rake $0.04 
Board [Jh 5h 9c 7d Th]
Seat 1: kahzura (button) folded before Flop (didn't bet)
Seat 2: ser313131 (small blind) folded before Flop
Seat 3: Saint_ANBU (big blind) collected ($1.11)
Seat 4: GoldenRabbit1 folded before Flop (didn't bet)
Seat 5: NecromiconP folded on the River
Seat 6: Scaaalll folded before Flop (didn't bet)



PokerStars Zoom Hand #229229979079:  Hold'em No Limit ($0.01/$0.02) - 2021/08/21 21:20:08 CET [2021/08/21 15:20:08 ET]
Table 'Halley' 6-max Seat #1 is the button
Seat 1: no way yo ($3.47 in chips) 
Seat 2: zbixxx ($2.59 in chips) 
Seat 3: Scaaalll ($2 in chips) 
Seat 4: VasquezSancho96 ($4.96 in chips) 
Seat 5: texashenry2 ($2.12 in chips) 
Seat 6: zeus11983 ($2.19 in chips) 
zbixxx: posts small blind $0.01
Scaaalll: posts big blind $0.02
*** HOLE CARDS ***
Dealt to Scaaalll [Ts 6c]
VasquezSancho96: folds 
texashenry2: folds 
zeus11983: folds 
no way yo: folds 
zbixxx: raises $0.04 to $0.06
Scaaalll: folds 
Uncalled bet ($0.04) returned to zbixxx
zbixxx collected $0.04 from pot
zbixxx: doesn't show hand 
*** SUMMARY ***
Total pot $0.04 | Rake $0 
Seat 1: no way yo (button) folded before Flop (didn't bet)
Seat 2: zbixxx (small blind) collected ($0.04)
Seat 3: Scaaalll (big blind) folded before Flop
Seat 4: VasquezSancho96 folded before Flop (didn't bet)
Seat 5: texashenry2 folded before Flop (didn't bet)
Seat 6: zeus11983 folded before Flop (didn't bet)



PokerStars Zoom Hand #229229969622:  Hold'em No Limit ($0.01/$0.02) - 2021/08/21 21:19:48 CET [2021/08/21 15:19:48 ET]
Table 'Halley' 6-max Seat #1 is the button
Seat 1: PapiMik3 ($2.30 in chips) 
Seat 2: Scaaalll ($2 in chips) 
Seat 3: Azrael AR ($2 in chips) 
Seat 4: timasblemba ($4.69 in chips) 
Seat 5: ROMIR777 ($0.40 in chips) 
Seat 6: igara tigara ($2.03 in chips) 
Scaaalll: posts small blind $0.01
Azrael AR: posts big blind $0.02
*** HOLE CARDS ***
Dealt to Scaaalll [5s Qh]
ROMIR777 is disconnected 
timasblemba: folds 
ROMIR777: folds 
igara tigara: raises $0.03 to $0.05
PapiMik3: raises $0.11 to $0.16
Scaaalll: folds 
Azrael AR: folds 
igara tigara: calls $0.11
*** FLOP *** [8h Ah Ac]
igara tigara: checks 
PapiMik3: bets $0.11
igara tigara: folds 
Uncalled bet ($0.11) returned to PapiMik3
PapiMik3 collected $0.34 from pot
PapiMik3: doesn't show hand 
*** SUMMARY ***
Total pot $0.35 | Rake $0.01 
Board [8h Ah Ac]
Seat 1: PapiMik3 (button) collected ($0.34)
Seat 2: Scaaalll (small blind) folded before Flop
Seat 3: Azrael AR (big blind) folded before Flop
Seat 4: timasblemba folded before Flop (didn't bet)
Seat 5: ROMIR777 folded before Flop (didn't bet)
Seat 6: igara tigara folded on the Flop



PokerStars Zoom Hand #229229977283:  Hold'em No Limit ($0.01/$0.02) - 2021/08/21 21:20:04 CET [2021/08/21 15:20:04 ET]
Table 'Halley' 6-max Seat #1 is the button
Seat 1: MIT_PKR ($3.32 in chips) 
Seat 2: CrazyyParis ($2.16 in chips) 
Seat 3: py100ta ($11.36 in chips) 
Seat 4: Scaaalll ($2 in chips) 
Seat 5: csmall14 ($2.09 in chips) 
Seat 6: Aroma Iceland ($2.10 in chips) 
CrazyyParis: posts small blind $0.01
py100ta: posts big blind $0.02
*** HOLE CARDS ***
Dealt to Scaaalll [2s Qc]
Scaaalll: folds 
csmall14: folds 
Aroma Iceland: raises $0.02 to $0.04
MIT_PKR: raises $0.12 to $0.16
CrazyyParis: folds 
py100ta: folds 
Aroma Iceland: folds 
Uncalled bet ($0.12) returned to MIT_PKR
MIT_PKR collected $0.11 from pot
MIT_PKR: doesn't show hand 
*** SUMMARY ***
Total pot $0.11 | Rake $0 
Seat 1: MIT_PKR (button) collected ($0.11)
Seat 2: CrazyyParis (small blind) folded before Flop
Seat 3: py100ta (big blind) folded before Flop
Seat 4: Scaaalll folded before Flop (didn't bet)
Seat 5: csmall14 folded before Flop (didn't bet)
Seat 6: Aroma Iceland folded before Flop



PokerStars Zoom Hand #229229971489:  Hold'em No Limit ($0.01/$0.02) - 2021/08/21 21:19:53 CET [2021/08/21 15:19:53 ET]
Table 'Halley' 6-max Seat #1 is the button
Seat 1: Scaaalll ($2 in chips) 
Seat 2: plmanuelpl ($0.79 in chips) 
Seat 3: KingsPoke185 ($1 in chips) 
Seat 4: FabOliveira9 ($2 in chips) 
Seat 5: lucksuckdonk ($5.60 in chips) 
Seat 6: pavlo8855 ($2.04 in chips) 
plmanuelpl: posts small blind $0.01
KingsPoke185: posts big blind $0.02
*** HOLE CARDS ***
Dealt to Scaaalll [Ks 9d]
FabOliveira9: raises $0.03 to $0.05
lucksuckdonk: folds 
pavlo8855: folds 
Scaaalll: folds 
plmanuelpl: calls $0.04
KingsPoke185: calls $0.03
*** FLOP *** [Td 3h 8d]
plmanuelpl: checks 
KingsPoke185: checks 
FabOliveira9: bets $0.10
plmanuelpl: folds 
plmanuelpl is disconnected 
KingsPoke185: calls $0.10
*** TURN *** [Td 3h 8d] [5h]
KingsPoke185: checks 
FabOliveira9: bets $0.22
KingsPoke185: calls $0.22
*** RIVER *** [Td 3h 8d 5h] [Ah]
KingsPoke185: checks 
FabOliveira9: checks 
*** SHOW DOWN ***
KingsPoke185: shows [7c Th] (a pair of Tens)
FabOliveira9: shows [Js Jh] (a pair of Jacks)
FabOliveira9 collected $0.76 from pot
*** SUMMARY ***
Total pot $0.79 | Rake $0.03 
Board [Td 3h 8d 5h Ah]
Seat 1: Scaaalll (button) folded before Flop (didn't bet)
Seat 2: plmanuelpl (small blind) folded on the Flop
Seat 3: KingsPoke185 (big blind) showed [7c Th] and lost with a pair of Tens
Seat 4: FabOliveira9 showed [Js Jh] and won ($0.76) with a pair of Jacks
Seat 5: lucksuckdonk folded before Flop (didn't bet)
Seat 6: pavlo8855 folded before Flop (didn't bet)



PokerStars Zoom Hand #229229985499:  Hold'em No Limit ($0.01/$0.02) - 2021/08/21 21:20:23 CET [2021/08/21 15:20:23 ET]
Table 'Halley' 6-max Seat #1 is the button
Seat 1: leedsrounder ($4.75 in chips) 
Seat 2: yositoas ($5.53 in chips) 
Seat 3: Henry Chinasky ($2.03 in chips) 
Seat 4: maressen ($3.36 in chips) 
Seat 5: MirkoV224 ($2.59 in chips) 
Seat 6: Scaaalll ($2 in chips) 
yositoas: posts small blind $0.01
Henry Chinasky: posts big blind $0.02
*** HOLE CARDS ***
Dealt to Scaaalll [3h 3c]
maressen: folds 
MirkoV224: calls $0.02
Scaaalll: raises $0.06 to $0.08
leedsrounder: folds 
yositoas: folds 
Henry Chinasky: folds 
MirkoV224: calls $0.06
*** FLOP *** [4d Js 6c]
MirkoV224: checks 
Scaaalll: bets $0.11
MirkoV224: folds 
Uncalled bet ($0.11) returned to Scaaalll
Scaaalll collected $0.18 from pot
Scaaalll: doesn't show hand 
*** SUMMARY ***
Total pot $0.19 | Rake $0.01 
Board [4d Js 6c]
Seat 1: leedsrounder (button) folded before Flop (didn't bet)
Seat 2: yositoas (small blind) folded before Flop
Seat 3: Henry Chinasky (big blind) folded before Flop
Seat 4: maressen folded before Flop (didn't bet)
Seat 5: MirkoV224 folded on the Flop
Seat 6: Scaaalll collected ($0.18)



PokerStars Zoom Hand #229230003998:  Hold'em No Limit ($0.01/$0.02) - 2021/08/21 21:21:02 CET [2021/08/21 15:21:02 ET]
Table 'Halley' 6-max Seat #1 is the button
Seat 1: Zelebobatyt ($2.55 in chips) 
Seat 2: morjachok8888 ($2.06 in chips) 
Seat 3: LuckyLlama0 ($0.60 in chips) 
Seat 4: vitalik199708 ($0.94 in chips) 
Seat 5: Scaaalll ($2.10 in chips) 
Seat 6: olga3021221 ($2.50 in chips) 
morjachok8888: posts small blind $0.01
LuckyLlama0: posts big blind $0.02
*** HOLE CARDS ***
Dealt to Scaaalll [Jd Jh]
vitalik199708: folds 
vitalik199708 is disconnected 
Scaaalll: raises $0.04 to $0.06
olga3021221: folds 
LuckyLlama0 is disconnected 
Zelebobatyt: folds 
morjachok8888: folds 
LuckyLlama0: folds 
Uncalled bet ($0.04) returned to Scaaalll
morjachok8888 is disconnected 
Scaaalll collected $0.05 from pot
Scaaalll: doesn't show hand 
*** SUMMARY ***
Total pot $0.05 | Rake $0 
Seat 1: Zelebobatyt (button) folded before Flop (didn't bet)
Seat 2: morjachok8888 (small blind) folded before Flop
Seat 3: LuckyLlama0 (big blind) folded before Flop
Seat 4: vitalik199708 folded before Flop (didn't bet)
Seat 5: Scaaalll collected ($0.05)
Seat 6: olga3021221 folded before Flop (didn't bet)



PokerStars Zoom Hand #229230013324:  Hold'em No Limit ($0.01/$0.02) - 2021/08/21 21:21:22 CET [2021/08/21 15:21:22 ET]
Table 'Halley' 6-max Seat #1 is the button
Seat 1: PapiMik3 ($2.10 in chips) 
Seat 2: Scaaalll ($2.13 in chips) 
Seat 3: igara tigara ($1.79 in chips) 
Seat 4: arsad725 ($6.99 in chips) 
Seat 5: py100ta ($2.43 in chips) 
Seat 6: Koldun 2636 ($3.11 in chips) 
Scaaalll: posts small blind $0.01
igara tigara: posts big blind $0.02
*** HOLE CARDS ***
Dealt to Scaaalll [5d 4s]
arsad725: folds 
py100ta: folds 
Koldun 2636: folds 
PapiMik3: folds 
Scaaalll: folds 
Uncalled bet ($0.01) returned to igara tigara
igara tigara collected $0.02 from pot
igara tigara: doesn't show hand 
*** SUMMARY ***
Total pot $0.02 | Rake $0 
Seat 1: PapiMik3 (button) folded before Flop (didn't bet)
Seat 2: Scaaalll (small blind) folded before Flop
Seat 3: igara tigara (big blind) collected ($0.02)
Seat 4: arsad725 folded before Flop (didn't bet)
Seat 5: py100ta folded before Flop (didn't bet)
Seat 6: Koldun 2636 folded before Flop (didn't bet)



PokerStars Zoom Hand #229230016068:  Hold'em No Limit ($0.01/$0.02) - 2021/08/21 21:21:28 CET [2021/08/21 15:21:28 ET]
Table 'Halley' 6-max Seat #1 is the button
Seat 1: Scaaalll ($2.12 in chips) 
Seat 2: pavlo8855 ($2.01 in chips) 
Seat 3: sorinysu ($1.05 in chips) 
Seat 4: WithMyWalker ($3.19 in chips) 
Seat 5: Shadi8 ($3.38 in chips) 
Seat 6: Freiflug66 ($2.09 in chips) 
pavlo8855: posts small blind $0.01
sorinysu: posts big blind $0.02
*** HOLE CARDS ***
Dealt to Scaaalll [Qc 6d]
WithMyWalker: folds 
Shadi8: folds 
Freiflug66: folds 
Scaaalll: folds 
pavlo8855: folds 
Uncalled bet ($0.01) returned to sorinysu
sorinysu collected $0.02 from pot
sorinysu: doesn't show hand 
*** SUMMARY ***
Total pot $0.02 | Rake $0 
Seat 1: Scaaalll (button) folded before Flop (didn't bet)
Seat 2: pavlo8855 (small blind) folded before Flop
Seat 3: sorinysu (big blind) collected ($0.02)
Seat 4: WithMyWalker folded before Flop (didn't bet)
Seat 5: Shadi8 folded before Flop (didn't bet)
Seat 6: Freiflug66 folded before Flop (didn't bet)



PokerStars Zoom Hand #229230017922:  Hold'em No Limit ($0.01/$0.02) - 2021/08/21 21:21:32 CET [2021/08/21 15:21:32 ET]
Table 'Halley' 6-max Seat #1 is the button
Seat 1: gasmar_29 ($5.21 in chips) 
Seat 2: Scaaalll ($2.12 in chips) 
Seat 3: 2m4m4 ($1.32 in chips) 
Seat 4: leedsrounder ($5.82 in chips) 
Seat 5: SchinkenToni ($1.38 in chips) 
Seat 6: Xlavariable ($2.90 in chips) 
Scaaalll: posts small blind $0.01
2m4m4: posts big blind $0.02
*** HOLE CARDS ***
Dealt to Scaaalll [6d 7s]
leedsrounder: folds 
SchinkenToni: folds 
Xlavariable: folds 
gasmar_29: raises $0.03 to $0.05
Scaaalll: folds 
2m4m4: raises $0.11 to $0.16
gasmar_29: raises $0.32 to $0.48
2m4m4: folds 
Uncalled bet ($0.32) returned to gasmar_29
gasmar_29 collected $0.33 from pot
gasmar_29: doesn't show hand 
*** SUMMARY ***
Total pot $0.33 | Rake $0 
Seat 1: gasmar_29 (button) collected ($0.33)
Seat 2: Scaaalll (small blind) folded before Flop
Seat 3: 2m4m4 (big blind) folded before Flop
Seat 4: leedsrounder folded before Flop (didn't bet)
Seat 5: SchinkenToni folded before Flop (didn't bet)
Seat 6: Xlavariable folded before Flop (didn't bet)



PokerStars Zoom Hand #229230023966:  Hold'em No Limit ($0.01/$0.02) - 2021/08/21 21:21:45 CET [2021/08/21 15:21:45 ET]
Table 'Halley' 6-max Seat #1 is the button
Seat 1: klugkk ($2 in chips) 
Seat 2: MIT_PKR ($3.46 in chips) 
Seat 3: S.B.O190 ($2.44 in chips) 
Seat 4: gasmar_29 ($2.64 in chips) 
Seat 5: Ferr4r1430 ($2.53 in chips) 
Seat 6: Scaaalll ($2.11 in chips) 
MIT_PKR: posts small blind $0.01
S.B.O190: posts big blind $0.02
*** HOLE CARDS ***
Dealt to Scaaalll [8d Ts]
gasmar_29: folds 
Ferr4r1430: raises $0.04 to $0.06
Scaaalll: folds 
klugkk: folds 
MIT_PKR: folds 
S.B.O190: folds 
Uncalled bet ($0.04) returned to Ferr4r1430
Ferr4r1430 collected $0.05 from pot
Ferr4r1430: doesn't show hand 
*** SUMMARY ***
Total pot $0.05 | Rake $0 
Seat 1: klugkk (button) folded before Flop (didn't bet)
Seat 2: MIT_PKR (small blind) folded before Flop
Seat 3: S.B.O190 (big blind) folded before Flop
Seat 4: gasmar_29 folded before Flop (didn't bet)
Seat 5: Ferr4r1430 collected ($0.05)
Seat 6: Scaaalll folded before Flop (didn't bet)



PokerStars Zoom Hand #229230029562:  Hold'em No Limit ($0.01/$0.02) - 2021/08/21 21:21:57 CET [2021/08/21 15:21:57 ET]
Table 'Halley' 6-max Seat #1 is the button
Seat 1: Lighio ($2.02 in chips) 
Seat 2: 77omsk ($3.73 in chips) 
Seat 3: Scaaalll ($2.11 in chips) 
Seat 4: KKARMELO ($2.15 in chips) 
Seat 5: CordiPS ($5 in chips) 
Seat 6: zeus11983 ($2.30 in chips) 
77omsk: posts small blind $0.01
Scaaalll: posts big blind $0.02
*** HOLE CARDS ***
Dealt to Scaaalll [Qc 8h]
KKARMELO: folds 
CordiPS: folds 
zeus11983: raises $0.03 to $0.05
Lighio: folds 
77omsk: folds 
Scaaalll: folds 
Uncalled bet ($0.03) returned to zeus11983
zeus11983 collected $0.05 from pot
zeus11983: doesn't show hand 
*** SUMMARY ***
Total pot $0.05 | Rake $0 
Seat 1: Lighio (button) folded before Flop (didn't bet)
Seat 2: 77omsk (small blind) folded before Flop
Seat 3: Scaaalll (big blind) folded before Flop
Seat 4: KKARMELO folded before Flop (didn't bet)
Seat 5: CordiPS folded before Flop (didn't bet)
Seat 6: zeus11983 collected ($0.05)



PokerStars Zoom Hand #229230036551:  Hold'em No Limit ($0.01/$0.02) - 2021/08/21 21:22:12 CET [2021/08/21 15:22:12 ET]
Table 'Halley' 6-max Seat #1 is the button
Seat 1: bossquaid ($2.99 in chips) 
Seat 2: Zelebobatyt ($1.59 in chips) 
Seat 3: SaRCh_Ale ($2.26 in chips) 
Seat 4: bigthereal ($2.38 in chips) 
Seat 5: Scaaalll ($2.09 in chips) 
Seat 6: so0love ($5.02 in chips) 
Zelebobatyt: posts small blind $0.01
SaRCh_Ale: posts big blind $0.02
*** HOLE CARDS ***
Dealt to Scaaalll [Jh 8c]
bigthereal: folds 
Scaaalll: folds 
so0love: raises $0.02 to $0.04
bossquaid: folds 
Zelebobatyt: folds 
SaRCh_Ale: folds 
Uncalled bet ($0.02) returned to so0love
so0love collected $0.05 from pot
so0love: doesn't show hand 
*** SUMMARY ***
Total pot $0.05 | Rake $0 
Seat 1: bossquaid (button) folded before Flop (didn't bet)
Seat 2: Zelebobatyt (small blind) folded before Flop
Seat 3: SaRCh_Ale (big blind) folded before Flop
Seat 4: bigthereal folded before Flop (didn't bet)
Seat 5: Scaaalll folded before Flop (didn't bet)
Seat 6: so0love collected ($0.05)



PokerStars Zoom Hand #229230041707:  Hold'em No Limit ($0.01/$0.02) - 2021/08/21 21:22:23 CET [2021/08/21 15:22:23 ET]
Table 'Halley' 6-max Seat #1 is the button
Seat 1: valet_hai ($1.05 in chips) 
Seat 2: pphit ($2.21 in chips) 
Seat 3: Scaaalll ($2.09 in chips) 
Seat 4: PapiMik3 ($2.19 in chips) 
Seat 5: Pechorin.G ($2.30 in chips) 
Seat 6: Xlavariable ($2.44 in chips) 
pphit: posts small blind $0.01
Scaaalll: posts big blind $0.02
*** HOLE CARDS ***
Dealt to Scaaalll [6h As]
PapiMik3: folds 
Pechorin.G: folds 
Xlavariable: folds 
valet_hai: calls $0.02
pphit: folds 
Scaaalll: checks 
*** FLOP *** [9d Qh Jd]
Scaaalll: checks 
valet_hai: bets $0.02
Scaaalll: folds 
Uncalled bet ($0.02) returned to valet_hai
valet_hai collected $0.05 from pot
valet_hai: doesn't show hand 
*** SUMMARY ***
Total pot $0.05 | Rake $0 
Board [9d Qh Jd]
Seat 1: valet_hai (button) collected ($0.05)
Seat 2: pphit (small blind) folded before Flop
Seat 3: Scaaalll (big blind) folded on the Flop
Seat 4: PapiMik3 folded before Flop (didn't bet)
Seat 5: Pechorin.G folded before Flop (didn't bet)
Seat 6: Xlavariable folded before Flop (didn't bet)



PokerStars Zoom Hand #229230058011:  Hold'em No Limit ($0.01/$0.02) - 2021/08/21 21:22:58 CET [2021/08/21 15:22:58 ET]
Table 'Halley' 6-max Seat #1 is the button
Seat 1: Scaaalll ($2.07 in chips) 
Seat 2: bossquaid ($2.97 in chips) 
Seat 3: VasquezSancho96 ($5.01 in chips) 
Seat 4: sg.32rus ($1.06 in chips) 
Seat 5: teutonknight ($1.97 in chips) 
Seat 6: QCcumm ($1.58 in chips) 
bossquaid: posts small blind $0.01
VasquezSancho96: posts big blind $0.02
*** HOLE CARDS ***
Dealt to Scaaalll [Ad Ah]
sg.32rus: folds 
teutonknight: calls $0.02
QCcumm: calls $0.02
Scaaalll: raises $0.08 to $0.10
bossquaid: calls $0.09
VasquezSancho96: folds 
teutonknight: calls $0.08
QCcumm: calls $0.08
*** FLOP *** [8d 2s Ts]
bossquaid: checks 
teutonknight: checks 
QCcumm: bets $0.02
Scaaalll: raises $0.24 to $0.26
bossquaid: folds 
teutonknight: folds 
QCcumm: calls $0.24
*** TURN *** [8d 2s Ts] [Tc]
QCcumm: checks 
Scaaalll: checks 
*** RIVER *** [8d 2s Ts Tc] [Qh]
QCcumm: checks 
Scaaalll: bets $0.62
QCcumm: raises $0.60 to $1.22 and is all-in
Scaaalll: folds 
Uncalled bet ($0.60) returned to QCcumm
QCcumm collected $2.10 from pot
QCcumm: doesn't show hand 
*** SUMMARY ***
Total pot $2.18 | Rake $0.08 
Board [8d 2s Ts Tc Qh]
Seat 1: Scaaalll (button) folded on the River
Seat 2: bossquaid (small blind) folded on the Flop
Seat 3: VasquezSancho96 (big blind) folded before Flop
Seat 4: sg.32rus folded before Flop (didn't bet)
Seat 5: teutonknight folded on the Flop
Seat 6: QCcumm collected ($2.10)



PokerStars Zoom Hand #229230091499:  Hold'em No Limit ($0.01/$0.02) - 2021/08/21 21:24:09 CET [2021/08/21 15:24:09 ET]
Table 'Halley' 6-max Seat #1 is the button
Seat 1: maliniak75 ($0.53 in chips) 
Seat 2: Gerar NB ($2.01 in chips) 
Seat 3: Shadi8 ($2.69 in chips) 
Seat 4: Scaaalll ($2 in chips) 
Seat 5: franquillooo ($2.85 in chips) 
Seat 6: leedsrounder ($2.18 in chips) 
Gerar NB: posts small blind $0.01
Shadi8: posts big blind $0.02
*** HOLE CARDS ***
Dealt to Scaaalll [3h Js]
Scaaalll: folds 
franquillooo: folds 
leedsrounder: raises $0.03 to $0.05
maliniak75: folds 
Gerar NB: folds 
Shadi8: folds 
Uncalled bet ($0.03) returned to leedsrounder
leedsrounder collected $0.05 from pot
leedsrounder: doesn't show hand 
*** SUMMARY ***
Total pot $0.05 | Rake $0 
Seat 1: maliniak75 (button) folded before Flop (didn't bet)
Seat 2: Gerar NB (small blind) folded before Flop
Seat 3: Shadi8 (big blind) folded before Flop
Seat 4: Scaaalll folded before Flop (didn't bet)
Seat 5: franquillooo folded before Flop (didn't bet)
Seat 6: leedsrounder collected ($0.05)



PokerStars Zoom Hand #229230095759:  Hold'em No Limit ($0.01/$0.02) - 2021/08/21 21:24:18 CET [2021/08/21 15:24:18 ET]
Table 'Halley' 6-max Seat #1 is the button
Seat 1: Oprichnick90 ($2.32 in chips) 
Seat 2: maressen ($3.78 in chips) 
Seat 3: Gabr Ribeiro ($2.50 in chips) 
Seat 4: der Kater464 ($2.62 in chips) 
Seat 5: kahzura ($2.08 in chips) 
Seat 6: Scaaalll ($2 in chips) 
maressen: posts small blind $0.01
Gabr Ribeiro: posts big blind $0.02
*** HOLE CARDS ***
Dealt to Scaaalll [Kh 7h]
der Kater464: folds 
kahzura: calls $0.02
Scaaalll: raises $0.06 to $0.08
Oprichnick90: folds 
maressen: folds 
Gabr Ribeiro: folds 
kahzura: calls $0.06
*** FLOP *** [6s 8s Kc]
kahzura: checks 
Scaaalll: bets $0.12
kahzura: folds 
Uncalled bet ($0.12) returned to Scaaalll
Scaaalll collected $0.18 from pot
Scaaalll: doesn't show hand 
*** SUMMARY ***
Total pot $0.19 | Rake $0.01 
Board [6s 8s Kc]
Seat 1: Oprichnick90 (button) folded before Flop (didn't bet)
Seat 2: maressen (small blind) folded before Flop
Seat 3: Gabr Ribeiro (big blind) folded before Flop
Seat 4: der Kater464 folded before Flop (didn't bet)
Seat 5: kahzura folded on the Flop
Seat 6: Scaaalll collected ($0.18)



PokerStars Zoom Hand #229230093349:  Hold'em No Limit ($0.01/$0.02) - 2021/08/21 21:24:13 CET [2021/08/21 15:24:13 ET]
Table 'Halley' 6-max Seat #1 is the button
Seat 1: drwal286 ($2.23 in chips) 
Seat 2: zergmiky ($2.28 in chips) 
Seat 3: Murphy1693 ($2.30 in chips) 
Seat 4: Scaaalll ($2 in chips) 
Seat 5: johniXL ($2.28 in chips) 
Seat 6: valet_hai ($1.25 in chips) 
zergmiky: posts small blind $0.01
Murphy1693: posts big blind $0.02
*** HOLE CARDS ***
Dealt to Scaaalll [6c Js]
Scaaalll: folds 
johniXL: folds 
valet_hai: folds 
drwal286: folds 
zergmiky: raises $0.04 to $0.06
Murphy1693: calls $0.04
*** FLOP *** [4h Ts 6d]
zergmiky: bets $0.04
Murphy1693: calls $0.04
*** TURN *** [4h Ts 6d] [2d]
zergmiky: checks 
Murphy1693: checks 
*** RIVER *** [4h Ts 6d 2d] [Tc]
zergmiky: checks 
Murphy1693: checks 
*** SHOW DOWN ***
zergmiky: shows [8s 7s] (a pair of Tens)
Murphy1693: shows [8h 9h] (a pair of Tens - Nine kicker)
Murphy1693 collected $0.19 from pot
*** SUMMARY ***
Total pot $0.20 | Rake $0.01 
Board [4h Ts 6d 2d Tc]
Seat 1: drwal286 (button) folded before Flop (didn't bet)
Seat 2: zergmiky (small blind) showed [8s 7s] and lost with a pair of Tens
Seat 3: Murphy1693 (big blind) showed [8h 9h] and won ($0.19) with a pair of Tens
Seat 4: Scaaalll folded before Flop (didn't bet)
Seat 5: johniXL folded before Flop (didn't bet)
Seat 6: valet_hai folded before Flop (didn't bet)



PokerStars Zoom Hand #229230115913:  Hold'em No Limit ($0.01/$0.02) - 2021/08/21 21:25:01 CET [2021/08/21 15:25:01 ET]
Table 'Halley' 6-max Seat #1 is the button
Seat 1: Clavis Noa ($2.43 in chips) 
Seat 2: kickBrain ($6.74 in chips) 
Seat 3: solosigueme ($3.06 in chips) 
Seat 4: EchoMR ($2.46 in chips) 
Seat 5: Scaaalll ($2.09 in chips) 
Seat 6: ash1448 ($9.03 in chips) 
kickBrain: posts small blind $0.01
solosigueme: posts big blind $0.02
*** HOLE CARDS ***
Dealt to Scaaalll [Jh 4d]
EchoMR: folds 
EchoMR is disconnected 
Scaaalll: folds 
ash1448: raises $0.02 to $0.04
Clavis Noa: folds 
kickBrain: folds 
solosigueme: folds 
Uncalled bet ($0.02) returned to ash1448
ash1448 collected $0.05 from pot
ash1448: doesn't show hand 
*** SUMMARY ***
Total pot $0.05 | Rake $0 
Seat 1: Clavis Noa (button) folded before Flop (didn't bet)
Seat 2: kickBrain (small blind) folded before Flop
Seat 3: solosigueme (big blind) folded before Flop
Seat 4: EchoMR folded before Flop (didn't bet)
Seat 5: Scaaalll folded before Flop (didn't bet)
Seat 6: ash1448 collected ($0.05)



PokerStars Zoom Hand #229230120132:  Hold'em No Limit ($0.01/$0.02) - 2021/08/21 21:25:10 CET [2021/08/21 15:25:10 ET]
Table 'Halley' 6-max Seat #1 is the button
Seat 1: Scaaalll ($2.09 in chips) 
Seat 2: XHerrTUMNUSX ($5.67 in chips) 
Seat 3: gasmar_29 ($3.55 in chips) 
Seat 4: yannikdaehne ($5.14 in chips) 
Seat 5: ctaceo ($2 in chips) 
Seat 6: NecromiconP ($2.32 in chips) 
XHerrTUMNUSX: posts small blind $0.01
gasmar_29: posts big blind $0.02
*** HOLE CARDS ***
Dealt to Scaaalll [7d 4s]
yannikdaehne: folds 
ctaceo has timed out
ctaceo: folds 
NecromiconP: folds 
Scaaalll: folds 
XHerrTUMNUSX: folds 
Uncalled bet ($0.01) returned to gasmar_29
gasmar_29 collected $0.02 from pot
gasmar_29: doesn't show hand 
*** SUMMARY ***
Total pot $0.02 | Rake $0 
Seat 1: Scaaalll (button) folded before Flop (didn't bet)
Seat 2: XHerrTUMNUSX (small blind) folded before Flop
Seat 3: gasmar_29 (big blind) collected ($0.02)
Seat 4: yannikdaehne folded before Flop (didn't bet)
Seat 5: ctaceo folded before Flop (didn't bet)
Seat 6: NecromiconP folded before Flop (didn't bet)



PokerStars Zoom Hand #229230127244:  Hold'em No Limit ($0.01/$0.02) - 2021/08/21 21:25:25 CET [2021/08/21 15:25:25 ET]
Table 'Halley' 6-max Seat #1 is the button
Seat 1: xxRoseIloveu ($1.48 in chips) 
Seat 2: Gabr Ribeiro ($2.45 in chips) 
Seat 3: Scaaalll ($2.09 in chips) 
Seat 4: Lacitoo ($2.03 in chips) 
Seat 5: Loto70 ($2.08 in chips) 
Seat 6: AndreaBsAs ($2.79 in chips) 
Gabr Ribeiro: posts small blind $0.01
Scaaalll: posts big blind $0.02
*** HOLE CARDS ***
Dealt to Scaaalll [4d 7s]
Lacitoo: folds 
Lacitoo is disconnected 
Loto70: folds 
AndreaBsAs: folds 
xxRoseIloveu: raises $0.04 to $0.06
Gabr Ribeiro: folds 
Scaaalll: folds 
Uncalled bet ($0.04) returned to xxRoseIloveu
xxRoseIloveu collected $0.05 from pot
xxRoseIloveu: doesn't show hand 
*** SUMMARY ***
Total pot $0.05 | Rake $0 
Seat 1: xxRoseIloveu (button) collected ($0.05)
Seat 2: Gabr Ribeiro (small blind) folded before Flop
Seat 3: Scaaalll (big blind) folded before Flop
Seat 4: Lacitoo folded before Flop (didn't bet)
Seat 5: Loto70 folded before Flop (didn't bet)
Seat 6: AndreaBsAs folded before Flop (didn't bet)



PokerStars Zoom Hand #229230125379:  Hold'em No Limit ($0.01/$0.02) - 2021/08/21 21:25:21 CET [2021/08/21 15:25:21 ET]
Table 'Halley' 6-max Seat #1 is the button
Seat 1: lucksuckdonk ($3.21 in chips) 
Seat 2: trakiar ($8.24 in chips) 
Seat 3: Babis97 ($2.35 in chips) 
Seat 4: superanton01 ($5.04 in chips) 
Seat 5: Scaaalll ($2.09 in chips) 
Seat 6: Loto70 ($2.08 in chips) 
trakiar: posts small blind $0.01
Babis97: posts big blind $0.02
*** HOLE CARDS ***
Dealt to Scaaalll [3h Tc]
superanton01: folds 
Scaaalll: folds 
Loto70: folds 
lucksuckdonk: folds 
superanton01 is disconnected 
trakiar: raises $0.04 to $0.06
Babis97: calls $0.04
*** FLOP *** [3c 2h 2s]
trakiar: checks 
Babis97: checks 
*** TURN *** [3c 2h 2s] [6d]
trakiar: checks 
Babis97: checks 
*** RIVER *** [3c 2h 2s 6d] [7s]
trakiar: checks 
Babis97: bets $0.17
trakiar: folds 
Uncalled bet ($0.17) returned to Babis97
Babis97 collected $0.12 from pot
Babis97: doesn't show hand 
trakiar is disconnected 
*** SUMMARY ***
Total pot $0.12 | Rake $0 
Board [3c 2h 2s 6d 7s]
Seat 1: lucksuckdonk (button) folded before Flop (didn't bet)
Seat 2: trakiar (small blind) folded on the River
Seat 3: Babis97 (big blind) collected ($0.12)
Seat 4: superanton01 folded before Flop (didn't bet)
Seat 5: Scaaalll folded before Flop (didn't bet)
Seat 6: Loto70 folded before Flop (didn't bet)



PokerStars Zoom Hand #229230109766:  Hold'em No Limit ($0.01/$0.02) - 2021/08/21 21:24:48 CET [2021/08/21 15:24:48 ET]
Table 'Halley' 6-max Seat #1 is the button
Seat 1: R4DiUS030 ($2.59 in chips) 
Seat 2: Scaaalll ($2.10 in chips) 
Seat 3: Cleysouza ($1 in chips) 
Seat 4: Ferr4r1430 ($2 in chips) 
Seat 5: BIITRU ($6.27 in chips) 
Seat 6: 77omsk ($2.33 in chips) 
Scaaalll: posts small blind $0.01
Cleysouza: posts big blind $0.02
*** HOLE CARDS ***
Dealt to Scaaalll [7c Qs]
Ferr4r1430: folds 
Ferr4r1430 is disconnected 
BIITRU: folds 
77omsk: raises $0.03 to $0.05
R4DiUS030: calls $0.05
Scaaalll: folds 
Cleysouza: calls $0.03
*** FLOP *** [2d Ts Kc]
Cleysouza: checks 
77omsk: checks 
R4DiUS030: bets $0.08
Cleysouza: folds 
Cleysouza is disconnected 
77omsk: calls $0.08
*** TURN *** [2d Ts Kc] [Qc]
77omsk: checks 
R4DiUS030: bets $0.16
77omsk: calls $0.16
*** RIVER *** [2d Ts Kc Qc] [4s]
77omsk: checks 
R4DiUS030: checks 
*** SHOW DOWN ***
77omsk: shows [Kh Jc] (a pair of Kings)
R4DiUS030: mucks hand 
77omsk collected $0.62 from pot
*** SUMMARY ***
Total pot $0.64 | Rake $0.02 
Board [2d Ts Kc Qc 4s]
Seat 1: R4DiUS030 (button) mucked [5s 5h]
Seat 2: Scaaalll (small blind) folded before Flop
Seat 3: Cleysouza (big blind) folded on the Flop
Seat 4: Ferr4r1430 folded before Flop (didn't bet)
Seat 5: BIITRU folded before Flop (didn't bet)
Seat 6: 77omsk showed [Kh Jc] and won ($0.62) with a pair of Kings



PokerStars Zoom Hand #229230150142:  Hold'em No Limit ($0.01/$0.02) - 2021/08/21 21:26:06 CET [2021/08/21 15:26:06 ET]
Table 'Halley' 6-max Seat #1 is the button
Seat 1: SpartanRace1 ($8.78 in chips) 
Seat 2: willpea2 ($2.07 in chips) 
Seat 3: PlayPokerHappy1 ($2.03 in chips) 
Seat 4: Murphy1693 ($4.28 in chips) 
Seat 5: Gamer577 ($2 in chips) 
Seat 6: Scaaalll ($2.06 in chips) 
willpea2: posts small blind $0.01
PlayPokerHappy1: posts big blind $0.02
*** HOLE CARDS ***
Dealt to Scaaalll [3s 2d]
Murphy1693: folds 
Gamer577: folds 
Scaaalll: folds 
SpartanRace1: folds 
willpea2: folds 
Uncalled bet ($0.01) returned to PlayPokerHappy1
PlayPokerHappy1 collected $0.02 from pot
PlayPokerHappy1: doesn't show hand 
*** SUMMARY ***
Total pot $0.02 | Rake $0 
Seat 1: SpartanRace1 (button) folded before Flop (didn't bet)
Seat 2: willpea2 (small blind) folded before Flop
Seat 3: PlayPokerHappy1 (big blind) collected ($0.02)
Seat 4: Murphy1693 folded before Flop (didn't bet)
Seat 5: Gamer577 folded before Flop (didn't bet)
Seat 6: Scaaalll folded before Flop (didn't bet)



PokerStars Zoom Hand #229230147332:  Hold'em No Limit ($0.01/$0.02) - 2021/08/21 21:26:00 CET [2021/08/21 15:26:00 ET]
Table 'Halley' 6-max Seat #1 is the button
Seat 1: Scaaalll ($2.06 in chips) 
Seat 2: S.B.O190 ($15.06 in chips) 
Seat 3: DaporteWins ($2 in chips) 
Seat 4: Gamer577 ($2 in chips) 
Seat 5: klausC3 ($5.89 in chips) 
Seat 6: emte1kaa ($1.84 in chips) 
S.B.O190: posts small blind $0.01
DaporteWins: posts big blind $0.02
*** HOLE CARDS ***
Dealt to Scaaalll [4h Qc]
Gamer577: folds 
klausC3: folds 
emte1kaa: folds 
Scaaalll: folds 
S.B.O190: raises $0.04 to $0.06
DaporteWins: folds 
Uncalled bet ($0.04) returned to S.B.O190
S.B.O190 collected $0.04 from pot
S.B.O190: doesn't show hand 
*** SUMMARY ***
Total pot $0.04 | Rake $0 
Seat 1: Scaaalll (button) folded before Flop (didn't bet)
Seat 2: S.B.O190 (small blind) collected ($0.04)
Seat 3: DaporteWins (big blind) folded before Flop
Seat 4: Gamer577 folded before Flop (didn't bet)
Seat 5: klausC3 folded before Flop (didn't bet)
Seat 6: emte1kaa folded before Flop (didn't bet)



PokerStars Zoom Hand #229230155196:  Hold'em No Limit ($0.01/$0.02) - 2021/08/21 21:26:17 CET [2021/08/21 15:26:17 ET]
Table 'Halley' 6-max Seat #1 is the button
Seat 1: ctaceo ($2.01 in chips) 
Seat 2: pavlo8855 ($2.07 in chips) 
Seat 3: Scaaalll ($2.06 in chips) 
Seat 4: Bufre ($2.29 in chips) 
Seat 5: Quantum771 ($2.17 in chips) 
Seat 6: NecromiconP ($2.28 in chips) 
pavlo8855: posts small blind $0.01
Scaaalll: posts big blind $0.02
*** HOLE CARDS ***
Dealt to Scaaalll [3d Ts]
Bufre: folds 
Quantum771: folds 
NecromiconP: raises $0.04 to $0.06
ctaceo: folds 
pavlo8855: folds 
Scaaalll: folds 
Uncalled bet ($0.04) returned to NecromiconP
NecromiconP collected $0.05 from pot
NecromiconP: doesn't show hand 
*** SUMMARY ***
Total pot $0.05 | Rake $0 
Seat 1: ctaceo (button) folded before Flop (didn't bet)
Seat 2: pavlo8855 (small blind) folded before Flop
Seat 3: Scaaalll (big blind) folded before Flop
Seat 4: Bufre folded before Flop (didn't bet)
Seat 5: Quantum771 folded before Flop (didn't bet)
Seat 6: NecromiconP collected ($0.05)



PokerStars Zoom Hand #229230145466:  Hold'em No Limit ($0.01/$0.02) - 2021/08/21 21:25:57 CET [2021/08/21 15:25:57 ET]
Table 'Halley' 6-max Seat #1 is the button
Seat 1: FLHG1921 ($1.09 in chips) 
Seat 2: Scaaalll ($2.07 in chips) 
Seat 3: brummie0 ($1.81 in chips) 
Seat 4: GiordanoBrn ($2 in chips) 
Seat 5: Fedor_Gar ($2 in chips) 
Seat 6: qpsq ($4.09 in chips) 
Scaaalll: posts small blind $0.01
brummie0: posts big blind $0.02
*** HOLE CARDS ***
Dealt to Scaaalll [7c 3s]
GiordanoBrn: folds 
GiordanoBrn is disconnected 
Fedor_Gar: raises $0.04 to $0.06
brummie0 is disconnected 
qpsq: calls $0.06
FLHG1921: calls $0.06
Scaaalll: folds 
brummie0: folds 
*** FLOP *** [Qd 4d 8h]
Fedor_Gar: bets $0.14
qpsq: calls $0.14
FLHG1921: calls $0.14
*** TURN *** [Qd 4d 8h] [4h]
Fedor_Gar: checks 
qpsq: bets $0.41
FLHG1921: folds 
Fedor_Gar: folds 
Uncalled bet ($0.41) returned to qpsq
qpsq collected $0.61 from pot
qpsq: doesn't show hand 
*** SUMMARY ***
Total pot $0.63 | Rake $0.02 
Board [Qd 4d 8h 4h]
Seat 1: FLHG1921 (button) folded on the Turn
Seat 2: Scaaalll (small blind) folded before Flop
Seat 3: brummie0 (big blind) folded before Flop
Seat 4: GiordanoBrn folded before Flop (didn't bet)
Seat 5: Fedor_Gar folded on the Turn
Seat 6: qpsq collected ($0.61)



PokerStars Zoom Hand #229230152438:  Hold'em No Limit ($0.01/$0.02) - 2021/08/21 21:26:11 CET [2021/08/21 15:26:11 ET]
Table 'Halley' 6-max Seat #1 is the button
Seat 1: z3317111711 ($2.01 in chips) 
Seat 2: Lighio ($2.08 in chips) 
Seat 3: no way yo ($1.13 in chips) 
Seat 4: pavlo8855 ($2.07 in chips) 
Seat 5: Scaaalll ($2.06 in chips) 
Seat 6: Murphy1693 ($4.28 in chips) 
Lighio: posts small blind $0.01
no way yo: posts big blind $0.02
*** HOLE CARDS ***
Dealt to Scaaalll [Qd 4s]
pavlo8855: folds 
Scaaalll: folds 
Murphy1693: folds 
z3317111711: raises $0.03 to $0.05
Lighio: folds 
no way yo: folds 
Uncalled bet ($0.03) returned to z3317111711
z3317111711 collected $0.05 from pot
z3317111711: doesn't show hand 
*** SUMMARY ***
Total pot $0.05 | Rake $0 
Seat 1: z3317111711 (button) collected ($0.05)
Seat 2: Lighio (small blind) folded before Flop
Seat 3: no way yo (big blind) folded before Flop
Seat 4: pavlo8855 folded before Flop (didn't bet)
Seat 5: Scaaalll folded before Flop (didn't bet)
Seat 6: Murphy1693 folded before Flop (didn't bet)



PokerStars Zoom Hand #229230161292:  Hold'em No Limit ($0.01/$0.02) - 2021/08/21 21:26:30 CET [2021/08/21 15:26:30 ET]
Table 'Halley' 6-max Seat #1 is the button
Seat 1: benubeção ($1 in chips) 
Seat 2: dkno77 ($2 in chips) 
Seat 3: lagesz32 ($3.04 in chips) 
Seat 4: Scaaalll ($2.04 in chips) 
Seat 5: csmall14 ($2.19 in chips) 
Seat 6: arturtsutsaev ($0.73 in chips) 
dkno77: posts small blind $0.01
lagesz32: posts big blind $0.02
*** HOLE CARDS ***
Dealt to Scaaalll [Qd Ac]
Scaaalll: raises $0.04 to $0.06
lagesz32 is disconnected 
csmall14: raises $0.12 to $0.18
arturtsutsaev: folds 
arturtsutsaev is disconnected 
benubeção: folds 
dkno77: folds 
lagesz32: folds 
benubeção is disconnected 
Scaaalll: folds 
Uncalled bet ($0.12) returned to csmall14
csmall14 collected $0.15 from pot
csmall14: doesn't show hand 
*** SUMMARY ***
Total pot $0.15 | Rake $0 
Seat 1: benubeção (button) folded before Flop (didn't bet)
Seat 2: dkno77 (small blind) folded before Flop
Seat 3: lagesz32 (big blind) folded before Flop
Seat 4: Scaaalll folded before Flop
Seat 5: csmall14 collected ($0.15)
Seat 6: arturtsutsaev folded before Flop (didn't bet)



PokerStars Zoom Hand #229230169703:  Hold'em No Limit ($0.01/$0.02) - 2021/08/21 21:26:49 CET [2021/08/21 15:26:49 ET]
Table 'Halley' 6-max Seat #1 is the button
Seat 1: no way yo ($3.28 in chips) 
Seat 2: Scaaalll ($2 in chips) 
Seat 3: arrow17 ($2.04 in chips) 
Seat 4: lafocaramona ($3.83 in chips) 
Seat 5: kykareky32 ($2.05 in chips) 
Seat 6: SideshowPen ($2.14 in chips) 
Scaaalll: posts small blind $0.01
arrow17: posts big blind $0.02
*** HOLE CARDS ***
Dealt to Scaaalll [7c Ad]
lafocaramona: folds 
kykareky32: folds 
SideshowPen: folds 
no way yo: folds 
Scaaalll: folds 
Uncalled bet ($0.01) returned to arrow17
lafocaramona is disconnected 
arrow17 collected $0.02 from pot
arrow17: doesn't show hand 
*** SUMMARY ***
Total pot $0.02 | Rake $0 
Seat 1: no way yo (button) folded before Flop (didn't bet)
Seat 2: Scaaalll (small blind) folded before Flop
Seat 3: arrow17 (big blind) collected ($0.02)
Seat 4: lafocaramona folded before Flop (didn't bet)
Seat 5: kykareky32 folded before Flop (didn't bet)
Seat 6: SideshowPen folded before Flop (didn't bet)



PokerStars Zoom Hand #229230171610:  Hold'em No Limit ($0.01/$0.02) - 2021/08/21 21:26:52 CET [2021/08/21 15:26:52 ET]
Table 'Halley' 6-max Seat #1 is the button
Seat 1: timasblemba ($4.49 in chips) 
Seat 2: kahzura ($2.08 in chips) 
Seat 3: iPitbull1 ($2.06 in chips) 
Seat 4: Alfmasterrr ($2 in chips) 
Seat 5: ARTMVSLV ($2.70 in chips) 
Seat 6: Scaaalll ($2 in chips) 
kahzura: posts small blind $0.01
iPitbull1: posts big blind $0.02
*** HOLE CARDS ***
Dealt to Scaaalll [3c 8s]
Alfmasterrr: raises $0.04 to $0.06
ARTMVSLV: folds 
Scaaalll: folds 
timasblemba: folds 
kahzura: folds 
iPitbull1: folds 
Uncalled bet ($0.04) returned to Alfmasterrr
Alfmasterrr collected $0.05 from pot
Alfmasterrr: doesn't show hand 
*** SUMMARY ***
Total pot $0.05 | Rake $0 
Seat 1: timasblemba (button) folded before Flop (didn't bet)
Seat 2: kahzura (small blind) folded before Flop
Seat 3: iPitbull1 (big blind) folded before Flop
Seat 4: Alfmasterrr collected ($0.05)
Seat 5: ARTMVSLV folded before Flop (didn't bet)
Seat 6: Scaaalll folded before Flop (didn't bet)



PokerStars Zoom Hand #229230173941:  Hold'em No Limit ($0.01/$0.02) - 2021/08/21 21:26:57 CET [2021/08/21 15:26:57 ET]
Table 'Halley' 6-max Seat #1 is the button
Seat 1: Scaaalll ($2 in chips) 
Seat 2: ash1448 ($2.06 in chips) 
Seat 3: der Kater464 ($2.69 in chips) 
Seat 4: Dron4uk UA ($2.38 in chips) 
Seat 5: E Z TAKEDOWN ($7.17 in chips) 
Seat 6: Koldun 2636 ($2.52 in chips) 
ash1448: posts small blind $0.01
der Kater464: posts big blind $0.02
*** HOLE CARDS ***
Dealt to Scaaalll [5s 5d]
Dron4uk UA: folds 
E Z TAKEDOWN: folds 
Koldun 2636: folds 
Scaaalll: raises $0.02 to $0.04
ash1448: folds 
der Kater464: raises $0.02 to $0.06
Scaaalll: calls $0.02
*** FLOP *** [Ts 5c Ah]
der Kater464: bets $0.06
Scaaalll: calls $0.06
*** TURN *** [Ts 5c Ah] [2c]
der Kater464: bets $0.10
Scaaalll: calls $0.10
*** RIVER *** [Ts 5c Ah 2c] [8s]
der Kater464: bets $0.10
Scaaalll: raises $0.29 to $0.39
der Kater464: folds 
Uncalled bet ($0.29) returned to Scaaalll
Scaaalll collected $0.63 from pot
Scaaalll: doesn't show hand 
*** SUMMARY ***
Total pot $0.65 | Rake $0.02 
Board [Ts 5c Ah 2c 8s]
Seat 1: Scaaalll (button) collected ($0.63)
Seat 2: ash1448 (small blind) folded before Flop
Seat 3: der Kater464 (big blind) folded on the River
Seat 4: Dron4uk UA folded before Flop (didn't bet)
Seat 5: E Z TAKEDOWN folded before Flop (didn't bet)
Seat 6: Koldun 2636 folded before Flop (didn't bet)



PokerStars Zoom Hand #229230225711:  Hold'em No Limit ($0.01/$0.02) - 2021/08/21 21:28:48 CET [2021/08/21 15:28:48 ET]
Table 'Halley' 6-max Seat #1 is the button
Seat 1: arturtsutsaev ($1.11 in chips) 
Seat 2: zergmiky ($2.07 in chips) 
Seat 3: Quantum771 ($2 in chips) 
Seat 4: Scaaalll ($2.31 in chips) 
Seat 5: twobii668 ($0.57 in chips) 
Seat 6: Fedor_Gar ($2.07 in chips) 
zergmiky: posts small blind $0.01
Quantum771: posts big blind $0.02
*** HOLE CARDS ***
Dealt to Scaaalll [2s Tc]
Scaaalll: folds 
twobii668: folds 
twobii668 is disconnected 
Fedor_Gar: folds 
arturtsutsaev: folds 
zergmiky: folds 
Uncalled bet ($0.01) returned to Quantum771
arturtsutsaev is disconnected 
Quantum771 collected $0.02 from pot
Quantum771: doesn't show hand 
*** SUMMARY ***
Total pot $0.02 | Rake $0 
Seat 1: arturtsutsaev (button) folded before Flop (didn't bet)
Seat 2: zergmiky (small blind) folded before Flop
Seat 3: Quantum771 (big blind) collected ($0.02)
Seat 4: Scaaalll folded before Flop (didn't bet)
Seat 5: twobii668 folded before Flop (didn't bet)
Seat 6: Fedor_Gar folded before Flop (didn't bet)



PokerStars Zoom Hand #229230227591:  Hold'em No Limit ($0.01/$0.02) - 2021/08/21 21:28:52 CET [2021/08/21 15:28:52 ET]
Table 'Halley' 6-max Seat #1 is the button
Seat 1: laetschnbene ($1.97 in chips) 
Seat 2: kamiso0904 ($1.21 in chips) 
Seat 3: Feliciano16 ($2 in chips) 
Seat 4: Scaaalll ($2.31 in chips) 
Seat 5: mity3333 ($2.76 in chips) 
Seat 6: MrRussia777 ($0.83 in chips) 
kamiso0904: posts small blind $0.01
Feliciano16: posts big blind $0.02
*** HOLE CARDS ***
Dealt to Scaaalll [Kc Tc]
Scaaalll: raises $0.04 to $0.06
mity3333: folds 
MrRussia777: folds 
laetschnbene: folds 
kamiso0904: folds 
Feliciano16: folds 
Uncalled bet ($0.04) returned to Scaaalll
Scaaalll collected $0.05 from pot
Scaaalll: doesn't show hand 
*** SUMMARY ***
Total pot $0.05 | Rake $0 
Seat 1: laetschnbene (button) folded before Flop (didn't bet)
Seat 2: kamiso0904 (small blind) folded before Flop
Seat 3: Feliciano16 (big blind) folded before Flop
Seat 4: Scaaalll collected ($0.05)
Seat 5: mity3333 folded before Flop (didn't bet)
Seat 6: MrRussia777 folded before Flop (didn't bet)



PokerStars Zoom Hand #229230235843:  Hold'em No Limit ($0.01/$0.02) - 2021/08/21 21:29:10 CET [2021/08/21 15:29:10 ET]
Table 'Halley' 6-max Seat #1 is the button
Seat 1: SchinkenToni ($1.50 in chips) 
Seat 2: jaamonra ($3.46 in chips) 
Seat 3: nodtress ($2.68 in chips) 
Seat 4: dz2204 ($0.87 in chips) 
Seat 5: AndreaBsAs ($2 in chips) 
Seat 6: Scaaalll ($2.34 in chips) 
jaamonra: posts small blind $0.01
nodtress: posts big blind $0.02
*** HOLE CARDS ***
Dealt to Scaaalll [5c Qs]
dz2204: folds 
AndreaBsAs: folds 
Scaaalll: folds 
SchinkenToni: folds 
jaamonra: raises $0.04 to $0.06
nodtress: folds 
Uncalled bet ($0.04) returned to jaamonra
jaamonra collected $0.04 from pot
jaamonra: doesn't show hand 
*** SUMMARY ***
Total pot $0.04 | Rake $0 
Seat 1: SchinkenToni (button) folded before Flop (didn't bet)
Seat 2: jaamonra (small blind) collected ($0.04)
Seat 3: nodtress (big blind) folded before Flop
Seat 4: dz2204 folded before Flop (didn't bet)
Seat 5: AndreaBsAs folded before Flop (didn't bet)
Seat 6: Scaaalll folded before Flop (didn't bet)



PokerStars Zoom Hand #229230241369:  Hold'em No Limit ($0.01/$0.02) - 2021/08/21 21:29:22 CET [2021/08/21 15:29:22 ET]
Table 'Halley' 6-max Seat #1 is the button
Seat 1: Appraiser73 ($1.11 in chips) 
Seat 2: Zastrzol ($1.52 in chips) 
Seat 3: Scaaalll ($2.34 in chips) 
Seat 4: empo magic ($1.99 in chips) 
Seat 5: Murileus ($2.66 in chips) 
Seat 6: arsad725 ($7.39 in chips) 
Zastrzol: posts small blind $0.01
Scaaalll: posts big blind $0.02
*** HOLE CARDS ***
Dealt to Scaaalll [Ah 3d]
empo magic: folds 
Murileus: raises $0.03 to $0.05
arsad725: folds 
Appraiser73: folds 
Zastrzol is disconnected 
Zastrzol: calls $0.04
Scaaalll: folds 
*** FLOP *** [Qd 8s Ks]
Zastrzol: checks 
Murileus: checks 
*** TURN *** [Qd 8s Ks] [Js]
Zastrzol: checks 
Murileus: bets $0.09
Zastrzol: folds 
Uncalled bet ($0.09) returned to Murileus
Murileus collected $0.12 from pot
Murileus: doesn't show hand 
Zastrzol is disconnected 
*** SUMMARY ***
Total pot $0.12 | Rake $0 
Board [Qd 8s Ks Js]
Seat 1: Appraiser73 (button) folded before Flop (didn't bet)
Seat 2: Zastrzol (small blind) folded on the Turn
Seat 3: Scaaalll (big blind) folded before Flop
Seat 4: empo magic folded before Flop (didn't bet)
Seat 5: Murileus collected ($0.12)
Seat 6: arsad725 folded before Flop (didn't bet)



PokerStars Zoom Hand #229230245524:  Hold'em No Limit ($0.01/$0.02) - 2021/08/21 21:29:31 CET [2021/08/21 15:29:31 ET]
Table 'Halley' 6-max Seat #1 is the button
Seat 1: bAttery01 ($3.44 in chips) 
Seat 2: Scaaalll ($2.32 in chips) 
Seat 3: DURO.RIVAL ($2.02 in chips) 
Seat 4: Lighio ($3.72 in chips) 
Seat 5: Andrey30071990 ($1.84 in chips) 
Seat 6: STE1NBERG ($3.48 in chips) 
Scaaalll: posts small blind $0.01
DURO.RIVAL: posts big blind $0.02
*** HOLE CARDS ***
Dealt to Scaaalll [4s 6d]
Lighio: folds 
Andrey30071990: calls $0.02
STE1NBERG: folds 
bAttery01: folds 
Scaaalll: folds 
DURO.RIVAL: raises $0.08 to $0.10
Andrey30071990: calls $0.08
*** FLOP *** [3h Ad Tc]
DURO.RIVAL: bets $0.06
Andrey30071990: folds 
Uncalled bet ($0.06) returned to DURO.RIVAL
DURO.RIVAL collected $0.20 from pot
DURO.RIVAL: doesn't show hand 
Andrey30071990 is disconnected 
*** SUMMARY ***
Total pot $0.21 | Rake $0.01 
Board [3h Ad Tc]
Seat 1: bAttery01 (button) folded before Flop (didn't bet)
Seat 2: Scaaalll (small blind) folded before Flop
Seat 3: DURO.RIVAL (big blind) collected ($0.20)
Seat 4: Lighio folded before Flop (didn't bet)
Seat 5: Andrey30071990 folded on the Flop
Seat 6: STE1NBERG folded before Flop (didn't bet)



PokerStars Zoom Hand #229230248816:  Hold'em No Limit ($0.01/$0.02) - 2021/08/21 21:29:38 CET [2021/08/21 15:29:38 ET]
Table 'Halley' 6-max Seat #1 is the button
Seat 1: MrRussia777 ($0.81 in chips) 
Seat 2: Henry Chinasky ($2.97 in chips) 
Seat 3: GeraKremmov ($1.47 in chips) 
Seat 4: Nihility77 ($2.46 in chips) 
Seat 5: Scaaalll ($2.31 in chips) 
Seat 6: Amigo113 ($2.11 in chips) 
Henry Chinasky: posts small blind $0.01
GeraKremmov: posts big blind $0.02
*** HOLE CARDS ***
Dealt to Scaaalll [9h Ks]
Nihility77: folds 
Scaaalll has timed out
Scaaalll: folds 
Amigo113: folds 
MrRussia777: raises $0.03 to $0.05
Henry Chinasky: raises $0.08 to $0.13
GeraKremmov: folds 
MrRussia777: folds 
Uncalled bet ($0.08) returned to Henry Chinasky
Henry Chinasky collected $0.12 from pot
Henry Chinasky: doesn't show hand 
*** SUMMARY ***
Total pot $0.12 | Rake $0 
Seat 1: MrRussia777 (button) folded before Flop
Seat 2: Henry Chinasky (small blind) collected ($0.12)
Seat 3: GeraKremmov (big blind) folded before Flop
Seat 4: Nihility77 folded before Flop (didn't bet)
Seat 5: Scaaalll folded before Flop (didn't bet)
Seat 6: Amigo113 folded before Flop (didn't bet)



PokerStars Zoom Hand #229230255840:  Hold'em No Limit ($0.01/$0.02) - 2021/08/21 21:29:53 CET [2021/08/21 15:29:53 ET]
Table 'Halley' 6-max Seat #1 is the button
Seat 1: ADWish ($1.25 in chips) 
Seat 2: bananAAbandit ($3.65 in chips) 
Seat 3: le_vlimeux ($5.08 in chips) 
Seat 4: Scaaalll ($2.31 in chips) 
Seat 5: keldh ($2.92 in chips) 
Seat 6: Lacitoo ($2.81 in chips) 
bananAAbandit: posts small blind $0.01
le_vlimeux: posts big blind $0.02
*** HOLE CARDS ***
Dealt to Scaaalll [2s Td]
Scaaalll: folds 
keldh: folds 
Lacitoo: folds 
ADWish: folds 
Lacitoo is disconnected 
bananAAbandit: folds 
Uncalled bet ($0.01) returned to le_vlimeux
le_vlimeux collected $0.02 from pot
le_vlimeux: doesn't show hand 
*** SUMMARY ***
Total pot $0.02 | Rake $0 
Seat 1: ADWish (button) folded before Flop (didn't bet)
Seat 2: bananAAbandit (small blind) folded before Flop
Seat 3: le_vlimeux (big blind) collected ($0.02)
Seat 4: Scaaalll folded before Flop (didn't bet)
Seat 5: keldh folded before Flop (didn't bet)
Seat 6: Lacitoo folded before Flop (didn't bet)



PokerStars Zoom Hand #229230263572:  Hold'em No Limit ($0.01/$0.02) - 2021/08/21 21:30:10 CET [2021/08/21 15:30:10 ET]
Table 'Halley' 6-max Seat #1 is the button
Seat 1: Saint_ANBU ($3.71 in chips) 
Seat 2: Pechorin.G ($2.22 in chips) 
Seat 3: Scaaalll ($2.31 in chips) 
Seat 4: lagesz32 ($1.90 in chips) 
Seat 5: MrRussia777 ($0.75 in chips) 
Seat 6: martuska88 ($2 in chips) 
Pechorin.G: posts small blind $0.01
Scaaalll: posts big blind $0.02
*** HOLE CARDS ***
Dealt to Scaaalll [4h Ks]
lagesz32: folds 
lagesz32 is disconnected 
MrRussia777: folds 
martuska88: folds 
Saint_ANBU: raises $0.03 to $0.05
Pechorin.G: folds 
Scaaalll: folds 
Uncalled bet ($0.03) returned to Saint_ANBU
Saint_ANBU collected $0.05 from pot
Saint_ANBU: doesn't show hand 
*** SUMMARY ***
Total pot $0.05 | Rake $0 
Seat 1: Saint_ANBU (button) collected ($0.05)
Seat 2: Pechorin.G (small blind) folded before Flop
Seat 3: Scaaalll (big blind) folded before Flop
Seat 4: lagesz32 folded before Flop (didn't bet)
Seat 5: MrRussia777 folded before Flop (didn't bet)
Seat 6: martuska88 folded before Flop (didn't bet)



PokerStars Zoom Hand #229230257678:  Hold'em No Limit ($0.01/$0.02) - 2021/08/21 21:29:57 CET [2021/08/21 15:29:57 ET]
Table 'Halley' 6-max Seat #1 is the button
Seat 1: Scaaalll ($2.31 in chips) 
Seat 2: Xlavariable ($5.15 in chips) 
Seat 3: keitho211 ($2.14 in chips) 
Seat 4: gwr85 ($1.72 in chips) 
Seat 5: Syd Wright ($2 in chips) 
Seat 6: Fedor_Gar ($2.81 in chips) 
Xlavariable: posts small blind $0.01
keitho211: posts big blind $0.02
*** HOLE CARDS ***
Dealt to Scaaalll [4c Ad]
gwr85: calls $0.02
Syd Wright: folds 
Fedor_Gar: calls $0.02
Scaaalll: folds 
Xlavariable: folds 
keitho211: checks 
*** FLOP *** [8c 3c 6s]
keitho211: checks 
gwr85: checks 
Fedor_Gar: bets $0.05
keitho211: folds 
gwr85: calls $0.05
*** TURN *** [8c 3c 6s] [Kh]
gwr85: checks 
Fedor_Gar: bets $0.14
gwr85: folds 
Uncalled bet ($0.14) returned to Fedor_Gar
Fedor_Gar collected $0.16 from pot
Fedor_Gar: doesn't show hand 
*** SUMMARY ***
Total pot $0.17 | Rake $0.01 
Board [8c 3c 6s Kh]
Seat 1: Scaaalll (button) folded before Flop (didn't bet)
Seat 2: Xlavariable (small blind) folded before Flop
Seat 3: keitho211 (big blind) folded on the Flop
Seat 4: gwr85 folded on the Turn
Seat 5: Syd Wright folded before Flop (didn't bet)
Seat 6: Fedor_Gar collected ($0.16)



PokerStars Zoom Hand #229230271464:  Hold'em No Limit ($0.01/$0.02) - 2021/08/21 21:30:26 CET [2021/08/21 15:30:26 ET]
Table 'Halley' 6-max Seat #1 is the button
Seat 1: lukzmodric10 ($1.19 in chips) 
Seat 2: Scaaalll ($2.29 in chips) 
Seat 3: ciucibaby ($4.44 in chips) 
Seat 4: SchinkenToni ($1.18 in chips) 
Seat 5: ser313131 ($2.26 in chips) 
Seat 6: WithMyWalker ($2.03 in chips) 
Scaaalll: posts small blind $0.01
ciucibaby: posts big blind $0.02
*** HOLE CARDS ***
Dealt to Scaaalll [Kc Td]
SchinkenToni: folds 
ser313131: calls $0.02
WithMyWalker: folds 
lukzmodric10: calls $0.02
Scaaalll: folds 
ciucibaby: checks 
*** FLOP *** [Qs 9c Ts]
ciucibaby: checks 
ser313131: checks 
lukzmodric10: bets $0.04
ciucibaby: folds 
ser313131: folds 
Uncalled bet ($0.04) returned to lukzmodric10
lukzmodric10 collected $0.07 from pot
lukzmodric10: doesn't show hand 
*** SUMMARY ***
Total pot $0.07 | Rake $0 
Board [Qs 9c Ts]
Seat 1: lukzmodric10 (button) collected ($0.07)
Seat 2: Scaaalll (small blind) folded before Flop
Seat 3: ciucibaby (big blind) folded on the Flop
Seat 4: SchinkenToni folded before Flop (didn't bet)
Seat 5: ser313131 folded on the Flop
Seat 6: WithMyWalker folded before Flop (didn't bet)



PokerStars Zoom Hand #229230277158:  Hold'em No Limit ($0.01/$0.02) - 2021/08/21 21:30:38 CET [2021/08/21 15:30:38 ET]
Table 'Halley' 6-max Seat #1 is the button
Seat 1: PlayPokerHappy1 ($2.11 in chips) 
Seat 2: tuolau ($2.34 in chips) 
Seat 3: zizu1014 ($2.62 in chips) 
Seat 4: MrRussia777 ($2.09 in chips) 
Seat 5: lucksuckdonk ($2.58 in chips) 
Seat 6: Scaaalll ($2.28 in chips) 
tuolau: posts small blind $0.01
zizu1014: posts big blind $0.02
*** HOLE CARDS ***
Dealt to Scaaalll [8c Kd]
MrRussia777: folds 
lucksuckdonk: folds 
Scaaalll has timed out
Scaaalll: folds 
PlayPokerHappy1: raises $0.04 to $0.06
tuolau: folds 
tuolau is disconnected 
zizu1014: calls $0.04
*** FLOP *** [5h 8d 4h]
zizu1014: checks 
PlayPokerHappy1: checks 
*** TURN *** [5h 8d 4h] [7c]
zizu1014: bets $0.10
PlayPokerHappy1: folds 
Uncalled bet ($0.10) returned to zizu1014
zizu1014 collected $0.13 from pot
zizu1014: doesn't show hand 
*** SUMMARY ***
Total pot $0.13 | Rake $0 
Board [5h 8d 4h 7c]
Seat 1: PlayPokerHappy1 (button) folded on the Turn
Seat 2: tuolau (small blind) folded before Flop
Seat 3: zizu1014 (big blind) collected ($0.13)
Seat 4: MrRussia777 folded before Flop (didn't bet)
Seat 5: lucksuckdonk folded before Flop (didn't bet)
Seat 6: Scaaalll folded before Flop (didn't bet)



PokerStars Zoom Hand #229230290721:  Hold'em No Limit ($0.01/$0.02) - 2021/08/21 21:31:06 CET [2021/08/21 15:31:06 ET]
Table 'Halley' 6-max Seat #1 is the button
Seat 1: GiordanoBrn ($2 in chips) 
Seat 2: sich77 ($1.41 in chips) 
Seat 3: pavel28918012 ($2.03 in chips) 
Seat 4: zallav ($2 in chips) 
Seat 5: Scaaalll ($2.28 in chips) 
Seat 6: Ferr4r1430 ($3.64 in chips) 
sich77: posts small blind $0.01
pavel28918012: posts big blind $0.02
*** HOLE CARDS ***
Dealt to Scaaalll [6h 8s]
GiordanoBrn is disconnected 
sich77 is disconnected 
zallav: raises $0.04 to $0.06
Scaaalll: folds 
Ferr4r1430: calls $0.06
GiordanoBrn: folds 
sich77: folds 
pavel28918012: calls $0.04
*** FLOP *** [2d 2h 7s]
pavel28918012: checks 
zallav: checks 
Ferr4r1430: checks 
*** TURN *** [2d 2h 7s] [5h]
pavel28918012: checks 
zallav: checks 
Ferr4r1430: checks 
*** RIVER *** [2d 2h 7s 5h] [3c]
pavel28918012: checks 
zallav: checks 
Ferr4r1430: checks 
*** SHOW DOWN ***
pavel28918012: shows [9s Jh] (a pair of Deuces)
zallav: shows [Jd Td] (a pair of Deuces - Jack+Ten kicker)
Ferr4r1430: shows [Ks Ad] (a pair of Deuces - Ace kicker)
Ferr4r1430 collected $0.18 from pot
*** SUMMARY ***
Total pot $0.19 | Rake $0.01 
Board [2d 2h 7s 5h 3c]
Seat 1: GiordanoBrn (button) folded before Flop (didn't bet)
Seat 2: sich77 (small blind) folded before Flop
Seat 3: pavel28918012 (big blind) showed [9s Jh] and lost with a pair of Deuces
Seat 4: zallav showed [Jd Td] and lost with a pair of Deuces
Seat 5: Scaaalll folded before Flop (didn't bet)
Seat 6: Ferr4r1430 showed [Ks Ad] and won ($0.18) with a pair of Deuces



PokerStars Zoom Hand #229230293535:  Hold'em No Limit ($0.01/$0.02) - 2021/08/21 21:31:11 CET [2021/08/21 15:31:11 ET]
Table 'Halley' 6-max Seat #1 is the button
Seat 1: LegendaryLRS ($2.01 in chips) 
Seat 2: ser313131 ($3.23 in chips) 
Seat 3: Scaaalll ($2.28 in chips) 
Seat 4: arrow17 ($2 in chips) 
Seat 5: Loto70 ($2.02 in chips) 
Seat 6: Jevgenij7 ($1.59 in chips) 
ser313131: posts small blind $0.01
Scaaalll: posts big blind $0.02
*** HOLE CARDS ***
Dealt to Scaaalll [4h Qc]
arrow17: folds 
Loto70: folds 
Jevgenij7: calls $0.02
LegendaryLRS: folds 
ser313131: calls $0.01
Scaaalll: checks 
*** FLOP *** [3s Td Th]
ser313131: checks 
Scaaalll: checks 
Jevgenij7: checks 
*** TURN *** [3s Td Th] [Ts]
ser313131: bets $0.02
Scaaalll: folds 
Jevgenij7: calls $0.02
*** RIVER *** [3s Td Th Ts] [Kh]
ser313131: bets $0.05
Jevgenij7: folds 
Uncalled bet ($0.05) returned to ser313131
ser313131 collected $0.10 from pot
ser313131: doesn't show hand 
Jevgenij7 is disconnected 
*** SUMMARY ***
Total pot $0.10 | Rake $0 
Board [3s Td Th Ts Kh]
Seat 1: LegendaryLRS (button) folded before Flop (didn't bet)
Seat 2: ser313131 (small blind) collected ($0.10)
Seat 3: Scaaalll (big blind) folded on the Turn
Seat 4: arrow17 folded before Flop (didn't bet)
Seat 5: Loto70 folded before Flop (didn't bet)
Seat 6: Jevgenij7 folded on the River



PokerStars Zoom Hand #229230311798:  Hold'em No Limit ($0.01/$0.02) - 2021/08/21 21:31:50 CET [2021/08/21 15:31:50 ET]
Table 'Halley' 6-max Seat #1 is the button
Seat 1: Scaaalll ($2.26 in chips) 
Seat 2: zergmiky ($2.22 in chips) 
Seat 3: Chefasuarus ($3.45 in chips) 
Seat 4: Bufre ($4.83 in chips) 
Seat 5: Clavis Noa ($2.97 in chips) 
Seat 6: malandro733 ($2.09 in chips) 
zergmiky: posts small blind $0.01
Chefasuarus: posts big blind $0.02
*** HOLE CARDS ***
Dealt to Scaaalll [Th Qh]
Bufre: folds 
Clavis Noa: folds 
malandro733: folds 
Scaaalll: raises $0.02 to $0.04
zergmiky: folds 
Chefasuarus: calls $0.02
*** FLOP *** [Jd Ks 3d]
Chefasuarus: checks 
Scaaalll: bets $0.06
Chefasuarus: calls $0.06
*** TURN *** [Jd Ks 3d] [3c]
Chefasuarus: checks 
Scaaalll: bets $0.14
Chefasuarus: folds 
Uncalled bet ($0.14) returned to Scaaalll
Scaaalll collected $0.20 from pot
Scaaalll: doesn't show hand 
*** SUMMARY ***
Total pot $0.21 | Rake $0.01 
Board [Jd Ks 3d 3c]
Seat 1: Scaaalll (button) collected ($0.20)
Seat 2: zergmiky (small blind) folded before Flop
Seat 3: Chefasuarus (big blind) folded on the Turn
Seat 4: Bufre folded before Flop (didn't bet)
Seat 5: Clavis Noa folded before Flop (didn't bet)
Seat 6: malandro733 folded before Flop (didn't bet)



PokerStars Zoom Hand #229230333500:  Hold'em No Limit ($0.01/$0.02) - 2021/08/21 21:32:36 CET [2021/08/21 15:32:36 ET]
Table 'Halley' 6-max Seat #1 is the button
Seat 1: bananAAbandit ($2.20 in chips) 
Seat 2: Loto70 ($2 in chips) 
Seat 3: DaporteWins ($2.43 in chips) 
Seat 4: Scaaalll ($2.36 in chips) 
Seat 5: Kb013497 ($2.49 in chips) 
Seat 6: pavel28918012 ($1.48 in chips) 
Loto70: posts small blind $0.01
DaporteWins: posts big blind $0.02
*** HOLE CARDS ***
Dealt to Scaaalll [6d 5h]
Scaaalll: folds 
Kb013497: folds 
pavel28918012: folds 
bananAAbandit: folds 
Loto70: raises $0.03 to $0.05
DaporteWins: folds 
Uncalled bet ($0.03) returned to Loto70
Loto70 collected $0.04 from pot
Loto70: doesn't show hand 
*** SUMMARY ***
Total pot $0.04 | Rake $0 
Seat 1: bananAAbandit (button) folded before Flop (didn't bet)
Seat 2: Loto70 (small blind) collected ($0.04)
Seat 3: DaporteWins (big blind) folded before Flop
Seat 4: Scaaalll folded before Flop (didn't bet)
Seat 5: Kb013497 folded before Flop (didn't bet)
Seat 6: pavel28918012 folded before Flop (didn't bet)



PokerStars Zoom Hand #229230337664:  Hold'em No Limit ($0.01/$0.02) - 2021/08/21 21:32:45 CET [2021/08/21 15:32:45 ET]
Table 'Halley' 6-max Seat #1 is the button
Seat 1: Daveys14 ($0.87 in chips) 
Seat 2: ferx1989 ($2 in chips) 
Seat 3: Bufre ($4.82 in chips) 
Seat 4: FicheroQuit ($3.40 in chips) 
Seat 5: Scaaalll ($2.35 in chips) 
Seat 6: emte1kaa ($3.69 in chips) 
ferx1989: posts small blind $0.01
Bufre: posts big blind $0.02
*** HOLE CARDS ***
Dealt to Scaaalll [Th Kh]
FicheroQuit: raises $0.03 to $0.05
Scaaalll: calls $0.05
emte1kaa: folds 
Daveys14: folds 
ferx1989: folds 
Bufre: folds 
*** FLOP *** [7h 7s 7c]
Daveys14 is disconnected 
FicheroQuit: bets $0.07
Scaaalll: folds 
Uncalled bet ($0.07) returned to FicheroQuit
FicheroQuit collected $0.13 from pot
FicheroQuit: doesn't show hand 
*** SUMMARY ***
Total pot $0.13 | Rake $0 
Board [7h 7s 7c]
Seat 1: Daveys14 (button) folded before Flop (didn't bet)
Seat 2: ferx1989 (small blind) folded before Flop
Seat 3: Bufre (big blind) folded before Flop
Seat 4: FicheroQuit collected ($0.13)
Seat 5: Scaaalll folded on the Flop
Seat 6: emte1kaa folded before Flop (didn't bet)



PokerStars Zoom Hand #229230331093:  Hold'em No Limit ($0.01/$0.02) - 2021/08/21 21:32:31 CET [2021/08/21 15:32:31 ET]
Table 'Halley' 6-max Seat #1 is the button
Seat 1: 77omsk ($7.23 in chips) 
Seat 2: fabor1303 ($8.72 in chips) 
Seat 3: kickBrain ($6.81 in chips) 
Seat 4: Plmax94 ($1.47 in chips) 
Seat 5: ugi-dugi ($2 in chips) 
Seat 6: Scaaalll ($2.36 in chips) 
fabor1303: posts small blind $0.01
kickBrain: posts big blind $0.02
*** HOLE CARDS ***
Dealt to Scaaalll [3h 4d]
Plmax94: raises $0.04 to $0.06
ugi-dugi: folds 
Scaaalll: folds 
77omsk: folds 
fabor1303: raises $0.14 to $0.20
kickBrain: folds 
Plmax94: calls $0.14
*** FLOP *** [Ts Kd 6s]
fabor1303: checks 
Plmax94: bets $0.31
fabor1303: calls $0.31
*** TURN *** [Ts Kd 6s] [Qh]
fabor1303: checks 
Plmax94: checks 
*** RIVER *** [Ts Kd 6s Qh] [4s]
fabor1303: checks 
Plmax94: checks 
*** SHOW DOWN ***
fabor1303: shows [Jd Qd] (a pair of Queens)
Plmax94: shows [Jc Kh] (a pair of Kings)
Plmax94 collected $1 from pot
*** SUMMARY ***
Total pot $1.04 | Rake $0.04 
Board [Ts Kd 6s Qh 4s]
Seat 1: 77omsk (button) folded before Flop (didn't bet)
Seat 2: fabor1303 (small blind) showed [Jd Qd] and lost with a pair of Queens
Seat 3: kickBrain (big blind) folded before Flop
Seat 4: Plmax94 showed [Jc Kh] and won ($1) with a pair of Kings
Seat 5: ugi-dugi folded before Flop (didn't bet)
Seat 6: Scaaalll folded before Flop (didn't bet)



PokerStars Zoom Hand #229230335863:  Hold'em No Limit ($0.01/$0.02) - 2021/08/21 21:32:42 CET [2021/08/21 15:32:42 ET]
Table 'Halley' 6-max Seat #1 is the button
Seat 1: Andrey30071990 ($1.82 in chips) 
Seat 2: Scaaalll ($2.36 in chips) 
Seat 3: arturtsutsaev ($0.90 in chips) 
Seat 4: LegendaryLRS ($2.26 in chips) 
Seat 5: someone0611 ($2.23 in chips) 
Seat 6: Nihility77 ($2.88 in chips) 
Scaaalll: posts small blind $0.01
arturtsutsaev: posts big blind $0.02
*** HOLE CARDS ***
Dealt to Scaaalll [2s 4c]
LegendaryLRS: folds 
someone0611: calls $0.02
Nihility77: raises $0.05 to $0.07
Andrey30071990: raises $0.05 to $0.12
Scaaalll: folds 
arturtsutsaev: folds 
arturtsutsaev is disconnected 
someone0611: folds 
Nihility77: calls $0.05
*** FLOP *** [6s 8d 4h]
Nihility77: checks 
Andrey30071990: bets $1.70 and is all-in
Nihility77: folds 
Uncalled bet ($1.70) returned to Andrey30071990
Andrey30071990 collected $0.28 from pot
Andrey30071990: doesn't show hand 
*** SUMMARY ***
Total pot $0.29 | Rake $0.01 
Board [6s 8d 4h]
Seat 1: Andrey30071990 (button) collected ($0.28)
Seat 2: Scaaalll (small blind) folded before Flop
Seat 3: arturtsutsaev (big blind) folded before Flop
Seat 4: LegendaryLRS folded before Flop (didn't bet)
Seat 5: someone0611 folded before Flop
Seat 6: Nihility77 folded on the Flop



PokerStars Zoom Hand #229230348400:  Hold'em No Limit ($0.01/$0.02) - 2021/08/21 21:33:08 CET [2021/08/21 15:33:08 ET]
Table 'Halley' 6-max Seat #1 is the button
Seat 1: Draat505 ($2.03 in chips) 
Seat 2: Kojak34 ($6.05 in chips) 
Seat 3: Scaaalll ($2.30 in chips) 
Seat 4: usenovm ($1.79 in chips) 
Seat 5: Gibsondelux ($1.90 in chips) 
Seat 6: KoAlRy ($2 in chips) 
Kojak34: posts small blind $0.01
Scaaalll: posts big blind $0.02
*** HOLE CARDS ***
Dealt to Scaaalll [Qh Th]
Gibsondelux is disconnected 
usenovm: folds 
Gibsondelux: folds 
KoAlRy: raises $0.03 to $0.05
Draat505: folds 
Kojak34: folds 
Scaaalll: raises $0.13 to $0.18
KoAlRy: calls $0.13
*** FLOP *** [5c 3d 7h]
Scaaalll: bets $0.22
KoAlRy: folds 
Uncalled bet ($0.22) returned to Scaaalll
Scaaalll collected $0.36 from pot
Scaaalll: doesn't show hand 
*** SUMMARY ***
Total pot $0.37 | Rake $0.01 
Board [5c 3d 7h]
Seat 1: Draat505 (button) folded before Flop (didn't bet)
Seat 2: Kojak34 (small blind) folded before Flop
Seat 3: Scaaalll (big blind) collected ($0.36)
Seat 4: usenovm folded before Flop (didn't bet)
Seat 5: Gibsondelux folded before Flop (didn't bet)
Seat 6: KoAlRy folded on the Flop



PokerStars Zoom Hand #229230365602:  Hold'em No Limit ($0.01/$0.02) - 2021/08/21 21:33:46 CET [2021/08/21 15:33:46 ET]
Table 'Halley' 6-max Seat #1 is the button
Seat 1: Scaaalll ($2.48 in chips) 
Seat 2: Fedor_Gar ($2 in chips) 
Seat 3: zergmiky ($3.04 in chips) 
Seat 4: kykareky32 ($1.79 in chips) 
Seat 5: rodrigoasor ($1.98 in chips) 
Seat 6: Lighio ($5.88 in chips) 
Fedor_Gar: posts small blind $0.01
zergmiky: posts big blind $0.02
*** HOLE CARDS ***
Dealt to Scaaalll [7c 2c]
kykareky32: folds 
rodrigoasor: folds 
Lighio: folds 
Scaaalll: folds 
Fedor_Gar: folds 
Uncalled bet ($0.01) returned to zergmiky
zergmiky collected $0.02 from pot
zergmiky: doesn't show hand 
*** SUMMARY ***
Total pot $0.02 | Rake $0 
Seat 1: Scaaalll (button) folded before Flop (didn't bet)
Seat 2: Fedor_Gar (small blind) folded before Flop
Seat 3: zergmiky (big blind) collected ($0.02)
Seat 4: kykareky32 folded before Flop (didn't bet)
Seat 5: rodrigoasor folded before Flop (didn't bet)
Seat 6: Lighio folded before Flop (didn't bet)



PokerStars Zoom Hand #229230367514:  Hold'em No Limit ($0.01/$0.02) - 2021/08/21 21:33:50 CET [2021/08/21 15:33:50 ET]
Table 'Halley' 6-max Seat #1 is the button
Seat 1: Nihility77 ($2.78 in chips) 
Seat 2: klausC3 ($5.78 in chips) 
Seat 3: andihorni1 ($1.49 in chips) 
Seat 4: Sharabora ($0.79 in chips) 
Seat 5: kahzura ($2.69 in chips) 
Seat 6: Scaaalll ($2.48 in chips) 
klausC3: posts small blind $0.01
andihorni1: posts big blind $0.02
*** HOLE CARDS ***
Dealt to Scaaalll [Ac 6c]
Sharabora: folds 
kahzura: raises $0.04 to $0.06
Scaaalll: folds 
Nihility77: folds 
klausC3: folds 
andihorni1: calls $0.04
*** FLOP *** [4s Qc 5d]
andihorni1: checks 
kahzura: bets $0.09
andihorni1: calls $0.09
*** TURN *** [4s Qc 5d] [Js]
andihorni1: checks 
kahzura: bets $0.22
andihorni1: calls $0.22
*** RIVER *** [4s Qc 5d Js] [3d]
andihorni1: checks 
kahzura: bets $0.48
andihorni1: raises $0.64 to $1.12 and is all-in
kahzura: calls $0.64
*** SHOW DOWN ***
andihorni1: shows [Qs Td] (a pair of Queens)
kahzura: shows [4d 4h] (three of a kind, Fours)
kahzura collected $2.89 from pot
*** SUMMARY ***
Total pot $2.99 | Rake $0.10 
Board [4s Qc 5d Js 3d]
Seat 1: Nihility77 (button) folded before Flop (didn't bet)
Seat 2: klausC3 (small blind) folded before Flop
Seat 3: andihorni1 (big blind) showed [Qs Td] and lost with a pair of Queens
Seat 4: Sharabora folded before Flop (didn't bet)
Seat 5: kahzura showed [4d 4h] and won ($2.89) with three of a kind, Fours
Seat 6: Scaaalll folded before Flop (didn't bet)



PokerStars Zoom Hand #229230372148:  Hold'em No Limit ($0.01/$0.02) - 2021/08/21 21:33:59 CET [2021/08/21 15:33:59 ET]
Table 'Halley' 6-max Seat #1 is the button
Seat 1: kickBrain ($3.93 in chips) 
Seat 2: Hb055 ($1.28 in chips) 
Seat 3: Bubobubob ($5.77 in chips) 
Seat 4: Aroma Iceland ($6.26 in chips) 
Seat 5: Scaaalll ($2.48 in chips) 
Seat 6: picuur ($3.09 in chips) 
Hb055: posts small blind $0.01
Bubobubob: posts big blind $0.02
*** HOLE CARDS ***
Dealt to Scaaalll [Ah Jc]
Aroma Iceland: folds 
Scaaalll: raises $0.04 to $0.06
picuur: folds 
kickBrain: folds 
Hb055: calls $0.05
Bubobubob: folds 
*** FLOP *** [6s 6c Jh]
Hb055: checks 
Scaaalll: bets $0.09
Hb055: raises $0.09 to $0.18
Scaaalll: calls $0.09
*** TURN *** [6s 6c Jh] [Ad]
Hb055: bets $0.48
Scaaalll: calls $0.48
*** RIVER *** [6s 6c Jh Ad] [4s]
Hb055: checks 
Scaaalll: bets $0.71
Hb055: calls $0.56 and is all-in
Uncalled bet ($0.15) returned to Scaaalll
*** SHOW DOWN ***
Scaaalll: shows [Ah Jc] (two pair, Aces and Jacks)
Hb055: shows [Qh Qc] (two pair, Queens and Sixes)
Scaaalll collected $2.47 from pot
*** SUMMARY ***
Total pot $2.58 | Rake $0.11 
Board [6s 6c Jh Ad 4s]
Seat 1: kickBrain (button) folded before Flop (didn't bet)
Seat 2: Hb055 (small blind) showed [Qh Qc] and lost with two pair, Queens and Sixes
Seat 3: Bubobubob (big blind) folded before Flop
Seat 4: Aroma Iceland folded before Flop (didn't bet)
Seat 5: Scaaalll showed [Ah Jc] and won ($2.47) with two pair, Aces and Jacks
Seat 6: picuur folded before Flop (didn't bet)



PokerStars Zoom Hand #229230395019:  Hold'em No Limit ($0.01/$0.02) - 2021/08/21 21:34:48 CET [2021/08/21 15:34:48 ET]
Table 'Halley' 6-max Seat #1 is the button
Seat 1: romochka1992 ($1.34 in chips) 
Seat 2: pipecmolodec ($2.02 in chips) 
Seat 3: tviskas ($2.69 in chips) 
Seat 4: Hilti66 ($0.72 in chips) 
Seat 5: Scaaalll ($3.67 in chips) 
Seat 6: meikoz ($2 in chips) 
pipecmolodec: posts small blind $0.01
tviskas: posts big blind $0.02
*** HOLE CARDS ***
Dealt to Scaaalll [9c Tc]
Hilti66: calls $0.02
Scaaalll: raises $0.06 to $0.08
meikoz: folds 
romochka1992: folds 
tviskas is disconnected 
pipecmolodec: folds 
tviskas: folds 
Hilti66: calls $0.06
*** FLOP *** [7c Js 5h]
Hilti66: checks 
Scaaalll: bets $0.11
Hilti66: calls $0.11
*** TURN *** [7c Js 5h] [4d]
Hilti66: bets $0.40
Scaaalll: folds 
Uncalled bet ($0.40) returned to Hilti66
Hilti66 collected $0.40 from pot
Hilti66: doesn't show hand 
*** SUMMARY ***
Total pot $0.41 | Rake $0.01 
Board [7c Js 5h 4d]
Seat 1: romochka1992 (button) folded before Flop (didn't bet)
Seat 2: pipecmolodec (small blind) folded before Flop
Seat 3: tviskas (big blind) folded before Flop
Seat 4: Hilti66 collected ($0.40)
Seat 5: Scaaalll folded on the Turn
Seat 6: meikoz folded before Flop (didn't bet)



PokerStars Zoom Hand #229230413521:  Hold'em No Limit ($0.01/$0.02) - 2021/08/21 21:35:29 CET [2021/08/21 15:35:29 ET]
Table 'Halley' 6-max Seat #1 is the button
Seat 1: DaporteWins ($2.38 in chips) 
Seat 2: Scaaalll ($3.48 in chips) 
Seat 3: Koldun 2636 ($2.30 in chips) 
Seat 4: HDYD18 ($3.25 in chips) 
Seat 5: RonilsonCosta ($2.01 in chips) 
Seat 6: Zhyla95 ($1.98 in chips) 
Scaaalll: posts small blind $0.01
Koldun 2636: posts big blind $0.02
*** HOLE CARDS ***
Dealt to Scaaalll [5c Qs]
HDYD18: raises $0.04 to $0.06
RonilsonCosta: folds 
Zhyla95: folds 
DaporteWins: folds 
Scaaalll: folds 
Koldun 2636: folds 
Uncalled bet ($0.04) returned to HDYD18
HDYD18 collected $0.05 from pot
HDYD18: doesn't show hand 
*** SUMMARY ***
Total pot $0.05 | Rake $0 
Seat 1: DaporteWins (button) folded before Flop (didn't bet)
Seat 2: Scaaalll (small blind) folded before Flop
Seat 3: Koldun 2636 (big blind) folded before Flop
Seat 4: HDYD18 collected ($0.05)
Seat 5: RonilsonCosta folded before Flop (didn't bet)
Seat 6: Zhyla95 folded before Flop (didn't bet)



PokerStars Zoom Hand #229230415833:  Hold'em No Limit ($0.01/$0.02) - 2021/08/21 21:35:34 CET [2021/08/21 15:35:34 ET]
Table 'Halley' 6-max Seat #1 is the button
Seat 1: IamFixxed ($2.04 in chips) 
Seat 2: 77omsk ($2.86 in chips) 
Seat 3: Kojak34 ($5.98 in chips) 
Seat 4: Scaaalll ($3.47 in chips) 
Seat 5: iPitbull1 ($2.03 in chips) 
Seat 6: Dron4uk UA ($3.16 in chips) 
77omsk: posts small blind $0.01
Kojak34: posts big blind $0.02
*** HOLE CARDS ***
Dealt to Scaaalll [Qd Jh]
Scaaalll: folds 
iPitbull1: folds 
Dron4uk UA: folds 
IamFixxed: folds 
77omsk: folds 
Uncalled bet ($0.01) returned to Kojak34
Kojak34 collected $0.02 from pot
Kojak34: doesn't show hand 
*** SUMMARY ***
Total pot $0.02 | Rake $0 
Seat 1: IamFixxed (button) folded before Flop (didn't bet)
Seat 2: 77omsk (small blind) folded before Flop
Seat 3: Kojak34 (big blind) collected ($0.02)
Seat 4: Scaaalll folded before Flop (didn't bet)
Seat 5: iPitbull1 folded before Flop (didn't bet)
Seat 6: Dron4uk UA folded before Flop (didn't bet)



PokerStars Zoom Hand #229230417696:  Hold'em No Limit ($0.01/$0.02) - 2021/08/21 21:35:38 CET [2021/08/21 15:35:38 ET]
Table 'Halley' 6-max Seat #1 is the button
Seat 1: stanthema661 ($0.72 in chips) 
Seat 2: H0mmer99 ($1.89 in chips) 
Seat 3: Scaaalll ($3.47 in chips) 
Seat 4: nitzed12 ($2.16 in chips) 
Seat 5: meikoz ($2.05 in chips) 
Seat 6: gugamoraes ($2.05 in chips) 
H0mmer99: posts small blind $0.01
Scaaalll: posts big blind $0.02
*** HOLE CARDS ***
Dealt to Scaaalll [2s Jd]
nitzed12: folds 
meikoz: folds 
gugamoraes: folds 
stanthema661: calls $0.02
H0mmer99: folds 
Scaaalll: checks 
*** FLOP *** [4d 2c Ad]
Scaaalll: checks 
stanthema661: bets $0.06
Scaaalll: folds 
Uncalled bet ($0.06) returned to stanthema661
stanthema661 collected $0.05 from pot
stanthema661: doesn't show hand 
*** SUMMARY ***
Total pot $0.05 | Rake $0 
Board [4d 2c Ad]
Seat 1: stanthema661 (button) collected ($0.05)
Seat 2: H0mmer99 (small blind) folded before Flop
Seat 3: Scaaalll (big blind) folded on the Flop
Seat 4: nitzed12 folded before Flop (didn't bet)
Seat 5: meikoz folded before Flop (didn't bet)
Seat 6: gugamoraes folded before Flop (didn't bet)



PokerStars Zoom Hand #229230426581:  Hold'em No Limit ($0.01/$0.02) - 2021/08/21 21:35:56 CET [2021/08/21 15:35:56 ET]
Table 'Halley' 6-max Seat #1 is the button
Seat 1: Scaaalll ($3.45 in chips) 
Seat 2: kickBrain ($6.45 in chips) 
Seat 3: ser313131 ($3.39 in chips) 
Seat 4: Lacitoo ($2.60 in chips) 
Seat 5: zergmiky ($2.30 in chips) 
Seat 6: alecha11 ($3.76 in chips) 
kickBrain: posts small blind $0.01
ser313131: posts big blind $0.02
*** HOLE CARDS ***
Dealt to Scaaalll [4h Tc]
Lacitoo: folds 
zergmiky: folds 
Lacitoo is disconnected 
alecha11: folds 
Scaaalll: folds 
kickBrain: raises $0.03 to $0.05
ser313131: raises $0.13 to $0.18
kickBrain: folds 
Uncalled bet ($0.13) returned to ser313131
ser313131 collected $0.10 from pot
ser313131: doesn't show hand 
*** SUMMARY ***
Total pot $0.10 | Rake $0 
Seat 1: Scaaalll (button) folded before Flop (didn't bet)
Seat 2: kickBrain (small blind) folded before Flop
Seat 3: ser313131 (big blind) collected ($0.10)
Seat 4: Lacitoo folded before Flop (didn't bet)
Seat 5: zergmiky folded before Flop (didn't bet)
Seat 6: alecha11 folded before Flop (didn't bet)



PokerStars Zoom Hand #229230432139:  Hold'em No Limit ($0.01/$0.02) - 2021/08/21 21:36:08 CET [2021/08/21 15:36:08 ET]
Table 'Halley' 6-max Seat #1 is the button
Seat 1: wikkers ($2.09 in chips) 
Seat 2: klausC3 ($3.98 in chips) 
Seat 3: NecromiconP ($3.32 in chips) 
Seat 4: Scaaalll ($3.45 in chips) 
Seat 5: trakiar ($7.82 in chips) 
Seat 6: G1olight ($2 in chips) 
klausC3: posts small blind $0.01
NecromiconP: posts big blind $0.02
*** HOLE CARDS ***
Dealt to Scaaalll [5h 4c]
trakiar is disconnected 
Scaaalll: folds 
trakiar: folds 
G1olight: raises $0.04 to $0.06
wikkers: folds 
klausC3: raises $0.18 to $0.24
NecromiconP: folds 
G1olight: folds 
Uncalled bet ($0.18) returned to klausC3
klausC3 collected $0.14 from pot
klausC3: doesn't show hand 
G1olight is disconnected 
*** SUMMARY ***
Total pot $0.14 | Rake $0 
Seat 1: wikkers (button) folded before Flop (didn't bet)
Seat 2: klausC3 (small blind) collected ($0.14)
Seat 3: NecromiconP (big blind) folded before Flop
Seat 4: Scaaalll folded before Flop (didn't bet)
Seat 5: trakiar folded before Flop (didn't bet)
Seat 6: G1olight folded before Flop



PokerStars Zoom Hand #229230434810:  Hold'em No Limit ($0.01/$0.02) - 2021/08/21 21:36:15 CET [2021/08/21 15:36:15 ET]
Table 'Halley' 6-max Seat #1 is the button
Seat 1: juraa14 ($1.98 in chips) 
Seat 2: Sul07 ($0.78 in chips) 
Seat 3: IamFixxed ($2 in chips) 
Seat 4: Cid s2 ($1.85 in chips) 
Seat 5: nodtress ($2.77 in chips) 
Seat 6: Scaaalll ($3.45 in chips) 
Sul07: posts small blind $0.01
IamFixxed: posts big blind $0.02
*** HOLE CARDS ***
Dealt to Scaaalll [7d Ad]
Cid s2: calls $0.02
nodtress: folds 
Scaaalll: raises $0.06 to $0.08
juraa14: folds 
Sul07: folds 
IamFixxed: calls $0.06
Cid s2: calls $0.06
*** FLOP *** [Ks 7h 7c]
IamFixxed: checks 
Cid s2: checks 
Scaaalll: bets $0.14
IamFixxed: folds 
Cid s2: folds 
Uncalled bet ($0.14) returned to Scaaalll
Scaaalll collected $0.24 from pot
Scaaalll: doesn't show hand 
*** SUMMARY ***
Total pot $0.25 | Rake $0.01 
Board [Ks 7h 7c]
Seat 1: juraa14 (button) folded before Flop (didn't bet)
Seat 2: Sul07 (small blind) folded before Flop
Seat 3: IamFixxed (big blind) folded on the Flop
Seat 4: Cid s2 folded on the Flop
Seat 5: nodtress folded before Flop (didn't bet)
Seat 6: Scaaalll collected ($0.24)



PokerStars Zoom Hand #229230453373:  Hold'em No Limit ($0.01/$0.02) - 2021/08/21 21:36:54 CET [2021/08/21 15:36:54 ET]
Table 'Halley' 6-max Seat #1 is the button
Seat 1: Pray_to_win ($2.46 in chips) 
Seat 2: Scaaalll ($3.61 in chips) 
Seat 3: ser313131 ($3.44 in chips) 
Seat 4: Gmenbubz ($3.10 in chips) 
Seat 5: Berti281 ($2 in chips) 
Seat 6: Healthys07 ($4.08 in chips) 
Scaaalll: posts small blind $0.01
ser313131: posts big blind $0.02
*** HOLE CARDS ***
Dealt to Scaaalll [Js 9d]
Gmenbubz: folds 
Berti281: folds 
Healthys07: folds 
Pray_to_win: folds 
Pray_to_win is disconnected 
Scaaalll: folds 
Uncalled bet ($0.01) returned to ser313131
ser313131 collected $0.02 from pot
ser313131: doesn't show hand 
*** SUMMARY ***
Total pot $0.02 | Rake $0 
Seat 1: Pray_to_win (button) folded before Flop (didn't bet)
Seat 2: Scaaalll (small blind) folded before Flop
Seat 3: ser313131 (big blind) collected ($0.02)
Seat 4: Gmenbubz folded before Flop (didn't bet)
Seat 5: Berti281 folded before Flop (didn't bet)
Seat 6: Healthys07 folded before Flop (didn't bet)



PokerStars Zoom Hand #229230458023:  Hold'em No Limit ($0.01/$0.02) - 2021/08/21 21:37:04 CET [2021/08/21 15:37:04 ET]
Table 'Halley' 6-max Seat #1 is the button
Seat 1: Flankeris ($4.03 in chips) 
Seat 2: CrazyyParis ($2 in chips) 
Seat 3: HARRY68rus ($2.37 in chips) 
Seat 4: PapiMik3 ($2.01 in chips) 
Seat 5: Scaaalll ($3.60 in chips) 
Seat 6: lsd paper ($0.07 in chips) 
CrazyyParis: posts small blind $0.01
HARRY68rus: posts big blind $0.02
*** HOLE CARDS ***
Dealt to Scaaalll [Th 2h]
PapiMik3: folds 
lsd paper is disconnected 
Scaaalll: folds 
lsd paper: folds 
Flankeris: raises $0.04 to $0.06
CrazyyParis: raises $0.16 to $0.22
HARRY68rus: folds 
Flankeris: folds 
Uncalled bet ($0.16) returned to CrazyyParis
CrazyyParis collected $0.14 from pot
CrazyyParis: doesn't show hand 
*** SUMMARY ***
Total pot $0.14 | Rake $0 
Seat 1: Flankeris (button) folded before Flop
Seat 2: CrazyyParis (small blind) collected ($0.14)
Seat 3: HARRY68rus (big blind) folded before Flop
Seat 4: PapiMik3 folded before Flop (didn't bet)
Seat 5: Scaaalll folded before Flop (didn't bet)
Seat 6: lsd paper folded before Flop (didn't bet)



PokerStars Zoom Hand #229230463569:  Hold'em No Limit ($0.01/$0.02) - 2021/08/21 21:37:16 CET [2021/08/21 15:37:16 ET]
Table 'Halley' 6-max Seat #1 is the button
Seat 1: Jujiluju ($1.90 in chips) 
Seat 2: Amigo113 ($2.68 in chips) 
Seat 3: Scaaalll ($3.60 in chips) 
Seat 4: Healthys07 ($4.36 in chips) 
Seat 5: sg.32rus ($1.64 in chips) 
Seat 6: zbixxx ($3.89 in chips) 
Amigo113: posts small blind $0.01
Scaaalll: posts big blind $0.02
*** HOLE CARDS ***
Dealt to Scaaalll [As 7h]
Healthys07: folds 
sg.32rus: folds 
zbixxx: folds 
Jujiluju: calls $0.02
Amigo113: folds 
Scaaalll: checks 
*** FLOP *** [Kd Jc 4h]
Scaaalll: checks 
Jujiluju: checks 
*** TURN *** [Kd Jc 4h] [8s]
Scaaalll: checks 
Jujiluju: checks 
*** RIVER *** [Kd Jc 4h 8s] [2c]
Scaaalll: checks 
Jujiluju: checks 
*** SHOW DOWN ***
Scaaalll: shows [As 7h] (high card Ace)
Jujiluju: shows [Ts Ad] (high card Ace - King+Jack+Ten kicker)
Jujiluju collected $0.05 from pot
*** SUMMARY ***
Total pot $0.05 | Rake $0 
Board [Kd Jc 4h 8s 2c]
Seat 1: Jujiluju (button) showed [Ts Ad] and won ($0.05) with high card Ace
Seat 2: Amigo113 (small blind) folded before Flop
Seat 3: Scaaalll (big blind) showed [As 7h] and lost with high card Ace
Seat 4: Healthys07 folded before Flop (didn't bet)
Seat 5: sg.32rus folded before Flop (didn't bet)
Seat 6: zbixxx folded before Flop (didn't bet)



PokerStars Zoom Hand #229230461721:  Hold'em No Limit ($0.01/$0.02) - 2021/08/21 21:37:13 CET [2021/08/21 15:37:13 ET]
Table 'Halley' 6-max Seat #1 is the button
Seat 1: Scaaalll ($3.60 in chips) 
Seat 2: py100ta ($2.11 in chips) 
Seat 3: KIraMan ($3.42 in chips) 
Seat 4: alecha11 ($3.73 in chips) 
Seat 5: arrow17 ($2.03 in chips) 
Seat 6: Draat505 ($2.14 in chips) 
py100ta: posts small blind $0.01
KIraMan: posts big blind $0.02
*** HOLE CARDS ***
Dealt to Scaaalll [7s 4d]
alecha11: folds 
arrow17: folds 
Draat505: folds 
Scaaalll: folds 
py100ta: raises $0.03 to $0.05
KIraMan: calls $0.03
*** FLOP *** [Qh 4s Jh]
py100ta: bets $0.04
KIraMan: calls $0.04
*** TURN *** [Qh 4s Jh] [8c]
py100ta: bets $0.13
KIraMan: calls $0.13
*** RIVER *** [Qh 4s Jh 8c] [6c]
py100ta: checks 
KIraMan: bets $3.20 and is all-in
py100ta: calls $1.89 and is all-in
Uncalled bet ($1.31) returned to KIraMan
*** SHOW DOWN ***
KIraMan: shows [5h 7h] (a straight, Four to Eight)
py100ta: shows [Qd 7c] (a pair of Queens)
KIraMan collected $4.07 from pot
*** SUMMARY ***
Total pot $4.22 | Rake $0.15 
Board [Qh 4s Jh 8c 6c]
Seat 1: Scaaalll (button) folded before Flop (didn't bet)
Seat 2: py100ta (small blind) showed [Qd 7c] and lost with a pair of Queens
Seat 3: KIraMan (big blind) showed [5h 7h] and won ($4.07) with a straight, Four to Eight
Seat 4: alecha11 folded before Flop (didn't bet)
Seat 5: arrow17 folded before Flop (didn't bet)
Seat 6: Draat505 folded before Flop (didn't bet)



PokerStars Zoom Hand #229230478038:  Hold'em No Limit ($0.01/$0.02) - 2021/08/21 21:37:48 CET [2021/08/21 15:37:48 ET]
Table 'Halley' 6-max Seat #1 is the button
Seat 1: Runway26 ($1.98 in chips) 
Seat 2: Scaaalll ($3.58 in chips) 
Seat 3: Lacitoo ($2.32 in chips) 
Seat 4: laetschnbene ($2.37 in chips) 
Seat 5: Kuzmich_2502 ($3.69 in chips) 
Seat 6: nitzed12 ($2 in chips) 
Scaaalll: posts small blind $0.01
Lacitoo: posts big blind $0.02
*** HOLE CARDS ***
Dealt to Scaaalll [Ad 2d]
laetschnbene: folds 
Kuzmich_2502: folds 
nitzed12: folds 
Runway26: folds 
Scaaalll: raises $0.04 to $0.06
Lacitoo: folds 
Uncalled bet ($0.04) returned to Scaaalll
Scaaalll collected $0.04 from pot
Scaaalll: doesn't show hand 
Lacitoo is disconnected 
*** SUMMARY ***
Total pot $0.04 | Rake $0 
Seat 1: Runway26 (button) folded before Flop (didn't bet)
Seat 2: Scaaalll (small blind) collected ($0.04)
Seat 3: Lacitoo (big blind) folded before Flop
Seat 4: laetschnbene folded before Flop (didn't bet)
Seat 5: Kuzmich_2502 folded before Flop (didn't bet)
Seat 6: nitzed12 folded before Flop (didn't bet)



PokerStars Zoom Hand #229230475763:  Hold'em No Limit ($0.01/$0.02) - 2021/08/21 21:37:43 CET [2021/08/21 15:37:43 ET]
Table 'Halley' 6-max Seat #1 is the button
Seat 1: bmnev ($1.16 in chips) 
Seat 2: so0love ($3.11 in chips) 
Seat 3: SpartanRace1 ($7.69 in chips) 
Seat 4: Daveys14 ($1.09 in chips) 
Seat 5: PapiMik3 ($2.47 in chips) 
Seat 6: Scaaalll ($3.58 in chips) 
so0love: posts small blind $0.01
SpartanRace1: posts big blind $0.02
*** HOLE CARDS ***
Dealt to Scaaalll [Th 3c]
Daveys14: folds 
Daveys14 is disconnected 
PapiMik3: raises $0.04 to $0.06
Scaaalll: folds 
bmnev: calls $0.06
so0love: folds 
SpartanRace1: calls $0.04
*** FLOP *** [Ah Qs 5c]
SpartanRace1: checks 
PapiMik3: bets $0.04
bmnev: calls $0.04
SpartanRace1: folds 
*** TURN *** [Ah Qs 5c] [Qd]
PapiMik3: checks 
bmnev: bets $0.13
PapiMik3: folds 
Uncalled bet ($0.13) returned to bmnev
bmnev collected $0.26 from pot
bmnev: doesn't show hand 
*** SUMMARY ***
Total pot $0.27 | Rake $0.01 
Board [Ah Qs 5c Qd]
Seat 1: bmnev (button) collected ($0.26)
Seat 2: so0love (small blind) folded before Flop
Seat 3: SpartanRace1 (big blind) folded on the Flop
Seat 4: Daveys14 folded before Flop (didn't bet)
Seat 5: PapiMik3 folded on the Turn
Seat 6: Scaaalll folded before Flop (didn't bet)



PokerStars Zoom Hand #229230487251:  Hold'em No Limit ($0.01/$0.02) - 2021/08/21 21:38:07 CET [2021/08/21 15:38:07 ET]
Table 'Halley' 6-max Seat #1 is the button
Seat 1: SpartanRace1 ($11.34 in chips) 
Seat 2: jolisabe ($2.11 in chips) 
Seat 3: Jujiluju ($1.84 in chips) 
Seat 4: Scaaalll ($3.60 in chips) 
Seat 5: Molineux2002 ($1.97 in chips) 
Seat 6: GiordanoBrn ($2.04 in chips) 
jolisabe: posts small blind $0.01
Jujiluju: posts big blind $0.02
*** HOLE CARDS ***
Dealt to Scaaalll [4c 2h]
Scaaalll: folds 
Molineux2002: folds 
GiordanoBrn: folds 
SpartanRace1: folds 
GiordanoBrn is disconnected 
jolisabe: raises $0.02 to $0.04
Jujiluju: folds 
Uncalled bet ($0.02) returned to jolisabe
jolisabe collected $0.04 from pot
jolisabe: doesn't show hand 
*** SUMMARY ***
Total pot $0.04 | Rake $0 
Seat 1: SpartanRace1 (button) folded before Flop (didn't bet)
Seat 2: jolisabe (small blind) collected ($0.04)
Seat 3: Jujiluju (big blind) folded before Flop
Seat 4: Scaaalll folded before Flop (didn't bet)
Seat 5: Molineux2002 folded before Flop (didn't bet)
Seat 6: GiordanoBrn folded before Flop (didn't bet)



PokerStars Zoom Hand #229230485458:  Hold'em No Limit ($0.01/$0.02) - 2021/08/21 21:38:04 CET [2021/08/21 15:38:04 ET]
Table 'Halley' 6-max Seat #1 is the button
Seat 1: Scaaalll ($3.60 in chips) 
Seat 2: AndreaBsAs ($2 in chips) 
Seat 3: malandro733 ($3.90 in chips) 
Seat 4: Molineux2002 ($1.97 in chips) 
Seat 5: pphit ($2 in chips) 
Seat 6: zeus11983 ($2 in chips) 
AndreaBsAs: posts small blind $0.01
malandro733: posts big blind $0.02
*** HOLE CARDS ***
Dealt to Scaaalll [Jd 4s]
Molineux2002: folds 
pphit: folds 
zeus11983: raises $0.03 to $0.05
Scaaalll: folds 
AndreaBsAs: folds 
malandro733: folds 
Uncalled bet ($0.03) returned to zeus11983
zeus11983 collected $0.05 from pot
zeus11983: doesn't show hand 
*** SUMMARY ***
Total pot $0.05 | Rake $0 
Seat 1: Scaaalll (button) folded before Flop (didn't bet)
Seat 2: AndreaBsAs (small blind) folded before Flop
Seat 3: malandro733 (big blind) folded before Flop
Seat 4: Molineux2002 folded before Flop (didn't bet)
Seat 5: pphit folded before Flop (didn't bet)
Seat 6: zeus11983 collected ($0.05)



PokerStars Zoom Hand #229230492732:  Hold'em No Limit ($0.01/$0.02) - 2021/08/21 21:38:20 CET [2021/08/21 15:38:20 ET]
Table 'Halley' 6-max Seat #1 is the button
Seat 1: JDGGrinder ($3.12 in chips) 
Seat 2: vtashmat1 ($3.25 in chips) 
Seat 3: Scaaalll ($3.60 in chips) 
Seat 4: dicey bear72 ($1.96 in chips) 
Seat 5: Auteezy ($4.23 in chips) 
Seat 6: bober2702 ($1.31 in chips) 
vtashmat1: posts small blind $0.01
Scaaalll: posts big blind $0.02
*** HOLE CARDS ***
Dealt to Scaaalll [Ac 2h]
dicey bear72: folds 
dicey bear72 is disconnected 
Auteezy: folds 
bober2702: folds 
JDGGrinder: raises $0.03 to $0.05
vtashmat1: folds 
Scaaalll: folds 
Uncalled bet ($0.03) returned to JDGGrinder
JDGGrinder collected $0.05 from pot
JDGGrinder: doesn't show hand 
*** SUMMARY ***
Total pot $0.05 | Rake $0 
Seat 1: JDGGrinder (button) collected ($0.05)
Seat 2: vtashmat1 (small blind) folded before Flop
Seat 3: Scaaalll (big blind) folded before Flop
Seat 4: dicey bear72 folded before Flop (didn't bet)
Seat 5: Auteezy folded before Flop (didn't bet)
Seat 6: bober2702 folded before Flop (didn't bet)



PokerStars Zoom Hand #229230490453:  Hold'em No Limit ($0.01/$0.02) - 2021/08/21 21:38:15 CET [2021/08/21 15:38:15 ET]
Table 'Halley' 6-max Seat #1 is the button
Seat 1: Dron4uk UA ($3.08 in chips) 
Seat 2: meikoz ($2 in chips) 
Seat 3: FicheroQuit ($2.67 in chips) 
Seat 4: S1fon4o ($1.08 in chips) 
Seat 5: Scaaalll ($3.60 in chips) 
Seat 6: Nihility77 ($3.08 in chips) 
meikoz: posts small blind $0.01
FicheroQuit: posts big blind $0.02
*** HOLE CARDS ***
Dealt to Scaaalll [5s 2d]
S1fon4o: folds 
Scaaalll: folds 
Nihility77: folds 
Dron4uk UA: raises $0.04 to $0.06
meikoz: calls $0.05
FicheroQuit: folds 
*** FLOP *** [2c Ah Qh]
meikoz: checks 
Dron4uk UA: checks 
*** TURN *** [2c Ah Qh] [Td]
meikoz: checks 
Dron4uk UA: checks 
*** RIVER *** [2c Ah Qh Td] [2s]
meikoz: checks 
Dron4uk UA: checks 
*** SHOW DOWN ***
meikoz: shows [7h 7c] (two pair, Sevens and Deuces)
Dron4uk UA: shows [Js Ts] (two pair, Tens and Deuces)
Dron4uk UA collected $0.14 from pot
*** SUMMARY ***
Total pot $0.14 | Rake $0 
Board [2c Ah Qh Td 2s]
Seat 1: Dron4uk UA (button) showed [Js Ts] and won ($0.14) with two pair, Tens and Deuces
Seat 2: meikoz (small blind) showed [7h 7c] and lost with two pair, Sevens and Deuces
Seat 3: FicheroQuit (big blind) folded before Flop
Seat 4: S1fon4o folded before Flop (didn't bet)
Seat 5: Scaaalll folded before Flop (didn't bet)
Seat 6: Nihility77 folded before Flop (didn't bet)



PokerStars Zoom Hand #229230500605:  Hold'em No Limit ($0.01/$0.02) - 2021/08/21 21:38:36 CET [2021/08/21 15:38:36 ET]
Table 'Halley' 6-max Seat #1 is the button
Seat 1: KoAlRy ($2 in chips) 
Seat 2: Gibsondelux ($2.68 in chips) 
Seat 3: WithMyWalker ($3.43 in chips) 
Seat 4: MrK_Leuven ($3.55 in chips) 
Seat 5: GeraKremmov ($1.42 in chips) 
Seat 6: Scaaalll ($3.58 in chips) 
Gibsondelux: posts small blind $0.01
WithMyWalker: posts big blind $0.02
*** HOLE CARDS ***
Dealt to Scaaalll [5s 4s]
MrK_Leuven: folds 
GeraKremmov: folds 
Scaaalll: raises $0.04 to $0.06
KoAlRy: folds 
Gibsondelux: calls $0.05
WithMyWalker: calls $0.04
*** FLOP *** [Ac 9h Qs]
Gibsondelux: checks 
WithMyWalker: checks 
Scaaalll: checks 
*** TURN *** [Ac 9h Qs] [Qd]
Gibsondelux: checks 
WithMyWalker: checks 
Scaaalll: checks 
*** RIVER *** [Ac 9h Qs Qd] [9s]
Gibsondelux: checks 
WithMyWalker: checks 
Scaaalll: bets $0.12
Gibsondelux: folds 
Gibsondelux is disconnected 
WithMyWalker: folds 
Uncalled bet ($0.12) returned to Scaaalll
Scaaalll collected $0.17 from pot
Scaaalll: doesn't show hand 
*** SUMMARY ***
Total pot $0.18 | Rake $0.01 
Board [Ac 9h Qs Qd 9s]
Seat 1: KoAlRy (button) folded before Flop (didn't bet)
Seat 2: Gibsondelux (small blind) folded on the River
Seat 3: WithMyWalker (big blind) folded on the River
Seat 4: MrK_Leuven folded before Flop (didn't bet)
Seat 5: GeraKremmov folded before Flop (didn't bet)
Seat 6: Scaaalll collected ($0.17)



PokerStars Zoom Hand #229230547325:  Hold'em No Limit ($0.01/$0.02) - 2021/08/21 21:40:07 CET [2021/08/21 15:40:07 ET]
Table 'Halley' 6-max Seat #1 is the button
Seat 1: RonilsonCosta ($2.03 in chips) 
Seat 2: Scaaalll ($3.69 in chips) 
Seat 3: 01527368 ($2.07 in chips) 
Seat 4: Sv1ch ($9.87 in chips) 
Seat 5: ChowMangao ($3.45 in chips) 
Seat 6: z3317111711 ($2.24 in chips) 
Scaaalll: posts small blind $0.01
01527368: posts big blind $0.02
*** HOLE CARDS ***
Dealt to Scaaalll [9d 5h]
Sv1ch: folds 
ChowMangao: folds 
z3317111711: folds 
RonilsonCosta: folds 
Scaaalll: folds 
Uncalled bet ($0.01) returned to 01527368
01527368 collected $0.02 from pot
01527368: doesn't show hand 
*** SUMMARY ***
Total pot $0.02 | Rake $0 
Seat 1: RonilsonCosta (button) folded before Flop (didn't bet)
Seat 2: Scaaalll (small blind) folded before Flop
Seat 3: 01527368 (big blind) collected ($0.02)
Seat 4: Sv1ch folded before Flop (didn't bet)
Seat 5: ChowMangao folded before Flop (didn't bet)
Seat 6: z3317111711 folded before Flop (didn't bet)



PokerStars Zoom Hand #229230544997:  Hold'em No Limit ($0.01/$0.02) - 2021/08/21 21:40:02 CET [2021/08/21 15:40:02 ET]
Table 'Halley' 6-max Seat #1 is the button
Seat 1: bober2702 ($1.09 in chips) 
Seat 2: z3317111711 ($2.25 in chips) 
Seat 3: lucksuckdonk ($3.12 in chips) 
Seat 4: Scaaalll ($3.69 in chips) 
Seat 5: S1fon4o ($2.40 in chips) 
Seat 6: Hilti66 ($1.77 in chips) 
z3317111711: posts small blind $0.01
lucksuckdonk: posts big blind $0.02
*** HOLE CARDS ***
Dealt to Scaaalll [Kh 7h]
Hilti66 is disconnected 
Scaaalll: folds 
S1fon4o: folds 
Hilti66: folds 
bober2702: raises $0.03 to $0.05
z3317111711: folds 
lucksuckdonk: raises $0.15 to $0.20
bober2702: calls $0.15
*** FLOP *** [7s 9d Ts]
lucksuckdonk: bets $0.27
bober2702: calls $0.27
*** TURN *** [7s 9d Ts] [Js]
lucksuckdonk: bets $0.62
bober2702: folds 
Uncalled bet ($0.62) returned to lucksuckdonk
lucksuckdonk collected $0.92 from pot
lucksuckdonk: doesn't show hand 
*** SUMMARY ***
Total pot $0.95 | Rake $0.03 
Board [7s 9d Ts Js]
Seat 1: bober2702 (button) folded on the Turn
Seat 2: z3317111711 (small blind) folded before Flop
Seat 3: lucksuckdonk (big blind) collected ($0.92)
Seat 4: Scaaalll folded before Flop (didn't bet)
Seat 5: S1fon4o folded before Flop (didn't bet)
Seat 6: Hilti66 folded before Flop (didn't bet)



PokerStars Zoom Hand #229230549096:  Hold'em No Limit ($0.01/$0.02) - 2021/08/21 21:40:11 CET [2021/08/21 15:40:11 ET]
Table 'Halley' 6-max Seat #1 is the button
Seat 1: SpartanRace1 ($8.26 in chips) 
Seat 2: RrriotGrrrl ($2.70 in chips) 
Seat 3: Scaaalll ($3.68 in chips) 
Seat 4: Draat505 ($2.18 in chips) 
Seat 5: Zastrzol ($2.36 in chips) 
Seat 6: alexant77 ($2.48 in chips) 
RrriotGrrrl: posts small blind $0.01
Scaaalll: posts big blind $0.02
*** HOLE CARDS ***
Dealt to Scaaalll [Tc Td]
Draat505: folds 
Zastrzol: folds 
alexant77: folds 
Zastrzol is disconnected 
SpartanRace1: raises $0.02 to $0.04
RrriotGrrrl: folds 
Scaaalll: raises $0.12 to $0.16
SpartanRace1: folds 
Uncalled bet ($0.12) returned to Scaaalll
Scaaalll collected $0.09 from pot
Scaaalll: doesn't show hand 
*** SUMMARY ***
Total pot $0.09 | Rake $0 
Seat 1: SpartanRace1 (button) folded before Flop
Seat 2: RrriotGrrrl (small blind) folded before Flop
Seat 3: Scaaalll (big blind) collected ($0.09)
Seat 4: Draat505 folded before Flop (didn't bet)
Seat 5: Zastrzol folded before Flop (didn't bet)
Seat 6: alexant77 folded before Flop (didn't bet)



PokerStars Zoom Hand #229230558808:  Hold'em No Limit ($0.01/$0.02) - 2021/08/21 21:40:31 CET [2021/08/21 15:40:31 ET]
Table 'Halley' 6-max Seat #1 is the button
Seat 1: Scaaalll ($3.73 in chips) 
Seat 2: estelionat171 ($1 in chips) 
Seat 3: Clavis Noa ($3.13 in chips) 
Seat 4: Amigo113 ($2.10 in chips) 
Seat 5: ximik D V ($2 in chips) 
Seat 6: fishh_play ($2.70 in chips) 
estelionat171: posts small blind $0.01
Clavis Noa: posts big blind $0.02
*** HOLE CARDS ***
Dealt to Scaaalll [5d 6c]
Amigo113: folds 
ximik D V: folds 
fishh_play: folds 
Scaaalll: folds 
estelionat171: folds 
Uncalled bet ($0.01) returned to Clavis Noa
Clavis Noa collected $0.02 from pot
Clavis Noa: doesn't show hand 
*** SUMMARY ***
Total pot $0.02 | Rake $0 
Seat 1: Scaaalll (button) folded before Flop (didn't bet)
Seat 2: estelionat171 (small blind) folded before Flop
Seat 3: Clavis Noa (big blind) collected ($0.02)
Seat 4: Amigo113 folded before Flop (didn't bet)
Seat 5: ximik D V folded before Flop (didn't bet)
Seat 6: fishh_play folded before Flop (didn't bet)



PokerStars Zoom Hand #229230560632:  Hold'em No Limit ($0.01/$0.02) - 2021/08/21 21:40:35 CET [2021/08/21 15:40:35 ET]
Table 'Halley' 6-max Seat #1 is the button
Seat 1: AlexGTPS ($1.97 in chips) 
Seat 2: PapiMik3 ($2.08 in chips) 
Seat 3: laetschnbene ($0.60 in chips) 
Seat 4: 77omsk ($7.98 in chips) 
Seat 5: Scaaalll ($3.73 in chips) 
Seat 6: zergmiky ($2.89 in chips) 
PapiMik3: posts small blind $0.01
laetschnbene: posts big blind $0.02
*** HOLE CARDS ***
Dealt to Scaaalll [Qd 5h]
77omsk: folds 
Scaaalll: folds 
zergmiky: folds 
AlexGTPS: raises $0.03 to $0.05
PapiMik3: raises $0.15 to $0.20
laetschnbene: folds 
AlexGTPS: folds 
Uncalled bet ($0.15) returned to PapiMik3
PapiMik3 collected $0.12 from pot
PapiMik3: doesn't show hand 
*** SUMMARY ***
Total pot $0.12 | Rake $0 
Seat 1: AlexGTPS (button) folded before Flop
Seat 2: PapiMik3 (small blind) collected ($0.12)
Seat 3: laetschnbene (big blind) folded before Flop
Seat 4: 77omsk folded before Flop (didn't bet)
Seat 5: Scaaalll folded before Flop (didn't bet)
Seat 6: zergmiky folded before Flop (didn't bet)



PokerStars Zoom Hand #229230562505:  Hold'em No Limit ($0.01/$0.02) - 2021/08/21 21:40:39 CET [2021/08/21 15:40:39 ET]
Table 'Halley' 6-max Seat #1 is the button
Seat 1: cowboy9100529 ($3.64 in chips) 
Seat 2: Rooster26396 ($1.15 in chips) 
Seat 3: NecromiconP ($2.82 in chips) 
Seat 4: BIITRU ($6.04 in chips) 
Seat 5: Salazar-MF ($2.57 in chips) 
Seat 6: Scaaalll ($3.73 in chips) 
Rooster26396: posts small blind $0.01
NecromiconP: posts big blind $0.02
*** HOLE CARDS ***
Dealt to Scaaalll [Jd 8h]
BIITRU: folds 
Salazar-MF: folds 
Scaaalll: folds 
cowboy9100529: raises $0.02 to $0.04
Rooster26396: raises $0.02 to $0.06
NecromiconP: folds 
cowboy9100529: calls $0.02
*** FLOP *** [Th 4h 6d]
Rooster26396: checks 
cowboy9100529: checks 
*** TURN *** [Th 4h 6d] [9d]
Rooster26396: checks 
cowboy9100529: bets $0.09
Rooster26396: calls $0.09
*** RIVER *** [Th 4h 6d 9d] [2h]
Rooster26396: checks 
cowboy9100529: bets $0.35
Rooster26396: folds 
Uncalled bet ($0.35) returned to cowboy9100529
cowboy9100529 collected $0.31 from pot
cowboy9100529: doesn't show hand 
Rooster26396 is disconnected 
*** SUMMARY ***
Total pot $0.32 | Rake $0.01 
Board [Th 4h 6d 9d 2h]
Seat 1: cowboy9100529 (button) collected ($0.31)
Seat 2: Rooster26396 (small blind) folded on the River
Seat 3: NecromiconP (big blind) folded before Flop
Seat 4: BIITRU folded before Flop (didn't bet)
Seat 5: Salazar-MF folded before Flop (didn't bet)
Seat 6: Scaaalll folded before Flop (didn't bet)



PokerStars Zoom Hand #229230564323:  Hold'em No Limit ($0.01/$0.02) - 2021/08/21 21:40:43 CET [2021/08/21 15:40:43 ET]
Table 'Halley' 6-max Seat #1 is the button
Seat 1: nodtress ($2 in chips) 
Seat 2: EevAA190 ($2.65 in chips) 
Seat 3: wikkers ($2.34 in chips) 
Seat 4: Scaaalll ($3.73 in chips) 
Seat 5: mheronmagno ($2.25 in chips) 
Seat 6: Kb013497 ($1.94 in chips) 
EevAA190: posts small blind $0.01
wikkers: posts big blind $0.02
*** HOLE CARDS ***
Dealt to Scaaalll [9c 9d]
Scaaalll: raises $0.04 to $0.06
mheronmagno: calls $0.06
Kb013497: folds 
nodtress: folds 
EevAA190: calls $0.05
wikkers: calls $0.04
*** FLOP *** [4d 8h Jh]
EevAA190: checks 
wikkers: checks 
Scaaalll: checks 
mheronmagno: checks 
*** TURN *** [4d 8h Jh] [Ad]
EevAA190: checks 
wikkers: checks 
Scaaalll: checks 
mheronmagno: checks 
*** RIVER *** [4d 8h Jh Ad] [4c]
EevAA190: checks 
wikkers: checks 
Scaaalll: checks 
mheronmagno: bets $0.10
EevAA190: folds 
wikkers: folds 
Scaaalll: calls $0.10
*** SHOW DOWN ***
mheronmagno: shows [Js Ah] (two pair, Aces and Jacks)
Scaaalll: mucks hand 
mheronmagno collected $0.42 from pot
*** SUMMARY ***
Total pot $0.44 | Rake $0.02 
Board [4d 8h Jh Ad 4c]
Seat 1: nodtress (button) folded before Flop (didn't bet)
Seat 2: EevAA190 (small blind) folded on the River
Seat 3: wikkers (big blind) folded on the River
Seat 4: Scaaalll mucked [9c 9d]
Seat 5: mheronmagno showed [Js Ah] and won ($0.42) with two pair, Aces and Jacks
Seat 6: Kb013497 folded before Flop (didn't bet)



PokerStars Zoom Hand #229230589617:  Hold'em No Limit ($0.01/$0.02) - 2021/08/21 21:41:39 CET [2021/08/21 15:41:39 ET]
Table 'Halley' 6-max Seat #1 is the button
Seat 1: HellNative ($3.35 in chips) 
Seat 2: kboskov123 ($1.98 in chips) 
Seat 3: juraa14 ($2.33 in chips) 
Seat 4: ARTMVSLV ($2.96 in chips) 
Seat 5: Scaaalll ($3.56 in chips) 
Seat 6: estelionat171 ($0.99 in chips) 
kboskov123: posts small blind $0.01
juraa14: posts big blind $0.02
*** HOLE CARDS ***
Dealt to Scaaalll [Td 4h]
ARTMVSLV: folds 
Scaaalll: folds 
estelionat171: folds 
HellNative: raises $0.03 to $0.05
kboskov123: folds 
juraa14: folds 
Uncalled bet ($0.03) returned to HellNative
HellNative collected $0.05 from pot
HellNative: doesn't show hand 
*** SUMMARY ***
Total pot $0.05 | Rake $0 
Seat 1: HellNative (button) collected ($0.05)
Seat 2: kboskov123 (small blind) folded before Flop
Seat 3: juraa14 (big blind) folded before Flop
Seat 4: ARTMVSLV folded before Flop (didn't bet)
Seat 5: Scaaalll folded before Flop (didn't bet)
Seat 6: estelionat171 folded before Flop (didn't bet)



PokerStars Zoom Hand #229230591476:  Hold'em No Limit ($0.01/$0.02) - 2021/08/21 21:41:43 CET [2021/08/21 15:41:43 ET]
Table 'Halley' 6-max Seat #1 is the button
Seat 1: Gamer577 ($2.02 in chips) 
Seat 2: arsad725 ($6.96 in chips) 
Seat 3: Molineux2002 ($1.81 in chips) 
Seat 4: Scaaalll ($3.56 in chips) 
Seat 5: woop333 ($0.50 in chips) 
Seat 6: zbixxx ($2.22 in chips) 
arsad725: posts small blind $0.01
Molineux2002: posts big blind $0.02
*** HOLE CARDS ***
Dealt to Scaaalll [Td Qs]
Scaaalll: folds 
woop333: folds 
zbixxx: folds 
Gamer577: folds 
arsad725: folds 
Uncalled bet ($0.01) returned to Molineux2002
Molineux2002 collected $0.02 from pot
Molineux2002: doesn't show hand 
*** SUMMARY ***
Total pot $0.02 | Rake $0 
Seat 1: Gamer577 (button) folded before Flop (didn't bet)
Seat 2: arsad725 (small blind) folded before Flop
Seat 3: Molineux2002 (big blind) collected ($0.02)
Seat 4: Scaaalll folded before Flop (didn't bet)
Seat 5: woop333 folded before Flop (didn't bet)
Seat 6: zbixxx folded before Flop (didn't bet)



PokerStars Zoom Hand #229230586801:  Hold'em No Limit ($0.01/$0.02) - 2021/08/21 21:41:33 CET [2021/08/21 15:41:33 ET]
Table 'Halley' 6-max Seat #1 is the button
Seat 1: shingo594 ($2.17 in chips) 
Seat 2: Scaaalll ($3.57 in chips) 
Seat 3: nV6TR ($1.91 in chips) 
Seat 4: HellNative ($2.60 in chips) 
Seat 5: valet_hai ($0.57 in chips) 
Seat 6: SIGREX ($2.30 in chips) 
Scaaalll: posts small blind $0.01
nV6TR: posts big blind $0.02
*** HOLE CARDS ***
Dealt to Scaaalll [8d 2h]
HellNative: folds 
valet_hai: folds 
SIGREX: folds 
shingo594: raises $0.04 to $0.06
Scaaalll: folds 
nV6TR: calls $0.04
*** FLOP *** [5s 7s 7d]
nV6TR: checks 
shingo594: bets $0.06
nV6TR: folds 
Uncalled bet ($0.06) returned to shingo594
shingo594 collected $0.13 from pot
shingo594: doesn't show hand 
*** SUMMARY ***
Total pot $0.13 | Rake $0 
Board [5s 7s 7d]
Seat 1: shingo594 (button) collected ($0.13)
Seat 2: Scaaalll (small blind) folded before Flop
Seat 3: nV6TR (big blind) folded on the Flop
Seat 4: HellNative folded before Flop (didn't bet)
Seat 5: valet_hai folded before Flop (didn't bet)
Seat 6: SIGREX folded before Flop (didn't bet)



PokerStars Zoom Hand #229230593365:  Hold'em No Limit ($0.01/$0.02) - 2021/08/21 21:41:46 CET [2021/08/21 15:41:46 ET]
Table 'Halley' 6-max Seat #1 is the button
Seat 1: Scaaalll ($3.56 in chips) 
Seat 2: 77omsk ($7.40 in chips) 
Seat 3: kykareky32 ($1.92 in chips) 
Seat 4: AlexGTPS ($2.06 in chips) 
Seat 5: Ruopolo1982 ($2.12 in chips) 
Seat 6: ash1448 ($10.95 in chips) 
77omsk: posts small blind $0.01
kykareky32: posts big blind $0.02
*** HOLE CARDS ***
Dealt to Scaaalll [5h Js]
AlexGTPS: raises $0.03 to $0.05
Ruopolo1982: folds 
ash1448: folds 
Scaaalll: folds 
77omsk: folds 
kykareky32: folds 
Uncalled bet ($0.03) returned to AlexGTPS
AlexGTPS collected $0.05 from pot
AlexGTPS: doesn't show hand 
*** SUMMARY ***
Total pot $0.05 | Rake $0 
Seat 1: Scaaalll (button) folded before Flop (didn't bet)
Seat 2: 77omsk (small blind) folded before Flop
Seat 3: kykareky32 (big blind) folded before Flop
Seat 4: AlexGTPS collected ($0.05)
Seat 5: Ruopolo1982 folded before Flop (didn't bet)
Seat 6: ash1448 folded before Flop (didn't bet)



PokerStars Zoom Hand #229230595686:  Hold'em No Limit ($0.01/$0.02) - 2021/08/21 21:41:52 CET [2021/08/21 15:41:52 ET]
Table 'Halley' 6-max Seat #1 is the button
Seat 1: OFSHOR ($2 in chips) 
Seat 2: klausC3 ($6 in chips) 
Seat 3: Scaaalll ($3.56 in chips) 
Seat 4: csmall14 ($2.87 in chips) 
Seat 5: Quad Jacks21 ($2.79 in chips) 
Seat 6: JaguarAndy17 ($1.97 in chips) 
klausC3: posts small blind $0.01
Scaaalll: posts big blind $0.02
*** HOLE CARDS ***
Dealt to Scaaalll [3c 9c]
csmall14: folds 
Quad Jacks21: folds 
JaguarAndy17: raises $0.03 to $0.05
OFSHOR: folds 
klausC3: folds 
Scaaalll: folds 
Uncalled bet ($0.03) returned to JaguarAndy17
JaguarAndy17 collected $0.05 from pot
JaguarAndy17: doesn't show hand 
*** SUMMARY ***
Total pot $0.05 | Rake $0 
Seat 1: OFSHOR (button) folded before Flop (didn't bet)
Seat 2: klausC3 (small blind) folded before Flop
Seat 3: Scaaalll (big blind) folded before Flop
Seat 4: csmall14 folded before Flop (didn't bet)
Seat 5: Quad Jacks21 folded before Flop (didn't bet)
Seat 6: JaguarAndy17 collected ($0.05)



PokerStars Zoom Hand #229230602176:  Hold'em No Limit ($0.01/$0.02) - 2021/08/21 21:42:06 CET [2021/08/21 15:42:06 ET]
Table 'Halley' 6-max Seat #1 is the button
Seat 1: Scaaalll ($3.54 in chips) 
Seat 2: Auteezy ($2.51 in chips) 
Seat 3: jaamonra ($3.93 in chips) 
Seat 4: Mad_Clock ($2.08 in chips) 
Seat 5: Evgen_sol23 ($0.62 in chips) 
Seat 6: BIITRU ($6 in chips) 
Auteezy: posts small blind $0.01
jaamonra: posts big blind $0.02
*** HOLE CARDS ***
Dealt to Scaaalll [3h 4s]
Mad_Clock: folds 
Evgen_sol23: raises $0.06 to $0.08
BIITRU: folds 
Scaaalll: folds 
Auteezy: folds 
jaamonra: folds 
Uncalled bet ($0.06) returned to Evgen_sol23
Evgen_sol23 collected $0.05 from pot
Evgen_sol23: doesn't show hand 
*** SUMMARY ***
Total pot $0.05 | Rake $0 
Seat 1: Scaaalll (button) folded before Flop (didn't bet)
Seat 2: Auteezy (small blind) folded before Flop
Seat 3: jaamonra (big blind) folded before Flop
Seat 4: Mad_Clock folded before Flop (didn't bet)
Seat 5: Evgen_sol23 collected ($0.05)
Seat 6: BIITRU folded before Flop (didn't bet)



PokerStars Zoom Hand #229230606279:  Hold'em No Limit ($0.01/$0.02) - 2021/08/21 21:42:15 CET [2021/08/21 15:42:15 ET]
Table 'Halley' 6-max Seat #1 is the button
Seat 1: estelionat171 ($0.92 in chips) 
Seat 2: Scaaalll ($3.54 in chips) 
Seat 3: Flankeris ($5.67 in chips) 
Seat 4: ash1448 ($2.90 in chips) 
Seat 5: usenovm ($1.73 in chips) 
Seat 6: Nihility77 ($2.10 in chips) 
Scaaalll: posts small blind $0.01
Flankeris: posts big blind $0.02
*** HOLE CARDS ***
Dealt to Scaaalll [Qs 6d]
ash1448: folds 
usenovm: folds 
Nihility77: folds 
estelionat171: folds 
Scaaalll: folds 
Uncalled bet ($0.01) returned to Flankeris
Flankeris collected $0.02 from pot
Flankeris: doesn't show hand 
*** SUMMARY ***
Total pot $0.02 | Rake $0 
Seat 1: estelionat171 (button) folded before Flop (didn't bet)
Seat 2: Scaaalll (small blind) folded before Flop
Seat 3: Flankeris (big blind) collected ($0.02)
Seat 4: ash1448 folded before Flop (didn't bet)
Seat 5: usenovm folded before Flop (didn't bet)
Seat 6: Nihility77 folded before Flop (didn't bet)



PokerStars Zoom Hand #229230604445:  Hold'em No Limit ($0.01/$0.02) - 2021/08/21 21:42:10 CET [2021/08/21 15:42:10 ET]
Table 'Halley' 6-max Seat #1 is the button
Seat 1: estelionat171 ($0.97 in chips) 
Seat 2: z3317111711 ($2.14 in chips) 
Seat 3: G1olight ($3.86 in chips) 
Seat 4: Kuzmich_2502 ($3.67 in chips) 
Seat 5: boa juice ($1.45 in chips) 
Seat 6: Scaaalll ($3.54 in chips) 
z3317111711: posts small blind $0.01
G1olight: posts big blind $0.02
*** HOLE CARDS ***
Dealt to Scaaalll [6d Jc]
Kuzmich_2502: folds 
boa juice: raises $0.04 to $0.06
Scaaalll: folds 
estelionat171: folds 
z3317111711: folds 
G1olight: folds 
Uncalled bet ($0.04) returned to boa juice
boa juice collected $0.05 from pot
boa juice: doesn't show hand 
G1olight is disconnected 
*** SUMMARY ***
Total pot $0.05 | Rake $0 
Seat 1: estelionat171 (button) folded before Flop (didn't bet)
Seat 2: z3317111711 (small blind) folded before Flop
Seat 3: G1olight (big blind) folded before Flop
Seat 4: Kuzmich_2502 folded before Flop (didn't bet)
Seat 5: boa juice collected ($0.05)
Seat 6: Scaaalll folded before Flop (didn't bet)



PokerStars Zoom Hand #229230608110:  Hold'em No Limit ($0.01/$0.02) - 2021/08/21 21:42:19 CET [2021/08/21 15:42:19 ET]
Table 'Halley' 6-max Seat #1 is the button
Seat 1: malandro733 ($2.79 in chips) 
Seat 2: RrriotGrrrl ($8.88 in chips) 
Seat 3: herbas ($2.05 in chips) 
Seat 4: zergmiky ($2 in chips) 
Seat 5: Scaaalll ($3.53 in chips) 
Seat 6: elmex886 ($2 in chips) 
RrriotGrrrl: posts small blind $0.01
herbas: posts big blind $0.02
*** HOLE CARDS ***
Dealt to Scaaalll [Ah Qc]
zergmiky: raises $0.03 to $0.05
Scaaalll: calls $0.05
elmex886: folds 
malandro733: folds 
RrriotGrrrl: folds 
herbas: calls $0.03
*** FLOP *** [2d 9h Jh]
herbas: checks 
zergmiky: bets $0.08
Scaaalll: folds 
herbas: folds 
Uncalled bet ($0.08) returned to zergmiky
zergmiky collected $0.15 from pot
zergmiky: doesn't show hand 
*** SUMMARY ***
Total pot $0.16 | Rake $0.01 
Board [2d 9h Jh]
Seat 1: malandro733 (button) folded before Flop (didn't bet)
Seat 2: RrriotGrrrl (small blind) folded before Flop
Seat 3: herbas (big blind) folded on the Flop
Seat 4: zergmiky collected ($0.15)
Seat 5: Scaaalll folded on the Flop
Seat 6: elmex886 folded before Flop (didn't bet)



PokerStars Zoom Hand #229230618773:  Hold'em No Limit ($0.01/$0.02) - 2021/08/21 21:42:41 CET [2021/08/21 15:42:41 ET]
Table 'Halley' 6-max Seat #1 is the button
Seat 1: Clavis Noa ($2.08 in chips) 
Seat 2: RaulacateFolds ($2.11 in chips) 
Seat 3: Scaaalll ($3.48 in chips) 
Seat 4: puratiino ($1.19 in chips) 
Seat 5: superstar1070 ($1.70 in chips) 
Seat 6: alecha11 ($3.64 in chips) 
RaulacateFolds: posts small blind $0.01
Scaaalll: posts big blind $0.02
*** HOLE CARDS ***
Dealt to Scaaalll [2s 8c]
puratiino: folds 
superstar1070: raises $0.02 to $0.04
alecha11: folds 
Clavis Noa: calls $0.04
RaulacateFolds: folds 
Scaaalll: folds 
*** FLOP *** [9s 6h Jh]
superstar1070: bets $0.06
Clavis Noa: calls $0.06
*** TURN *** [9s 6h Jh] [Qd]
superstar1070: checks 
Clavis Noa: checks 
*** RIVER *** [9s 6h Jh Qd] [5c]
superstar1070: checks 
Clavis Noa: checks 
*** SHOW DOWN ***
superstar1070: shows [Tc 7s] (high card Queen)
Clavis Noa: shows [Ts Js] (a pair of Jacks)
Clavis Noa collected $0.22 from pot
*** SUMMARY ***
Total pot $0.23 | Rake $0.01 
Board [9s 6h Jh Qd 5c]
Seat 1: Clavis Noa (button) showed [Ts Js] and won ($0.22) with a pair of Jacks
Seat 2: RaulacateFolds (small blind) folded before Flop
Seat 3: Scaaalll (big blind) folded before Flop
Seat 4: puratiino folded before Flop (didn't bet)
Seat 5: superstar1070 showed [Tc 7s] and lost with high card Queen
Seat 6: alecha11 folded before Flop (didn't bet)



PokerStars Zoom Hand #229230625764:  Hold'em No Limit ($0.01/$0.02) - 2021/08/21 21:42:56 CET [2021/08/21 15:42:56 ET]
Table 'Halley' 6-max Seat #1 is the button
Seat 1: benubeção ($1.03 in chips) 
Seat 2: meikoz ($2.31 in chips) 
Seat 3: Nihility77 ($2.02 in chips) 
Seat 4: Scaaalll ($3.46 in chips) 
Seat 5: fabor1303 ($2 in chips) 
Seat 6: William7737 ($1.31 in chips) 
meikoz: posts small blind $0.01
Nihility77: posts big blind $0.02
*** HOLE CARDS ***
Dealt to Scaaalll [Kh 3c]
Scaaalll: folds 
fabor1303: folds 
William7737: folds 
benubeção: calls $0.02
meikoz: folds 
Nihility77: checks 
*** FLOP *** [2c 2h 4s]
Nihility77: checks 
benubeção: checks 
*** TURN *** [2c 2h 4s] [8s]
Nihility77: checks 
benubeção: checks 
*** RIVER *** [2c 2h 4s 8s] [2s]
Nihility77: checks 
benubeção: checks 
*** SHOW DOWN ***
Nihility77: shows [3d 6s] (three of a kind, Deuces)
benubeção: shows [Jh Th] (three of a kind, Deuces - Jack kicker)
benubeção collected $0.05 from pot
*** SUMMARY ***
Total pot $0.05 | Rake $0 
Board [2c 2h 4s 8s 2s]
Seat 1: benubeção (button) showed [Jh Th] and won ($0.05) with three of a kind, Deuces
Seat 2: meikoz (small blind) folded before Flop
Seat 3: Nihility77 (big blind) showed [3d 6s] and lost with three of a kind, Deuces
Seat 4: Scaaalll folded before Flop (didn't bet)
Seat 5: fabor1303 folded before Flop (didn't bet)
Seat 6: William7737 folded before Flop (didn't bet)



PokerStars Zoom Hand #229230627633:  Hold'em No Limit ($0.01/$0.02) - 2021/08/21 21:43:00 CET [2021/08/21 15:43:00 ET]
Table 'Halley' 6-max Seat #1 is the button
Seat 1: Henry Chinasky ($2.62 in chips) 
Seat 2: cowboy9100529 ($3.89 in chips) 
Seat 3: kykareky32 ($2.09 in chips) 
Seat 4: qpsq ($3.12 in chips) 
Seat 5: meikoz ($2.30 in chips) 
Seat 6: Scaaalll ($3.46 in chips) 
cowboy9100529: posts small blind $0.01
kykareky32: posts big blind $0.02
*** HOLE CARDS ***
Dealt to Scaaalll [7h 9h]
qpsq: folds 
meikoz: folds 
Scaaalll: raises $0.04 to $0.06
Henry Chinasky: calls $0.06
cowboy9100529: calls $0.05
kykareky32: folds 
*** FLOP *** [6h 9d 3s]
cowboy9100529: checks 
Scaaalll: bets $0.12
Henry Chinasky: folds 
cowboy9100529: folds 
Uncalled bet ($0.12) returned to Scaaalll
Scaaalll collected $0.19 from pot
Scaaalll: doesn't show hand 
cowboy9100529 is disconnected 
*** SUMMARY ***
Total pot $0.20 | Rake $0.01 
Board [6h 9d 3s]
Seat 1: Henry Chinasky (button) folded on the Flop
Seat 2: cowboy9100529 (small blind) folded on the Flop
Seat 3: kykareky32 (big blind) folded before Flop
Seat 4: qpsq folded before Flop (didn't bet)
Seat 5: meikoz folded before Flop (didn't bet)
Seat 6: Scaaalll collected ($0.19)



PokerStars Zoom Hand #229230642319:  Hold'em No Limit ($0.01/$0.02) - 2021/08/21 21:43:32 CET [2021/08/21 15:43:32 ET]
Table 'Halley' 6-max Seat #1 is the button
Seat 1: Scaaalll ($3.59 in chips) 
Seat 2: z1z2z315 ($0.77 in chips) 
Seat 3: zergmiky ($2.88 in chips) 
Seat 4: ser313131 ($2.07 in chips) 
Seat 5: CrazyyParis ($2 in chips) 
Seat 6: Fedor_Gar ($4.01 in chips) 
z1z2z315: posts small blind $0.01
zergmiky: posts big blind $0.02
*** HOLE CARDS ***
Dealt to Scaaalll [Qh As]
ser313131: folds 
CrazyyParis: folds 
Fedor_Gar: folds 
Scaaalll: raises $0.02 to $0.04
z1z2z315: calls $0.03
zergmiky: folds 
*** FLOP *** [7d 4c Jc]
z1z2z315: checks 
Scaaalll: bets $0.06
z1z2z315: calls $0.06
*** TURN *** [7d 4c Jc] [7c]
z1z2z315: checks 
Scaaalll: checks 
*** RIVER *** [7d 4c Jc 7c] [3h]
z1z2z315: bets $0.06
Scaaalll: folds 
Uncalled bet ($0.06) returned to z1z2z315
z1z2z315 collected $0.21 from pot
z1z2z315: doesn't show hand 
*** SUMMARY ***
Total pot $0.22 | Rake $0.01 
Board [7d 4c Jc 7c 3h]
Seat 1: Scaaalll (button) folded on the River
Seat 2: z1z2z315 (small blind) collected ($0.21)
Seat 3: zergmiky (big blind) folded before Flop
Seat 4: ser313131 folded before Flop (didn't bet)
Seat 5: CrazyyParis folded before Flop (didn't bet)
Seat 6: Fedor_Gar folded before Flop (didn't bet)



PokerStars Zoom Hand #229230661386:  Hold'em No Limit ($0.01/$0.02) - 2021/08/21 21:44:15 CET [2021/08/21 15:44:15 ET]
Table 'Halley' 6-max Seat #1 is the button
Seat 1: Grashüpferchen ($0.76 in chips) 
Seat 2: Scaaalll ($3.49 in chips) 
Seat 3: Gerar NB ($2 in chips) 
Seat 4: Finderra ($4.37 in chips) 
Seat 5: fabor1303 ($2.01 in chips) 
Seat 6: samn102 ($2.35 in chips) 
Scaaalll: posts small blind $0.01
Gerar NB: posts big blind $0.02
*** HOLE CARDS ***
Dealt to Scaaalll [3h 9c]
samn102 is disconnected 
Finderra: folds 
fabor1303: raises $0.03 to $0.05
samn102: folds 
Grashüpferchen: folds 
Scaaalll: folds 
Gerar NB: folds 
Uncalled bet ($0.03) returned to fabor1303
fabor1303 collected $0.05 from pot
fabor1303: doesn't show hand 
*** SUMMARY ***
Total pot $0.05 | Rake $0 
Seat 1: Grashüpferchen (button) folded before Flop (didn't bet)
Seat 2: Scaaalll (small blind) folded before Flop
Seat 3: Gerar NB (big blind) folded before Flop
Seat 4: Finderra folded before Flop (didn't bet)
Seat 5: fabor1303 collected ($0.05)
Seat 6: samn102 folded before Flop (didn't bet)



PokerStars Zoom Hand #229230663669:  Hold'em No Limit ($0.01/$0.02) - 2021/08/21 21:44:20 CET [2021/08/21 15:44:20 ET]
Table 'Halley' 6-max Seat #1 is the button
Seat 1: cowboy9100529 ($3.81 in chips) 
Seat 2: elmex886 ($2.01 in chips) 
Seat 3: Scaaalll ($3.48 in chips) 
Seat 4: fede venegas ($2 in chips) 
Seat 5: uniicecube ($2.02 in chips) 
Seat 6: lukzmodric10 ($2.37 in chips) 
elmex886: posts small blind $0.01
Scaaalll: posts big blind $0.02
*** HOLE CARDS ***
Dealt to Scaaalll [2c 3c]
fede venegas: folds 
uniicecube: raises $0.09 to $0.11
cowboy9100529 is disconnected 
lukzmodric10: calls $0.11
cowboy9100529: folds 
elmex886: folds 
Scaaalll: folds 
*** FLOP *** [9h 7s Qh]
uniicecube: checks 
lukzmodric10: bets $0.12
uniicecube: calls $0.12
*** TURN *** [9h 7s Qh] [Js]
uniicecube: bets $0.14
lukzmodric10: calls $0.14
*** RIVER *** [9h 7s Qh Js] [8s]
uniicecube: bets $0.12
lukzmodric10: calls $0.12
*** SHOW DOWN ***
uniicecube: shows [As Ad] (a pair of Aces)
lukzmodric10: shows [9d 8d] (two pair, Nines and Eights)
lukzmodric10 collected $0.97 from pot
*** SUMMARY ***
Total pot $1.01 | Rake $0.04 
Board [9h 7s Qh Js 8s]
Seat 1: cowboy9100529 (button) folded before Flop (didn't bet)
Seat 2: elmex886 (small blind) folded before Flop
Seat 3: Scaaalll (big blind) folded before Flop
Seat 4: fede venegas folded before Flop (didn't bet)
Seat 5: uniicecube showed [As Ad] and lost with a pair of Aces
Seat 6: lukzmodric10 showed [9d 8d] and won ($0.97) with two pair, Nines and Eights



PokerStars Zoom Hand #229230671542:  Hold'em No Limit ($0.01/$0.02) - 2021/08/21 21:44:37 CET [2021/08/21 15:44:37 ET]
Table 'Halley' 6-max Seat #1 is the button
Seat 1: Nihility77 ($2.93 in chips) 
Seat 2: so0love ($4.27 in chips) 
Seat 3: CordiPS ($3.17 in chips) 
Seat 4: kahzura ($2.26 in chips) 
Seat 5: Kb013497 ($1.76 in chips) 
Seat 6: Scaaalll ($3.46 in chips) 
so0love: posts small blind $0.01
CordiPS: posts big blind $0.02
*** HOLE CARDS ***
Dealt to Scaaalll [Js 4d]
kahzura: folds 
Kb013497: folds 
Scaaalll: folds 
Nihility77: raises $0.03 to $0.05
so0love: folds 
CordiPS: calls $0.03
*** FLOP *** [5d Qc 4h]
CordiPS: checks 
Nihility77: bets $0.06
CordiPS: calls $0.06
*** TURN *** [5d Qc 4h] [9s]
CordiPS: checks 
Nihility77: bets $0.11
CordiPS: calls $0.11
*** RIVER *** [5d Qc 4h 9s] [3h]
CordiPS: checks 
Nihility77: checks 
*** SHOW DOWN ***
CordiPS: shows [Qh 7h] (a pair of Queens)
Nihility77: mucks hand 
CordiPS collected $0.43 from pot
*** SUMMARY ***
Total pot $0.45 | Rake $0.02 
Board [5d Qc 4h 9s 3h]
Seat 1: Nihility77 (button) mucked [6h 5h]
Seat 2: so0love (small blind) folded before Flop
Seat 3: CordiPS (big blind) showed [Qh 7h] and won ($0.43) with a pair of Queens
Seat 4: kahzura folded before Flop (didn't bet)
Seat 5: Kb013497 folded before Flop (didn't bet)
Seat 6: Scaaalll folded before Flop (didn't bet)



PokerStars Zoom Hand #229230673307:  Hold'em No Limit ($0.01/$0.02) - 2021/08/21 21:44:40 CET [2021/08/21 15:44:40 ET]
Table 'Halley' 6-max Seat #1 is the button
Seat 1: Syberya ($2.12 in chips) 
Seat 2: samn102 ($2.33 in chips) 
Seat 3: Syd Wright ($2.30 in chips) 
Seat 4: AlexGTPS ($2.25 in chips) 
Seat 5: Scaaalll ($3.46 in chips) 
Seat 6: zeus11983 ($2.11 in chips) 
samn102: posts small blind $0.01
Syd Wright: posts big blind $0.02
*** HOLE CARDS ***
Dealt to Scaaalll [7c Tc]
Syberya is disconnected 
AlexGTPS: folds 
Scaaalll: folds 
zeus11983: folds 
Syberya: folds 
samn102: raises $0.04 to $0.06
Syd Wright: calls $0.04
*** FLOP *** [9s 5d As]
samn102: bets $0.06
Syd Wright: folds 
Uncalled bet ($0.06) returned to samn102
samn102 collected $0.12 from pot
samn102: doesn't show hand 
*** SUMMARY ***
Total pot $0.12 | Rake $0 
Board [9s 5d As]
Seat 1: Syberya (button) folded before Flop (didn't bet)
Seat 2: samn102 (small blind) collected ($0.12)
Seat 3: Syd Wright (big blind) folded on the Flop
Seat 4: AlexGTPS folded before Flop (didn't bet)
Seat 5: Scaaalll folded before Flop (didn't bet)
Seat 6: zeus11983 folded before Flop (didn't bet)



PokerStars Zoom Hand #229230677795:  Hold'em No Limit ($0.01/$0.02) - 2021/08/21 21:44:51 CET [2021/08/21 15:44:51 ET]
Table 'Halley' 6-max Seat #1 is the button
Seat 1: Fanatspartak ($1.16 in chips) 
Seat 2: kahzura ($5.80 in chips) 
Seat 3: LegendaryLRS ($3.41 in chips) 
Seat 4: Scaaalll ($3.46 in chips) 
Seat 5: Respectik ($2.24 in chips) 
Seat 6: pipecmolodec ($2.05 in chips) 
kahzura: posts small blind $0.01
LegendaryLRS: posts big blind $0.02
*** HOLE CARDS ***
Dealt to Scaaalll [As Ah]
Scaaalll: raises $0.04 to $0.06
Respectik: calls $0.06
pipecmolodec: folds 
Fanatspartak: folds 
kahzura: folds 
LegendaryLRS: folds 
*** FLOP *** [3s Tc 7c]
Scaaalll: bets $0.09
Respectik: calls $0.09
*** TURN *** [3s Tc 7c] [6d]
Scaaalll: bets $0.20
Respectik: calls $0.20
*** RIVER *** [3s Tc 7c 6d] [Qd]
Scaaalll: bets $0.48
Respectik: raises $1.41 to $1.89 and is all-in
Scaaalll: folds 
Uncalled bet ($1.41) returned to Respectik
Respectik collected $1.63 from pot
Respectik: doesn't show hand 
*** SUMMARY ***
Total pot $1.69 | Rake $0.06 
Board [3s Tc 7c 6d Qd]
Seat 1: Fanatspartak (button) folded before Flop (didn't bet)
Seat 2: kahzura (small blind) folded before Flop
Seat 3: LegendaryLRS (big blind) folded before Flop
Seat 4: Scaaalll folded on the River
Seat 5: Respectik collected ($1.63)
Seat 6: pipecmolodec folded before Flop (didn't bet)



PokerStars Zoom Hand #229230700533:  Hold'em No Limit ($0.01/$0.02) - 2021/08/21 21:45:40 CET [2021/08/21 15:45:40 ET]
Table 'Halley' 6-max Seat #1 is the button
Seat 1: Healthys07 ($5.08 in chips) 
Seat 2: Scaaalll ($2.63 in chips) 
Seat 3: boa juice ($1.70 in chips) 
Seat 4: py100ta ($13.94 in chips) 
Seat 5: shingo594 ($2.16 in chips) 
Seat 6: Benjani1412 ($4.58 in chips) 
Scaaalll: posts small blind $0.01
boa juice: posts big blind $0.02
*** HOLE CARDS ***
Dealt to Scaaalll [6d 7d]
py100ta: folds 
shingo594: folds 
Benjani1412: folds 
Healthys07: folds 
shingo594 is disconnected 
Scaaalll: raises $0.04 to $0.06
boa juice: folds 
Uncalled bet ($0.04) returned to Scaaalll
Scaaalll collected $0.04 from pot
Scaaalll: doesn't show hand 
boa juice is disconnected 
*** SUMMARY ***
Total pot $0.04 | Rake $0 
Seat 1: Healthys07 (button) folded before Flop (didn't bet)
Seat 2: Scaaalll (small blind) collected ($0.04)
Seat 3: boa juice (big blind) folded before Flop
Seat 4: py100ta folded before Flop (didn't bet)
Seat 5: shingo594 folded before Flop (didn't bet)
Seat 6: Benjani1412 folded before Flop (didn't bet)



PokerStars Zoom Hand #229230706907:  Hold'em No Limit ($0.01/$0.02) - 2021/08/21 21:45:54 CET [2021/08/21 15:45:54 ET]
Table 'Halley' 6-max Seat #1 is the button
Seat 1: Gerar NB ($2.40 in chips) 
Seat 2: AshoT#001 ($2.16 in chips) 
Seat 3: Koldun 2636 ($2.66 in chips) 
Seat 4: 21041956 ($2.02 in chips) 
Seat 5: Scaaalll ($2.65 in chips) 
Seat 6: ctaceo ($2.14 in chips) 
AshoT#001: posts small blind $0.01
Koldun 2636: posts big blind $0.02
*** HOLE CARDS ***
Dealt to Scaaalll [Ad Jh]
AshoT#001 is disconnected 
21041956 has timed out
21041956: folds 
Scaaalll: raises $0.04 to $0.06
ctaceo: folds 
Gerar NB: folds 
AshoT#001: folds 
Koldun 2636: calls $0.04
*** FLOP *** [6h 7c Ah]
Koldun 2636: checks 
Scaaalll: bets $0.08
Koldun 2636: folds 
Uncalled bet ($0.08) returned to Scaaalll
Scaaalll collected $0.13 from pot
Scaaalll: doesn't show hand 
*** SUMMARY ***
Total pot $0.13 | Rake $0 
Board [6h 7c Ah]
Seat 1: Gerar NB (button) folded before Flop (didn't bet)
Seat 2: AshoT#001 (small blind) folded before Flop
Seat 3: Koldun 2636 (big blind) folded on the Flop
Seat 4: 21041956 folded before Flop (didn't bet)
Seat 5: Scaaalll collected ($0.13)
Seat 6: ctaceo folded before Flop (didn't bet)



PokerStars Zoom Hand #229230727310:  Hold'em No Limit ($0.01/$0.02) - 2021/08/21 21:46:40 CET [2021/08/21 15:46:40 ET]
Table 'Halley' 6-max Seat #1 is the button
Seat 1: Flankeris ($4.95 in chips) 
Seat 2: zallav ($4.91 in chips) 
Seat 3: Scaaalll ($2.72 in chips) 
Seat 4: HellNative ($3.31 in chips) 
Seat 5: Bufre ($3.82 in chips) 
Seat 6: VoidEclipse ($2.54 in chips) 
zallav: posts small blind $0.01
Scaaalll: posts big blind $0.02
*** HOLE CARDS ***
Dealt to Scaaalll [6c 2d]
zallav is disconnected 
HellNative: folds 
Bufre: folds 
VoidEclipse: folds 
Flankeris: raises $0.04 to $0.06
zallav: folds 
Scaaalll: folds 
Uncalled bet ($0.04) returned to Flankeris
Flankeris collected $0.05 from pot
Flankeris: doesn't show hand 
*** SUMMARY ***
Total pot $0.05 | Rake $0 
Seat 1: Flankeris (button) collected ($0.05)
Seat 2: zallav (small blind) folded before Flop
Seat 3: Scaaalll (big blind) folded before Flop
Seat 4: HellNative folded before Flop (didn't bet)
Seat 5: Bufre folded before Flop (didn't bet)
Seat 6: VoidEclipse folded before Flop (didn't bet)



PokerStars Zoom Hand #229230733319:  Hold'em No Limit ($0.01/$0.02) - 2021/08/21 21:46:53 CET [2021/08/21 15:46:53 ET]
Table 'Halley' 6-max Seat #1 is the button
Seat 1: Scaaalll ($2.70 in chips) 
Seat 2: Berti281 ($2.59 in chips) 
Seat 3: estelionat171 ($1.79 in chips) 
Seat 4: Jujiluju ($1.82 in chips) 
Seat 5: zallav ($4.90 in chips) 
Seat 6: Benjani1412 ($2.14 in chips) 
Berti281: posts small blind $0.01
estelionat171: posts big blind $0.02
*** HOLE CARDS ***
Dealt to Scaaalll [3c Qh]
Jujiluju: folds 
zallav has timed out
zallav: folds 
Benjani1412: folds 
Scaaalll: folds 
Berti281: folds 
Uncalled bet ($0.01) returned to estelionat171
zallav is disconnected 
estelionat171 collected $0.02 from pot
estelionat171: doesn't show hand 
*** SUMMARY ***
Total pot $0.02 | Rake $0 
Seat 1: Scaaalll (button) folded before Flop (didn't bet)
Seat 2: Berti281 (small blind) folded before Flop
Seat 3: estelionat171 (big blind) collected ($0.02)
Seat 4: Jujiluju folded before Flop (didn't bet)
Seat 5: zallav folded before Flop (didn't bet)
Seat 6: Benjani1412 folded before Flop (didn't bet)



PokerStars Zoom Hand #229230737423:  Hold'em No Limit ($0.01/$0.02) - 2021/08/21 21:47:02 CET [2021/08/21 15:47:02 ET]
Table 'Halley' 6-max Seat #1 is the button
Seat 1: ryancudmore ($3.24 in chips) 
Seat 2: dinoVIEIRA ($2 in chips) 
Seat 3: man070707 ($0.97 in chips) 
Seat 4: Scaaalll ($2.70 in chips) 
Seat 5: CrazyyParis ($2.15 in chips) 
Seat 6: Nihility77 ($3.40 in chips) 
dinoVIEIRA: posts small blind $0.01
man070707: posts big blind $0.02
*** HOLE CARDS ***
Dealt to Scaaalll [6d 9d]
Scaaalll: folds 
CrazyyParis: folds 
Nihility77: folds 
ryancudmore: raises $0.04 to $0.06
dinoVIEIRA: folds 
man070707: folds 
Uncalled bet ($0.04) returned to ryancudmore
ryancudmore collected $0.05 from pot
ryancudmore: doesn't show hand 
man070707 is disconnected 
*** SUMMARY ***
Total pot $0.05 | Rake $0 
Seat 1: ryancudmore (button) collected ($0.05)
Seat 2: dinoVIEIRA (small blind) folded before Flop
Seat 3: man070707 (big blind) folded before Flop
Seat 4: Scaaalll folded before Flop (didn't bet)
Seat 5: CrazyyParis folded before Flop (didn't bet)
Seat 6: Nihility77 folded before Flop (didn't bet)



PokerStars Zoom Hand #229230735594:  Hold'em No Limit ($0.01/$0.02) - 2021/08/21 21:46:57 CET [2021/08/21 15:46:57 ET]
Table 'Halley' 6-max Seat #1 is the button
Seat 1: Fanatspartak ($0.38 in chips) 
Seat 2: gugamoraes ($2.08 in chips) 
Seat 3: Tabitaji ($4.33 in chips) 
Seat 4: Koldun 2636 ($2.87 in chips) 
Seat 5: tviskas ($3.92 in chips) 
Seat 6: Scaaalll ($2.70 in chips) 
gugamoraes: posts small blind $0.01
Tabitaji: posts big blind $0.02
*** HOLE CARDS ***
Dealt to Scaaalll [5d Qh]
Koldun 2636: folds 
tviskas: raises $0.04 to $0.06
Scaaalll: folds 
Fanatspartak: folds 
gugamoraes: folds 
Tabitaji: folds 
Uncalled bet ($0.04) returned to tviskas
tviskas collected $0.05 from pot
tviskas: doesn't show hand 
*** SUMMARY ***
Total pot $0.05 | Rake $0 
Seat 1: Fanatspartak (button) folded before Flop (didn't bet)
Seat 2: gugamoraes (small blind) folded before Flop
Seat 3: Tabitaji (big blind) folded before Flop
Seat 4: Koldun 2636 folded before Flop (didn't bet)
Seat 5: tviskas collected ($0.05)
Seat 6: Scaaalll folded before Flop (didn't bet)



PokerStars Zoom Hand #229230739304:  Hold'em No Limit ($0.01/$0.02) - 2021/08/21 21:47:05 CET [2021/08/21 15:47:05 ET]
Table 'Halley' 6-max Seat #1 is the button
Seat 1: johniXL ($0.89 in chips) 
Seat 2: arrow17 ($2.02 in chips) 
Seat 3: plmanuelpl ($1.24 in chips) 
Seat 4: Scaaalll ($2.70 in chips) 
Seat 5: CrazyyParis ($2 in chips) 
Seat 6: amario89 ($3.99 in chips) 
arrow17: posts small blind $0.01
plmanuelpl: posts big blind $0.02
*** HOLE CARDS ***
Dealt to Scaaalll [9d Td]
Scaaalll: raises $0.04 to $0.06
CrazyyParis: folds 
amario89: folds 
johniXL: folds 
arrow17: folds 
plmanuelpl: calls $0.04
*** FLOP *** [6h Jc Ah]
plmanuelpl: checks 
Scaaalll: bets $0.08
plmanuelpl: folds 
Uncalled bet ($0.08) returned to Scaaalll
Scaaalll collected $0.13 from pot
Scaaalll: doesn't show hand 
plmanuelpl is disconnected 
*** SUMMARY ***
Total pot $0.13 | Rake $0 
Board [6h Jc Ah]
Seat 1: johniXL (button) folded before Flop (didn't bet)
Seat 2: arrow17 (small blind) folded before Flop
Seat 3: plmanuelpl (big blind) folded on the Flop
Seat 4: Scaaalll collected ($0.13)
Seat 5: CrazyyParis folded before Flop (didn't bet)
Seat 6: amario89 folded before Flop (didn't bet)



PokerStars Zoom Hand #229230760541:  Hold'em No Limit ($0.01/$0.02) - 2021/08/21 21:47:52 CET [2021/08/21 15:47:52 ET]
Table 'Halley' 6-max Seat #1 is the button
Seat 1: plmanuelpl ($1.18 in chips) 
Seat 2: Scaaalll ($2.77 in chips) 
Seat 3: zbixxx ($5.56 in chips) 
Seat 4: playneto ($1.90 in chips) 
Seat 5: Mikeloko182 ($2.06 in chips) 
Seat 6: elcuchu168 ($1.37 in chips) 
Scaaalll: posts small blind $0.01
zbixxx: posts big blind $0.02
*** HOLE CARDS ***
Dealt to Scaaalll [Qh 2c]
playneto: raises $0.03 to $0.05
plmanuelpl is disconnected 
Mikeloko182: folds 
elcuchu168: folds 
plmanuelpl: folds 
Scaaalll: folds 
zbixxx: folds 
Uncalled bet ($0.03) returned to playneto
playneto collected $0.05 from pot
playneto: doesn't show hand 
*** SUMMARY ***
Total pot $0.05 | Rake $0 
Seat 1: plmanuelpl (button) folded before Flop (didn't bet)
Seat 2: Scaaalll (small blind) folded before Flop
Seat 3: zbixxx (big blind) folded before Flop
Seat 4: playneto collected ($0.05)
Seat 5: Mikeloko182 folded before Flop (didn't bet)
Seat 6: elcuchu168 folded before Flop (didn't bet)



PokerStars Zoom Hand #229230762453:  Hold'em No Limit ($0.01/$0.02) - 2021/08/21 21:47:57 CET [2021/08/21 15:47:57 ET]
Table 'Halley' 6-max Seat #1 is the button
Seat 1: Scaaalll ($2.76 in chips) 
Seat 2: estelionat171 ($0.92 in chips) 
Seat 3: radin125 ($2.57 in chips) 
Seat 4: Alex Koshva1 ($1.48 in chips) 
Seat 5: bober2702 ($3.67 in chips) 
Seat 6: Henry Chinasky ($5.46 in chips) 
estelionat171: posts small blind $0.01
radin125: posts big blind $0.02
*** HOLE CARDS ***
Dealt to Scaaalll [Qc Qd]
Alex Koshva1: folds 
bober2702: folds 
Henry Chinasky: raises $0.04 to $0.06
Scaaalll: raises $0.12 to $0.18
estelionat171: folds 
radin125: calls $0.16
Henry Chinasky: folds 
*** FLOP *** [Kd 5s 2s]
radin125: checks 
Scaaalll: bets $0.23
radin125: folds 
Uncalled bet ($0.23) returned to Scaaalll
Scaaalll collected $0.41 from pot
Scaaalll: doesn't show hand 
*** SUMMARY ***
Total pot $0.43 | Rake $0.02 
Board [Kd 5s 2s]
Seat 1: Scaaalll (button) collected ($0.41)
Seat 2: estelionat171 (small blind) folded before Flop
Seat 3: radin125 (big blind) folded on the Flop
Seat 4: Alex Koshva1 folded before Flop (didn't bet)
Seat 5: bober2702 folded before Flop (didn't bet)
Seat 6: Henry Chinasky folded before Flop



PokerStars Zoom Hand #229230789806:  Hold'em No Limit ($0.01/$0.02) - 2021/08/21 21:48:57 CET [2021/08/21 15:48:57 ET]
Table 'Halley' 6-max Seat #1 is the button
Seat 1: Kuzmich_2502 ($3.15 in chips) 
Seat 2: Sergant20081 ($2 in chips) 
Seat 3: Scaaalll ($2.99 in chips) 
Seat 4: Saint_ANBU ($3.69 in chips) 
Seat 5: AlexGTPS ($2.76 in chips) 
Seat 6: Reipinguimm ($2.07 in chips) 
Sergant20081: posts small blind $0.01
Scaaalll: posts big blind $0.02
*** HOLE CARDS ***
Dealt to Scaaalll [5h Kh]
Saint_ANBU: folds 
AlexGTPS: folds 
Reipinguimm: folds 
Kuzmich_2502: folds 
Sergant20081: raises $0.03 to $0.05
Scaaalll: folds 
Uncalled bet ($0.03) returned to Sergant20081
Sergant20081 collected $0.04 from pot
Sergant20081: doesn't show hand 
*** SUMMARY ***
Total pot $0.04 | Rake $0 
Seat 1: Kuzmich_2502 (button) folded before Flop (didn't bet)
Seat 2: Sergant20081 (small blind) collected ($0.04)
Seat 3: Scaaalll (big blind) folded before Flop
Seat 4: Saint_ANBU folded before Flop (didn't bet)
Seat 5: AlexGTPS folded before Flop (didn't bet)
Seat 6: Reipinguimm folded before Flop (didn't bet)



PokerStars Zoom Hand #229230796612:  Hold'em No Limit ($0.01/$0.02) - 2021/08/21 21:49:11 CET [2021/08/21 15:49:11 ET]
Table 'Halley' 6-max Seat #1 is the button
Seat 1: nagiloR ($2.32 in chips) 
Seat 2: pavlo8855 ($2.24 in chips) 
Seat 3: ash1448 ($10.22 in chips) 
Seat 4: ARTMVSLV ($5.12 in chips) 
Seat 5: iPitbull1 ($4.75 in chips) 
Seat 6: Scaaalll ($2.97 in chips) 
pavlo8855: posts small blind $0.01
ash1448: posts big blind $0.02
*** HOLE CARDS ***
Dealt to Scaaalll [2s 4c]
ARTMVSLV: folds 
iPitbull1: raises $0.04 to $0.06
Scaaalll: folds 
nagiloR: folds 
pavlo8855: folds 
ash1448: folds 
Uncalled bet ($0.04) returned to iPitbull1
iPitbull1 collected $0.05 from pot
iPitbull1: doesn't show hand 
*** SUMMARY ***
Total pot $0.05 | Rake $0 
Seat 1: nagiloR (button) folded before Flop (didn't bet)
Seat 2: pavlo8855 (small blind) folded before Flop
Seat 3: ash1448 (big blind) folded before Flop
Seat 4: ARTMVSLV folded before Flop (didn't bet)
Seat 5: iPitbull1 collected ($0.05)
Seat 6: Scaaalll folded before Flop (didn't bet)



PokerStars Zoom Hand #229230798445:  Hold'em No Limit ($0.01/$0.02) - 2021/08/21 21:49:15 CET [2021/08/21 15:49:15 ET]
Table 'Halley' 6-max Seat #1 is the button
Seat 1: Iluvatar922 ($9.61 in chips) 
Seat 2: nagiloR ($2.32 in chips) 
Seat 3: Fanatspartak ($0.87 in chips) 
Seat 4: ctaceo ($2 in chips) 
Seat 5: Scaaalll ($2.97 in chips) 
Seat 6: Mikeloko182 ($2 in chips) 
nagiloR: posts small blind $0.01
Fanatspartak: posts big blind $0.02
*** HOLE CARDS ***
Dealt to Scaaalll [Qs 4c]
ctaceo: folds 
Scaaalll: folds 
Mikeloko182: folds 
Iluvatar922: folds 
nagiloR: folds 
Uncalled bet ($0.01) returned to Fanatspartak
Fanatspartak collected $0.02 from pot
Fanatspartak: doesn't show hand 
*** SUMMARY ***
Total pot $0.02 | Rake $0 
Seat 1: Iluvatar922 (button) folded before Flop (didn't bet)
Seat 2: nagiloR (small blind) folded before Flop
Seat 3: Fanatspartak (big blind) collected ($0.02)
Seat 4: ctaceo folded before Flop (didn't bet)
Seat 5: Scaaalll folded before Flop (didn't bet)
Seat 6: Mikeloko182 folded before Flop (didn't bet)



PokerStars Zoom Hand #229230802382:  Hold'em No Limit ($0.01/$0.02) - 2021/08/21 21:49:24 CET [2021/08/21 15:49:24 ET]
Table 'Halley' 6-max Seat #1 is the button
Seat 1: ppluiaule ($2.22 in chips) 
Seat 2: Gamer577 ($3.81 in chips) 
Seat 3: Xlavariable ($5.34 in chips) 
Seat 4: siebens777 ($2.25 in chips) 
Seat 5: Scaaalll ($2.97 in chips) 
Seat 6: lucksuckdonk ($6.44 in chips) 
Gamer577: posts small blind $0.01
Xlavariable: posts big blind $0.02
*** HOLE CARDS ***
Dealt to Scaaalll [2c 6s]
siebens777: folds 
Scaaalll has timed out
Scaaalll: folds 
lucksuckdonk: folds 
ppluiaule: folds 
Gamer577: raises $0.04 to $0.06
Xlavariable: calls $0.04
*** FLOP *** [9d 6d 6h]
Gamer577: bets $0.06
Xlavariable: folds 
Uncalled bet ($0.06) returned to Gamer577
Gamer577 collected $0.12 from pot
Gamer577: doesn't show hand 
*** SUMMARY ***
Total pot $0.12 | Rake $0 
Board [9d 6d 6h]
Seat 1: ppluiaule (button) folded before Flop (didn't bet)
Seat 2: Gamer577 (small blind) collected ($0.12)
Seat 3: Xlavariable (big blind) folded on the Flop
Seat 4: siebens777 folded before Flop (didn't bet)
Seat 5: Scaaalll folded before Flop (didn't bet)
Seat 6: lucksuckdonk folded before Flop (didn't bet)



PokerStars Zoom Hand #229230810075:  Hold'em No Limit ($0.01/$0.02) - 2021/08/21 21:49:41 CET [2021/08/21 15:49:41 ET]
Table 'Halley' 6-max Seat #1 is the button
Seat 1: Scaaalll ($2.97 in chips) 
Seat 2: SaRCh_Ale ($1.95 in chips) 
Seat 3: StartGoy ($2.85 in chips) 
Seat 4: CrazyyParis ($2 in chips) 
Seat 5: meikoz ($3.80 in chips) 
Seat 6: E Z TAKEDOWN ($6.41 in chips) 
SaRCh_Ale: posts small blind $0.01
StartGoy: posts big blind $0.02
*** HOLE CARDS ***
Dealt to Scaaalll [Qd Tc]
CrazyyParis: folds 
meikoz: folds 
E Z TAKEDOWN: folds 
Scaaalll: raises $0.02 to $0.04
SaRCh_Ale: folds 
StartGoy: raises $0.09 to $0.13
Scaaalll: folds 
Uncalled bet ($0.09) returned to StartGoy
StartGoy collected $0.09 from pot
StartGoy: doesn't show hand 
*** SUMMARY ***
Total pot $0.09 | Rake $0 
Seat 1: Scaaalll (button) folded before Flop
Seat 2: SaRCh_Ale (small blind) folded before Flop
Seat 3: StartGoy (big blind) collected ($0.09)
Seat 4: CrazyyParis folded before Flop (didn't bet)
Seat 5: meikoz folded before Flop (didn't bet)
Seat 6: E Z TAKEDOWN folded before Flop (didn't bet)



PokerStars Zoom Hand #229230825108:  Hold'em No Limit ($0.01/$0.02) - 2021/08/21 21:50:15 CET [2021/08/21 15:50:15 ET]
Table 'Halley' 6-max Seat #1 is the button
Seat 1: mgort1988 ($1.70 in chips) 
Seat 2: Tabitaji ($2 in chips) 
Seat 3: Scaaalll ($2.92 in chips) 
Seat 4: snowy_96 ($2 in chips) 
Seat 5: estelionat171 ($0.85 in chips) 
Seat 6: causavera ($4.20 in chips) 
Tabitaji: posts small blind $0.01
Scaaalll: posts big blind $0.02
*** HOLE CARDS ***
Dealt to Scaaalll [Qc 7d]
snowy_96: folds 
estelionat171: folds 
causavera: folds 
mgort1988: folds 
Tabitaji: folds 
Uncalled bet ($0.01) returned to Scaaalll
Scaaalll collected $0.02 from pot
Scaaalll: doesn't show hand 
*** SUMMARY ***
Total pot $0.02 | Rake $0 
Seat 1: mgort1988 (button) folded before Flop (didn't bet)
Seat 2: Tabitaji (small blind) folded before Flop
Seat 3: Scaaalll (big blind) collected ($0.02)
Seat 4: snowy_96 folded before Flop (didn't bet)
Seat 5: estelionat171 folded before Flop (didn't bet)
Seat 6: causavera folded before Flop (didn't bet)



PokerStars Zoom Hand #229230829508:  Hold'em No Limit ($0.01/$0.02) - 2021/08/21 21:50:25 CET [2021/08/21 15:50:25 ET]
Table 'Halley' 6-max Seat #1 is the button
Seat 1: BIITRU ($3.62 in chips) 
Seat 2: MrK_Leuven ($4.07 in chips) 
Seat 3: so0love ($2.02 in chips) 
Seat 4: Scaaalll ($2.93 in chips) 
Seat 5: SIGREX ($2.18 in chips) 
Seat 6: arsad725 ($6.46 in chips) 
MrK_Leuven: posts small blind $0.01
so0love: posts big blind $0.02
*** HOLE CARDS ***
Dealt to Scaaalll [7c 8s]
Scaaalll: folds 
SIGREX: folds 
arsad725: folds 
BIITRU: folds 
MrK_Leuven: folds 
Uncalled bet ($0.01) returned to so0love
so0love collected $0.02 from pot
so0love: doesn't show hand 
*** SUMMARY ***
Total pot $0.02 | Rake $0 
Seat 1: BIITRU (button) folded before Flop (didn't bet)
Seat 2: MrK_Leuven (small blind) folded before Flop
Seat 3: so0love (big blind) collected ($0.02)
Seat 4: Scaaalll folded before Flop (didn't bet)
Seat 5: SIGREX folded before Flop (didn't bet)
Seat 6: arsad725 folded before Flop (didn't bet)



PokerStars Zoom Hand #229230819305:  Hold'em No Limit ($0.01/$0.02) - 2021/08/21 21:50:02 CET [2021/08/21 15:50:02 ET]
Table 'Halley' 6-max Seat #1 is the button
Seat 1: Player XVII ($2.77 in chips) 
Seat 2: Scaaalll ($2.93 in chips) 
Seat 3: fishh_play ($5.09 in chips) 
Seat 4: HellNative ($2.03 in chips) 
Seat 5: Jackb9908 ($1.64 in chips) 
Seat 6: maliniak75 ($2.22 in chips) 
Scaaalll: posts small blind $0.01
fishh_play: posts big blind $0.02
*** HOLE CARDS ***
Dealt to Scaaalll [7d Js]
HellNative: folds 
Jackb9908: folds 
maliniak75: calls $0.02
Player XVII: raises $0.02 to $0.04
Scaaalll: folds 
fishh_play: folds 
maliniak75: calls $0.02
*** FLOP *** [Qd 3s 2s]
maliniak75: checks 
Player XVII: checks 
*** TURN *** [Qd 3s 2s] [7c]
maliniak75: checks 
Player XVII: bets $0.11
maliniak75: calls $0.11
*** RIVER *** [Qd 3s 2s 7c] [9c]
maliniak75: checks 
Player XVII: checks 
*** SHOW DOWN ***
maliniak75: shows [7s 5s] (a pair of Sevens)
Player XVII: mucks hand 
maliniak75 collected $0.32 from pot
*** SUMMARY ***
Total pot $0.33 | Rake $0.01 
Board [Qd 3s 2s 7c 9c]
Seat 1: Player XVII (button) mucked [As Kh]
Seat 2: Scaaalll (small blind) folded before Flop
Seat 3: fishh_play (big blind) folded before Flop
Seat 4: HellNative folded before Flop (didn't bet)
Seat 5: Jackb9908 folded before Flop (didn't bet)
Seat 6: maliniak75 showed [7s 5s] and won ($0.32) with a pair of Sevens



PokerStars Zoom Hand #229230831396:  Hold'em No Limit ($0.01/$0.02) - 2021/08/21 21:50:29 CET [2021/08/21 15:50:29 ET]
Table 'Halley' 6-max Seat #1 is the button
Seat 1: fabor1303 ($2.28 in chips) 
Seat 2: usenovm ($2.31 in chips) 
Seat 3: dkno77 ($1.90 in chips) 
Seat 4: Flankeris ($5.15 in chips) 
Seat 5: RaulacateFolds ($3.04 in chips) 
Seat 6: Scaaalll ($2.93 in chips) 
usenovm: posts small blind $0.01
dkno77: posts big blind $0.02
*** HOLE CARDS ***
Dealt to Scaaalll [7d As]
Flankeris: folds 
RaulacateFolds: folds 
Scaaalll: folds 
fabor1303: folds 
usenovm: calls $0.01
dkno77: checks 
*** FLOP *** [6s 8s Js]
usenovm: bets $0.12
dkno77: folds 
Uncalled bet ($0.12) returned to usenovm
usenovm collected $0.04 from pot
usenovm: doesn't show hand 
*** SUMMARY ***
Total pot $0.04 | Rake $0 
Board [6s 8s Js]
Seat 1: fabor1303 (button) folded before Flop (didn't bet)
Seat 2: usenovm (small blind) collected ($0.04)
Seat 3: dkno77 (big blind) folded on the Flop
Seat 4: Flankeris folded before Flop (didn't bet)
Seat 5: RaulacateFolds folded before Flop (didn't bet)
Seat 6: Scaaalll folded before Flop (didn't bet)



PokerStars Zoom Hand #229230836860:  Hold'em No Limit ($0.01/$0.02) - 2021/08/21 21:50:40 CET [2021/08/21 15:50:40 ET]
Table 'Halley' 6-max Seat #1 is the button
Seat 1: estelionat171 ($1.85 in chips) 
Seat 2: zeus11983 ($2 in chips) 
Seat 3: Fedor_Gar ($3.96 in chips) 
Seat 4: StartGoy ($2.96 in chips) 
Seat 5: Xlavariable ($2.68 in chips) 
Seat 6: Scaaalll ($2.92 in chips) 
zeus11983: posts small blind $0.01
Fedor_Gar: posts big blind $0.02
*** HOLE CARDS ***
Dealt to Scaaalll [Qh 2c]
StartGoy: raises $0.05 to $0.07
Xlavariable: folds 
Scaaalll: folds 
estelionat171: folds 
zeus11983: folds 
Fedor_Gar: folds 
Uncalled bet ($0.05) returned to StartGoy
StartGoy collected $0.05 from pot
StartGoy: doesn't show hand 
*** SUMMARY ***
Total pot $0.05 | Rake $0 
Seat 1: estelionat171 (button) folded before Flop (didn't bet)
Seat 2: zeus11983 (small blind) folded before Flop
Seat 3: Fedor_Gar (big blind) folded before Flop
Seat 4: StartGoy collected ($0.05)
Seat 5: Xlavariable folded before Flop (didn't bet)
Seat 6: Scaaalll folded before Flop (didn't bet)



PokerStars Zoom Hand #229230833194:  Hold'em No Limit ($0.01/$0.02) - 2021/08/21 21:50:33 CET [2021/08/21 15:50:33 ET]
Table 'Halley' 6-max Seat #1 is the button
Seat 1: brasilroger ($1.97 in chips) 
Seat 2: bAttery01 ($2.88 in chips) 
Seat 3: csmall14 ($2 in chips) 
Seat 4: Scaaalll ($2.93 in chips) 
Seat 5: gasmar_29 ($3.58 in chips) 
Seat 6: FabOliveira9 ($2.24 in chips) 
bAttery01: posts small blind $0.01
csmall14: posts big blind $0.02
*** HOLE CARDS ***
Dealt to Scaaalll [Jd 3h]
Scaaalll: folds 
gasmar_29: folds 
FabOliveira9: folds 
brasilroger: raises $0.04 to $0.06
bAttery01: raises $0.14 to $0.20
csmall14: folds 
brasilroger: folds 
Uncalled bet ($0.14) returned to bAttery01
bAttery01 collected $0.14 from pot
bAttery01: doesn't show hand 
*** SUMMARY ***
Total pot $0.14 | Rake $0 
Seat 1: brasilroger (button) folded before Flop
Seat 2: bAttery01 (small blind) collected ($0.14)
Seat 3: csmall14 (big blind) folded before Flop
Seat 4: Scaaalll folded before Flop (didn't bet)
Seat 5: gasmar_29 folded before Flop (didn't bet)
Seat 6: FabOliveira9 folded before Flop (didn't bet)



PokerStars Zoom Hand #229230835053:  Hold'em No Limit ($0.01/$0.02) - 2021/08/21 21:50:36 CET [2021/08/21 15:50:36 ET]
Table 'Halley' 6-max Seat #1 is the button
Seat 1: Aho1337 ($3.03 in chips) 
Seat 2: Scaaalll ($2.93 in chips) 
Seat 3: aenehev ($4.53 in chips) 
Seat 4: ash1448 ($3.52 in chips) 
Seat 5: usenovm ($1.92 in chips) 
Seat 6: lucksuckdonk ($4.13 in chips) 
Scaaalll: posts small blind $0.01
aenehev: posts big blind $0.02
*** HOLE CARDS ***
Dealt to Scaaalll [2s 9c]
ash1448: folds 
usenovm: folds 
lucksuckdonk: raises $0.04 to $0.06
Aho1337: folds 
Scaaalll: folds 
aenehev: calls $0.04
*** FLOP *** [9s Th 2c]
aenehev: checks 
lucksuckdonk: checks 
*** TURN *** [9s Th 2c] [9d]
aenehev: checks 
lucksuckdonk: bets $0.09
aenehev: folds 
Uncalled bet ($0.09) returned to lucksuckdonk
lucksuckdonk collected $0.13 from pot
lucksuckdonk: doesn't show hand 
*** SUMMARY ***
Total pot $0.13 | Rake $0 
Board [9s Th 2c 9d]
Seat 1: Aho1337 (button) folded before Flop (didn't bet)
Seat 2: Scaaalll (small blind) folded before Flop
Seat 3: aenehev (big blind) folded on the Turn
Seat 4: ash1448 folded before Flop (didn't bet)
Seat 5: usenovm folded before Flop (didn't bet)
Seat 6: lucksuckdonk collected ($0.13)



PokerStars Zoom Hand #229230847312:  Hold'em No Limit ($0.01/$0.02) - 2021/08/21 21:51:03 CET [2021/08/21 15:51:03 ET]
Table 'Halley' 6-max Seat #1 is the button
Seat 1: Scaaalll ($2.90 in chips) 
Seat 2: TESTGOSHI ($1.28 in chips) 
Seat 3: pavlo8855 ($2 in chips) 
Seat 4: CronZ86 ($0.45 in chips) 
Seat 5: ash1448 ($10.22 in chips) 
Seat 6: bananAAbandit ($2 in chips) 
TESTGOSHI: posts small blind $0.01
pavlo8855: posts big blind $0.02
*** HOLE CARDS ***
Dealt to Scaaalll [As Ts]
CronZ86 has timed out
CronZ86: folds 
ash1448: folds 
CronZ86 is disconnected 
bananAAbandit: folds 
Scaaalll: raises $0.02 to $0.04
TESTGOSHI: folds 
pavlo8855: folds 
Uncalled bet ($0.02) returned to Scaaalll
Scaaalll collected $0.05 from pot
Scaaalll: doesn't show hand 
*** SUMMARY ***
Total pot $0.05 | Rake $0 
Seat 1: Scaaalll (button) collected ($0.05)
Seat 2: TESTGOSHI (small blind) folded before Flop
Seat 3: pavlo8855 (big blind) folded before Flop
Seat 4: CronZ86 folded before Flop (didn't bet)
Seat 5: ash1448 folded before Flop (didn't bet)
Seat 6: bananAAbandit folded before Flop (didn't bet)



PokerStars Zoom Hand #229230839607:  Hold'em No Limit ($0.01/$0.02) - 2021/08/21 21:50:46 CET [2021/08/21 15:50:46 ET]
Table 'Halley' 6-max Seat #1 is the button
Seat 1: yannikdaehne ($7.95 in chips) 
Seat 2: Quad Jacks21 ($3.29 in chips) 
Seat 3: Scaaalll ($2.92 in chips) 
Seat 4: szajm ($1.69 in chips) 
Seat 5: Kb013497 ($2.92 in chips) 
Seat 6: Syberya ($2.03 in chips) 
Quad Jacks21: posts small blind $0.01
Scaaalll: posts big blind $0.02
*** HOLE CARDS ***
Dealt to Scaaalll [Ts Qh]
szajm: folds 
szajm is disconnected 
Syberya is disconnected 
Kb013497: folds 
Syberya: folds 
yannikdaehne: raises $0.03 to $0.05
Quad Jacks21: calls $0.04
Scaaalll: folds 
*** FLOP *** [Th 6h 6d]
Quad Jacks21: checks 
yannikdaehne: bets $0.07
Quad Jacks21: calls $0.07
*** TURN *** [Th 6h 6d] [Qs]
Quad Jacks21: checks 
yannikdaehne: checks 
*** RIVER *** [Th 6h 6d Qs] [5d]
Quad Jacks21: bets $0.28
yannikdaehne: folds 
Uncalled bet ($0.28) returned to Quad Jacks21
Quad Jacks21 collected $0.25 from pot
Quad Jacks21: doesn't show hand 
*** SUMMARY ***
Total pot $0.26 | Rake $0.01 
Board [Th 6h 6d Qs 5d]
Seat 1: yannikdaehne (button) folded on the River
Seat 2: Quad Jacks21 (small blind) collected ($0.25)
Seat 3: Scaaalll (big blind) folded before Flop
Seat 4: szajm folded before Flop (didn't bet)
Seat 5: Kb013497 folded before Flop (didn't bet)
Seat 6: Syberya folded before Flop (didn't bet)



PokerStars Zoom Hand #229230858616:  Hold'em No Limit ($0.01/$0.02) - 2021/08/21 21:51:28 CET [2021/08/21 15:51:28 ET]
Table 'Halley' 6-max Seat #1 is the button
Seat 1: shingo594 ($2.53 in chips) 
Seat 2: nagaboom ($2.16 in chips) 
Seat 3: estelionat171 ($1.38 in chips) 
Seat 4: arrow17 ($2.04 in chips) 
Seat 5: Scaaalll ($2.93 in chips) 
Seat 6: HellNative ($2.61 in chips) 
nagaboom: posts small blind $0.01
estelionat171: posts big blind $0.02
*** HOLE CARDS ***
Dealt to Scaaalll [Jd 2d]
arrow17: folds 
Scaaalll: folds 
HellNative: folds 
shingo594: raises $0.04 to $0.06
nagaboom: folds 
estelionat171: folds 
Uncalled bet ($0.04) returned to shingo594
shingo594 collected $0.05 from pot
shingo594: doesn't show hand 
*** SUMMARY ***
Total pot $0.05 | Rake $0 
Seat 1: shingo594 (button) collected ($0.05)
Seat 2: nagaboom (small blind) folded before Flop
Seat 3: estelionat171 (big blind) folded before Flop
Seat 4: arrow17 folded before Flop (didn't bet)
Seat 5: Scaaalll folded before Flop (didn't bet)
Seat 6: HellNative folded before Flop (didn't bet)



PokerStars Zoom Hand #229230860868:  Hold'em No Limit ($0.01/$0.02) - 2021/08/21 21:51:33 CET [2021/08/21 15:51:33 ET]
Table 'Halley' 6-max Seat #1 is the button
Seat 1: Scaaalll ($2.93 in chips) 
Seat 2: Blaackie ($2 in chips) 
Seat 3: olga3021221 ($2.33 in chips) 
Seat 4: Antipirate ($2.43 in chips) 
Seat 5: lucksuckdonk ($3.92 in chips) 
Seat 6: Gamer577 ($3.89 in chips) 
Blaackie: posts small blind $0.01
olga3021221: posts big blind $0.02
*** HOLE CARDS ***
Dealt to Scaaalll [Td 5d]
Antipirate: folds 
Antipirate is disconnected 
lucksuckdonk: raises $0.04 to $0.06
Gamer577: folds 
Scaaalll: folds 
Blaackie: folds 
olga3021221: folds 
Uncalled bet ($0.04) returned to lucksuckdonk
lucksuckdonk collected $0.05 from pot
lucksuckdonk: doesn't show hand 
*** SUMMARY ***
Total pot $0.05 | Rake $0 
Seat 1: Scaaalll (button) folded before Flop (didn't bet)
Seat 2: Blaackie (small blind) folded before Flop
Seat 3: olga3021221 (big blind) folded before Flop
Seat 4: Antipirate folded before Flop (didn't bet)
Seat 5: lucksuckdonk collected ($0.05)
Seat 6: Gamer577 folded before Flop (didn't bet)



PokerStars Zoom Hand #229230863088:  Hold'em No Limit ($0.01/$0.02) - 2021/08/21 21:51:38 CET [2021/08/21 15:51:38 ET]
Table 'Halley' 6-max Seat #1 is the button
Seat 1: arrow17 ($2.46 in chips) 
Seat 2: Scaaalll ($2.93 in chips) 
Seat 3: Bufre ($3.68 in chips) 
Seat 4: Baksit79 ($2.28 in chips) 
Seat 5: SchinkenToni ($1.99 in chips) 
Seat 6: nagiloR ($2.43 in chips) 
Scaaalll: posts small blind $0.01
Bufre: posts big blind $0.02
*** HOLE CARDS ***
Dealt to Scaaalll [2h Td]
Baksit79: folds 
Baksit79 is disconnected 
SchinkenToni: raises $0.04 to $0.06
nagiloR: folds 
arrow17: calls $0.06
Scaaalll: folds 
Bufre: calls $0.04
*** FLOP *** [Jd 5c Ac]
Bufre: checks 
SchinkenToni: checks 
arrow17: bets $0.12
Bufre: calls $0.12
SchinkenToni: folds 
*** TURN *** [Jd 5c Ac] [Qs]
Bufre: checks 
arrow17: bets $0.21
Bufre: calls $0.21
*** RIVER *** [Jd 5c Ac Qs] [Kc]
Bufre: checks 
arrow17: checks 
*** SHOW DOWN ***
Bufre: shows [3c 4c] (a flush, Ace high)
arrow17: mucks hand 
Bufre collected $0.81 from pot
*** SUMMARY ***
Total pot $0.85 | Rake $0.04 
Board [Jd 5c Ac Qs Kc]
Seat 1: arrow17 (button) mucked [5d 5s]
Seat 2: Scaaalll (small blind) folded before Flop
Seat 3: Bufre (big blind) showed [3c 4c] and won ($0.81) with a flush, Ace high
Seat 4: Baksit79 folded before Flop (didn't bet)
Seat 5: SchinkenToni folded on the Flop
Seat 6: nagiloR folded before Flop (didn't bet)



PokerStars Zoom Hand #229230874356:  Hold'em No Limit ($0.01/$0.02) - 2021/08/21 21:52:04 CET [2021/08/21 15:52:04 ET]
Table 'Halley' 6-max Seat #1 is the button
Seat 1: yal.AnToJKe ($1.87 in chips) 
Seat 2: pavlo8855 ($2.01 in chips) 
Seat 3: Scaaalll ($2.92 in chips) 
Seat 4: lexus00174 ($1.90 in chips) 
Seat 5: EevAA190 ($2.30 in chips) 
Seat 6: Lighio ($2.22 in chips) 
pavlo8855: posts small blind $0.01
Scaaalll: posts big blind $0.02
*** HOLE CARDS ***
Dealt to Scaaalll [Qs 5h]
lexus00174: folds 
EevAA190: folds 
Lighio: folds 
yal.AnToJKe: raises $0.04 to $0.06
pavlo8855: calls $0.05
Scaaalll: folds 
*** FLOP *** [Kd 7h Kh]
pavlo8855: checks 
yal.AnToJKe: checks 
*** TURN *** [Kd 7h Kh] [Js]
pavlo8855: checks 
yal.AnToJKe: bets $0.07
pavlo8855: calls $0.07
*** RIVER *** [Kd 7h Kh Js] [4c]
pavlo8855: checks 
yal.AnToJKe: checks 
*** SHOW DOWN ***
pavlo8855: shows [Jh Th] (two pair, Kings and Jacks)
yal.AnToJKe: shows [Qc Jd] (two pair, Kings and Jacks - Queen kicker)
yal.AnToJKe collected $0.27 from pot
*** SUMMARY ***
Total pot $0.28 | Rake $0.01 
Board [Kd 7h Kh Js 4c]
Seat 1: yal.AnToJKe (button) showed [Qc Jd] and won ($0.27) with two pair, Kings and Jacks
Seat 2: pavlo8855 (small blind) showed [Jh Th] and lost with two pair, Kings and Jacks
Seat 3: Scaaalll (big blind) folded before Flop
Seat 4: lexus00174 folded before Flop (didn't bet)
Seat 5: EevAA190 folded before Flop (didn't bet)
Seat 6: Lighio folded before Flop (didn't bet)



PokerStars Zoom Hand #229230869356:  Hold'em No Limit ($0.01/$0.02) - 2021/08/21 21:51:53 CET [2021/08/21 15:51:53 ET]
Table 'Halley' 6-max Seat #1 is the button
Seat 1: pipecmolodec ($2 in chips) 
Seat 2: 48159348 ($2.56 in chips) 
Seat 3: Shcherbak252 ($2.34 in chips) 
Seat 4: Feliciano16 ($2.09 in chips) 
Seat 5: valdemar@v8 ($3.51 in chips) 
Seat 6: Scaaalll ($2.92 in chips) 
48159348: posts small blind $0.01
Shcherbak252: posts big blind $0.02
*** HOLE CARDS ***
Dealt to Scaaalll [4s 7d]
valdemar@v8 is disconnected 
Feliciano16 has timed out
Feliciano16: folds 
valdemar@v8: folds 
Scaaalll: folds 
pipecmolodec: raises $0.02 to $0.04
48159348: calls $0.03
Shcherbak252: calls $0.02
*** FLOP *** [Ks 8d Qd]
48159348: checks 
Shcherbak252: checks 
pipecmolodec: checks 
*** TURN *** [Ks 8d Qd] [9s]
48159348: bets $0.06
Shcherbak252: calls $0.06
pipecmolodec: folds 
*** RIVER *** [Ks 8d Qd 9s] [Qs]
48159348: bets $0.12
Shcherbak252: raises $0.12 to $0.24
48159348: calls $0.12
*** SHOW DOWN ***
Shcherbak252: shows [3s As] (a flush, Ace high)
48159348: mucks hand 
Shcherbak252 collected $0.69 from pot
*** SUMMARY ***
Total pot $0.72 | Rake $0.03 
Board [Ks 8d Qd 9s Qs]
Seat 1: pipecmolodec (button) folded on the Turn
Seat 2: 48159348 (small blind) mucked [Th Jc]
Seat 3: Shcherbak252 (big blind) showed [3s As] and won ($0.69) with a flush, Ace high
Seat 4: Feliciano16 folded before Flop (didn't bet)
Seat 5: valdemar@v8 folded before Flop (didn't bet)
Seat 6: Scaaalll folded before Flop (didn't bet)



PokerStars Zoom Hand #229230890802:  Hold'em No Limit ($0.01/$0.02) - 2021/08/21 21:52:30 CET [2021/08/21 15:52:30 ET]
Table 'Halley' 6-max Seat #1 is the button
Seat 1: SICKDIRTY416 ($5.11 in chips) 
Seat 2: Koldun 2636 ($5.02 in chips) 
Seat 3: szajm ($1.65 in chips) 
Seat 4: Scaaalll ($2.90 in chips) 
Seat 5: lucksuckdonk ($4.55 in chips) 
Seat 6: gds2003 ($0.99 in chips) 
Koldun 2636: posts small blind $0.01
szajm: posts big blind $0.02
*** HOLE CARDS ***
Dealt to Scaaalll [Kh Kc]
SICKDIRTY416 is disconnected 
Scaaalll: raises $0.04 to $0.06
szajm is disconnected 
lucksuckdonk: folds 
gds2003: calls $0.06
SICKDIRTY416: folds 
Koldun 2636: folds 
szajm: folds 
*** FLOP *** [7c 6c 8s]
Scaaalll: bets $0.08
gds2003: calls $0.08
*** TURN *** [7c 6c 8s] [Tc]
Scaaalll: checks 
gds2003: checks 
*** RIVER *** [7c 6c 8s Tc] [6d]
Scaaalll: checks 
gds2003: checks 
*** SHOW DOWN ***
Scaaalll: shows [Kh Kc] (two pair, Kings and Sixes)
gds2003: mucks hand 
Scaaalll collected $0.30 from pot
*** SUMMARY ***
Total pot $0.31 | Rake $0.01 
Board [7c 6c 8s Tc 6d]
Seat 1: SICKDIRTY416 (button) folded before Flop (didn't bet)
Seat 2: Koldun 2636 (small blind) folded before Flop
Seat 3: szajm (big blind) folded before Flop
Seat 4: Scaaalll showed [Kh Kc] and won ($0.30) with two pair, Kings and Sixes
Seat 5: lucksuckdonk folded before Flop (didn't bet)
Seat 6: gds2003 mucked [As Qc]



PokerStars Zoom Hand #229230906093:  Hold'em No Limit ($0.01/$0.02) - 2021/08/21 21:53:04 CET [2021/08/21 15:53:04 ET]
Table 'Halley' 6-max Seat #1 is the button
Seat 1: Tietz1990 ($8.81 in chips) 
Seat 2: ViBiG ($1.33 in chips) 
Seat 3: pavlo8855 ($2.03 in chips) 
Seat 4: Scaaalll ($3.06 in chips) 
Seat 5: ARTMVSLV ($2 in chips) 
Seat 6: fabor1303 ($2.13 in chips) 
ViBiG: posts small blind $0.01
pavlo8855: posts big blind $0.02
*** HOLE CARDS ***
Dealt to Scaaalll [Js Qs]
Scaaalll: raises $0.04 to $0.06
ARTMVSLV: folds 
fabor1303: calls $0.06
Tietz1990: folds 
ViBiG: folds 
pavlo8855: folds 
*** FLOP *** [Qh 7s 2d]
Scaaalll: bets $0.08
fabor1303: folds 
Uncalled bet ($0.08) returned to Scaaalll
Scaaalll collected $0.14 from pot
Scaaalll: doesn't show hand 
*** SUMMARY ***
Total pot $0.15 | Rake $0.01 
Board [Qh 7s 2d]
Seat 1: Tietz1990 (button) folded before Flop (didn't bet)
Seat 2: ViBiG (small blind) folded before Flop
Seat 3: pavlo8855 (big blind) folded before Flop
Seat 4: Scaaalll collected ($0.14)
Seat 5: ARTMVSLV folded before Flop (didn't bet)
Seat 6: fabor1303 folded on the Flop



PokerStars Zoom Hand #229230902977:  Hold'em No Limit ($0.01/$0.02) - 2021/08/21 21:52:57 CET [2021/08/21 15:52:57 ET]
Table 'Halley' 6-max Seat #1 is the button
Seat 1: Lighio ($2.16 in chips) 
Seat 2: Pechorin.G ($3.03 in chips) 
Seat 3: STE1NBERG ($4.35 in chips) 
Seat 4: zeus11983 ($2.50 in chips) 
Seat 5: Scaaalll ($3.06 in chips) 
Seat 6: Saint_ANBU ($2.23 in chips) 
Pechorin.G: posts small blind $0.01
STE1NBERG: posts big blind $0.02
*** HOLE CARDS ***
Dealt to Scaaalll [Qc 7d]
zeus11983: raises $0.03 to $0.05
Scaaalll: folds 
Saint_ANBU: calls $0.05
Lighio: folds 
Pechorin.G: folds 
STE1NBERG: folds 
*** FLOP *** [8h 2s 5h]
zeus11983: bets $0.08
Saint_ANBU: calls $0.08
*** TURN *** [8h 2s 5h] [9c]
zeus11983: bets $0.19
Saint_ANBU: calls $0.19
*** RIVER *** [8h 2s 5h 9c] [Ah]
zeus11983: checks 
Saint_ANBU: checks 
*** SHOW DOWN ***
zeus11983: shows [Kc Kh] (a pair of Kings)
Saint_ANBU: mucks hand 
zeus11983 collected $0.65 from pot
*** SUMMARY ***
Total pot $0.67 | Rake $0.02 
Board [8h 2s 5h 9c Ah]
Seat 1: Lighio (button) folded before Flop (didn't bet)
Seat 2: Pechorin.G (small blind) folded before Flop
Seat 3: STE1NBERG (big blind) folded before Flop
Seat 4: zeus11983 showed [Kc Kh] and won ($0.65) with a pair of Kings
Seat 5: Scaaalll folded before Flop (didn't bet)
Seat 6: Saint_ANBU mucked [Ts Th]



PokerStars Zoom Hand #229230922468:  Hold'em No Limit ($0.01/$0.02) - 2021/08/21 21:53:39 CET [2021/08/21 15:53:39 ET]
Table 'Halley' 6-max Seat #1 is the button
Seat 1: bananAAbandit ($6.57 in chips) 
Seat 2: NecromiconP ($3.20 in chips) 
Seat 3: boa juice ($1.07 in chips) 
Seat 4: Emilmoller1 ($1.36 in chips) 
Seat 5: valdemar@v8 ($5.31 in chips) 
Seat 6: Scaaalll ($3.13 in chips) 
NecromiconP: posts small blind $0.01
boa juice: posts big blind $0.02
*** HOLE CARDS ***
Dealt to Scaaalll [2c 6s]
Emilmoller1: folds 
valdemar@v8 is disconnected 
valdemar@v8 has timed out while disconnected
valdemar@v8: folds 
Scaaalll: folds 
bananAAbandit: folds 
NecromiconP: raises $0.02 to $0.04
boa juice: folds 
Uncalled bet ($0.02) returned to NecromiconP
NecromiconP collected $0.04 from pot
NecromiconP: doesn't show hand 
boa juice is disconnected 
*** SUMMARY ***
Total pot $0.04 | Rake $0 
Seat 1: bananAAbandit (button) folded before Flop (didn't bet)
Seat 2: NecromiconP (small blind) collected ($0.04)
Seat 3: boa juice (big blind) folded before Flop
Seat 4: Emilmoller1 folded before Flop (didn't bet)
Seat 5: valdemar@v8 folded before Flop (didn't bet)
Seat 6: Scaaalll folded before Flop (didn't bet)



PokerStars Zoom Hand #229230920143:  Hold'em No Limit ($0.01/$0.02) - 2021/08/21 21:53:35 CET [2021/08/21 15:53:35 ET]
Table 'Halley' 6-max Seat #1 is the button
Seat 1: Lighio ($2.13 in chips) 
Seat 2: Scaaalll ($3.14 in chips) 
Seat 3: LuckyCheewey ($5.62 in chips) 
Seat 4: FabOliveira9 ($2.03 in chips) 
Seat 5: Jujiluju ($2.75 in chips) 
Seat 6: BaronMax ($0.43 in chips) 
Scaaalll: posts small blind $0.01
LuckyCheewey: posts big blind $0.02
*** HOLE CARDS ***
Dealt to Scaaalll [9h Jc]
FabOliveira9: raises $0.03 to $0.05
Jujiluju: folds 
BaronMax: calls $0.05
Lighio: folds 
Scaaalll: folds 
LuckyCheewey: folds 
*** FLOP *** [9c Qs 7h]
FabOliveira9: bets $0.06
BaronMax: raises $0.06 to $0.12
FabOliveira9: folds 
Uncalled bet ($0.06) returned to BaronMax
BaronMax collected $0.24 from pot
BaronMax: doesn't show hand 
*** SUMMARY ***
Total pot $0.25 | Rake $0.01 
Board [9c Qs 7h]
Seat 1: Lighio (button) folded before Flop (didn't bet)
Seat 2: Scaaalll (small blind) folded before Flop
Seat 3: LuckyCheewey (big blind) folded before Flop
Seat 4: FabOliveira9 folded on the Flop
Seat 5: Jujiluju folded before Flop (didn't bet)
Seat 6: BaronMax collected ($0.24)



PokerStars Zoom Hand #229230937427:  Hold'em No Limit ($0.01/$0.02) - 2021/08/21 21:54:12 CET [2021/08/21 15:54:12 ET]
Table 'Halley' 6-max Seat #1 is the button
Seat 1: Scaaalll ($3.11 in chips) 
Seat 2: rodrigoaduar ($0.83 in chips) 
Seat 3: Richaud ($1.73 in chips) 
Seat 4: Blaackie ($1.98 in chips) 
Seat 5: zergmiky ($4.17 in chips) 
Seat 6: RoughRafff ($2.03 in chips) 
rodrigoaduar: posts small blind $0.01
Richaud: posts big blind $0.02
*** HOLE CARDS ***
Dealt to Scaaalll [8h Qs]
Blaackie: folds 
zergmiky: folds 
RoughRafff: folds 
Scaaalll: folds 
rodrigoaduar: raises $0.04 to $0.06
Richaud: folds 
Uncalled bet ($0.04) returned to rodrigoaduar
rodrigoaduar collected $0.04 from pot
rodrigoaduar: doesn't show hand 
*** SUMMARY ***
Total pot $0.04 | Rake $0 
Seat 1: Scaaalll (button) folded before Flop (didn't bet)
Seat 2: rodrigoaduar (small blind) collected ($0.04)
Seat 3: Richaud (big blind) folded before Flop
Seat 4: Blaackie folded before Flop (didn't bet)
Seat 5: zergmiky folded before Flop (didn't bet)
Seat 6: RoughRafff folded before Flop (didn't bet)



PokerStars Zoom Hand #229230942293:  Hold'em No Limit ($0.01/$0.02) - 2021/08/21 21:54:24 CET [2021/08/21 15:54:24 ET]
Table 'Halley' 6-max Seat #1 is the button
Seat 1: elcuchu168 ($1.25 in chips) 
Seat 2: Richaud ($1.71 in chips) 
Seat 3: boa juice ($2.17 in chips) 
Seat 4: Scaaalll ($3.11 in chips) 
Seat 5: BadBeat Bert ($1.54 in chips) 
Seat 6: lucksuckdonk ($4.38 in chips) 
Richaud: posts small blind $0.01
boa juice: posts big blind $0.02
*** HOLE CARDS ***
Dealt to Scaaalll [6c Ac]
Scaaalll: raises $0.04 to $0.06
BadBeat Bert: folds 
boa juice is disconnected 
lucksuckdonk: folds 
elcuchu168: folds 
Richaud: folds 
boa juice: folds 
Uncalled bet ($0.04) returned to Scaaalll
Scaaalll collected $0.05 from pot
Scaaalll: doesn't show hand 
*** SUMMARY ***
Total pot $0.05 | Rake $0 
Seat 1: elcuchu168 (button) folded before Flop (didn't bet)
Seat 2: Richaud (small blind) folded before Flop
Seat 3: boa juice (big blind) folded before Flop
Seat 4: Scaaalll collected ($0.05)
Seat 5: BadBeat Bert folded before Flop (didn't bet)
Seat 6: lucksuckdonk folded before Flop (didn't bet)



PokerStars Zoom Hand #229230939655:  Hold'em No Limit ($0.01/$0.02) - 2021/08/21 21:54:18 CET [2021/08/21 15:54:18 ET]
Table 'Halley' 6-max Seat #1 is the button
Seat 1: 1_KoLizeI_1 ($2.67 in chips) 
Seat 2: zergmiky ($2.54 in chips) 
Seat 3: pavlo8855 ($2.05 in chips) 
Seat 4: Laonikos ($8.40 in chips) 
Seat 5: Scaaalll ($3.11 in chips) 
Seat 6: arrow17 ($2.18 in chips) 
zergmiky: posts small blind $0.01
pavlo8855: posts big blind $0.02
*** HOLE CARDS ***
Dealt to Scaaalll [Jc 8s]
Laonikos: folds 
Scaaalll: folds 
arrow17: raises $0.04 to $0.06
1_KoLizeI_1: raises $0.15 to $0.21
zergmiky: folds 
pavlo8855: folds 
arrow17: folds 
Uncalled bet ($0.15) returned to 1_KoLizeI_1
1_KoLizeI_1 collected $0.15 from pot
1_KoLizeI_1: doesn't show hand 
*** SUMMARY ***
Total pot $0.15 | Rake $0 
Seat 1: 1_KoLizeI_1 (button) collected ($0.15)
Seat 2: zergmiky (small blind) folded before Flop
Seat 3: pavlo8855 (big blind) folded before Flop
Seat 4: Laonikos folded before Flop (didn't bet)
Seat 5: Scaaalll folded before Flop (didn't bet)
Seat 6: arrow17 folded before Flop



PokerStars Zoom Hand #229230930197:  Hold'em No Limit ($0.01/$0.02) - 2021/08/21 21:53:57 CET [2021/08/21 15:53:57 ET]
Table 'Halley' 6-max Seat #1 is the button
Seat 1: @Kwiebus2 ($2 in chips) 
Seat 2: yasinffm ($2.22 in chips) 
Seat 3: Scaaalll ($3.13 in chips) 
Seat 4: dominik7315 ($2.18 in chips) 
Seat 5: Clavis Noa ($3.17 in chips) 
Seat 6: EmperorKurr ($2 in chips) 
yasinffm: posts small blind $0.01
Scaaalll: posts big blind $0.02
*** HOLE CARDS ***
Dealt to Scaaalll [2s Qd]
dominik7315: folds 
dominik7315 is disconnected 
Clavis Noa: folds 
EmperorKurr: raises $0.04 to $0.06
@Kwiebus2: calls $0.06
yasinffm: folds 
Scaaalll: folds 
*** FLOP *** [Kd 9d 4d]
EmperorKurr: checks 
@Kwiebus2: checks 
*** TURN *** [Kd 9d 4d] [6d]
EmperorKurr: checks 
@Kwiebus2: bets $0.06
EmperorKurr: folds 
Uncalled bet ($0.06) returned to @Kwiebus2
@Kwiebus2 collected $0.14 from pot
@Kwiebus2: doesn't show hand 
*** SUMMARY ***
Total pot $0.15 | Rake $0.01 
Board [Kd 9d 4d 6d]
Seat 1: @Kwiebus2 (button) collected ($0.14)
Seat 2: yasinffm (small blind) folded before Flop
Seat 3: Scaaalll (big blind) folded before Flop
Seat 4: dominik7315 folded before Flop (didn't bet)
Seat 5: Clavis Noa folded before Flop (didn't bet)
Seat 6: EmperorKurr folded on the Turn



PokerStars Zoom Hand #229230953443:  Hold'em No Limit ($0.01/$0.02) - 2021/08/21 21:54:49 CET [2021/08/21 15:54:49 ET]
Table 'Halley' 6-max Seat #1 is the button
Seat 1: AtZ3899 ($1.29 in chips) 
Seat 2: twobii668 ($1.53 in chips) 
Seat 3: lucksuckdonk ($3.45 in chips) 
Seat 4: Ufiltreret ($4.98 in chips) 
Seat 5: Scaaalll ($3.14 in chips) 
Seat 6: ChowMangao ($4.17 in chips) 
twobii668: posts small blind $0.01
lucksuckdonk: posts big blind $0.02
*** HOLE CARDS ***
Dealt to Scaaalll [Qh Ks]
Ufiltreret: raises $0.04 to $0.06
twobii668 is disconnected 
Scaaalll: folds 
ChowMangao: folds 
AtZ3899: folds 
twobii668: folds 
lucksuckdonk: folds 
Uncalled bet ($0.04) returned to Ufiltreret
Ufiltreret collected $0.05 from pot
Ufiltreret: doesn't show hand 
*** SUMMARY ***
Total pot $0.05 | Rake $0 
Seat 1: AtZ3899 (button) folded before Flop (didn't bet)
Seat 2: twobii668 (small blind) folded before Flop
Seat 3: lucksuckdonk (big blind) folded before Flop
Seat 4: Ufiltreret collected ($0.05)
Seat 5: Scaaalll folded before Flop (didn't bet)
Seat 6: ChowMangao folded before Flop (didn't bet)



PokerStars Zoom Hand #229230949827:  Hold'em No Limit ($0.01/$0.02) - 2021/08/21 21:54:41 CET [2021/08/21 15:54:41 ET]
Table 'Halley' 6-max Seat #1 is the button
Seat 1: fabor1303 ($2.02 in chips) 
Seat 2: sg.32rus ($0.84 in chips) 
Seat 3: Xlavariable ($2.67 in chips) 
Seat 4: Scaaalll ($3.14 in chips) 
Seat 5: Victor151886 ($3.38 in chips) 
Seat 6: csmall14 ($2.88 in chips) 
sg.32rus: posts small blind $0.01
Xlavariable: posts big blind $0.02
*** HOLE CARDS ***
Dealt to Scaaalll [3h Ad]
Scaaalll: folds 
Victor151886: raises $0.03 to $0.05
csmall14: folds 
fabor1303: folds 
sg.32rus: folds 
Xlavariable: calls $0.03
*** FLOP *** [2s 4h 5c]
Xlavariable: checks 
Victor151886: checks 
*** TURN *** [2s 4h 5c] [Jd]
Xlavariable: checks 
Victor151886: bets $0.08
Xlavariable: folds 
Uncalled bet ($0.08) returned to Victor151886
Victor151886 collected $0.11 from pot
Victor151886: doesn't show hand 
*** SUMMARY ***
Total pot $0.11 | Rake $0 
Board [2s 4h 5c Jd]
Seat 1: fabor1303 (button) folded before Flop (didn't bet)
Seat 2: sg.32rus (small blind) folded before Flop
Seat 3: Xlavariable (big blind) folded on the Turn
Seat 4: Scaaalll folded before Flop (didn't bet)
Seat 5: Victor151886 collected ($0.11)
Seat 6: csmall14 folded before Flop (didn't bet)



PokerStars Zoom Hand #229230959218:  Hold'em No Limit ($0.01/$0.02) - 2021/08/21 21:55:02 CET [2021/08/21 15:55:02 ET]
Table 'Halley' 6-max Seat #1 is the button
Seat 1: SKV_1985 ($2.81 in chips) 
Seat 2: AlexGTPS ($1.97 in chips) 
Seat 3: Scaaalll ($3.14 in chips) 
Seat 4: RoughRafff ($2.12 in chips) 
Seat 5: rpycmbEM ($4.74 in chips) 
Seat 6: Flankeris ($11.09 in chips) 
AlexGTPS: posts small blind $0.01
Scaaalll: posts big blind $0.02
*** HOLE CARDS ***
Dealt to Scaaalll [Th 2h]
RoughRafff: folds 
rpycmbEM: folds 
Flankeris: raises $0.04 to $0.06
SKV_1985: folds 
AlexGTPS: folds 
Scaaalll: folds 
Uncalled bet ($0.04) returned to Flankeris
Flankeris collected $0.05 from pot
Flankeris: doesn't show hand 
*** SUMMARY ***
Total pot $0.05 | Rake $0 
Seat 1: SKV_1985 (button) folded before Flop (didn't bet)
Seat 2: AlexGTPS (small blind) folded before Flop
Seat 3: Scaaalll (big blind) folded before Flop
Seat 4: RoughRafff folded before Flop (didn't bet)
Seat 5: rpycmbEM folded before Flop (didn't bet)
Seat 6: Flankeris collected ($0.05)



PokerStars Zoom Hand #229230963150:  Hold'em No Limit ($0.01/$0.02) - 2021/08/21 21:55:14 CET [2021/08/21 15:55:14 ET]
Table 'Halley' 6-max Seat #1 is the button
Seat 1: caiolima99 ($5.82 in chips) 
Seat 2: Scaaalll ($3.12 in chips) 
Seat 3: HellNative ($3.28 in chips) 
Seat 4: elcuchu168 ($0.99 in chips) 
Seat 5: pavlo8855 ($2 in chips) 
Seat 6: senornamsen ($1.91 in chips) 
Scaaalll: posts small blind $0.01
HellNative: posts big blind $0.02
*** HOLE CARDS ***
Dealt to Scaaalll [Qc 5d]
elcuchu168: raises $0.04 to $0.06
pavlo8855: folds 
senornamsen has timed out
senornamsen: folds 
senornamsen is disconnected 
caiolima99: folds 
Scaaalll: folds 
HellNative: folds 
Uncalled bet ($0.04) returned to elcuchu168
elcuchu168 collected $0.05 from pot
elcuchu168: doesn't show hand 
*** SUMMARY ***
Total pot $0.05 | Rake $0 
Seat 1: caiolima99 (button) folded before Flop (didn't bet)
Seat 2: Scaaalll (small blind) folded before Flop
Seat 3: HellNative (big blind) folded before Flop
Seat 4: elcuchu168 collected ($0.05)
Seat 5: pavlo8855 folded before Flop (didn't bet)
Seat 6: senornamsen folded before Flop (didn't bet)



PokerStars Zoom Hand #229230966856:  Hold'em No Limit ($0.01/$0.02) - 2021/08/21 21:55:26 CET [2021/08/21 15:55:26 ET]
Table 'Halley' 6-max Seat #1 is the button
Seat 1: Scaaalll ($3.11 in chips) 
Seat 2: ctaceo ($2.11 in chips) 
Seat 3: yal.AnToJKe ($1.91 in chips) 
Seat 4: Emilmoller1 ($1.45 in chips) 
Seat 5: derry,me ($1.89 in chips) 
Seat 6: gasmar_29 ($4.50 in chips) 
ctaceo: posts small blind $0.01
yal.AnToJKe: posts big blind $0.02
*** HOLE CARDS ***
Dealt to Scaaalll [Kh 6c]
Emilmoller1: folds 
derry,me: calls $0.02
gasmar_29: folds 
Scaaalll: folds 
ctaceo: folds 
yal.AnToJKe: checks 
*** FLOP *** [7h Qc Ad]
yal.AnToJKe: checks 
derry,me: checks 
*** TURN *** [7h Qc Ad] [9c]
yal.AnToJKe: checks 
derry,me: checks 
*** RIVER *** [7h Qc Ad 9c] [As]
yal.AnToJKe: checks 
derry,me: checks 
*** SHOW DOWN ***
yal.AnToJKe: shows [5c Qh] (two pair, Aces and Queens)
derry,me: mucks hand 
yal.AnToJKe collected $0.05 from pot
*** SUMMARY ***
Total pot $0.05 | Rake $0 
Board [7h Qc Ad 9c As]
Seat 1: Scaaalll (button) folded before Flop (didn't bet)
Seat 2: ctaceo (small blind) folded before Flop
Seat 3: yal.AnToJKe (big blind) showed [5c Qh] and won ($0.05) with two pair, Aces and Queens
Seat 4: Emilmoller1 folded before Flop (didn't bet)
Seat 5: derry,me mucked [Jd Td]
Seat 6: gasmar_29 folded before Flop (didn't bet)



PokerStars Zoom Hand #229230967999:  Hold'em No Limit ($0.01/$0.02) - 2021/08/21 21:55:30 CET [2021/08/21 15:55:30 ET]
Table 'Halley' 6-max Seat #1 is the button
Seat 1: Koldun 2636 ($4.78 in chips) 
Seat 2: Begon505 ($0.73 in chips) 
Seat 3: Iwanb4 ($2 in chips) 
Seat 4: Atiszon ($2.10 in chips) 
Seat 5: zielony ($2.01 in chips) 
Seat 6: Scaaalll ($3.11 in chips) 
Begon505: posts small blind $0.01
Iwanb4: posts big blind $0.02
*** HOLE CARDS ***
Dealt to Scaaalll [As 6s]
Atiszon: raises $0.04 to $0.06
zielony: folds 
Scaaalll: folds 
Koldun 2636: folds 
Begon505: folds 
Iwanb4: folds 
Uncalled bet ($0.04) returned to Atiszon
Atiszon collected $0.05 from pot
Atiszon: doesn't show hand 
*** SUMMARY ***
Total pot $0.05 | Rake $0 
Seat 1: Koldun 2636 (button) folded before Flop (didn't bet)
Seat 2: Begon505 (small blind) folded before Flop
Seat 3: Iwanb4 (big blind) folded before Flop
Seat 4: Atiszon collected ($0.05)
Seat 5: zielony folded before Flop (didn't bet)
Seat 6: Scaaalll folded before Flop (didn't bet)



PokerStars Zoom Hand #229230973041:  Hold'em No Limit ($0.01/$0.02) - 2021/08/21 21:55:46 CET [2021/08/21 15:55:46 ET]
Table 'Halley' 6-max Seat #1 is the button
Seat 1: djMegagirl ($1.99 in chips) 
Seat 2: Nihility77 ($3.03 in chips) 
Seat 3: Tabitaji ($4.14 in chips) 
Seat 4: ARTMVSLV ($2.69 in chips) 
Seat 5: caiolima99 ($5.82 in chips) 
Seat 6: Scaaalll ($3.11 in chips) 
Nihility77: posts small blind $0.01
Tabitaji: posts big blind $0.02
*** HOLE CARDS ***
Dealt to Scaaalll [7c Jd]
ARTMVSLV: folds 
caiolima99: folds 
Scaaalll: folds 
djMegagirl: folds 
Nihility77: raises $0.03 to $0.05
Tabitaji: folds 
Uncalled bet ($0.03) returned to Nihility77
Nihility77 collected $0.04 from pot
Nihility77: doesn't show hand 
*** SUMMARY ***
Total pot $0.04 | Rake $0 
Seat 1: djMegagirl (button) folded before Flop (didn't bet)
Seat 2: Nihility77 (small blind) collected ($0.04)
Seat 3: Tabitaji (big blind) folded before Flop
Seat 4: ARTMVSLV folded before Flop (didn't bet)
Seat 5: caiolima99 folded before Flop (didn't bet)
Seat 6: Scaaalll folded before Flop (didn't bet)



PokerStars Zoom Hand #229230971825:  Hold'em No Limit ($0.01/$0.02) - 2021/08/21 21:55:42 CET [2021/08/21 15:55:42 ET]
Table 'Halley' 6-max Seat #1 is the button
Seat 1: FajlapO ($1.63 in chips) 
Seat 2: Blofeld197 ($2.62 in chips) 
Seat 3: gugamoraes ($2.18 in chips) 
Seat 4: Scaaalll ($3.11 in chips) 
Seat 5: Mokkavit ($1.94 in chips) 
Seat 6: ppluiaule ($2 in chips) 
Blofeld197: posts small blind $0.01
gugamoraes: posts big blind $0.02
*** HOLE CARDS ***
Dealt to Scaaalll [3d Qc]
Scaaalll: folds 
Mokkavit: folds 
ppluiaule: folds 
FajlapO: raises $0.04 to $0.06
Blofeld197: folds 
Blofeld197 is disconnected 
gugamoraes: calls $0.04
*** FLOP *** [2s Ah 4c]
gugamoraes: checks 
FajlapO: checks 
*** TURN *** [2s Ah 4c] [Kh]
gugamoraes: checks 
FajlapO: checks 
*** RIVER *** [2s Ah 4c Kh] [4s]
gugamoraes: bets $0.08
FajlapO: folds 
Uncalled bet ($0.08) returned to gugamoraes
gugamoraes collected $0.13 from pot
gugamoraes: doesn't show hand 
FajlapO is disconnected 
*** SUMMARY ***
Total pot $0.13 | Rake $0 
Board [2s Ah 4c Kh 4s]
Seat 1: FajlapO (button) folded on the River
Seat 2: Blofeld197 (small blind) folded before Flop
Seat 3: gugamoraes (big blind) collected ($0.13)
Seat 4: Scaaalll folded before Flop (didn't bet)
Seat 5: Mokkavit folded before Flop (didn't bet)
Seat 6: ppluiaule folded before Flop (didn't bet)



PokerStars Zoom Hand #229230974220:  Hold'em No Limit ($0.01/$0.02) - 2021/08/21 21:55:50 CET [2021/08/21 15:55:50 ET]
Table 'Halley' 6-max Seat #1 is the button
Seat 1: ximik D V ($2.33 in chips) 
Seat 2: Quantum771 ($2.09 in chips) 
Seat 3: Scaaalll ($3.11 in chips) 
Seat 4: 77omsk ($2.87 in chips) 
Seat 5: Grama480 ($3.23 in chips) 
Seat 6: IamFixxed ($2.84 in chips) 
Quantum771: posts small blind $0.01
Scaaalll: posts big blind $0.02
*** HOLE CARDS ***
Dealt to Scaaalll [Ad Kd]
77omsk: raises $0.03 to $0.05
Grama480: folds 
IamFixxed: folds 
ximik D V: raises $0.13 to $0.18
Quantum771: folds 
Scaaalll: calls $0.16
77omsk: folds 
*** FLOP *** [9c 4h Td]
Scaaalll: checks 
ximik D V: bets $0.27
Scaaalll: folds 
Uncalled bet ($0.27) returned to ximik D V
ximik D V collected $0.41 from pot
ximik D V: doesn't show hand 
*** SUMMARY ***
Total pot $0.42 | Rake $0.01 
Board [9c 4h Td]
Seat 1: ximik D V (button) collected ($0.41)
Seat 2: Quantum771 (small blind) folded before Flop
Seat 3: Scaaalll (big blind) folded on the Flop
Seat 4: 77omsk folded before Flop
Seat 5: Grama480 folded before Flop (didn't bet)
Seat 6: IamFixxed folded before Flop (didn't bet)



PokerStars Zoom Hand #229230992259:  Hold'em No Limit ($0.01/$0.02) - 2021/08/21 21:56:48 CET [2021/08/21 15:56:48 ET]
Table 'Halley' 6-max Seat #1 is the button
Seat 1: Scaaalll ($2.92 in chips) 
Seat 2: amario89 ($2.24 in chips) 
Seat 3: DukeOfBlackburn ($2.34 in chips) 
Seat 4: Pechorin.G ($2.01 in chips) 
Seat 5: alexxandr ($1.98 in chips) 
Seat 6: Davingo25 ($1.87 in chips) 
amario89: posts small blind $0.01
DukeOfBlackburn: posts big blind $0.02
*** HOLE CARDS ***
Dealt to Scaaalll [2d 9s]
Pechorin.G: folds 
alexxandr: folds 
Davingo25: raises $0.04 to $0.06
Scaaalll: folds 
amario89: folds 
DukeOfBlackburn: folds 
Uncalled bet ($0.04) returned to Davingo25
Davingo25 collected $0.05 from pot
Davingo25: doesn't show hand 
DukeOfBlackburn is disconnected 
*** SUMMARY ***
Total pot $0.05 | Rake $0 
Seat 1: Scaaalll (button) folded before Flop (didn't bet)
Seat 2: amario89 (small blind) folded before Flop
Seat 3: DukeOfBlackburn (big blind) folded before Flop
Seat 4: Pechorin.G folded before Flop (didn't bet)
Seat 5: alexxandr folded before Flop (didn't bet)
Seat 6: Davingo25 collected ($0.05)



PokerStars Zoom Hand #229230990647:  Hold'em No Limit ($0.01/$0.02) - 2021/08/21 21:56:43 CET [2021/08/21 15:56:43 ET]
Table 'Halley' 6-max Seat #1 is the button
Seat 1: martuska88 ($2.78 in chips) 
Seat 2: Scaaalll ($2.93 in chips) 
Seat 3: Pechorin.G ($2.03 in chips) 
Seat 4: lucksuckdonk ($3.95 in chips) 
Seat 5: Mikalai M. ($0.68 in chips) 
Seat 6: FabOliveira9 ($2.05 in chips) 
Scaaalll: posts small blind $0.01
Pechorin.G: posts big blind $0.02
*** HOLE CARDS ***
Dealt to Scaaalll [3d 5s]
lucksuckdonk: raises $0.04 to $0.06
Mikalai M. has timed out
Mikalai M.: folds 
FabOliveira9: folds 
martuska88: folds 
Scaaalll: folds 
Pechorin.G: folds 
Uncalled bet ($0.04) returned to lucksuckdonk
Mikalai M. is disconnected 
lucksuckdonk collected $0.05 from pot
lucksuckdonk: doesn't show hand 
*** SUMMARY ***
Total pot $0.05 | Rake $0 
Seat 1: martuska88 (button) folded before Flop (didn't bet)
Seat 2: Scaaalll (small blind) folded before Flop
Seat 3: Pechorin.G (big blind) folded before Flop
Seat 4: lucksuckdonk collected ($0.05)
Seat 5: Mikalai M. folded before Flop (didn't bet)
Seat 6: FabOliveira9 folded before Flop (didn't bet)



PokerStars Zoom Hand #229230993512:  Hold'em No Limit ($0.01/$0.02) - 2021/08/21 21:56:52 CET [2021/08/21 15:56:52 ET]
Table 'Halley' 6-max Seat #1 is the button
Seat 1: Matias Jesus N ($0.40 in chips) 
Seat 2: Shcherbak252 ($1.68 in chips) 
Seat 3: kahzura ($2.08 in chips) 
Seat 4: EmperorKurr ($2 in chips) 
Seat 5: Scaaalll ($2.92 in chips) 
Seat 6: rpycmbEM ($4.88 in chips) 
Shcherbak252: posts small blind $0.01
kahzura: posts big blind $0.02
*** HOLE CARDS ***
Dealt to Scaaalll [Jh 4c]
EmperorKurr: folds 
Scaaalll: folds 
rpycmbEM: folds 
Matias Jesus N: raises $0.04 to $0.06
Shcherbak252: folds 
kahzura: folds 
Uncalled bet ($0.04) returned to Matias Jesus N
Matias Jesus N collected $0.05 from pot
Matias Jesus N: doesn't show hand 
*** SUMMARY ***
Total pot $0.05 | Rake $0 
Seat 1: Matias Jesus N (button) collected ($0.05)
Seat 2: Shcherbak252 (small blind) folded before Flop
Seat 3: kahzura (big blind) folded before Flop
Seat 4: EmperorKurr folded before Flop (didn't bet)
Seat 5: Scaaalll folded before Flop (didn't bet)
Seat 6: rpycmbEM folded before Flop (didn't bet)



PokerStars Zoom Hand #229230994802:  Hold'em No Limit ($0.01/$0.02) - 2021/08/21 21:56:56 CET [2021/08/21 15:56:56 ET]
Table 'Halley' 6-max Seat #1 is the button
Seat 1: Kb013497 ($4.68 in chips) 
Seat 2: gasmar_29 ($3.46 in chips) 
Seat 3: gugamoraes ($2.64 in chips) 
Seat 4: LuckyCheewey ($7.74 in chips) 
Seat 5: belbo888 ($3.38 in chips) 
Seat 6: Scaaalll ($2.92 in chips) 
gasmar_29: posts small blind $0.01
gugamoraes: posts big blind $0.02
*** HOLE CARDS ***
Dealt to Scaaalll [7d 6c]
LuckyCheewey: folds 
belbo888: folds 
Scaaalll has timed out
Scaaalll: folds 
Kb013497: folds 
gasmar_29: raises $0.04 to $0.06
gugamoraes: folds 
Uncalled bet ($0.04) returned to gasmar_29
gasmar_29 collected $0.04 from pot
gasmar_29: doesn't show hand 
*** SUMMARY ***
Total pot $0.04 | Rake $0 
Seat 1: Kb013497 (button) folded before Flop (didn't bet)
Seat 2: gasmar_29 (small blind) collected ($0.04)
Seat 3: gugamoraes (big blind) folded before Flop
Seat 4: LuckyCheewey folded before Flop (didn't bet)
Seat 5: belbo888 folded before Flop (didn't bet)
Seat 6: Scaaalll folded before Flop (didn't bet)



PokerStars Zoom Hand #229231002617:  Hold'em No Limit ($0.01/$0.02) - 2021/08/21 21:57:21 CET [2021/08/21 15:57:21 ET]
Table 'Halley' 6-max Seat #1 is the button
Seat 1: DukeOfBlackburn ($2.31 in chips) 
Seat 2: Scaaalll ($2.92 in chips) 
Seat 3: STE1NBERG ($4.31 in chips) 
Seat 4: usenovm ($1.56 in chips) 
Seat 5: gasmar_29 ($3.77 in chips) 
Seat 6: Wegezin ($1.90 in chips) 
Scaaalll: posts small blind $0.01
STE1NBERG: posts big blind $0.02
*** HOLE CARDS ***
Dealt to Scaaalll [As Kc]
DukeOfBlackburn is disconnected 
usenovm: folds 
gasmar_29: folds 
Wegezin: folds 
DukeOfBlackburn: folds 
Scaaalll: raises $0.04 to $0.06
STE1NBERG: calls $0.04
*** FLOP *** [4c 2h 2c]
Scaaalll: bets $0.08
STE1NBERG: calls $0.08
*** TURN *** [4c 2h 2c] [6h]
Scaaalll: checks 
STE1NBERG: checks 
*** RIVER *** [4c 2h 2c 6h] [Ks]
Scaaalll: bets $0.16
STE1NBERG: calls $0.16
*** SHOW DOWN ***
Scaaalll: shows [As Kc] (two pair, Kings and Deuces)
STE1NBERG: mucks hand 
Scaaalll collected $0.58 from pot
*** SUMMARY ***
Total pot $0.60 | Rake $0.02 
Board [4c 2h 2c 6h Ks]
Seat 1: DukeOfBlackburn (button) folded before Flop (didn't bet)
Seat 2: Scaaalll (small blind) showed [As Kc] and won ($0.58) with two pair, Kings and Deuces
Seat 3: STE1NBERG (big blind) mucked [Ad 4s]
Seat 4: usenovm folded before Flop (didn't bet)
Seat 5: gasmar_29 folded before Flop (didn't bet)
Seat 6: Wegezin folded before Flop (didn't bet)



PokerStars Zoom Hand #229231001110:  Hold'em No Limit ($0.01/$0.02) - 2021/08/21 21:57:16 CET [2021/08/21 15:57:16 ET]
Table 'Halley' 6-max Seat #1 is the button
Seat 1: texashenry2 ($1.11 in chips) 
Seat 2: xFruJensen ($0.99 in chips) 
Seat 3: olliejaydee ($1.48 in chips) 
Seat 4: Scaaalll ($2.92 in chips) 
Seat 5: H0mmer99 ($3.28 in chips) 
Seat 6: EstiBan18 ($2.40 in chips) 
xFruJensen: posts small blind $0.01
olliejaydee: posts big blind $0.02
*** HOLE CARDS ***
Dealt to Scaaalll [Jd 9h]
Scaaalll: folds 
H0mmer99: folds 
EstiBan18: raises $0.04 to $0.06
texashenry2: folds 
xFruJensen: calls $0.05
olliejaydee: calls $0.04
*** FLOP *** [Ts 8s 6h]
xFruJensen: bets $0.09
olliejaydee: calls $0.09
EstiBan18: raises $0.23 to $0.32
xFruJensen: calls $0.23
olliejaydee: calls $0.23
*** TURN *** [Ts 8s 6h] [Ac]
xFruJensen: checks 
olliejaydee: checks 
EstiBan18: bets $1.10
xFruJensen: calls $0.61 and is all-in
olliejaydee: calls $1.10 and is all-in
*** RIVER *** [Ts 8s 6h Ac] [7s]
*** SHOW DOWN ***
olliejaydee: shows [4s Ks] (a flush, King high)
EstiBan18: shows [Tc Td] (three of a kind, Tens)
olliejaydee collected $0.94 from side pot
xFruJensen: shows [8d 8c] (three of a kind, Eights)
olliejaydee collected $2.87 from main pot
EstiBan18 cashed out the hand for $3.07 | Cash Out Fee $0.03
*** SUMMARY ***
Total pot $3.95 Main pot $2.87. Side pot $0.94. | Rake $0.14 
Board [Ts 8s 6h Ac 7s]
Seat 1: texashenry2 (button) folded before Flop (didn't bet)
Seat 2: xFruJensen (small blind) showed [8d 8c] and lost with three of a kind, Eights
Seat 3: olliejaydee (big blind) showed [4s Ks] and won ($3.81) with a flush, King high
Seat 4: Scaaalll folded before Flop (didn't bet)
Seat 5: H0mmer99 folded before Flop (didn't bet)
Seat 6: EstiBan18 showed [Tc Td] and lost with three of a kind, Tens (cashed out).



PokerStars Zoom Hand #229231017350:  Hold'em No Limit ($0.01/$0.02) - 2021/08/21 21:58:08 CET [2021/08/21 15:58:08 ET]
Table 'Halley' 6-max Seat #1 is the button
Seat 1: RrriotGrrrl ($9.50 in chips) 
Seat 2: maaitee ($2 in chips) 
Seat 3: Scaaalll ($3.20 in chips) 
Seat 4: Agno$tic ($2.03 in chips) 
Seat 5: Blaackie ($2.13 in chips) 
Seat 6: STE1NBERG ($4.01 in chips) 
maaitee: posts small blind $0.01
Scaaalll: posts big blind $0.02
*** HOLE CARDS ***
Dealt to Scaaalll [5h Kd]
Agno$tic: raises $0.04 to $0.06
Blaackie: folds 
STE1NBERG: folds 
RrriotGrrrl: folds 
maaitee: folds 
Scaaalll: folds 
Uncalled bet ($0.04) returned to Agno$tic
Agno$tic collected $0.05 from pot
Agno$tic: doesn't show hand 
*** SUMMARY ***
Total pot $0.05 | Rake $0 
Seat 1: RrriotGrrrl (button) folded before Flop (didn't bet)
Seat 2: maaitee (small blind) folded before Flop
Seat 3: Scaaalll (big blind) folded before Flop
Seat 4: Agno$tic collected ($0.05)
Seat 5: Blaackie folded before Flop (didn't bet)
Seat 6: STE1NBERG folded before Flop (didn't bet)



PokerStars Zoom Hand #229231026850:  Hold'em No Limit ($0.01/$0.02) - 2021/08/21 21:58:38 CET [2021/08/21 15:58:38 ET]
Table 'Halley' 6-max Seat #1 is the button
Seat 1: Aho1337 ($3.54 in chips) 
Seat 2: Scaaalll ($3.18 in chips) 
Seat 3: SICKDIRTY416 ($5.29 in chips) 
Seat 4: wstanula ($2.82 in chips) 
Seat 5: dinoVIEIRA ($2 in chips) 
Seat 6: Ne0net ($2.05 in chips) 
Scaaalll: posts small blind $0.01
SICKDIRTY416: posts big blind $0.02
*** HOLE CARDS ***
Dealt to Scaaalll [8s 6s]
wstanula: folds 
dinoVIEIRA: folds 
Ne0net: raises $0.03 to $0.05
Aho1337: folds 
SICKDIRTY416 is disconnected 
Scaaalll: folds 
SICKDIRTY416: folds 
Uncalled bet ($0.03) returned to Ne0net
Ne0net collected $0.05 from pot
Ne0net: doesn't show hand 
*** SUMMARY ***
Total pot $0.05 | Rake $0 
Seat 1: Aho1337 (button) folded before Flop (didn't bet)
Seat 2: Scaaalll (small blind) folded before Flop
Seat 3: SICKDIRTY416 (big blind) folded before Flop
Seat 4: wstanula folded before Flop (didn't bet)
Seat 5: dinoVIEIRA folded before Flop (didn't bet)
Seat 6: Ne0net collected ($0.05)



PokerStars Zoom Hand #229231030270:  Hold'em No Limit ($0.01/$0.02) - 2021/08/21 21:58:49 CET [2021/08/21 15:58:49 ET]
Table 'Halley' 6-max Seat #1 is the button
Seat 1: zielony ($2.59 in chips) 
Seat 2: SICKDIRTY416 ($5.27 in chips) 
Seat 3: sg.32rus ($1.36 in chips) 
Seat 4: kboskov123 ($2.19 in chips) 
Seat 5: Scaaalll ($3.17 in chips) 
Seat 6: tuolau ($3.45 in chips) 
SICKDIRTY416: posts small blind $0.01
sg.32rus: posts big blind $0.02
*** HOLE CARDS ***
Dealt to Scaaalll [Kc Qd]
SICKDIRTY416 is disconnected 
kboskov123: folds 
Scaaalll: raises $0.04 to $0.06
tuolau: folds 
tuolau is disconnected 
zielony: folds 
SICKDIRTY416: folds 
sg.32rus: folds 
Uncalled bet ($0.04) returned to Scaaalll
Scaaalll collected $0.05 from pot
Scaaalll: doesn't show hand 
*** SUMMARY ***
Total pot $0.05 | Rake $0 
Seat 1: zielony (button) folded before Flop (didn't bet)
Seat 2: SICKDIRTY416 (small blind) folded before Flop
Seat 3: sg.32rus (big blind) folded before Flop
Seat 4: kboskov123 folded before Flop (didn't bet)
Seat 5: Scaaalll collected ($0.05)
Seat 6: tuolau folded before Flop (didn't bet)



PokerStars Zoom Hand #229231021177:  Hold'em No Limit ($0.01/$0.02) - 2021/08/21 21:58:20 CET [2021/08/21 15:58:20 ET]
Table 'Halley' 6-max Seat #1 is the button
Seat 1: Scaaalll ($3.18 in chips) 
Seat 2: SGALINAE ($1 in chips) 
Seat 3: Aho1337 ($2.59 in chips) 
Seat 4: Flankeris ($4.82 in chips) 
Seat 5: RoughRafff ($3.02 in chips) 
Seat 6: Ruslan076 ($1.64 in chips) 
SGALINAE: posts small blind $0.01
Aho1337: posts big blind $0.02
*** HOLE CARDS ***
Dealt to Scaaalll [5c Qd]
Flankeris: raises $0.04 to $0.06
RoughRafff: folds 
Ruslan076: calls $0.06
Scaaalll: folds 
SGALINAE: calls $0.05
Aho1337: folds 
*** FLOP *** [Jd Qc 6c]
SGALINAE: checks 
Flankeris: checks 
Ruslan076: checks 
*** TURN *** [Jd Qc 6c] [5h]
SGALINAE: bets $0.19
Ruslan076 is disconnected 
Flankeris: calls $0.19
Ruslan076: folds 
*** RIVER *** [Jd Qc 6c 5h] [2h]
SGALINAE: bets $0.75 and is all-in
Flankeris: calls $0.75
*** SHOW DOWN ***
SGALINAE: shows [9s Jh] (a pair of Jacks)
Flankeris: shows [Qh Qs] (three of a kind, Queens)
Flankeris collected $2.01 from pot
*** SUMMARY ***
Total pot $2.08 | Rake $0.07 
Board [Jd Qc 6c 5h 2h]
Seat 1: Scaaalll (button) folded before Flop (didn't bet)
Seat 2: SGALINAE (small blind) showed [9s Jh] and lost with a pair of Jacks
Seat 3: Aho1337 (big blind) folded before Flop
Seat 4: Flankeris showed [Qh Qs] and won ($2.01) with three of a kind, Queens
Seat 5: RoughRafff folded before Flop (didn't bet)
Seat 6: Ruslan076 folded on the Turn



PokerStars Zoom Hand #229231023151:  Hold'em No Limit ($0.01/$0.02) - 2021/08/21 21:58:26 CET [2021/08/21 15:58:26 ET]
Table 'Halley' 6-max Seat #1 is the button
Seat 1: AligatorsBlood ($2 in chips) 
Seat 2: Mokkavit ($1.94 in chips) 
Seat 3: Janey44 ($1.97 in chips) 
Seat 4: Blaackie ($2.07 in chips) 
Seat 5: rodrigoaduar ($0.88 in chips) 
Seat 6: Scaaalll ($3.18 in chips) 
Mokkavit: posts small blind $0.01
Janey44: posts big blind $0.02
*** HOLE CARDS ***
Dealt to Scaaalll [7d Qc]
Blaackie: folds 
rodrigoaduar: calls $0.02
Scaaalll: folds 
AligatorsBlood: folds 
rodrigoaduar is disconnected 
rodrigoaduar is disconnected 
rodrigoaduar is disconnected 
Mokkavit: calls $0.01
Janey44: checks 
*** FLOP *** [Ad 4c Kc]
Mokkavit: checks 
Janey44: checks 
rodrigoaduar: checks 
*** TURN *** [Ad 4c Kc] [2h]
Mokkavit: checks 
Janey44: checks 
rodrigoaduar: checks 
*** RIVER *** [Ad 4c Kc 2h] [3d]
Mokkavit: checks 
Janey44: bets $0.06
rodrigoaduar: calls $0.06
Mokkavit: folds 
*** SHOW DOWN ***
Janey44: shows [6d 5s] (a straight, Deuce to Six)
rodrigoaduar: mucks hand 
Janey44 collected $0.17 from pot
*** SUMMARY ***
Total pot $0.18 | Rake $0.01 
Board [Ad 4c Kc 2h 3d]
Seat 1: AligatorsBlood (button) folded before Flop (didn't bet)
Seat 2: Mokkavit (small blind) folded on the River
Seat 3: Janey44 (big blind) showed [6d 5s] and won ($0.17) with a straight, Deuce to Six
Seat 4: Blaackie folded before Flop (didn't bet)
Seat 5: rodrigoaduar mucked [7s 7c]
Seat 6: Scaaalll folded before Flop (didn't bet)



PokerStars Zoom Hand #229231035245:  Hold'em No Limit ($0.01/$0.02) - 2021/08/21 21:59:05 CET [2021/08/21 15:59:05 ET]
Table 'Halley' 6-max Seat #1 is the button
Seat 1: olga3021221 ($3.73 in chips) 
Seat 2: jacobifer ($1.13 in chips) 
Seat 3: IamScald ($2.10 in chips) 
Seat 4: Scaaalll ($3.20 in chips) 
Seat 5: ppluiaule ($2.23 in chips) 
Seat 6: Larson_mfk ($0.83 in chips) 
jacobifer: posts small blind $0.01
IamScald: posts big blind $0.02
*** HOLE CARDS ***
Dealt to Scaaalll [6c Qs]
Larson_mfk is disconnected 
Scaaalll: folds 
ppluiaule: raises $0.03 to $0.05
Larson_mfk: folds 
olga3021221: folds 
jacobifer: calls $0.04
IamScald: folds 
*** FLOP *** [7h Qh 5c]
IamScald is disconnected 
jacobifer: checks 
ppluiaule: bets $0.06
jacobifer: folds 
Uncalled bet ($0.06) returned to ppluiaule
ppluiaule collected $0.12 from pot
ppluiaule: doesn't show hand 
jacobifer is disconnected 
*** SUMMARY ***
Total pot $0.12 | Rake $0 
Board [7h Qh 5c]
Seat 1: olga3021221 (button) folded before Flop (didn't bet)
Seat 2: jacobifer (small blind) folded on the Flop
Seat 3: IamScald (big blind) folded before Flop
Seat 4: Scaaalll folded before Flop (didn't bet)
Seat 5: ppluiaule collected ($0.12)
Seat 6: Larson_mfk folded before Flop (didn't bet)



PokerStars Zoom Hand #229231036863:  Hold'em No Limit ($0.01/$0.02) - 2021/08/21 21:59:10 CET [2021/08/21 15:59:10 ET]
Table 'Halley' 6-max Seat #1 is the button
Seat 1: Gerar NB ($2.18 in chips) 
Seat 2: Fanatspartak ($1.37 in chips) 
Seat 3: Scaaalll ($3.20 in chips) 
Seat 4: dinoVIEIRA ($2.26 in chips) 
Seat 5: Bryan11129 ($0.66 in chips) 
Seat 6: ggluglul ($1.10 in chips) 
Fanatspartak: posts small blind $0.01
Scaaalll: posts big blind $0.02
*** HOLE CARDS ***
Dealt to Scaaalll [Ah 7s]
dinoVIEIRA: folds 
Bryan11129: folds 
ggluglul: folds 
Gerar NB: folds 
Bryan11129 is disconnected 
Fanatspartak: raises $0.02 to $0.04
Scaaalll: calls $0.02
*** FLOP *** [Ks 3s 2c]
Fanatspartak: bets $0.04
Scaaalll: folds 
Uncalled bet ($0.04) returned to Fanatspartak
Fanatspartak collected $0.08 from pot
Fanatspartak: doesn't show hand 
*** SUMMARY ***
Total pot $0.08 | Rake $0 
Board [Ks 3s 2c]
Seat 1: Gerar NB (button) folded before Flop (didn't bet)
Seat 2: Fanatspartak (small blind) collected ($0.08)
Seat 3: Scaaalll (big blind) folded on the Flop
Seat 4: dinoVIEIRA folded before Flop (didn't bet)
Seat 5: Bryan11129 folded before Flop (didn't bet)
Seat 6: ggluglul folded before Flop (didn't bet)



PokerStars Zoom Hand #229231046093:  Hold'em No Limit ($0.01/$0.02) - 2021/08/21 21:59:39 CET [2021/08/21 15:59:39 ET]
Table 'Halley' 6-max Seat #1 is the button
Seat 1: Scaaalll ($3.16 in chips) 
Seat 2: Soban89 ($0.81 in chips) 
Seat 3: elmex886 ($2.06 in chips) 
Seat 4: andihorni1 ($1.78 in chips) 
Seat 5: Bufre ($4.07 in chips) 
Seat 6: zeus11983 ($2.17 in chips) 
Soban89: posts small blind $0.01
elmex886: posts big blind $0.02
*** HOLE CARDS ***
Dealt to Scaaalll [2d 9c]
andihorni1: folds 
Bufre: folds 
zeus11983: folds 
Scaaalll: folds 
Soban89: folds 
Uncalled bet ($0.01) returned to elmex886
elmex886 collected $0.02 from pot
elmex886: doesn't show hand 
*** SUMMARY ***
Total pot $0.02 | Rake $0 
Seat 1: Scaaalll (button) folded before Flop (didn't bet)
Seat 2: Soban89 (small blind) folded before Flop
Seat 3: elmex886 (big blind) collected ($0.02)
Seat 4: andihorni1 folded before Flop (didn't bet)
Seat 5: Bufre folded before Flop (didn't bet)
Seat 6: zeus11983 folded before Flop (didn't bet)



PokerStars Zoom Hand #229231049268:  Hold'em No Limit ($0.01/$0.02) - 2021/08/21 21:59:50 CET [2021/08/21 15:59:50 ET]
Table 'Halley' 6-max Seat #1 is the button
Seat 1: Shcherbak252 ($1.61 in chips) 
Seat 2: alexxandr ($1.78 in chips) 
Seat 3: BIITRU ($5.31 in chips) 
Seat 4: alecha11 ($2.22 in chips) 
Seat 5: Scaaalll ($3.16 in chips) 
Seat 6: EevAA190 ($3.23 in chips) 
alexxandr: posts small blind $0.01
BIITRU: posts big blind $0.02
*** HOLE CARDS ***
Dealt to Scaaalll [4d 3c]
alecha11: folds 
Scaaalll: folds 
EevAA190: folds 
Shcherbak252: folds 
alexxandr: folds 
Uncalled bet ($0.01) returned to BIITRU
BIITRU collected $0.02 from pot
BIITRU: doesn't show hand 
*** SUMMARY ***
Total pot $0.02 | Rake $0 
Seat 1: Shcherbak252 (button) folded before Flop (didn't bet)
Seat 2: alexxandr (small blind) folded before Flop
Seat 3: BIITRU (big blind) collected ($0.02)
Seat 4: alecha11 folded before Flop (didn't bet)
Seat 5: Scaaalll folded before Flop (didn't bet)
Seat 6: EevAA190 folded before Flop (didn't bet)



PokerStars Zoom Hand #229231050567:  Hold'em No Limit ($0.01/$0.02) - 2021/08/21 21:59:54 CET [2021/08/21 15:59:54 ET]
Table 'Halley' 6-max Seat #1 is the button
Seat 1: LSDenny ($1.61 in chips) 
Seat 2: Ne0net ($2.09 in chips) 
Seat 3: Koldun 2636 ($2.30 in chips) 
Seat 4: dcd113 ($2.52 in chips) 
Seat 5: byakuda ($3.85 in chips) 
Seat 6: Scaaalll ($3.16 in chips) 
Ne0net: posts small blind $0.01
Koldun 2636: posts big blind $0.02
*** HOLE CARDS ***
Dealt to Scaaalll [7s Kh]
dcd113: folds 
LSDenny is disconnected 
byakuda: folds 
Scaaalll: folds 
LSDenny: folds 
Ne0net: folds 
Uncalled bet ($0.01) returned to Koldun 2636
Koldun 2636 collected $0.02 from pot
Koldun 2636: doesn't show hand 
*** SUMMARY ***
Total pot $0.02 | Rake $0 
Seat 1: LSDenny (button) folded before Flop (didn't bet)
Seat 2: Ne0net (small blind) folded before Flop
Seat 3: Koldun 2636 (big blind) collected ($0.02)
Seat 4: dcd113 folded before Flop (didn't bet)
Seat 5: byakuda folded before Flop (didn't bet)
Seat 6: Scaaalll folded before Flop (didn't bet)



PokerStars Zoom Hand #229231053099:  Hold'em No Limit ($0.01/$0.02) - 2021/08/21 22:00:02 CET [2021/08/21 16:00:02 ET]
Table 'Halley' 6-max Seat #1 is the button
Seat 1: Fanatspartak ($1.25 in chips) 
Seat 2: Scaaalll ($3.16 in chips) 
Seat 3: SchinkenToni ($1.91 in chips) 
Seat 4: STE1NBERG ($2.36 in chips) 
Seat 5: LuckyCheewey ($2.26 in chips) 
Seat 6: RonilsonCosta ($2.44 in chips) 
Scaaalll: posts small blind $0.01
SchinkenToni: posts big blind $0.02
*** HOLE CARDS ***
Dealt to Scaaalll [2d Ah]
STE1NBERG: folds 
LuckyCheewey: folds 
RonilsonCosta: folds 
Fanatspartak: folds 
Scaaalll: folds 
Uncalled bet ($0.01) returned to SchinkenToni
SchinkenToni collected $0.02 from pot
SchinkenToni: doesn't show hand 
*** SUMMARY ***
Total pot $0.02 | Rake $0 
Seat 1: Fanatspartak (button) folded before Flop (didn't bet)
Seat 2: Scaaalll (small blind) folded before Flop
Seat 3: SchinkenToni (big blind) collected ($0.02)
Seat 4: STE1NBERG folded before Flop (didn't bet)
Seat 5: LuckyCheewey folded before Flop (didn't bet)
Seat 6: RonilsonCosta folded before Flop (didn't bet)



PokerStars Zoom Hand #229231055982:  Hold'em No Limit ($0.01/$0.02) - 2021/08/21 22:00:10 CET [2021/08/21 16:00:10 ET]
Table 'Halley' 6-max Seat #1 is the button
Seat 1: Kb013497 ($2.96 in chips) 
Seat 2: boa juice ($0.84 in chips) 
Seat 3: LuckyCheewey ($6 in chips) 
Seat 4: Berti281 ($3.41 in chips) 
Seat 5: Scaaalll ($3.15 in chips) 
Seat 6: wopl ($1.38 in chips) 
boa juice: posts small blind $0.01
LuckyCheewey: posts big blind $0.02
*** HOLE CARDS ***
Dealt to Scaaalll [8c 9s]
Berti281: folds 
boa juice is disconnected 
Scaaalll: folds 
wopl: folds 
Kb013497: folds 
boa juice: folds 
Uncalled bet ($0.01) returned to LuckyCheewey
LuckyCheewey collected $0.02 from pot
LuckyCheewey: doesn't show hand 
*** SUMMARY ***
Total pot $0.02 | Rake $0 
Seat 1: Kb013497 (button) folded before Flop (didn't bet)
Seat 2: boa juice (small blind) folded before Flop
Seat 3: LuckyCheewey (big blind) collected ($0.02)
Seat 4: Berti281 folded before Flop (didn't bet)
Seat 5: Scaaalll folded before Flop (didn't bet)
Seat 6: wopl folded before Flop (didn't bet)



PokerStars Zoom Hand #229231058609:  Hold'em No Limit ($0.01/$0.02) - 2021/08/21 22:00:18 CET [2021/08/21 16:00:18 ET]
Table 'Halley' 6-max Seat #1 is the button
Seat 1: gramy20013 ($0.95 in chips) 
Seat 2: meikoz ($3.63 in chips) 
Seat 3: Scaaalll ($3.15 in chips) 
Seat 4: Syberya ($1.46 in chips) 
Seat 5: guniu07 ($2 in chips) 
Seat 6: JustÁnotherGuy ($2.98 in chips) 
meikoz: posts small blind $0.01
Scaaalll: posts big blind $0.02
*** HOLE CARDS ***
Dealt to Scaaalll [Ad 4c]
Syberya: folds 
Syberya is disconnected 
guniu07: folds 
JustÁnotherGuy: raises $0.03 to $0.05
gramy20013: raises $0.03 to $0.08
meikoz: raises $0.18 to $0.26
Scaaalll: folds 
JustÁnotherGuy: folds 
gramy20013: raises $0.18 to $0.44
meikoz: calls $0.18
*** FLOP *** [9s 5c Kd]
meikoz: checks 
gramy20013: checks 
*** TURN *** [9s 5c Kd] [3h]
meikoz: bets $0.52
gramy20013: folds 
Uncalled bet ($0.52) returned to meikoz
meikoz collected $0.92 from pot
meikoz: doesn't show hand 
gramy20013 is disconnected 
*** SUMMARY ***
Total pot $0.95 | Rake $0.03 
Board [9s 5c Kd 3h]
Seat 1: gramy20013 (button) folded on the Turn
Seat 2: meikoz (small blind) collected ($0.92)
Seat 3: Scaaalll (big blind) folded before Flop
Seat 4: Syberya folded before Flop (didn't bet)
Seat 5: guniu07 folded before Flop (didn't bet)
Seat 6: JustÁnotherGuy folded before Flop



PokerStars Zoom Hand #229231065212:  Hold'em No Limit ($0.01/$0.02) - 2021/08/21 22:00:37 CET [2021/08/21 16:00:37 ET]
Table 'Halley' 6-max Seat #1 is the button
Seat 1: gasmar_29 ($3.72 in chips) 
Seat 2: LegendaryLRS ($6.48 in chips) 
Seat 3: maurivispa10 ($1.65 in chips) 
Seat 4: pphit ($2.12 in chips) 
Seat 5: fishh_play ($5.97 in chips) 
Seat 6: Scaaalll ($3.13 in chips) 
LegendaryLRS: posts small blind $0.01
maurivispa10: posts big blind $0.02
*** HOLE CARDS ***
Dealt to Scaaalll [7d As]
pphit: raises $0.03 to $0.05
fishh_play: folds 
Scaaalll: folds 
gasmar_29: folds 
LegendaryLRS: folds 
maurivispa10: folds 
Uncalled bet ($0.03) returned to pphit
pphit collected $0.05 from pot
pphit: doesn't show hand 
*** SUMMARY ***
Total pot $0.05 | Rake $0 
Seat 1: gasmar_29 (button) folded before Flop (didn't bet)
Seat 2: LegendaryLRS (small blind) folded before Flop
Seat 3: maurivispa10 (big blind) folded before Flop
Seat 4: pphit collected ($0.05)
Seat 5: fishh_play folded before Flop (didn't bet)
Seat 6: Scaaalll folded before Flop (didn't bet)



PokerStars Zoom Hand #229231069654:  Hold'em No Limit ($0.01/$0.02) - 2021/08/21 22:00:49 CET [2021/08/21 16:00:49 ET]
Table 'Halley' 6-max Seat #1 is the button
Seat 1: Scaaalll ($3.13 in chips) 
Seat 2: Gamer577 ($5.48 in chips) 
Seat 3: Dulli007 ($5.45 in chips) 
Seat 4: Denisov V. ($0.66 in chips) 
Seat 5: Osetrov.A.A ($2.39 in chips) 
Seat 6: BriceDo1917 ($2.76 in chips) 
Gamer577: posts small blind $0.01
Dulli007: posts big blind $0.02
*** HOLE CARDS ***
Dealt to Scaaalll [Td 7d]
Denisov V.: calls $0.02
Osetrov.A.A: raises $0.12 to $0.14
BriceDo1917: folds 
BriceDo1917 is disconnected 
Scaaalll: folds 
Gamer577: folds 
Dulli007: folds 
Denisov V.: folds 
Uncalled bet ($0.12) returned to Osetrov.A.A
Osetrov.A.A collected $0.07 from pot
Osetrov.A.A: doesn't show hand 
Denisov V. is disconnected 
*** SUMMARY ***
Total pot $0.07 | Rake $0 
Seat 1: Scaaalll (button) folded before Flop (didn't bet)
Seat 2: Gamer577 (small blind) folded before Flop
Seat 3: Dulli007 (big blind) folded before Flop
Seat 4: Denisov V. folded before Flop
Seat 5: Osetrov.A.A collected ($0.07)
Seat 6: BriceDo1917 folded before Flop (didn't bet)



PokerStars Zoom Hand #229231080073:  Hold'em No Limit ($0.01/$0.02) - 2021/08/21 22:01:08 CET [2021/08/21 16:01:08 ET]
Table 'Halley' 6-max Seat #1 is the button
Seat 1: felipeciji ($2 in chips) 
Seat 2: RrriotGrrrl ($9.73 in chips) 
Seat 3: alecha11 ($2.16 in chips) 
Seat 4: Scaaalll ($3.13 in chips) 
Seat 5: hubertott ($2.52 in chips) 
Seat 6: KoAlRy ($2.06 in chips) 
RrriotGrrrl: posts small blind $0.01
alecha11: posts big blind $0.02
*** HOLE CARDS ***
Dealt to Scaaalll [8c 3c]
Scaaalll: folds 
hubertott: folds 
KoAlRy: folds 
felipeciji: folds 
RrriotGrrrl: folds 
Uncalled bet ($0.01) returned to alecha11
alecha11 collected $0.02 from pot
alecha11: doesn't show hand 
*** SUMMARY ***
Total pot $0.02 | Rake $0 
Seat 1: felipeciji (button) folded before Flop (didn't bet)
Seat 2: RrriotGrrrl (small blind) folded before Flop
Seat 3: alecha11 (big blind) collected ($0.02)
Seat 4: Scaaalll folded before Flop (didn't bet)
Seat 5: hubertott folded before Flop (didn't bet)
Seat 6: KoAlRy folded before Flop (didn't bet)



PokerStars Zoom Hand #229231075014:  Hold'em No Limit ($0.01/$0.02) - 2021/08/21 22:01:03 CET [2021/08/21 16:01:03 ET]
Table 'Halley' 6-max Seat #1 is the button
Seat 1: estelionat171 ($0.97 in chips) 
Seat 2: Agno$tic ($2 in chips) 
Seat 3: zielony ($2.41 in chips) 
Seat 4: SICKDIRTY416 ($4.52 in chips) 
Seat 5: Scaaalll ($3.13 in chips) 
Seat 6: 2hoesonmydick ($1.93 in chips) 
Agno$tic: posts small blind $0.01
zielony: posts big blind $0.02
*** HOLE CARDS ***
Dealt to Scaaalll [9d Ah]
2hoesonmydick is disconnected 
SICKDIRTY416 has timed out
SICKDIRTY416: folds 
Scaaalll: folds 
2hoesonmydick: folds 
SICKDIRTY416 is disconnected 
estelionat171: folds 
Agno$tic: raises $0.04 to $0.06
zielony: folds 
Uncalled bet ($0.04) returned to Agno$tic
Agno$tic collected $0.04 from pot
Agno$tic: doesn't show hand 
*** SUMMARY ***
Total pot $0.04 | Rake $0 
Seat 1: estelionat171 (button) folded before Flop (didn't bet)
Seat 2: Agno$tic (small blind) collected ($0.04)
Seat 3: zielony (big blind) folded before Flop
Seat 4: SICKDIRTY416 folded before Flop (didn't bet)
Seat 5: Scaaalll folded before Flop (didn't bet)
Seat 6: 2hoesonmydick folded before Flop (didn't bet)



PokerStars Zoom Hand #229231083273:  Hold'em No Limit ($0.01/$0.02) - 2021/08/21 22:01:16 CET [2021/08/21 16:01:16 ET]
Table 'Halley' 6-max Seat #1 is the button
Seat 1: ugi-dugi ($2.29 in chips) 
Seat 2: Henry Chinasky ($0.71 in chips) 
Seat 3: Scaaalll ($3.13 in chips) 
Seat 4: Atiszon ($3.90 in chips) 
Seat 5: LegendaryLRS ($6.55 in chips) 
Seat 6: fishh_play ($4.04 in chips) 
Henry Chinasky: posts small blind $0.01
Scaaalll: posts big blind $0.02
*** HOLE CARDS ***
Dealt to Scaaalll [9h Qh]
Atiszon: raises $0.04 to $0.06
LegendaryLRS: folds 
fishh_play: folds 
ugi-dugi: folds 
Henry Chinasky: folds 
Scaaalll: folds 
Uncalled bet ($0.04) returned to Atiszon
Atiszon collected $0.05 from pot
Atiszon: doesn't show hand 
*** SUMMARY ***
Total pot $0.05 | Rake $0 
Seat 1: ugi-dugi (button) folded before Flop (didn't bet)
Seat 2: Henry Chinasky (small blind) folded before Flop
Seat 3: Scaaalll (big blind) folded before Flop
Seat 4: Atiszon collected ($0.05)
Seat 5: LegendaryLRS folded before Flop (didn't bet)
Seat 6: fishh_play folded before Flop (didn't bet)



PokerStars Zoom Hand #229231081703:  Hold'em No Limit ($0.01/$0.02) - 2021/08/21 22:01:12 CET [2021/08/21 16:01:12 ET]
Table 'Halley' 6-max Seat #1 is the button
Seat 1: RoughRafff ($2.25 in chips) 
Seat 2: martuska88 ($3.21 in chips) 
Seat 3: LuckyCheewey ($2.24 in chips) 
Seat 4: Scaaalll ($3.13 in chips) 
Seat 5: feedwizard ($2 in chips) 
Seat 6: ChuckGaylordIII ($2 in chips) 
martuska88: posts small blind $0.01
LuckyCheewey: posts big blind $0.02
*** HOLE CARDS ***
Dealt to Scaaalll [9d Tc]
ChuckGaylordIII is disconnected 
Scaaalll: folds 
feedwizard: folds 
ChuckGaylordIII: folds 
RoughRafff: folds 
martuska88: raises $0.02 to $0.04
LuckyCheewey: calls $0.02
*** FLOP *** [3c Ts 5d]
martuska88: bets $0.03
LuckyCheewey: calls $0.03
*** TURN *** [3c Ts 5d] [9s]
martuska88: checks 
LuckyCheewey: bets $0.07
martuska88: folds 
Uncalled bet ($0.07) returned to LuckyCheewey
LuckyCheewey collected $0.14 from pot
LuckyCheewey: doesn't show hand 
*** SUMMARY ***
Total pot $0.14 | Rake $0 
Board [3c Ts 5d 9s]
Seat 1: RoughRafff (button) folded before Flop (didn't bet)
Seat 2: martuska88 (small blind) folded on the Turn
Seat 3: LuckyCheewey (big blind) collected ($0.14)
Seat 4: Scaaalll folded before Flop (didn't bet)
Seat 5: feedwizard folded before Flop (didn't bet)
Seat 6: ChuckGaylordIII folded before Flop (didn't bet)



PokerStars Zoom Hand #229231089937:  Hold'em No Limit ($0.01/$0.02) - 2021/08/21 22:01:32 CET [2021/08/21 16:01:32 ET]
Table 'Halley' 6-max Seat #1 is the button
Seat 1: ppluiaule ($2.48 in chips) 
Seat 2: Scaaalll ($3.11 in chips) 
Seat 3: HubertFroh ($2 in chips) 
Seat 4: zeus11983 ($2 in chips) 
Seat 5: RrriotGrrrl ($9.72 in chips) 
Seat 6: Oprichnick90 ($3.95 in chips) 
Scaaalll: posts small blind $0.01
HubertFroh: posts big blind $0.02
*** HOLE CARDS ***
Dealt to Scaaalll [7c 7d]
zeus11983: raises $0.03 to $0.05
RrriotGrrrl: folds 
Oprichnick90: folds 
ppluiaule: folds 
Scaaalll: calls $0.04
HubertFroh: folds 
*** FLOP *** [Jc 8c Tc]
Scaaalll: checks 
zeus11983: bets $0.05
Scaaalll: calls $0.05
*** TURN *** [Jc 8c Tc] [As]
Scaaalll: checks 
zeus11983: checks 
*** RIVER *** [Jc 8c Tc As] [8d]
Scaaalll: checks 
zeus11983: checks 
*** SHOW DOWN ***
Scaaalll: shows [7c 7d] (two pair, Eights and Sevens)
zeus11983: shows [Kh Th] (two pair, Tens and Eights)
zeus11983 collected $0.21 from pot
*** SUMMARY ***
Total pot $0.22 | Rake $0.01 
Board [Jc 8c Tc As 8d]
Seat 1: ppluiaule (button) folded before Flop (didn't bet)
Seat 2: Scaaalll (small blind) showed [7c 7d] and lost with two pair, Eights and Sevens
Seat 3: HubertFroh (big blind) folded before Flop
Seat 4: zeus11983 showed [Kh Th] and won ($0.21) with two pair, Tens and Eights
Seat 5: RrriotGrrrl folded before Flop (didn't bet)
Seat 6: Oprichnick90 folded before Flop (didn't bet)



PokerStars Zoom Hand #229231109905:  Hold'em No Limit ($0.01/$0.02) - 2021/08/21 22:02:18 CET [2021/08/21 16:02:18 ET]
Table 'Halley' 6-max Seat #1 is the button
Seat 1: gasmar_29 ($3.48 in chips) 
Seat 2: RonilsonCosta ($2.23 in chips) 
Seat 3: bananAAbandit ($4.48 in chips) 
Seat 4: maliniak75 ($1.04 in chips) 
Seat 5: BIITRU ($6.03 in chips) 
Seat 6: Scaaalll ($3.01 in chips) 
RonilsonCosta: posts small blind $0.01
bananAAbandit: posts big blind $0.02
*** HOLE CARDS ***
Dealt to Scaaalll [5h 4d]
maliniak75: folds 
BIITRU: raises $0.04 to $0.06
Scaaalll: folds 
gasmar_29: folds 
RonilsonCosta: folds 
bananAAbandit: folds 
Uncalled bet ($0.04) returned to BIITRU
BIITRU collected $0.05 from pot
BIITRU: doesn't show hand 
*** SUMMARY ***
Total pot $0.05 | Rake $0 
Seat 1: gasmar_29 (button) folded before Flop (didn't bet)
Seat 2: RonilsonCosta (small blind) folded before Flop
Seat 3: bananAAbandit (big blind) folded before Flop
Seat 4: maliniak75 folded before Flop (didn't bet)
Seat 5: BIITRU collected ($0.05)
Seat 6: Scaaalll folded before Flop (didn't bet)



PokerStars Zoom Hand #229231107331:  Hold'em No Limit ($0.01/$0.02) - 2021/08/21 22:02:12 CET [2021/08/21 16:02:12 ET]
Table 'Halley' 6-max Seat #1 is the button
Seat 1: Scaaalll ($3.01 in chips) 
Seat 2: alecha11 ($2.14 in chips) 
Seat 3: maaitee ($2.03 in chips) 
Seat 4: rpycmbEM ($4.26 in chips) 
Seat 5: Shcherbak252 ($2.49 in chips) 
Seat 6: HellNative ($2.20 in chips) 
alecha11: posts small blind $0.01
maaitee: posts big blind $0.02
*** HOLE CARDS ***
Dealt to Scaaalll [2h Qd]
rpycmbEM: raises $0.04 to $0.06
Shcherbak252: folds 
HellNative: folds 
Scaaalll: folds 
alecha11: folds 
maaitee: calls $0.04
*** FLOP *** [Kc 3h 9c]
maaitee: checks 
rpycmbEM: bets $0.04
maaitee: folds 
Uncalled bet ($0.04) returned to rpycmbEM
rpycmbEM collected $0.13 from pot
rpycmbEM: doesn't show hand 
*** SUMMARY ***
Total pot $0.13 | Rake $0 
Board [Kc 3h 9c]
Seat 1: Scaaalll (button) folded before Flop (didn't bet)
Seat 2: alecha11 (small blind) folded before Flop
Seat 3: maaitee (big blind) folded on the Flop
Seat 4: rpycmbEM collected ($0.13)
Seat 5: Shcherbak252 folded before Flop (didn't bet)
Seat 6: HellNative folded before Flop (didn't bet)



PokerStars Zoom Hand #229231111490:  Hold'em No Limit ($0.01/$0.02) - 2021/08/21 22:02:22 CET [2021/08/21 16:02:22 ET]
Table 'Halley' 6-max Seat #1 is the button
Seat 1: tomsa01 ($1.48 in chips) 
Seat 2: Scaaalll ($3.01 in chips) 
Seat 3: gugamoraes ($2.57 in chips) 
Seat 4: KoAlRy ($2 in chips) 
Seat 5: Pechorin.G ($2 in chips) 
Seat 6: Gerar NB ($2 in chips) 
Scaaalll: posts small blind $0.01
gugamoraes: posts big blind $0.02
*** HOLE CARDS ***
Dealt to Scaaalll [As 3s]
KoAlRy: folds 
Pechorin.G: folds 
tomsa01 is disconnected 
Gerar NB: raises $0.04 to $0.06
tomsa01: folds 
Scaaalll: folds 
gugamoraes: folds 
Uncalled bet ($0.04) returned to Gerar NB
Gerar NB collected $0.05 from pot
Gerar NB: doesn't show hand 
*** SUMMARY ***
Total pot $0.05 | Rake $0 
Seat 1: tomsa01 (button) folded before Flop (didn't bet)
Seat 2: Scaaalll (small blind) folded before Flop
Seat 3: gugamoraes (big blind) folded before Flop
Seat 4: KoAlRy folded before Flop (didn't bet)
Seat 5: Pechorin.G folded before Flop (didn't bet)
Seat 6: Gerar NB collected ($0.05)



PokerStars Zoom Hand #229231116776:  Hold'em No Limit ($0.01/$0.02) - 2021/08/21 22:02:34 CET [2021/08/21 16:02:34 ET]
Table 'Halley' 6-max Seat #1 is the button
Seat 1: caiolima99 ($5.90 in chips) 
Seat 2: Ruopolo1982 ($1.32 in chips) 
Seat 3: weire99 ($2.14 in chips) 
Seat 4: dinoVIEIRA ($2.29 in chips) 
Seat 5: Scaaalll ($3 in chips) 
Seat 6: bananAAbandit ($2.01 in chips) 
Ruopolo1982: posts small blind $0.01
weire99: posts big blind $0.02
*** HOLE CARDS ***
Dealt to Scaaalll [3s 8h]
dinoVIEIRA: folds 
Scaaalll: folds 
bananAAbandit: folds 
caiolima99: raises $0.04 to $0.06
Ruopolo1982: folds 
weire99: calls $0.04
*** FLOP *** [9c 2d Jh]
weire99: checks 
caiolima99: bets $0.04
weire99: folds 
Uncalled bet ($0.04) returned to caiolima99
caiolima99 collected $0.13 from pot
caiolima99: doesn't show hand 
weire99 is disconnected 
*** SUMMARY ***
Total pot $0.13 | Rake $0 
Board [9c 2d Jh]
Seat 1: caiolima99 (button) collected ($0.13)
Seat 2: Ruopolo1982 (small blind) folded before Flop
Seat 3: weire99 (big blind) folded on the Flop
Seat 4: dinoVIEIRA folded before Flop (didn't bet)
Seat 5: Scaaalll folded before Flop (didn't bet)
Seat 6: bananAAbandit folded before Flop (didn't bet)



PokerStars Zoom Hand #229231121031:  Hold'em No Limit ($0.01/$0.02) - 2021/08/21 22:02:44 CET [2021/08/21 16:02:44 ET]
Table 'Halley' 6-max Seat #1 is the button
Seat 1: arrow17 ($2.45 in chips) 
Seat 2: Clavis Noa ($2.50 in chips) 
Seat 3: Scaaalll ($3 in chips) 
Seat 4: Demidov V.S. ($2.71 in chips) 
Seat 5: BIITRU ($4.79 in chips) 
Seat 6: BlackhawKK's ($3.23 in chips) 
Clavis Noa: posts small blind $0.01
Scaaalll: posts big blind $0.02
*** HOLE CARDS ***
Dealt to Scaaalll [9h 6s]
Demidov V.S.: folds 
BIITRU: folds 
BlackhawKK's: folds 
Demidov V.S. is disconnected 
arrow17: raises $0.03 to $0.05
Clavis Noa: folds 
Scaaalll: folds 
Uncalled bet ($0.03) returned to arrow17
arrow17 collected $0.05 from pot
arrow17: doesn't show hand 
*** SUMMARY ***
Total pot $0.05 | Rake $0 
Seat 1: arrow17 (button) collected ($0.05)
Seat 2: Clavis Noa (small blind) folded before Flop
Seat 3: Scaaalll (big blind) folded before Flop
Seat 4: Demidov V.S. folded before Flop (didn't bet)
Seat 5: BIITRU folded before Flop (didn't bet)
Seat 6: BlackhawKK's folded before Flop (didn't bet)



PokerStars Zoom Hand #229231119367:  Hold'em No Limit ($0.01/$0.02) - 2021/08/21 22:02:40 CET [2021/08/21 16:02:40 ET]
Table 'Halley' 6-max Seat #1 is the button
Seat 1: BlackhawKK's ($3.23 in chips) 
Seat 2: nodtress ($2.58 in chips) 
Seat 3: bananAAbandit ($6.80 in chips) 
Seat 4: Scaaalll ($3 in chips) 
Seat 5: djewlz ($3.35 in chips) 
Seat 6: LSDenny ($1.46 in chips) 
nodtress: posts small blind $0.01
bananAAbandit: posts big blind $0.02
*** HOLE CARDS ***
Dealt to Scaaalll [Th 9s]
LSDenny is disconnected 
Scaaalll: folds 
djewlz: raises $0.04 to $0.06
LSDenny: folds 
BlackhawKK's: folds 
nodtress: folds 
bananAAbandit: calls $0.04
*** FLOP *** [2d Qs Ah]
bananAAbandit: checks 
djewlz: bets $0.04
bananAAbandit: calls $0.04
*** TURN *** [2d Qs Ah] [5d]
bananAAbandit: checks 
djewlz: checks 
*** RIVER *** [2d Qs Ah 5d] [3d]
bananAAbandit: bets $0.10
djewlz: folds 
Uncalled bet ($0.10) returned to bananAAbandit
bananAAbandit collected $0.20 from pot
bananAAbandit: doesn't show hand 
*** SUMMARY ***
Total pot $0.21 | Rake $0.01 
Board [2d Qs Ah 5d 3d]
Seat 1: BlackhawKK's (button) folded before Flop (didn't bet)
Seat 2: nodtress (small blind) folded before Flop
Seat 3: bananAAbandit (big blind) collected ($0.20)
Seat 4: Scaaalll folded before Flop (didn't bet)
Seat 5: djewlz folded on the River
Seat 6: LSDenny folded before Flop (didn't bet)



PokerStars Zoom Hand #229231134420:  Hold'em No Limit ($0.01/$0.02) - 2021/08/21 22:03:15 CET [2021/08/21 16:03:15 ET]
Table 'Halley' 6-max Seat #1 is the button
Seat 1: rodrigocvx ($1.03 in chips) 
Seat 2: LucasG155 ($2.54 in chips) 
Seat 3: KoAlRy ($2.06 in chips) 
Seat 4: hubertott ($2.33 in chips) 
Seat 5: kiril688 ($0.72 in chips) 
Seat 6: Scaaalll ($2.98 in chips) 
LucasG155: posts small blind $0.01
KoAlRy: posts big blind $0.02
*** HOLE CARDS ***
Dealt to Scaaalll [Ah 7s]
hubertott: folds 
kiril688 has timed out
kiril688: folds 
kiril688 is disconnected 
Scaaalll: folds 
rodrigocvx: folds 
LucasG155: folds 
Uncalled bet ($0.01) returned to KoAlRy
KoAlRy collected $0.02 from pot
KoAlRy: doesn't show hand 
*** SUMMARY ***
Total pot $0.02 | Rake $0 
Seat 1: rodrigocvx (button) folded before Flop (didn't bet)
Seat 2: LucasG155 (small blind) folded before Flop
Seat 3: KoAlRy (big blind) collected ($0.02)
Seat 4: hubertott folded before Flop (didn't bet)
Seat 5: kiril688 folded before Flop (didn't bet)
Seat 6: Scaaalll folded before Flop (didn't bet)



PokerStars Zoom Hand #229231130910:  Hold'em No Limit ($0.01/$0.02) - 2021/08/21 22:03:07 CET [2021/08/21 16:03:07 ET]
Table 'Halley' 6-max Seat #1 is the button
Seat 1: Scaaalll ($2.98 in chips) 
Seat 2: NOLUWDtC ($2 in chips) 
Seat 3: Ebbelwoiexp ($2 in chips) 
Seat 4: nV6TR ($1.29 in chips) 
Seat 5: 365p2eva ($3.96 in chips) 
Seat 6: golfffffer ($1.02 in chips) 
NOLUWDtC: posts small blind $0.01
Ebbelwoiexp: posts big blind $0.02
*** HOLE CARDS ***
Dealt to Scaaalll [8c 6h]
NOLUWDtC is disconnected 
nV6TR: raises $0.02 to $0.04
365p2eva: folds 
golfffffer has timed out
golfffffer: folds 
Scaaalll: folds 
NOLUWDtC: folds 
Ebbelwoiexp: calls $0.02
*** FLOP *** [4c Th 3h]
golfffffer is disconnected 
Ebbelwoiexp: checks 
nV6TR: bets $0.09
Ebbelwoiexp: folds 
Uncalled bet ($0.09) returned to nV6TR
nV6TR collected $0.09 from pot
nV6TR: doesn't show hand 
Ebbelwoiexp is disconnected 
*** SUMMARY ***
Total pot $0.09 | Rake $0 
Board [4c Th 3h]
Seat 1: Scaaalll (button) folded before Flop (didn't bet)
Seat 2: NOLUWDtC (small blind) folded before Flop
Seat 3: Ebbelwoiexp (big blind) folded on the Flop
Seat 4: nV6TR collected ($0.09)
Seat 5: 365p2eva folded before Flop (didn't bet)
Seat 6: golfffffer folded before Flop (didn't bet)



PokerStars Zoom Hand #229231144394:  Hold'em No Limit ($0.01/$0.02) - 2021/08/21 22:03:37 CET [2021/08/21 16:03:37 ET]
Table 'Halley' 6-max Seat #1 is the button
Seat 1: yuzu0921 ($1.25 in chips) 
Seat 2: ppluiaule ($3.99 in chips) 
Seat 3: RrriotGrrrl ($4.03 in chips) 
Seat 4: Han_Solo_71 ($1.30 in chips) 
Seat 5: Scaaalll ($2.98 in chips) 
Seat 6: zergmiky ($2 in chips) 
ppluiaule: posts small blind $0.01
RrriotGrrrl: posts big blind $0.02
*** HOLE CARDS ***
Dealt to Scaaalll [Tc 7h]
Han_Solo_71: folds 
Han_Solo_71 is disconnected 
Scaaalll: folds 
zergmiky: folds 
yuzu0921: folds 
ppluiaule: folds 
Uncalled bet ($0.01) returned to RrriotGrrrl
RrriotGrrrl collected $0.02 from pot
RrriotGrrrl: doesn't show hand 
*** SUMMARY ***
Total pot $0.02 | Rake $0 
Seat 1: yuzu0921 (button) folded before Flop (didn't bet)
Seat 2: ppluiaule (small blind) folded before Flop
Seat 3: RrriotGrrrl (big blind) collected ($0.02)
Seat 4: Han_Solo_71 folded before Flop (didn't bet)
Seat 5: Scaaalll folded before Flop (didn't bet)
Seat 6: zergmiky folded before Flop (didn't bet)



PokerStars Zoom Hand #229231147477:  Hold'em No Limit ($0.01/$0.02) - 2021/08/21 22:03:44 CET [2021/08/21 16:03:44 ET]
Table 'Halley' 6-max Seat #1 is the button
Seat 1: zinho_83 ($0.62 in chips) 
Seat 2: Scaaalll ($2.98 in chips) 
Seat 3: dcd113 ($2.65 in chips) 
Seat 4: DaporteWins ($2 in chips) 
Seat 5: meps88 ($4.09 in chips) 
Seat 6: AtZ3899 ($1.27 in chips) 
Scaaalll: posts small blind $0.01
dcd113: posts big blind $0.02
*** HOLE CARDS ***
Dealt to Scaaalll [3s 8s]
DaporteWins: folds 
meps88: folds 
AtZ3899: folds 
zinho_83: folds 
Scaaalll: folds 
Uncalled bet ($0.01) returned to dcd113
zinho_83 is disconnected 
dcd113 collected $0.02 from pot
dcd113: doesn't show hand 
*** SUMMARY ***
Total pot $0.02 | Rake $0 
Seat 1: zinho_83 (button) folded before Flop (didn't bet)
Seat 2: Scaaalll (small blind) folded before Flop
Seat 3: dcd113 (big blind) collected ($0.02)
Seat 4: DaporteWins folded before Flop (didn't bet)
Seat 5: meps88 folded before Flop (didn't bet)
Seat 6: AtZ3899 folded before Flop (didn't bet)



PokerStars Zoom Hand #229231159483:  Hold'em No Limit ($0.01/$0.02) - 2021/08/21 22:04:11 CET [2021/08/21 16:04:11 ET]
Table 'Halley' 6-max Seat #1 is the button
Seat 1: zbixxx ($4.92 in chips) 
Seat 2: HubertFroh ($2.01 in chips) 
Seat 3: Scaaalll ($2.97 in chips) 
Seat 4: Plmax94 ($0.38 in chips) 
Seat 5: skatocharlie ($2.25 in chips) 
Seat 6: chinex_sba ($2.11 in chips) 
HubertFroh: posts small blind $0.01
Scaaalll: posts big blind $0.02
*** HOLE CARDS ***
Dealt to Scaaalll [Js Jh]
Plmax94: folds 
skatocharlie: folds 
chinex_sba: folds 
zbixxx: folds 
HubertFroh: folds 
Uncalled bet ($0.01) returned to Scaaalll
Scaaalll collected $0.02 from pot
Scaaalll: doesn't show hand 
*** SUMMARY ***
Total pot $0.02 | Rake $0 
Seat 1: zbixxx (button) folded before Flop (didn't bet)
Seat 2: HubertFroh (small blind) folded before Flop
Seat 3: Scaaalll (big blind) collected ($0.02)
Seat 4: Plmax94 folded before Flop (didn't bet)
Seat 5: skatocharlie folded before Flop (didn't bet)
Seat 6: chinex_sba folded before Flop (didn't bet)



PokerStars Zoom Hand #229231157221:  Hold'em No Limit ($0.01/$0.02) - 2021/08/21 22:04:06 CET [2021/08/21 16:04:06 ET]
Table 'Halley' 6-max Seat #1 is the button
Seat 1: THE-RS7 ($1.51 in chips) 
Seat 2: Luben_76 ($2.63 in chips) 
Seat 3: pavlo8855 ($2 in chips) 
Seat 4: Scaaalll ($2.97 in chips) 
Seat 5: PapiMik3 ($2.21 in chips) 
Seat 6: lucksuckdonk ($3.81 in chips) 
Luben_76: posts small blind $0.01
pavlo8855: posts big blind $0.02
*** HOLE CARDS ***
Dealt to Scaaalll [Qd 2c]
THE-RS7 is disconnected 
Scaaalll: folds 
PapiMik3: folds 
lucksuckdonk: folds 
THE-RS7: folds 
Luben_76: raises $0.04 to $0.06
pavlo8855: calls $0.04
*** FLOP *** [Td 7d 3c]
Luben_76: checks 
pavlo8855: checks 
*** TURN *** [Td 7d 3c] [Tc]
Luben_76: checks 
pavlo8855: checks 
*** RIVER *** [Td 7d 3c Tc] [Th]
Luben_76: checks 
pavlo8855: bets $0.06
Luben_76: calls $0.06
*** SHOW DOWN ***
pavlo8855: shows [4c 4h] (a full house, Tens full of Fours)
Luben_76: mucks hand 
pavlo8855 collected $0.23 from pot
*** SUMMARY ***
Total pot $0.24 | Rake $0.01 
Board [Td 7d 3c Tc Th]
Seat 1: THE-RS7 (button) folded before Flop (didn't bet)
Seat 2: Luben_76 (small blind) mucked [Ks Ah]
Seat 3: pavlo8855 (big blind) showed [4c 4h] and won ($0.23) with a full house, Tens full of Fours
Seat 4: Scaaalll folded before Flop (didn't bet)
Seat 5: PapiMik3 folded before Flop (didn't bet)
Seat 6: lucksuckdonk folded before Flop (didn't bet)



PokerStars Zoom Hand #229231163105:  Hold'em No Limit ($0.01/$0.02) - 2021/08/21 22:04:19 CET [2021/08/21 16:04:19 ET]
Table 'Halley' 6-max Seat #1 is the button
Seat 1: Scaaalll ($2.98 in chips) 
Seat 2: zbixxx ($5.98 in chips) 
Seat 3: F_oksi(BLR) ($2 in chips) 
Seat 4: Wegezin ($2.87 in chips) 
Seat 5: ramalhorod ($2.16 in chips) 
Seat 6: HellNative ($2.95 in chips) 
zbixxx: posts small blind $0.01
F_oksi(BLR): posts big blind $0.02
*** HOLE CARDS ***
Dealt to Scaaalll [3d Kh]
Wegezin: folds 
ramalhorod: calls $0.02
HellNative: folds 
Scaaalll: folds 
zbixxx: folds 
F_oksi(BLR): checks 
*** FLOP *** [4h Kd Qc]
F_oksi(BLR): checks 
ramalhorod: bets $0.22
F_oksi(BLR): folds 
Uncalled bet ($0.22) returned to ramalhorod
ramalhorod collected $0.05 from pot
ramalhorod: doesn't show hand 
*** SUMMARY ***
Total pot $0.05 | Rake $0 
Board [4h Kd Qc]
Seat 1: Scaaalll (button) folded before Flop (didn't bet)
Seat 2: zbixxx (small blind) folded before Flop
Seat 3: F_oksi(BLR) (big blind) folded on the Flop
Seat 4: Wegezin folded before Flop (didn't bet)
Seat 5: ramalhorod collected ($0.05)
Seat 6: HellNative folded before Flop (didn't bet)



PokerStars Zoom Hand #229231149681:  Hold'em No Limit ($0.01/$0.02) - 2021/08/21 22:03:49 CET [2021/08/21 16:03:49 ET]
Table 'Halley' 6-max Seat #1 is the button
Seat 1: zeus11983 ($2.01 in chips) 
Seat 2: Mikeloko182 ($2 in chips) 
Seat 3: Allexii ($2.08 in chips) 
Seat 4: Iluvatar922 ($9.27 in chips) 
Seat 5: HellNative ($2.96 in chips) 
Seat 6: Scaaalll ($2.97 in chips) 
Mikeloko182: posts small blind $0.01
Allexii: posts big blind $0.02
*** HOLE CARDS ***
Dealt to Scaaalll [7s 2s]
Iluvatar922: raises $0.03 to $0.05
HellNative: folds 
Scaaalll: folds 
zeus11983: folds 
Mikeloko182: folds 
Allexii: calls $0.03
*** FLOP *** [Qh Ah Ac]
Allexii: checks 
Iluvatar922: bets $0.06
Allexii: calls $0.06
*** TURN *** [Qh Ah Ac] [4h]
Allexii: checks 
Iluvatar922: checks 
*** RIVER *** [Qh Ah Ac 4h] [9s]
Allexii: bets $0.11
Iluvatar922: calls $0.11
*** SHOW DOWN ***
Allexii: shows [9d Qd] (two pair, Aces and Queens)
Iluvatar922: mucks hand 
Allexii collected $0.43 from pot
*** SUMMARY ***
Total pot $0.45 | Rake $0.02 
Board [Qh Ah Ac 4h 9s]
Seat 1: zeus11983 (button) folded before Flop (didn't bet)
Seat 2: Mikeloko182 (small blind) folded before Flop
Seat 3: Allexii (big blind) showed [9d Qd] and won ($0.43) with two pair, Aces and Queens
Seat 4: Iluvatar922 mucked [7h 7c]
Seat 5: HellNative folded before Flop (didn't bet)
Seat 6: Scaaalll folded before Flop (didn't bet)



PokerStars Zoom Hand #229231165761:  Hold'em No Limit ($0.01/$0.02) - 2021/08/21 22:04:25 CET [2021/08/21 16:04:25 ET]
Table 'Halley' 6-max Seat #1 is the button
Seat 1: KoAlRy ($2.13 in chips) 
Seat 2: Scaaalll ($2.98 in chips) 
Seat 3: satti1337 ($3.80 in chips) 
Seat 4: caiolima99 ($5.72 in chips) 
Seat 5: estelionat171 ($0.91 in chips) 
Seat 6: Haken68 ($2.84 in chips) 
Scaaalll: posts small blind $0.01
satti1337: posts big blind $0.02
*** HOLE CARDS ***
Dealt to Scaaalll [3h Qc]
caiolima99: raises $0.04 to $0.06
estelionat171: folds 
Haken68: raises $0.20 to $0.26
KoAlRy: folds 
Scaaalll: folds 
satti1337: folds 
caiolima99: calls $0.20
*** FLOP *** [9h 3d 9d]
caiolima99: checks 
Haken68: bets $0.53
caiolima99: folds 
Uncalled bet ($0.53) returned to Haken68
Haken68 collected $0.53 from pot
Haken68: doesn't show hand 
*** SUMMARY ***
Total pot $0.55 | Rake $0.02 
Board [9h 3d 9d]
Seat 1: KoAlRy (button) folded before Flop (didn't bet)
Seat 2: Scaaalll (small blind) folded before Flop
Seat 3: satti1337 (big blind) folded before Flop
Seat 4: caiolima99 folded on the Flop
Seat 5: estelionat171 folded before Flop (didn't bet)
Seat 6: Haken68 collected ($0.53)



PokerStars Zoom Hand #229231167566:  Hold'em No Limit ($0.01/$0.02) - 2021/08/21 22:04:29 CET [2021/08/21 16:04:29 ET]
Table 'Halley' 6-max Seat #1 is the button
Seat 1: boa juice ($1.85 in chips) 
Seat 2: Gerar NB ($3.43 in chips) 
Seat 3: EevAA190 ($2.02 in chips) 
Seat 4: thekidisnuts ($3.96 in chips) 
Seat 5: Scaaalll ($2.97 in chips) 
Seat 6: Chapaev136 ($2.82 in chips) 
Gerar NB: posts small blind $0.01
EevAA190: posts big blind $0.02
*** HOLE CARDS ***
Dealt to Scaaalll [Ah Ts]
thekidisnuts: folds 
Scaaalll: raises $0.04 to $0.06
Chapaev136: folds 
boa juice: calls $0.06
Gerar NB: folds 
EevAA190: folds 
*** FLOP *** [8s 6d Qc]
Scaaalll: bets $0.08
boa juice: folds 
Uncalled bet ($0.08) returned to Scaaalll
Scaaalll collected $0.14 from pot
Scaaalll: doesn't show hand 
boa juice is disconnected 
*** SUMMARY ***
Total pot $0.15 | Rake $0.01 
Board [8s 6d Qc]
Seat 1: boa juice (button) folded on the Flop
Seat 2: Gerar NB (small blind) folded before Flop
Seat 3: EevAA190 (big blind) folded before Flop
Seat 4: thekidisnuts folded before Flop (didn't bet)
Seat 5: Scaaalll collected ($0.14)
Seat 6: Chapaev136 folded before Flop (didn't bet)



PokerStars Zoom Hand #229231183911:  Hold'em No Limit ($0.01/$0.02) - 2021/08/21 22:05:06 CET [2021/08/21 16:05:06 ET]
Table 'Halley' 6-max Seat #1 is the button
Seat 1: SICKDIRTY416 ($4.24 in chips) 
Seat 2: G1olight ($5.58 in chips) 
Seat 3: Scaaalll ($3.05 in chips) 
Seat 4: BriceDo1917 ($2.06 in chips) 
Seat 5: zielony ($2.23 in chips) 
Seat 6: AlexGTPS ($3.61 in chips) 
G1olight: posts small blind $0.01
Scaaalll: posts big blind $0.02
*** HOLE CARDS ***
Dealt to Scaaalll [4c Qh]
BriceDo1917: folds 
BriceDo1917 is disconnected 
SICKDIRTY416 is disconnected 
zielony: folds 
AlexGTPS: folds 
SICKDIRTY416: folds 
G1olight: raises $0.04 to $0.06
Scaaalll: folds 
Uncalled bet ($0.04) returned to G1olight
G1olight collected $0.04 from pot
G1olight: doesn't show hand 
*** SUMMARY ***
Total pot $0.04 | Rake $0 
Seat 1: SICKDIRTY416 (button) folded before Flop (didn't bet)
Seat 2: G1olight (small blind) collected ($0.04)
Seat 3: Scaaalll (big blind) folded before Flop
Seat 4: BriceDo1917 folded before Flop (didn't bet)
Seat 5: zielony folded before Flop (didn't bet)
Seat 6: AlexGTPS folded before Flop (didn't bet)



PokerStars Zoom Hand #229231190076:  Hold'em No Limit ($0.01/$0.02) - 2021/08/21 22:05:20 CET [2021/08/21 16:05:20 ET]
Table 'Halley' 6-max Seat #1 is the button
Seat 1: Scaaalll ($3.03 in chips) 
Seat 2: PapiMik3 ($3.08 in chips) 
Seat 3: arrow17 ($2.45 in chips) 
Seat 4: japoneis mt ($2.40 in chips) 
Seat 5: CowboyNicky ($2 in chips) 
Seat 6: Draat505 ($3.44 in chips) 
PapiMik3: posts small blind $0.01
arrow17: posts big blind $0.02
*** HOLE CARDS ***
Dealt to Scaaalll [4h 7h]
CowboyNicky is disconnected 
japoneis mt: raises $0.02 to $0.04
CowboyNicky: folds 
Draat505: calls $0.04
Scaaalll: folds 
PapiMik3: folds 
arrow17: folds 
*** FLOP *** [Ac 7c 9s]
japoneis mt: bets $0.11
Draat505: folds 
Uncalled bet ($0.11) returned to japoneis mt
japoneis mt collected $0.11 from pot
japoneis mt: doesn't show hand 
*** SUMMARY ***
Total pot $0.11 | Rake $0 
Board [Ac 7c 9s]
Seat 1: Scaaalll (button) folded before Flop (didn't bet)
Seat 2: PapiMik3 (small blind) folded before Flop
Seat 3: arrow17 (big blind) folded before Flop
Seat 4: japoneis mt collected ($0.11)
Seat 5: CowboyNicky folded before Flop (didn't bet)
Seat 6: Draat505 folded on the Flop



PokerStars Zoom Hand #229231182092:  Hold'em No Limit ($0.01/$0.02) - 2021/08/21 22:05:02 CET [2021/08/21 16:05:02 ET]
Table 'Halley' 6-max Seat #1 is the button
Seat 1: Dron4uk UA ($3.44 in chips) 
Seat 2: texashenry2 ($1.16 in chips) 
Seat 3: feybys ($1.97 in chips) 
Seat 4: Scaaalll ($3.05 in chips) 
Seat 5: CordiPS ($4.16 in chips) 
Seat 6: skatocharlie ($5.02 in chips) 
texashenry2: posts small blind $0.01
feybys: posts big blind $0.02
*** HOLE CARDS ***
Dealt to Scaaalll [7c Kd]
Scaaalll: folds 
CordiPS: folds 
skatocharlie: raises $0.04 to $0.06
Dron4uk UA: calls $0.06
texashenry2: calls $0.05
feybys: raises $0.32 to $0.38
skatocharlie: calls $0.32
Dron4uk UA: calls $0.32
texashenry2: calls $0.32
*** FLOP *** [3c Ks 2d]
texashenry2: checks 
feybys: bets $1.59 and is all-in
skatocharlie: calls $1.59
Dron4uk UA: folds 
texashenry2: folds 
*** TURN *** [3c Ks 2d] [3s]
*** RIVER *** [3c Ks 2d 3s] [Qc]
*** SHOW DOWN ***
feybys: shows [Kc Ah] (two pair, Kings and Threes)
skatocharlie: shows [Kh As] (two pair, Kings and Threes)
feybys collected $2.27 from pot
skatocharlie collected $2.27 from pot
*** SUMMARY ***
Total pot $4.70 | Rake $0.16 
Board [3c Ks 2d 3s Qc]
Seat 1: Dron4uk UA (button) folded on the Flop
Seat 2: texashenry2 (small blind) folded on the Flop
Seat 3: feybys (big blind) showed [Kc Ah] and won ($2.27) with two pair, Kings and Threes
Seat 4: Scaaalll folded before Flop (didn't bet)
Seat 5: CordiPS folded before Flop (didn't bet)
Seat 6: skatocharlie showed [Kh As] and won ($2.27) with two pair, Kings and Threes



PokerStars Zoom Hand #229231194060:  Hold'em No Limit ($0.01/$0.02) - 2021/08/21 22:05:29 CET [2021/08/21 16:05:29 ET]
Table 'Halley' 6-max Seat #1 is the button
Seat 1: guntren.ps ($2 in chips) 
Seat 2: Kojak34 ($5.94 in chips) 
Seat 3: Iwanb4 ($3.12 in chips) 
Seat 4: Bufre ($4.34 in chips) 
Seat 5: zielony ($2.22 in chips) 
Seat 6: Scaaalll ($3.03 in chips) 
Kojak34: posts small blind $0.01
Iwanb4: posts big blind $0.02
*** HOLE CARDS ***
Dealt to Scaaalll [3s 2c]
Bufre has timed out
Bufre: folds 
zielony: folds 
Scaaalll: folds 
guntren.ps: raises $0.03 to $0.05
Kojak34: folds 
Iwanb4: raises $0.07 to $0.12
guntren.ps: folds 
Uncalled bet ($0.07) returned to Iwanb4
Iwanb4 collected $0.11 from pot
Iwanb4: doesn't show hand 
*** SUMMARY ***
Total pot $0.11 | Rake $0 
Seat 1: guntren.ps (button) folded before Flop
Seat 2: Kojak34 (small blind) folded before Flop
Seat 3: Iwanb4 (big blind) collected ($0.11)
Seat 4: Bufre folded before Flop (didn't bet)
Seat 5: zielony folded before Flop (didn't bet)
Seat 6: Scaaalll folded before Flop (didn't bet)



PokerStars Zoom Hand #229231204268:  Hold'em No Limit ($0.01/$0.02) - 2021/08/21 22:05:52 CET [2021/08/21 16:05:52 ET]
Table 'Halley' 6-max Seat #1 is the button
Seat 1: Kreodont1987 ($4.59 in chips) 
Seat 2: Diegor1924 ($1.94 in chips) 
Seat 3: meps88 ($4.17 in chips) 
Seat 4: Clavis Noa ($3.56 in chips) 
Seat 5: SaRCh_Ale ($2.20 in chips) 
Seat 6: Scaaalll ($3.02 in chips) 
Diegor1924: posts small blind $0.01
meps88: posts big blind $0.02
*** HOLE CARDS ***
Dealt to Scaaalll [6c 5s]
Clavis Noa: folds 
SaRCh_Ale: folds 
Scaaalll: folds 
Kreodont1987: folds 
Diegor1924: raises $0.02 to $0.04
meps88: calls $0.02
*** FLOP *** [Qc 4s 5h]
Diegor1924: bets $0.02
meps88: raises $0.04 to $0.06
Diegor1924: folds 
Uncalled bet ($0.04) returned to meps88
meps88 collected $0.12 from pot
meps88: doesn't show hand 
*** SUMMARY ***
Total pot $0.12 | Rake $0 
Board [Qc 4s 5h]
Seat 1: Kreodont1987 (button) folded before Flop (didn't bet)
Seat 2: Diegor1924 (small blind) folded on the Flop
Seat 3: meps88 (big blind) collected ($0.12)
Seat 4: Clavis Noa folded before Flop (didn't bet)
Seat 5: SaRCh_Ale folded before Flop (didn't bet)
Seat 6: Scaaalll folded before Flop (didn't bet)



PokerStars Zoom Hand #229231206468:  Hold'em No Limit ($0.01/$0.02) - 2021/08/21 22:05:57 CET [2021/08/21 16:05:57 ET]
Table 'Halley' 6-max Seat #1 is the button
Seat 1: pavlo8855 ($2.10 in chips) 
Seat 2: Reipinguimm ($2.06 in chips) 
Seat 3: fishh_play ($4.41 in chips) 
Seat 4: Pechorin.G ($2.55 in chips) 
Seat 5: Scaaalll ($3.02 in chips) 
Seat 6: bananAAbandit ($4 in chips) 
Reipinguimm: posts small blind $0.01
fishh_play: posts big blind $0.02
*** HOLE CARDS ***
Dealt to Scaaalll [Qd 6s]
Pechorin.G: folds 
Scaaalll: folds 
bananAAbandit: folds 
pavlo8855: folds 
Reipinguimm: raises $0.04 to $0.06
fishh_play: calls $0.04
*** FLOP *** [7s Ks 8s]
Reipinguimm: bets $0.06
fishh_play: folds 
Uncalled bet ($0.06) returned to Reipinguimm
Reipinguimm collected $0.12 from pot
Reipinguimm: doesn't show hand 
*** SUMMARY ***
Total pot $0.12 | Rake $0 
Board [7s Ks 8s]
Seat 1: pavlo8855 (button) folded before Flop (didn't bet)
Seat 2: Reipinguimm (small blind) collected ($0.12)
Seat 3: fishh_play (big blind) folded on the Flop
Seat 4: Pechorin.G folded before Flop (didn't bet)
Seat 5: Scaaalll folded before Flop (didn't bet)
Seat 6: bananAAbandit folded before Flop (didn't bet)



PokerStars Zoom Hand #229231210931:  Hold'em No Limit ($0.01/$0.02) - 2021/08/21 22:06:07 CET [2021/08/21 16:06:07 ET]
Table 'Halley' 6-max Seat #1 is the button
Seat 1: Begon505 ($0.97 in chips) 
Seat 2: blillad ($1.96 in chips) 
Seat 3: Scaaalll ($3.02 in chips) 
Seat 4: zielony ($3.02 in chips) 
Seat 5: ugi-dugi ($2.10 in chips) 
Seat 6: chinex_sba ($2 in chips) 
blillad: posts small blind $0.01
Scaaalll: posts big blind $0.02
*** HOLE CARDS ***
Dealt to Scaaalll [4h 6c]
zielony: folds 
ugi-dugi: folds 
chinex_sba: folds 
Begon505: raises $0.03 to $0.05
blillad: folds 
Scaaalll: folds 
Uncalled bet ($0.03) returned to Begon505
Begon505 collected $0.05 from pot
Begon505: doesn't show hand 
*** SUMMARY ***
Total pot $0.05 | Rake $0 
Seat 1: Begon505 (button) collected ($0.05)
Seat 2: blillad (small blind) folded before Flop
Seat 3: Scaaalll (big blind) folded before Flop
Seat 4: zielony folded before Flop (didn't bet)
Seat 5: ugi-dugi folded before Flop (didn't bet)
Seat 6: chinex_sba folded before Flop (didn't bet)



PokerStars Zoom Hand #229231208732:  Hold'em No Limit ($0.01/$0.02) - 2021/08/21 22:06:02 CET [2021/08/21 16:06:02 ET]
Table 'Halley' 6-max Seat #1 is the button
Seat 1: Ne0net ($2.71 in chips) 
Seat 2: meps88 ($3.91 in chips) 
Seat 3: H0mmer99 ($2.74 in chips) 
Seat 4: Scaaalll ($3.02 in chips) 
Seat 5: SICKDIRTY416 ($4.62 in chips) 
Seat 6: Blaackie ($0.94 in chips) 
meps88: posts small blind $0.01
H0mmer99: posts big blind $0.02
*** HOLE CARDS ***
Dealt to Scaaalll [8d Js]
SICKDIRTY416 is disconnected 
Scaaalll: folds 
SICKDIRTY416: folds 
Blaackie: folds 
Ne0net: folds 
meps88: raises $0.03 to $0.05
H0mmer99: calls $0.03
*** FLOP *** [7h Th 7d]
meps88: checks 
H0mmer99: bets $0.05
meps88: calls $0.05
*** TURN *** [7h Th 7d] [7s]
meps88: checks 
H0mmer99: bets $0.10
meps88: calls $0.10
*** RIVER *** [7h Th 7d 7s] [5s]
meps88: checks 
H0mmer99: checks 
*** SHOW DOWN ***
meps88: shows [Ah Ad] (a full house, Sevens full of Aces)
H0mmer99: mucks hand 
meps88 collected $0.39 from pot
*** SUMMARY ***
Total pot $0.40 | Rake $0.01 
Board [7h Th 7d 7s 5s]
Seat 1: Ne0net (button) folded before Flop (didn't bet)
Seat 2: meps88 (small blind) showed [Ah Ad] and won ($0.39) with a full house, Sevens full of Aces
Seat 3: H0mmer99 (big blind) mucked [9h Qs]
Seat 4: Scaaalll folded before Flop (didn't bet)
Seat 5: SICKDIRTY416 folded before Flop (didn't bet)
Seat 6: Blaackie folded before Flop (didn't bet)



PokerStars Zoom Hand #229231216781:  Hold'em No Limit ($0.01/$0.02) - 2021/08/21 22:06:20 CET [2021/08/21 16:06:20 ET]
Table 'Halley' 6-max Seat #1 is the button
Seat 1: Scaaalll ($3 in chips) 
Seat 2: zbixxx ($4.99 in chips) 
Seat 3: snowy_96 ($2.07 in chips) 
Seat 4: Kb013497 ($6.71 in chips) 
Seat 5: RrriotGrrrl ($4.22 in chips) 
Seat 6: olliejaydee ($3.98 in chips) 
zbixxx: posts small blind $0.01
snowy_96: posts big blind $0.02
*** HOLE CARDS ***
Dealt to Scaaalll [5h 5d]
Kb013497: folds 
RrriotGrrrl: folds 
olliejaydee: folds 
Scaaalll: raises $0.02 to $0.04
zbixxx: folds 
snowy_96: calls $0.02
*** FLOP *** [4h 6d 6c]
snowy_96: checks 
Scaaalll: bets $0.06
snowy_96: folds 
Uncalled bet ($0.06) returned to Scaaalll
Scaaalll collected $0.09 from pot
Scaaalll: doesn't show hand 
*** SUMMARY ***
Total pot $0.09 | Rake $0 
Board [4h 6d 6c]
Seat 1: Scaaalll (button) collected ($0.09)
Seat 2: zbixxx (small blind) folded before Flop
Seat 3: snowy_96 (big blind) folded on the Flop
Seat 4: Kb013497 folded before Flop (didn't bet)
Seat 5: RrriotGrrrl folded before Flop (didn't bet)
Seat 6: olliejaydee folded before Flop (didn't bet)



PokerStars Zoom Hand #229231202049:  Hold'em No Limit ($0.01/$0.02) - 2021/08/21 22:05:47 CET [2021/08/21 16:05:47 ET]
Table 'Halley' 6-max Seat #1 is the button
Seat 1: Saint_ANBU ($4.57 in chips) 
Seat 2: Scaaalll ($3.03 in chips) 
Seat 3: NecromiconP ($3.70 in chips) 
Seat 4: Flankeris ($11.33 in chips) 
Seat 5: carlomagno ($2.07 in chips) 
Seat 6: martuska88 ($2.43 in chips) 
Scaaalll: posts small blind $0.01
NecromiconP: posts big blind $0.02
*** HOLE CARDS ***
Dealt to Scaaalll [Td 8h]
Flankeris: folds 
carlomagno: raises $0.02 to $0.04
martuska88: folds 
Saint_ANBU: folds 
Scaaalll: folds 
NecromiconP: calls $0.02
*** FLOP *** [Kd 9s 5c]
NecromiconP: checks 
carlomagno: bets $0.03
NecromiconP: calls $0.03
*** TURN *** [Kd 9s 5c] [4h]
NecromiconP: checks 
carlomagno: bets $0.07
NecromiconP: calls $0.07
*** RIVER *** [Kd 9s 5c 4h] [4c]
NecromiconP: checks 
carlomagno: bets $0.13
NecromiconP: calls $0.13
*** SHOW DOWN ***
carlomagno: shows [Qd Jc] (a pair of Fours)
NecromiconP: shows [Kh 7h] (two pair, Kings and Fours)
NecromiconP collected $0.53 from pot
*** SUMMARY ***
Total pot $0.55 | Rake $0.02 
Board [Kd 9s 5c 4h 4c]
Seat 1: Saint_ANBU (button) folded before Flop (didn't bet)
Seat 2: Scaaalll (small blind) folded before Flop
Seat 3: NecromiconP (big blind) showed [Kh 7h] and won ($0.53) with two pair, Kings and Fours
Seat 4: Flankeris folded before Flop (didn't bet)
Seat 5: carlomagno showed [Qd Jc] and lost with a pair of Fours
Seat 6: martuska88 folded before Flop (didn't bet)



PokerStars Zoom Hand #229231214991:  Hold'em No Limit ($0.01/$0.02) - 2021/08/21 22:06:16 CET [2021/08/21 16:06:16 ET]
Table 'Halley' 6-max Seat #1 is the button
Seat 1: py100ta ($15.91 in chips) 
Seat 2: Larson_mfk ($0.73 in chips) 
Seat 3: CowboyNicky ($2 in chips) 
Seat 4: Scaaalll ($3 in chips) 
Seat 5: XHerrTUMNUSX ($7.92 in chips) 
Seat 6: LucasG155 ($2 in chips) 
Larson_mfk: posts small blind $0.01
CowboyNicky: posts big blind $0.02
*** HOLE CARDS ***
Dealt to Scaaalll [Td 7d]
Scaaalll: folds 
XHerrTUMNUSX: folds 
Larson_mfk is disconnected 
LucasG155: raises $0.04 to $0.06
py100ta: calls $0.06
Larson_mfk: folds 
CowboyNicky: folds 
*** FLOP *** [3s 2d 7s]
CowboyNicky is disconnected 
LucasG155: checks 
py100ta: bets $0.11
LucasG155: calls $0.11
*** TURN *** [3s 2d 7s] [9c]
LucasG155: checks 
py100ta: bets $0.28
LucasG155: folds 
Uncalled bet ($0.28) returned to py100ta
py100ta collected $0.36 from pot
py100ta: doesn't show hand 
*** SUMMARY ***
Total pot $0.37 | Rake $0.01 
Board [3s 2d 7s 9c]
Seat 1: py100ta (button) collected ($0.36)
Seat 2: Larson_mfk (small blind) folded before Flop
Seat 3: CowboyNicky (big blind) folded before Flop
Seat 4: Scaaalll folded before Flop (didn't bet)
Seat 5: XHerrTUMNUSX folded before Flop (didn't bet)
Seat 6: LucasG155 folded on the Turn



PokerStars Zoom Hand #229231232717:  Hold'em No Limit ($0.01/$0.02) - 2021/08/21 22:06:56 CET [2021/08/21 16:06:56 ET]
Table 'Halley' 6-max Seat #1 is the button
Seat 1: JustGums ($2.89 in chips) 
Seat 2: Mikeloko182 ($2 in chips) 
Seat 3: Scaaalll ($3.03 in chips) 
Seat 4: LuckyCheewey ($7.45 in chips) 
Seat 5: Iwanb4 ($1.99 in chips) 
Seat 6: Loto70 ($2.12 in chips) 
Mikeloko182: posts small blind $0.01
Scaaalll: posts big blind $0.02
*** HOLE CARDS ***
Dealt to Scaaalll [4s Tc]
LuckyCheewey: folds 
Iwanb4: folds 
Loto70: folds 
JustGums: calls $0.02
Mikeloko182: folds 
Scaaalll: checks 
*** FLOP *** [6c 5h 3c]
Scaaalll: checks 
JustGums: bets $0.04
Scaaalll: folds 
Uncalled bet ($0.04) returned to JustGums
JustGums collected $0.05 from pot
JustGums: doesn't show hand 
*** SUMMARY ***
Total pot $0.05 | Rake $0 
Board [6c 5h 3c]
Seat 1: JustGums (button) collected ($0.05)
Seat 2: Mikeloko182 (small blind) folded before Flop
Seat 3: Scaaalll (big blind) folded on the Flop
Seat 4: LuckyCheewey folded before Flop (didn't bet)
Seat 5: Iwanb4 folded before Flop (didn't bet)
Seat 6: Loto70 folded before Flop (didn't bet)



PokerStars Zoom Hand #229231250434:  Hold'em No Limit ($0.01/$0.02) - 2021/08/21 22:07:36 CET [2021/08/21 16:07:36 ET]
Table 'Halley' 6-max Seat #1 is the button
Seat 1: zbixxx ($5.75 in chips) 
Seat 2: leoniduch93 ($1.27 in chips) 
Seat 3: bananAAbandit ($6.65 in chips) 
Seat 4: BARDICHExSIN ($1.77 in chips) 
Seat 5: Mikeloko182 ($2 in chips) 
Seat 6: Scaaalll ($3.01 in chips) 
leoniduch93: posts small blind $0.01
bananAAbandit: posts big blind $0.02
*** HOLE CARDS ***
Dealt to Scaaalll [Kd Kc]
BARDICHExSIN: folds 
BARDICHExSIN is disconnected 
Mikeloko182: folds 
Scaaalll: raises $0.04 to $0.06
zbixxx: folds 
leoniduch93: folds 
bananAAbandit: folds 
Uncalled bet ($0.04) returned to Scaaalll
Scaaalll collected $0.05 from pot
Scaaalll: doesn't show hand 
*** SUMMARY ***
Total pot $0.05 | Rake $0 
Seat 1: zbixxx (button) folded before Flop (didn't bet)
Seat 2: leoniduch93 (small blind) folded before Flop
Seat 3: bananAAbandit (big blind) folded before Flop
Seat 4: BARDICHExSIN folded before Flop (didn't bet)
Seat 5: Mikeloko182 folded before Flop (didn't bet)
Seat 6: Scaaalll collected ($0.05)



PokerStars Zoom Hand #229231260684:  Hold'em No Limit ($0.01/$0.02) - 2021/08/21 22:07:59 CET [2021/08/21 16:07:59 ET]
Table 'Halley' 6-max Seat #1 is the button
Seat 1: Scaaalll ($3.04 in chips) 
Seat 2: Ne0net ($2.57 in chips) 
Seat 3: BigTestIcicle ($5.58 in chips) 
Seat 4: rpycmbEM ($4.67 in chips) 
Seat 5: nodtress ($2.47 in chips) 
Seat 6: Mad_Clock ($1.96 in chips) 
Ne0net: posts small blind $0.01
BigTestIcicle: posts big blind $0.02
*** HOLE CARDS ***
Dealt to Scaaalll [3h Kd]
rpycmbEM: folds 
nodtress: raises $0.03 to $0.05
Mad_Clock: folds 
Scaaalll: folds 
Ne0net: folds 
BigTestIcicle: folds 
Uncalled bet ($0.03) returned to nodtress
nodtress collected $0.05 from pot
nodtress: doesn't show hand 
*** SUMMARY ***
Total pot $0.05 | Rake $0 
Seat 1: Scaaalll (button) folded before Flop (didn't bet)
Seat 2: Ne0net (small blind) folded before Flop
Seat 3: BigTestIcicle (big blind) folded before Flop
Seat 4: rpycmbEM folded before Flop (didn't bet)
Seat 5: nodtress collected ($0.05)
Seat 6: Mad_Clock folded before Flop (didn't bet)



PokerStars Zoom Hand #229231224312:  Hold'em No Limit ($0.01/$0.02) - 2021/08/21 22:06:36 CET [2021/08/21 16:06:36 ET]
Table 'Halley' 6-max Seat #1 is the button
Seat 1: polymorhp ($2 in chips) 
Seat 2: Scaaalll ($3.05 in chips) 
Seat 3: andihorni1 ($1.23 in chips) 
Seat 4: Mokkavit ($2.09 in chips) 
Seat 5: MsSuffolk ($3.31 in chips) 
Seat 6: Amigo113 ($2.92 in chips) 
Scaaalll: posts small blind $0.01
andihorni1: posts big blind $0.02
*** HOLE CARDS ***
Dealt to Scaaalll [As 7h]
Mokkavit: calls $0.02
MsSuffolk: folds 
Amigo113: folds 
polymorhp: calls $0.02
Scaaalll: calls $0.01
andihorni1: raises $0.08 to $0.10
Mokkavit: calls $0.08
polymorhp: calls $0.08
Scaaalll: folds 
*** FLOP *** [5d Th Jh]
andihorni1: bets $0.16
Mokkavit: calls $0.16
polymorhp: calls $0.16
*** TURN *** [5d Th Jh] [8h]
andihorni1: checks 
Mokkavit: checks 
polymorhp: bets $0.60
andihorni1: calls $0.60
Mokkavit: folds 
*** RIVER *** [5d Th Jh 8h] [Qh]
andihorni1: checks 
polymorhp: bets $0.58
andihorni1: calls $0.37 and is all-in
Uncalled bet ($0.21) returned to polymorhp
*** SHOW DOWN ***
polymorhp: shows [6h 9h] (a straight flush, Eight to Queen)
andihorni1: shows [8s 8d] (three of a kind, Eights)
polymorhp collected $2.64 from pot
*** SUMMARY ***
Total pot $2.74 | Rake $0.10 
Board [5d Th Jh 8h Qh]
Seat 1: polymorhp (button) showed [6h 9h] and won ($2.64) with a straight flush, Eight to Queen
Seat 2: Scaaalll (small blind) folded before Flop
Seat 3: andihorni1 (big blind) showed [8s 8d] and lost with three of a kind, Eights
Seat 4: Mokkavit folded on the Turn
Seat 5: MsSuffolk folded before Flop (didn't bet)
Seat 6: Amigo113 folded before Flop (didn't bet)



PokerStars Zoom Hand #229231264168:  Hold'em No Limit ($0.01/$0.02) - 2021/08/21 22:08:07 CET [2021/08/21 16:08:07 ET]
Table 'Halley' 6-max Seat #1 is the button
Seat 1: BigTestIcicle ($5.56 in chips) 
Seat 2: Koldun 2636 ($4.60 in chips) 
Seat 3: Loto70 ($2.21 in chips) 
Seat 4: Ramirres ($2.42 in chips) 
Seat 5: Scaaalll ($3.04 in chips) 
Seat 6: skitai555 ($1.96 in chips) 
Koldun 2636: posts small blind $0.01
Loto70: posts big blind $0.02
*** HOLE CARDS ***
Dealt to Scaaalll [8h 6d]
Ramirres: folds 
Scaaalll: folds 
skitai555: folds 
BigTestIcicle: folds 
Koldun 2636: folds 
Uncalled bet ($0.01) returned to Loto70
Loto70 collected $0.02 from pot
Loto70: doesn't show hand 
*** SUMMARY ***
Total pot $0.02 | Rake $0 
Seat 1: BigTestIcicle (button) folded before Flop (didn't bet)
Seat 2: Koldun 2636 (small blind) folded before Flop
Seat 3: Loto70 (big blind) collected ($0.02)
Seat 4: Ramirres folded before Flop (didn't bet)
Seat 5: Scaaalll folded before Flop (didn't bet)
Seat 6: skitai555 folded before Flop (didn't bet)



PokerStars Zoom Hand #229231262433:  Hold'em No Limit ($0.01/$0.02) - 2021/08/21 22:08:03 CET [2021/08/21 16:08:03 ET]
Table 'Halley' 6-max Seat #1 is the button
Seat 1: Mad_Clock ($1.96 in chips) 
Seat 2: MSD2006 ($1.73 in chips) 
Seat 3: yannikdaehne ($7.90 in chips) 
Seat 4: ash1448 ($3.20 in chips) 
Seat 5: Scaaalll ($3.04 in chips) 
Seat 6: HellNative ($3.78 in chips) 
MSD2006: posts small blind $0.01
yannikdaehne: posts big blind $0.02
*** HOLE CARDS ***
Dealt to Scaaalll [8s Ad]
ash1448: folds 
Scaaalll: folds 
HellNative: raises $0.02 to $0.04
Mad_Clock: folds 
MSD2006: folds 
yannikdaehne: calls $0.02
*** FLOP *** [6d 2d Qd]
yannikdaehne: checks 
HellNative: bets $0.06
yannikdaehne: folds 
Uncalled bet ($0.06) returned to HellNative
HellNative collected $0.09 from pot
HellNative: doesn't show hand 
*** SUMMARY ***
Total pot $0.09 | Rake $0 
Board [6d 2d Qd]
Seat 1: Mad_Clock (button) folded before Flop (didn't bet)
Seat 2: MSD2006 (small blind) folded before Flop
Seat 3: yannikdaehne (big blind) folded on the Flop
Seat 4: ash1448 folded before Flop (didn't bet)
Seat 5: Scaaalll folded before Flop (didn't bet)
Seat 6: HellNative collected ($0.09)



PokerStars Zoom Hand #229231265898:  Hold'em No Limit ($0.01/$0.02) - 2021/08/21 22:08:11 CET [2021/08/21 16:08:11 ET]
Table 'Halley' 6-max Seat #1 is the button
Seat 1: Koldun 2636 ($2.86 in chips) 
Seat 2: Scaaalll ($3.04 in chips) 
Seat 3: olcham7 ($2 in chips) 
Seat 4: Iwanb4 ($3.31 in chips) 
Seat 5: ARTMVSLV ($2.86 in chips) 
Seat 6: Mikeloko182 ($2 in chips) 
Scaaalll: posts small blind $0.01
olcham7: posts big blind $0.02
*** HOLE CARDS ***
Dealt to Scaaalll [Th Js]
Iwanb4: folds 
ARTMVSLV: folds 
Mikeloko182: folds 
Koldun 2636: raises $0.03 to $0.05
Scaaalll: raises $0.13 to $0.18
olcham7: folds 
Koldun 2636: folds 
Uncalled bet ($0.13) returned to Scaaalll
Scaaalll collected $0.12 from pot
Scaaalll: doesn't show hand 
*** SUMMARY ***
Total pot $0.12 | Rake $0 
Seat 1: Koldun 2636 (button) folded before Flop
Seat 2: Scaaalll (small blind) collected ($0.12)
Seat 3: olcham7 (big blind) folded before Flop
Seat 4: Iwanb4 folded before Flop (didn't bet)
Seat 5: ARTMVSLV folded before Flop (didn't bet)
Seat 6: Mikeloko182 folded before Flop (didn't bet)



PokerStars Zoom Hand #229231275674:  Hold'em No Limit ($0.01/$0.02) - 2021/08/21 22:08:33 CET [2021/08/21 16:08:33 ET]
Table 'Halley' 6-max Seat #1 is the button
Seat 1: davidalejag ($2.95 in chips) 
Seat 2: krowio ($2 in chips) 
Seat 3: KoAlRy ($2 in chips) 
Seat 4: Scaaalll ($3.11 in chips) 
Seat 5: Kreodont1987 ($5.56 in chips) 
Seat 6: jjjj135 ($0.88 in chips) 
krowio: posts small blind $0.01
KoAlRy: posts big blind $0.02
*** HOLE CARDS ***
Dealt to Scaaalll [5h 8c]
Scaaalll: folds 
Kreodont1987: folds 
jjjj135 has timed out while disconnected
jjjj135: folds 
davidalejag: raises $0.04 to $0.06
krowio: folds 
KoAlRy: folds 
Uncalled bet ($0.04) returned to davidalejag
davidalejag collected $0.05 from pot
davidalejag: doesn't show hand 
*** SUMMARY ***
Total pot $0.05 | Rake $0 
Seat 1: davidalejag (button) collected ($0.05)
Seat 2: krowio (small blind) folded before Flop
Seat 3: KoAlRy (big blind) folded before Flop
Seat 4: Scaaalll folded before Flop (didn't bet)
Seat 5: Kreodont1987 folded before Flop (didn't bet)
Seat 6: jjjj135 folded before Flop (didn't bet)



PokerStars Zoom Hand #229231277868:  Hold'em No Limit ($0.01/$0.02) - 2021/08/21 22:08:38 CET [2021/08/21 16:08:38 ET]
Table 'Halley' 6-max Seat #1 is the button
Seat 1: Scaaalll ($3.11 in chips) 
Seat 2: magicfay ($1.21 in chips) 
Seat 3: 77omsk ($2.39 in chips) 
Seat 4: ppluiaule ($2 in chips) 
Seat 5: Henry Chinasky ($1.36 in chips) 
Seat 6: Djalmethedj ($1.97 in chips) 
magicfay: posts small blind $0.01
77omsk: posts big blind $0.02
*** HOLE CARDS ***
Dealt to Scaaalll [6c 2c]
ppluiaule: folds 
Henry Chinasky: folds 
Djalmethedj: folds 
Scaaalll: folds 
magicfay: calls $0.01
77omsk: checks 
*** FLOP *** [3d 8c Jh]
magicfay: checks 
77omsk: bets $0.03
magicfay: folds 
Uncalled bet ($0.03) returned to 77omsk
77omsk collected $0.04 from pot
77omsk: doesn't show hand 
magicfay is disconnected 
*** SUMMARY ***
Total pot $0.04 | Rake $0 
Board [3d 8c Jh]
Seat 1: Scaaalll (button) folded before Flop (didn't bet)
Seat 2: magicfay (small blind) folded on the Flop
Seat 3: 77omsk (big blind) collected ($0.04)
Seat 4: ppluiaule folded before Flop (didn't bet)
Seat 5: Henry Chinasky folded before Flop (didn't bet)
Seat 6: Djalmethedj folded before Flop (didn't bet)



PokerStars Zoom Hand #229231282227:  Hold'em No Limit ($0.01/$0.02) - 2021/08/21 22:08:48 CET [2021/08/21 16:08:48 ET]
Table 'Halley' 6-max Seat #1 is the button
Seat 1: BlackhawKK's ($4.64 in chips) 
Seat 2: Richaud ($3.33 in chips) 
Seat 3: Scaaalll ($3.11 in chips) 
Seat 4: Dulli007 ($6.02 in chips) 
Seat 5: NecromiconP ($2.14 in chips) 
Seat 6: estelionat171 ($1.25 in chips) 
Richaud: posts small blind $0.01
Scaaalll: posts big blind $0.02
*** HOLE CARDS ***
Dealt to Scaaalll [2c As]
Dulli007: calls $0.02
NecromiconP: folds 
estelionat171: folds 
BlackhawKK's: folds 
Richaud: calls $0.01
Scaaalll: checks 
*** FLOP *** [4c 9s Kc]
Richaud: checks 
Scaaalll: checks 
Dulli007: checks 
*** TURN *** [4c 9s Kc] [4s]
Richaud: checks 
Scaaalll: checks 
Dulli007: checks 
*** RIVER *** [4c 9s Kc 4s] [5h]
Richaud: bets $0.02
Scaaalll: folds 
Dulli007: folds 
Uncalled bet ($0.02) returned to Richaud
Richaud collected $0.06 from pot
Richaud: doesn't show hand 
*** SUMMARY ***
Total pot $0.06 | Rake $0 
Board [4c 9s Kc 4s 5h]
Seat 1: BlackhawKK's (button) folded before Flop (didn't bet)
Seat 2: Richaud (small blind) collected ($0.06)
Seat 3: Scaaalll (big blind) folded on the River
Seat 4: Dulli007 folded on the River
Seat 5: NecromiconP folded before Flop (didn't bet)
Seat 6: estelionat171 folded before Flop (didn't bet)



PokerStars Zoom Hand #229231297477:  Hold'em No Limit ($0.01/$0.02) - 2021/08/21 22:09:23 CET [2021/08/21 16:09:23 ET]
Table 'Halley' 6-max Seat #1 is the button
Seat 1: Pechorin.G ($2.36 in chips) 
Seat 2: Scaaalll ($3.09 in chips) 
Seat 3: Saint_ANBU ($4.17 in chips) 
Seat 4: guntren.ps ($2.01 in chips) 
Seat 5: DaBaDaBaDooo ($2.46 in chips) 
Seat 6: Tacojesuscrisp ($2 in chips) 
Scaaalll: posts small blind $0.01
Saint_ANBU: posts big blind $0.02
*** HOLE CARDS ***
Dealt to Scaaalll [Qs Qd]
guntren.ps: folds 
DaBaDaBaDooo: folds 
Tacojesuscrisp: folds 
Pechorin.G: folds 
Scaaalll: raises $0.04 to $0.06
Saint_ANBU: calls $0.04
*** FLOP *** [5d 6h 3d]
Scaaalll: bets $0.07
Saint_ANBU: folds 
Uncalled bet ($0.07) returned to Scaaalll
Scaaalll collected $0.12 from pot
Scaaalll: doesn't show hand 
*** SUMMARY ***
Total pot $0.12 | Rake $0 
Board [5d 6h 3d]
Seat 1: Pechorin.G (button) folded before Flop (didn't bet)
Seat 2: Scaaalll (small blind) collected ($0.12)
Seat 3: Saint_ANBU (big blind) folded on the Flop
Seat 4: guntren.ps folded before Flop (didn't bet)
Seat 5: DaBaDaBaDooo folded before Flop (didn't bet)
Seat 6: Tacojesuscrisp folded before Flop (didn't bet)



PokerStars Zoom Hand #229231317457:  Hold'em No Limit ($0.01/$0.02) - 2021/08/21 22:10:08 CET [2021/08/21 16:10:08 ET]
Table 'Halley' 6-max Seat #1 is the button
Seat 1: RoughRafff ($2.49 in chips) 
Seat 2: EevAA190 ($2.21 in chips) 
Seat 3: Davingo25 ($2 in chips) 
Seat 4: 77omsk ($2.35 in chips) 
Seat 5: Scaaalll ($3.15 in chips) 
Seat 6: NoLuckLeck ($2.13 in chips) 
EevAA190: posts small blind $0.01
Davingo25: posts big blind $0.02
*** HOLE CARDS ***
Dealt to Scaaalll [Ks 9d]
77omsk: folds 
Scaaalll: folds 
NoLuckLeck: folds 
RoughRafff: folds 
EevAA190: folds 
Uncalled bet ($0.01) returned to Davingo25
Davingo25 collected $0.02 from pot
Davingo25: doesn't show hand 
*** SUMMARY ***
Total pot $0.02 | Rake $0 
Seat 1: RoughRafff (button) folded before Flop (didn't bet)
Seat 2: EevAA190 (small blind) folded before Flop
Seat 3: Davingo25 (big blind) collected ($0.02)
Seat 4: 77omsk folded before Flop (didn't bet)
Seat 5: Scaaalll folded before Flop (didn't bet)
Seat 6: NoLuckLeck folded before Flop (didn't bet)



PokerStars Zoom Hand #229231314315:  Hold'em No Limit ($0.01/$0.02) - 2021/08/21 22:10:01 CET [2021/08/21 16:10:01 ET]
Table 'Halley' 6-max Seat #1 is the button
Seat 1: Clavis Noa ($2.32 in chips) 
Seat 2: NoLuckLeck ($2 in chips) 
Seat 3: yannikdaehne ($8.61 in chips) 
Seat 4: Rafaxn ($2.05 in chips) 
Seat 5: PapiMik3 ($2.51 in chips) 
Seat 6: Scaaalll ($3.15 in chips) 
NoLuckLeck: posts small blind $0.01
yannikdaehne: posts big blind $0.02
*** HOLE CARDS ***
Dealt to Scaaalll [4h 7d]
Rafaxn: folds 
PapiMik3: folds 
Scaaalll: folds 
Clavis Noa: raises $0.08 to $0.10
NoLuckLeck: folds 
yannikdaehne: calls $0.08
*** FLOP *** [6h Qd 3h]
yannikdaehne: checks 
Clavis Noa: bets $0.10
yannikdaehne: calls $0.10
*** TURN *** [6h Qd 3h] [9h]
yannikdaehne: checks 
Clavis Noa: checks 
*** RIVER *** [6h Qd 3h 9h] [4d]
yannikdaehne: bets $0.24
Clavis Noa: folds 
Uncalled bet ($0.24) returned to yannikdaehne
yannikdaehne collected $0.40 from pot
yannikdaehne: doesn't show hand 
*** SUMMARY ***
Total pot $0.41 | Rake $0.01 
Board [6h Qd 3h 9h 4d]
Seat 1: Clavis Noa (button) folded on the River
Seat 2: NoLuckLeck (small blind) folded before Flop
Seat 3: yannikdaehne (big blind) collected ($0.40)
Seat 4: Rafaxn folded before Flop (didn't bet)
Seat 5: PapiMik3 folded before Flop (didn't bet)
Seat 6: Scaaalll folded before Flop (didn't bet)



PokerStars Zoom Hand #229231310324:  Hold'em No Limit ($0.01/$0.02) - 2021/08/21 22:09:52 CET [2021/08/21 16:09:52 ET]
Table 'Halley' 6-max Seat #1 is the button
Seat 1: PapiMik3 ($2.51 in chips) 
Seat 2: elmex886 ($2 in chips) 
Seat 3: Slirey ($3.28 in chips) 
Seat 4: rpycmbEM ($3.77 in chips) 
Seat 5: RaulacateFolds ($2.06 in chips) 
Seat 6: Scaaalll ($3.15 in chips) 
elmex886: posts small blind $0.01
Slirey: posts big blind $0.02
*** HOLE CARDS ***
Dealt to Scaaalll [3h 4s]
rpycmbEM: folds 
RaulacateFolds: folds 
Scaaalll: folds 
PapiMik3: folds 
elmex886: raises $0.04 to $0.06
Slirey: calls $0.04
*** FLOP *** [8h Tc Jh]
elmex886: bets $0.10
Slirey: calls $0.10
*** TURN *** [8h Tc Jh] [5h]
elmex886: bets $0.16
Slirey: calls $0.16
*** RIVER *** [8h Tc Jh 5h] [2s]
elmex886: checks 
Slirey: bets $0.29
elmex886: calls $0.29
*** SHOW DOWN ***
Slirey: shows [9h Th] (a flush, Jack high)
elmex886: mucks hand 
Slirey collected $1.18 from pot
*** SUMMARY ***
Total pot $1.22 | Rake $0.04 
Board [8h Tc Jh 5h 2s]
Seat 1: PapiMik3 (button) folded before Flop (didn't bet)
Seat 2: elmex886 (small blind) mucked [Kd Jd]
Seat 3: Slirey (big blind) showed [9h Th] and won ($1.18) with a flush, Jack high
Seat 4: rpycmbEM folded before Flop (didn't bet)
Seat 5: RaulacateFolds folded before Flop (didn't bet)
Seat 6: Scaaalll folded before Flop (didn't bet)



PokerStars Zoom Hand #229231319652:  Hold'em No Limit ($0.01/$0.02) - 2021/08/21 22:10:13 CET [2021/08/21 16:10:13 ET]
Table 'Halley' 6-max Seat #1 is the button
Seat 1: WithMyWalker ($2.56 in chips) 
Seat 2: SIGREX ($3.39 in chips) 
Seat 3: Healthys07 ($5.05 in chips) 
Seat 4: Scaaalll ($3.15 in chips) 
Seat 5: bananAAbandit ($6.59 in chips) 
Seat 6: HirotoBeats ($1.97 in chips) 
SIGREX: posts small blind $0.01
Healthys07: posts big blind $0.02
*** HOLE CARDS ***
Dealt to Scaaalll [Ad Th]
Scaaalll: raises $0.04 to $0.06
bananAAbandit: folds 
HirotoBeats: folds 
WithMyWalker: folds 
SIGREX: folds 
Healthys07: calls $0.04
*** FLOP *** [4d 7c 6h]
Healthys07: checks 
Scaaalll: bets $0.08
Healthys07: raises $0.16 to $0.24
Scaaalll: folds 
Uncalled bet ($0.16) returned to Healthys07
Healthys07 collected $0.28 from pot
Healthys07: doesn't show hand 
*** SUMMARY ***
Total pot $0.29 | Rake $0.01 
Board [4d 7c 6h]
Seat 1: WithMyWalker (button) folded before Flop (didn't bet)
Seat 2: SIGREX (small blind) folded before Flop
Seat 3: Healthys07 (big blind) collected ($0.28)
Seat 4: Scaaalll folded on the Flop
Seat 5: bananAAbandit folded before Flop (didn't bet)
Seat 6: HirotoBeats folded before Flop (didn't bet)



PokerStars Zoom Hand #229231336914:  Hold'em No Limit ($0.01/$0.02) - 2021/08/21 22:10:52 CET [2021/08/21 16:10:52 ET]
Table 'Halley' 6-max Seat #1 is the button
Seat 1: Scaaalll ($3.01 in chips) 
Seat 2: CordiPS ($4.92 in chips) 
Seat 3: LuckyCheewey ($2.43 in chips) 
Seat 4: gy67 ($2.82 in chips) 
Seat 5: maaitee ($3.66 in chips) 
Seat 6: DaBaDaBaDooo ($2.05 in chips) 
CordiPS: posts small blind $0.01
LuckyCheewey: posts big blind $0.02
*** HOLE CARDS ***
Dealt to Scaaalll [Ad 7d]
gy67: folds 
maaitee: folds 
DaBaDaBaDooo: folds 
Scaaalll: raises $0.02 to $0.04
CordiPS: folds 
LuckyCheewey: folds 
Uncalled bet ($0.02) returned to Scaaalll
Scaaalll collected $0.05 from pot
Scaaalll: doesn't show hand 
*** SUMMARY ***
Total pot $0.05 | Rake $0 
Seat 1: Scaaalll (button) collected ($0.05)
Seat 2: CordiPS (small blind) folded before Flop
Seat 3: LuckyCheewey (big blind) folded before Flop
Seat 4: gy67 folded before Flop (didn't bet)
Seat 5: maaitee folded before Flop (didn't bet)
Seat 6: DaBaDaBaDooo folded before Flop (didn't bet)



PokerStars Zoom Hand #229231342199:  Hold'em No Limit ($0.01/$0.02) - 2021/08/21 22:11:04 CET [2021/08/21 16:11:04 ET]
Table 'Halley' 6-max Seat #1 is the button
Seat 1: satti1337 ($6.21 in chips) 
Seat 2: maksim1-2012 ($0.98 in chips) 
Seat 3: Scaaalll ($3.04 in chips) 
Seat 4: innexplus ($1.58 in chips) 
Seat 5: Tacojesuscrisp ($2.03 in chips) 
Seat 6: nippurkaunas ($1.47 in chips) 
maksim1-2012: posts small blind $0.01
Scaaalll: posts big blind $0.02
*** HOLE CARDS ***
Dealt to Scaaalll [5c Qs]
innexplus has timed out
innexplus: folds 
Tacojesuscrisp: folds 
nippurkaunas: folds 
satti1337: folds 
maksim1-2012: folds 
Uncalled bet ($0.01) returned to Scaaalll
Scaaalll collected $0.02 from pot
Scaaalll: doesn't show hand 
*** SUMMARY ***
Total pot $0.02 | Rake $0 
Seat 1: satti1337 (button) folded before Flop (didn't bet)
Seat 2: maksim1-2012 (small blind) folded before Flop
Seat 3: Scaaalll (big blind) collected ($0.02)
Seat 4: innexplus folded before Flop (didn't bet)
Seat 5: Tacojesuscrisp folded before Flop (didn't bet)
Seat 6: nippurkaunas folded before Flop (didn't bet)



PokerStars Zoom Hand #229231349320:  Hold'em No Limit ($0.01/$0.02) - 2021/08/21 22:11:20 CET [2021/08/21 16:11:20 ET]
Table 'Halley' 6-max Seat #1 is the button
Seat 1: Padde68 ($2.80 in chips) 
Seat 2: Scaaalll ($3.05 in chips) 
Seat 3: 888lifeIS ($2.17 in chips) 
Seat 4: olga3021221 ($5.47 in chips) 
Seat 5: estelionat171 ($1.77 in chips) 
Seat 6: pipecmolodec ($2.36 in chips) 
Scaaalll: posts small blind $0.01
888lifeIS: posts big blind $0.02
*** HOLE CARDS ***
Dealt to Scaaalll [8d 7d]
olga3021221: raises $0.03 to $0.05
estelionat171: folds 
pipecmolodec: folds 
Padde68: calls $0.05
Scaaalll: calls $0.04
888lifeIS: folds 
*** FLOP *** [Tc 2h 8s]
Scaaalll: checks 
olga3021221: bets $0.04
Padde68: folds 
Padde68 is disconnected 
Scaaalll: calls $0.04
*** TURN *** [Tc 2h 8s] [9s]
Scaaalll: checks 
olga3021221: checks 
*** RIVER *** [Tc 2h 8s 9s] [Jh]
Scaaalll: bets $0.12
olga3021221: calls $0.12
*** SHOW DOWN ***
Scaaalll: shows [8d 7d] (a straight, Seven to Jack)
olga3021221: mucks hand 
Scaaalll collected $0.47 from pot
*** SUMMARY ***
Total pot $0.49 | Rake $0.02 
Board [Tc 2h 8s 9s Jh]
Seat 1: Padde68 (button) folded on the Flop
Seat 2: Scaaalll (small blind) showed [8d 7d] and won ($0.47) with a straight, Seven to Jack
Seat 3: 888lifeIS (big blind) folded before Flop
Seat 4: olga3021221 mucked [Jc Ah]
Seat 5: estelionat171 folded before Flop (didn't bet)
Seat 6: pipecmolodec folded before Flop (didn't bet)



PokerStars Zoom Hand #229231374514:  Hold'em No Limit ($0.01/$0.02) - 2021/08/21 22:12:17 CET [2021/08/21 16:12:17 ET]
Table 'Halley' 6-max Seat #1 is the button
Seat 1: ugi-dugi ($2.45 in chips) 
Seat 2: so0love ($2.31 in chips) 
Seat 3: Phoenixxxxxxxx ($2 in chips) 
Seat 4: RrriotGrrrl ($9.70 in chips) 
Seat 5: Pechorin.G ($2 in chips) 
Seat 6: Scaaalll ($3.31 in chips) 
so0love: posts small blind $0.01
Phoenixxxxxxxx: posts big blind $0.02
*** HOLE CARDS ***
Dealt to Scaaalll [5d Qd]
RrriotGrrrl: folds 
Pechorin.G: folds 
Scaaalll: folds 
ugi-dugi: raises $0.04 to $0.06
so0love: folds 
Phoenixxxxxxxx: folds 
Uncalled bet ($0.04) returned to ugi-dugi
ugi-dugi collected $0.05 from pot
ugi-dugi: doesn't show hand 
*** SUMMARY ***
Total pot $0.05 | Rake $0 
Seat 1: ugi-dugi (button) collected ($0.05)
Seat 2: so0love (small blind) folded before Flop
Seat 3: Phoenixxxxxxxx (big blind) folded before Flop
Seat 4: RrriotGrrrl folded before Flop (didn't bet)
Seat 5: Pechorin.G folded before Flop (didn't bet)
Seat 6: Scaaalll folded before Flop (didn't bet)



PokerStars Zoom Hand #229231370507:  Hold'em No Limit ($0.01/$0.02) - 2021/08/21 22:12:08 CET [2021/08/21 16:12:08 ET]
Table 'Halley' 6-max Seat #1 is the button
Seat 1: Scaaalll ($3.31 in chips) 
Seat 2: satti1337 ($2.24 in chips) 
Seat 3: lucksuckdonk ($2 in chips) 
Seat 4: meikoz ($4.47 in chips) 
Seat 5: Nihility77 ($5.17 in chips) 
Seat 6: Hug0Flavi0 ($1.66 in chips) 
satti1337: posts small blind $0.01
lucksuckdonk: posts big blind $0.02
*** HOLE CARDS ***
Dealt to Scaaalll [6c 9s]
meikoz: folds 
Nihility77: folds 
Hug0Flavi0: folds 
Scaaalll: folds 
satti1337: raises $0.04 to $0.06
lucksuckdonk: calls $0.04
*** FLOP *** [Jc Ad 9h]
satti1337: checks 
lucksuckdonk: bets $0.06
satti1337: calls $0.06
*** TURN *** [Jc Ad 9h] [3d]
satti1337: checks 
lucksuckdonk: checks 
*** RIVER *** [Jc Ad 9h 3d] [As]
satti1337: checks 
lucksuckdonk: checks 
*** SHOW DOWN ***
satti1337: shows [Qd Ks] (a pair of Aces)
lucksuckdonk: shows [4c 4h] (two pair, Aces and Fours)
lucksuckdonk collected $0.23 from pot
*** SUMMARY ***
Total pot $0.24 | Rake $0.01 
Board [Jc Ad 9h 3d As]
Seat 1: Scaaalll (button) folded before Flop (didn't bet)
Seat 2: satti1337 (small blind) showed [Qd Ks] and lost with a pair of Aces
Seat 3: lucksuckdonk (big blind) showed [4c 4h] and won ($0.23) with two pair, Aces and Fours
Seat 4: meikoz folded before Flop (didn't bet)
Seat 5: Nihility77 folded before Flop (didn't bet)
Seat 6: Hug0Flavi0 folded before Flop (didn't bet)



PokerStars Zoom Hand #229231378003:  Hold'em No Limit ($0.01/$0.02) - 2021/08/21 22:12:25 CET [2021/08/21 16:12:25 ET]
Table 'Halley' 6-max Seat #1 is the button
Seat 1: DaBaDaBaDooo ($2 in chips) 
Seat 2: herket ($0.68 in chips) 
Seat 3: Red Sky 15 ($8.98 in chips) 
Seat 4: Flankeris ($5.12 in chips) 
Seat 5: Scaaalll ($3.31 in chips) 
Seat 6: LuckyCheewey ($7.62 in chips) 
herket: posts small blind $0.01
Red Sky 15: posts big blind $0.02
*** HOLE CARDS ***
Dealt to Scaaalll [2s 2c]
Flankeris: folds 
Scaaalll: raises $0.04 to $0.06
LuckyCheewey: folds 
DaBaDaBaDooo: folds 
herket: calls $0.05
Red Sky 15: calls $0.04
*** FLOP *** [6h Qh Kc]
herket: checks 
Red Sky 15: checks 
Scaaalll: checks 
*** TURN *** [6h Qh Kc] [4s]
herket: checks 
Red Sky 15: bets $0.10
Scaaalll: folds 
herket: calls $0.10
*** RIVER *** [6h Qh Kc 4s] [Kh]
herket: checks 
Red Sky 15: bets $0.20
herket: folds 
Uncalled bet ($0.20) returned to Red Sky 15
Red Sky 15 collected $0.37 from pot
Red Sky 15: doesn't show hand 
*** SUMMARY ***
Total pot $0.38 | Rake $0.01 
Board [6h Qh Kc 4s Kh]
Seat 1: DaBaDaBaDooo (button) folded before Flop (didn't bet)
Seat 2: herket (small blind) folded on the River
Seat 3: Red Sky 15 (big blind) collected ($0.37)
Seat 4: Flankeris folded before Flop (didn't bet)
Seat 5: Scaaalll folded on the Turn
Seat 6: LuckyCheewey folded before Flop (didn't bet)



PokerStars Zoom Hand #229231397500:  Hold'em No Limit ($0.01/$0.02) - 2021/08/21 22:13:09 CET [2021/08/21 16:13:09 ET]
Table 'Halley' 6-max Seat #1 is the button
Seat 1: tragedy1986 ($2.14 in chips) 
Seat 2: ARTMVSLV ($2.29 in chips) 
Seat 3: Scaaalll ($3.25 in chips) 
Seat 4: Aho1337 ($2.26 in chips) 
Seat 5: Pechorin.G ($2 in chips) 
Seat 6: RoughRafff ($2.70 in chips) 
ARTMVSLV: posts small blind $0.01
Scaaalll: posts big blind $0.02
*** HOLE CARDS ***
Dealt to Scaaalll [5c Th]
Aho1337: folds 
Pechorin.G: folds 
RoughRafff: folds 
tragedy1986: calls $0.02
ARTMVSLV: folds 
Scaaalll: checks 
*** FLOP *** [Jc 9c Ah]
Scaaalll: checks 
tragedy1986: bets $0.05
Scaaalll: folds 
Uncalled bet ($0.05) returned to tragedy1986
tragedy1986 collected $0.05 from pot
tragedy1986: doesn't show hand 
*** SUMMARY ***
Total pot $0.05 | Rake $0 
Board [Jc 9c Ah]
Seat 1: tragedy1986 (button) collected ($0.05)
Seat 2: ARTMVSLV (small blind) folded before Flop
Seat 3: Scaaalll (big blind) folded on the Flop
Seat 4: Aho1337 folded before Flop (didn't bet)
Seat 5: Pechorin.G folded before Flop (didn't bet)
Seat 6: RoughRafff folded before Flop (didn't bet)



PokerStars Zoom Hand #229231408010:  Hold'em No Limit ($0.01/$0.02) - 2021/08/21 22:13:33 CET [2021/08/21 16:13:33 ET]
Table 'Halley' 6-max Seat #1 is the button
Seat 1: 21041956 ($1.50 in chips) 
Seat 2: Sergant20081 ($2.31 in chips) 
Seat 3: Finderra ($2 in chips) 
Seat 4: Scaaalll ($3.23 in chips) 
Seat 5: EmperorKurr ($2.54 in chips) 
Seat 6: tolstii906 ($3.80 in chips) 
Sergant20081: posts small blind $0.01
Finderra: posts big blind $0.02
*** HOLE CARDS ***
Dealt to Scaaalll [6s 2h]
Scaaalll: folds 
EmperorKurr: folds 
tolstii906: folds 
21041956: folds 
Sergant20081: folds 
Uncalled bet ($0.01) returned to Finderra
Finderra collected $0.02 from pot
Finderra: doesn't show hand 
*** SUMMARY ***
Total pot $0.02 | Rake $0 
Seat 1: 21041956 (button) folded before Flop (didn't bet)
Seat 2: Sergant20081 (small blind) folded before Flop
Seat 3: Finderra (big blind) collected ($0.02)
Seat 4: Scaaalll folded before Flop (didn't bet)
Seat 5: EmperorKurr folded before Flop (didn't bet)
Seat 6: tolstii906 folded before Flop (didn't bet)



PokerStars Zoom Hand #229231409802:  Hold'em No Limit ($0.01/$0.02) - 2021/08/21 22:13:37 CET [2021/08/21 16:13:37 ET]
Table 'Halley' 6-max Seat #1 is the button
Seat 1: martifact ($3.19 in chips) 
Seat 2: Scaaalll ($3.23 in chips) 
Seat 3: SICKDIRTY416 ($6.14 in chips) 
Seat 4: LuckyCheewey ($7.70 in chips) 
Seat 5: ARTMVSLV ($7.13 in chips) 
Seat 6: pavlo8855 ($2.01 in chips) 
Scaaalll: posts small blind $0.01
SICKDIRTY416: posts big blind $0.02
*** HOLE CARDS ***
Dealt to Scaaalll [7d Ks]
LuckyCheewey: folds 
ARTMVSLV: folds 
pavlo8855: folds 
martifact: folds 
Scaaalll: folds 
Uncalled bet ($0.01) returned to SICKDIRTY416
SICKDIRTY416 collected $0.02 from pot
SICKDIRTY416: doesn't show hand 
*** SUMMARY ***
Total pot $0.02 | Rake $0 
Seat 1: martifact (button) folded before Flop (didn't bet)
Seat 2: Scaaalll (small blind) folded before Flop
Seat 3: SICKDIRTY416 (big blind) collected ($0.02)
Seat 4: LuckyCheewey folded before Flop (didn't bet)
Seat 5: ARTMVSLV folded before Flop (didn't bet)
Seat 6: pavlo8855 folded before Flop (didn't bet)



PokerStars Zoom Hand #229231416346:  Hold'em No Limit ($0.01/$0.02) - 2021/08/21 22:13:52 CET [2021/08/21 16:13:52 ET]
Table 'Halley' 6-max Seat #1 is the button
Seat 1: Scaaalll ($3.22 in chips) 
Seat 2: Esskeetit420/69 ($1.70 in chips) 
Seat 3: meikoz ($2.23 in chips) 
Seat 4: Draat505 ($4.98 in chips) 
Seat 5: pavlo8855 ($2 in chips) 
Seat 6: Fanatspartak ($0.89 in chips) 
Esskeetit420/69: posts small blind $0.01
meikoz: posts big blind $0.02
*** HOLE CARDS ***
Dealt to Scaaalll [7c Ts]
Draat505: folds 
pavlo8855: folds 
Fanatspartak: folds 
Scaaalll: folds 
Esskeetit420/69: folds 
Uncalled bet ($0.01) returned to meikoz
meikoz collected $0.02 from pot
meikoz: doesn't show hand 
*** SUMMARY ***
Total pot $0.02 | Rake $0 
Seat 1: Scaaalll (button) folded before Flop (didn't bet)
Seat 2: Esskeetit420/69 (small blind) folded before Flop
Seat 3: meikoz (big blind) collected ($0.02)
Seat 4: Draat505 folded before Flop (didn't bet)
Seat 5: pavlo8855 folded before Flop (didn't bet)
Seat 6: Fanatspartak folded before Flop (didn't bet)



PokerStars Zoom Hand #229231419854:  Hold'em No Limit ($0.01/$0.02) - 2021/08/21 22:14:00 CET [2021/08/21 16:14:00 ET]
Table 'Halley' 6-max Seat #1 is the button
Seat 1: ARTMVSLV ($7.11 in chips) 
Seat 2: mrsavagep ($1.17 in chips) 
Seat 3: polymorhp ($2.71 in chips) 
Seat 4: Clavis Noa ($2.79 in chips) 
Seat 5: Scaaalll ($3.22 in chips) 
Seat 6: Nancy_88 ($2.03 in chips) 
mrsavagep: posts small blind $0.01
polymorhp: posts big blind $0.02
*** HOLE CARDS ***
Dealt to Scaaalll [5s 5c]
Clavis Noa: folds 
Scaaalll: raises $0.04 to $0.06
Nancy_88: folds 
Nancy_88 is disconnected 
ARTMVSLV: raises $0.11 to $0.17
mrsavagep: raises $1 to $1.17 and is all-in
polymorhp: folds 
Scaaalll: folds 
ARTMVSLV: folds 
Uncalled bet ($1) returned to mrsavagep
mrsavagep collected $0.42 from pot
mrsavagep: doesn't show hand 
*** SUMMARY ***
Total pot $0.42 | Rake $0 
Seat 1: ARTMVSLV (button) folded before Flop
Seat 2: mrsavagep (small blind) collected ($0.42)
Seat 3: polymorhp (big blind) folded before Flop
Seat 4: Clavis Noa folded before Flop (didn't bet)
Seat 5: Scaaalll folded before Flop
Seat 6: Nancy_88 folded before Flop (didn't bet)



PokerStars Zoom Hand #229231444854:  Hold'em No Limit ($0.01/$0.02) - 2021/08/21 22:14:28 CET [2021/08/21 16:14:28 ET]
Table 'Halley' 6-max Seat #1 is the button
Seat 1: Richaud ($2.89 in chips) 
Seat 2: Loto70 ($2 in chips) 
Seat 3: Scaaalll ($3.16 in chips) 
Seat 4: kahzura ($2.28 in chips) 
Seat 5: ash1448 ($10 in chips) 
Seat 6: jejmcclu ($2.35 in chips) 
Loto70: posts small blind $0.01
Scaaalll: posts big blind $0.02
*** HOLE CARDS ***
Dealt to Scaaalll [7d 2s]
kahzura: folds 
ash1448: folds 
jejmcclu: folds 
Richaud: folds 
Loto70: raises $0.03 to $0.05
Scaaalll: folds 
Uncalled bet ($0.03) returned to Loto70
Loto70 collected $0.04 from pot
Loto70: doesn't show hand 
*** SUMMARY ***
Total pot $0.04 | Rake $0 
Seat 1: Richaud (button) folded before Flop (didn't bet)
Seat 2: Loto70 (small blind) collected ($0.04)
Seat 3: Scaaalll (big blind) folded before Flop
Seat 4: kahzura folded before Flop (didn't bet)
Seat 5: ash1448 folded before Flop (didn't bet)
Seat 6: jejmcclu folded before Flop (didn't bet)



PokerStars Zoom Hand #229231453613:  Hold'em No Limit ($0.01/$0.02) - 2021/08/21 22:14:48 CET [2021/08/21 16:14:48 ET]
Table 'Halley' 6-max Seat #1 is the button
Seat 1: zielony ($2.27 in chips) 
Seat 2: sewq55 ($1.03 in chips) 
Seat 3: Loto70 ($2.14 in chips) 
Seat 4: Mikeloko182 ($2 in chips) 
Seat 5: texashenry2 ($0.86 in chips) 
Seat 6: Scaaalll ($3.14 in chips) 
sewq55: posts small blind $0.01
Loto70: posts big blind $0.02
*** HOLE CARDS ***
Dealt to Scaaalll [Js Jh]
Mikeloko182: folds 
texashenry2: folds 
Scaaalll: raises $0.04 to $0.06
zielony: raises $0.12 to $0.18
sewq55: folds 
Loto70: raises $0.26 to $0.44
Scaaalll: folds 
zielony: calls $0.26
*** FLOP *** [4s As 3s]
Loto70: bets $0.26
zielony: folds 
Uncalled bet ($0.26) returned to Loto70
Loto70 collected $0.92 from pot
Loto70: doesn't show hand 
*** SUMMARY ***
Total pot $0.95 | Rake $0.03 
Board [4s As 3s]
Seat 1: zielony (button) folded on the Flop
Seat 2: sewq55 (small blind) folded before Flop
Seat 3: Loto70 (big blind) collected ($0.92)
Seat 4: Mikeloko182 folded before Flop (didn't bet)
Seat 5: texashenry2 folded before Flop (didn't bet)
Seat 6: Scaaalll folded before Flop



PokerStars Zoom Hand #229231463597:  Hold'em No Limit ($0.01/$0.02) - 2021/08/21 22:15:10 CET [2021/08/21 16:15:10 ET]
Table 'Halley' 6-max Seat #1 is the button
Seat 1: so0love ($4.34 in chips) 
Seat 2: LuckyCheewey ($8.79 in chips) 
Seat 3: Clavis Noa ($2.75 in chips) 
Seat 4: Scaaalll ($3.08 in chips) 
Seat 5: Allexii ($2.49 in chips) 
Seat 6: Mikeloko182 ($2 in chips) 
LuckyCheewey: posts small blind $0.01
Clavis Noa: posts big blind $0.02
*** HOLE CARDS ***
Dealt to Scaaalll [9d 6h]
Scaaalll: folds 
Allexii: folds 
Allexii is disconnected 
Mikeloko182: folds 
so0love: raises $0.02 to $0.04
LuckyCheewey: folds 
Clavis Noa: calls $0.02
*** FLOP *** [9h Js 9c]
Clavis Noa: checks 
so0love: bets $0.04
Clavis Noa: calls $0.04
*** TURN *** [9h Js 9c] [Ks]
Clavis Noa: checks 
so0love: checks 
*** RIVER *** [9h Js 9c Ks] [2s]
Clavis Noa: checks 
so0love: checks 
*** SHOW DOWN ***
Clavis Noa: shows [7h Th] (a pair of Nines)
so0love: mucks hand 
Clavis Noa collected $0.16 from pot
*** SUMMARY ***
Total pot $0.17 | Rake $0.01 
Board [9h Js 9c Ks 2s]
Seat 1: so0love (button) mucked [7c 6s]
Seat 2: LuckyCheewey (small blind) folded before Flop
Seat 3: Clavis Noa (big blind) showed [7h Th] and won ($0.16) with a pair of Nines
Seat 4: Scaaalll folded before Flop (didn't bet)
Seat 5: Allexii folded before Flop (didn't bet)
Seat 6: Mikeloko182 folded before Flop (didn't bet)



PokerStars Zoom Hand #229231472302:  Hold'em No Limit ($0.01/$0.02) - 2021/08/21 22:15:29 CET [2021/08/21 16:15:29 ET]
Table 'Halley' 6-max Seat #1 is the button
Seat 1: vovo4kapooh ($2.22 in chips) 
Seat 2: Scaaalll ($3.08 in chips) 
Seat 3: WithMyWalker ($3.94 in chips) 
Seat 4: Luben_76 ($2.04 in chips) 
Seat 5: KRITAYA ($1.12 in chips) 
Seat 6: nemat_g ($2.16 in chips) 
Scaaalll: posts small blind $0.01
WithMyWalker: posts big blind $0.02
*** HOLE CARDS ***
Dealt to Scaaalll [3h 2s]
Luben_76: folds 
KRITAYA: folds 
nemat_g: raises $0.04 to $0.06
vovo4kapooh: folds 
Scaaalll: folds 
WithMyWalker: folds 
Uncalled bet ($0.04) returned to nemat_g
nemat_g collected $0.05 from pot
nemat_g: doesn't show hand 
*** SUMMARY ***
Total pot $0.05 | Rake $0 
Seat 1: vovo4kapooh (button) folded before Flop (didn't bet)
Seat 2: Scaaalll (small blind) folded before Flop
Seat 3: WithMyWalker (big blind) folded before Flop
Seat 4: Luben_76 folded before Flop (didn't bet)
Seat 5: KRITAYA folded before Flop (didn't bet)
Seat 6: nemat_g collected ($0.05)



PokerStars Zoom Hand #229231468161:  Hold'em No Limit ($0.01/$0.02) - 2021/08/21 22:15:20 CET [2021/08/21 16:15:20 ET]
Table 'Halley' 6-max Seat #1 is the button
Seat 1: stipe 31 ($2.86 in chips) 
Seat 2: oleg12312441 ($1.85 in chips) 
Seat 3: tragedy1986 ($2.35 in chips) 
Seat 4: ser313131 ($6.82 in chips) 
Seat 5: Scaaalll ($3.08 in chips) 
Seat 6: ChowMangao ($5.59 in chips) 
oleg12312441: posts small blind $0.01
tragedy1986: posts big blind $0.02
*** HOLE CARDS ***
Dealt to Scaaalll [5s 3d]
ser313131: calls $0.02
Scaaalll: folds 
ChowMangao: folds 
stipe 31: calls $0.02
oleg12312441: calls $0.01
tragedy1986: raises $0.31 to $0.33
oleg12312441 is disconnected 
ser313131: folds 
stipe 31: folds 
oleg12312441: folds 
Uncalled bet ($0.31) returned to tragedy1986
tragedy1986 collected $0.08 from pot
tragedy1986: doesn't show hand 
*** SUMMARY ***
Total pot $0.08 | Rake $0 
Seat 1: stipe 31 (button) folded before Flop
Seat 2: oleg12312441 (small blind) folded before Flop
Seat 3: tragedy1986 (big blind) collected ($0.08)
Seat 4: ser313131 folded before Flop
Seat 5: Scaaalll folded before Flop (didn't bet)
Seat 6: ChowMangao folded before Flop (didn't bet)



PokerStars Zoom Hand #229231480898:  Hold'em No Limit ($0.01/$0.02) - 2021/08/21 22:15:48 CET [2021/08/21 16:15:48 ET]
Table 'Halley' 6-max Seat #1 is the button
Seat 1: Scaaalll ($3.07 in chips) 
Seat 2: stipe 31 ($2.84 in chips) 
Seat 3: KoAlRy ($2 in chips) 
Seat 4: Kreodont1987 ($4.17 in chips) 
Seat 5: HubertFroh ($2.46 in chips) 
Seat 6: olcham7 ($2 in chips) 
stipe 31: posts small blind $0.01
KoAlRy: posts big blind $0.02
*** HOLE CARDS ***
Dealt to Scaaalll [2s 6s]
Kreodont1987: raises $0.03 to $0.05
HubertFroh: folds 
olcham7: folds 
Scaaalll: folds 
stipe 31: folds 
KoAlRy: folds 
Uncalled bet ($0.03) returned to Kreodont1987
Kreodont1987 collected $0.05 from pot
Kreodont1987: doesn't show hand 
*** SUMMARY ***
Total pot $0.05 | Rake $0 
Seat 1: Scaaalll (button) folded before Flop (didn't bet)
Seat 2: stipe 31 (small blind) folded before Flop
Seat 3: KoAlRy (big blind) folded before Flop
Seat 4: Kreodont1987 collected ($0.05)
Seat 5: HubertFroh folded before Flop (didn't bet)
Seat 6: olcham7 folded before Flop (didn't bet)



PokerStars Zoom Hand #229231486310:  Hold'em No Limit ($0.01/$0.02) - 2021/08/21 22:16:00 CET [2021/08/21 16:16:00 ET]
Table 'Halley' 6-max Seat #1 is the button
Seat 1: NoLuckLeck ($2.58 in chips) 
Seat 2: Blaackie ($1.08 in chips) 
Seat 3: Scaaalll ($3.07 in chips) 
Seat 4: Reipinguimm ($2.43 in chips) 
Seat 5: Thaleshs ($2 in chips) 
Seat 6: satti1337 ($2.03 in chips) 
Blaackie: posts small blind $0.01
Scaaalll: posts big blind $0.02
*** HOLE CARDS ***
Dealt to Scaaalll [Kh 8h]
Reipinguimm: folds 
Thaleshs: raises $0.04 to $0.06
satti1337: folds 
NoLuckLeck: folds 
Blaackie: folds 
Scaaalll: folds 
Uncalled bet ($0.04) returned to Thaleshs
Thaleshs collected $0.05 from pot
Thaleshs: doesn't show hand 
*** SUMMARY ***
Total pot $0.05 | Rake $0 
Seat 1: NoLuckLeck (button) folded before Flop (didn't bet)
Seat 2: Blaackie (small blind) folded before Flop
Seat 3: Scaaalll (big blind) folded before Flop
Seat 4: Reipinguimm folded before Flop (didn't bet)
Seat 5: Thaleshs collected ($0.05)
Seat 6: satti1337 folded before Flop (didn't bet)



PokerStars Zoom Hand #229231465384:  Hold'em No Limit ($0.01/$0.02) - 2021/08/21 22:15:14 CET [2021/08/21 16:15:14 ET]
Table 'Halley' 6-max Seat #1 is the button
Seat 1: LuckyCheewey ($2.22 in chips) 
Seat 2: dinoVIEIRA ($2.58 in chips) 
Seat 3: rekopo203 ($6.31 in chips) 
Seat 4: Scaaalll ($3.08 in chips) 
Seat 5: F_oksi(BLR) ($1.74 in chips) 
Seat 6: boa juice ($1.83 in chips) 
dinoVIEIRA: posts small blind $0.01
rekopo203: posts big blind $0.02
*** HOLE CARDS ***
Dealt to Scaaalll [2d Jc]
boa juice is disconnected 
Scaaalll: folds 
F_oksi(BLR): raises $0.03 to $0.05
boa juice: folds 
LuckyCheewey: calls $0.05
dinoVIEIRA: folds 
rekopo203: calls $0.03
*** FLOP *** [4d Jd 5d]
rekopo203: checks 
F_oksi(BLR): checks 
LuckyCheewey: checks 
*** TURN *** [4d Jd 5d] [Kh]
rekopo203: checks 
F_oksi(BLR): checks 
LuckyCheewey: checks 
*** RIVER *** [4d Jd 5d Kh] [2h]
rekopo203: checks 
F_oksi(BLR): checks 
LuckyCheewey: checks 
*** SHOW DOWN ***
rekopo203: shows [6h 6d] (a pair of Sixes)
F_oksi(BLR): mucks hand 
LuckyCheewey: mucks hand 
rekopo203 collected $0.15 from pot
*** SUMMARY ***
Total pot $0.16 | Rake $0.01 
Board [4d Jd 5d Kh 2h]
Seat 1: LuckyCheewey (button) mucked [Ah 8h]
Seat 2: dinoVIEIRA (small blind) folded before Flop
Seat 3: rekopo203 (big blind) showed [6h 6d] and won ($0.15) with a pair of Sixes
Seat 4: Scaaalll folded before Flop (didn't bet)
Seat 5: F_oksi(BLR) mucked [9c Tc]
Seat 6: boa juice folded before Flop (didn't bet)



PokerStars Zoom Hand #229231499680:  Hold'em No Limit ($0.01/$0.02) - 2021/08/21 22:16:29 CET [2021/08/21 16:16:29 ET]
Table 'Halley' 6-max Seat #1 is the button
Seat 1: rpycmbEM ($4.40 in chips) 
Seat 2: Scaaalll ($3.05 in chips) 
Seat 3: pavlo8855 ($2 in chips) 
Seat 4: ChuckGaylordIII ($2 in chips) 
Seat 5: SIGREX ($3.24 in chips) 
Seat 6: estelionat171 ($0.94 in chips) 
Scaaalll: posts small blind $0.01
pavlo8855: posts big blind $0.02
*** HOLE CARDS ***
Dealt to Scaaalll [8s Kd]
ChuckGaylordIII: raises $0.04 to $0.06
SIGREX: folds 
estelionat171: folds 
rpycmbEM: folds 
Scaaalll: folds 
pavlo8855: calls $0.04
*** FLOP *** [3c 9d 5d]
pavlo8855: checks 
ChuckGaylordIII: checks 
*** TURN *** [3c 9d 5d] [Kh]
pavlo8855: checks 
ChuckGaylordIII: checks 
*** RIVER *** [3c 9d 5d Kh] [Ks]
pavlo8855: checks 
ChuckGaylordIII: checks 
*** SHOW DOWN ***
pavlo8855: shows [Qc Ac] (a pair of Kings)
ChuckGaylordIII: mucks hand 
pavlo8855 collected $0.13 from pot
*** SUMMARY ***
Total pot $0.13 | Rake $0 
Board [3c 9d 5d Kh Ks]
Seat 1: rpycmbEM (button) folded before Flop (didn't bet)
Seat 2: Scaaalll (small blind) folded before Flop
Seat 3: pavlo8855 (big blind) showed [Qc Ac] and won ($0.13) with a pair of Kings
Seat 4: ChuckGaylordIII mucked [Qh Th]
Seat 5: SIGREX folded before Flop (didn't bet)
Seat 6: estelionat171 folded before Flop (didn't bet)



PokerStars Zoom Hand #229231494616:  Hold'em No Limit ($0.01/$0.02) - 2021/08/21 22:16:18 CET [2021/08/21 16:16:18 ET]
Table 'Halley' 6-max Seat #1 is the button
Seat 1: Emilmoller1 ($1.40 in chips) 
Seat 2: xxRoseIloveu ($7.98 in chips) 
Seat 3: SIGREX ($2.65 in chips) 
Seat 4: vovo4kapooh ($2 in chips) 
Seat 5: boa juice ($1.80 in chips) 
Seat 6: Scaaalll ($3.05 in chips) 
xxRoseIloveu: posts small blind $0.01
SIGREX: posts big blind $0.02
*** HOLE CARDS ***
Dealt to Scaaalll [8h Js]
boa juice is disconnected 
vovo4kapooh: folds 
boa juice: folds 
Scaaalll: folds 
Emilmoller1: folds 
xxRoseIloveu: raises $0.04 to $0.06
SIGREX: calls $0.04
*** FLOP *** [2c 9d 2h]
xxRoseIloveu: checks 
SIGREX: bets $0.04
xxRoseIloveu: calls $0.04
*** TURN *** [2c 9d 2h] [4d]
xxRoseIloveu: checks 
SIGREX: bets $0.06
xxRoseIloveu: calls $0.06
*** RIVER *** [2c 9d 2h 4d] [6h]
xxRoseIloveu: checks 
SIGREX: bets $0.47
xxRoseIloveu: folds 
Uncalled bet ($0.47) returned to SIGREX
SIGREX collected $0.31 from pot
SIGREX: doesn't show hand 
*** SUMMARY ***
Total pot $0.32 | Rake $0.01 
Board [2c 9d 2h 4d 6h]
Seat 1: Emilmoller1 (button) folded before Flop (didn't bet)
Seat 2: xxRoseIloveu (small blind) folded on the River
Seat 3: SIGREX (big blind) collected ($0.31)
Seat 4: vovo4kapooh folded before Flop (didn't bet)
Seat 5: boa juice folded before Flop (didn't bet)
Seat 6: Scaaalll folded before Flop (didn't bet)



PokerStars Zoom Hand #229231501501:  Hold'em No Limit ($0.01/$0.02) - 2021/08/21 22:16:33 CET [2021/08/21 16:16:33 ET]
Table 'Halley' 6-max Seat #1 is the button
Seat 1: rekopo203 ($6.41 in chips) 
Seat 2: stealth_ua ($4.15 in chips) 
Seat 3: mheronmagno ($2.74 in chips) 
Seat 4: KoAlRy ($2.17 in chips) 
Seat 5: Scaaalll ($3.04 in chips) 
Seat 6: yeahyeeei ($0.92 in chips) 
stealth_ua: posts small blind $0.01
mheronmagno: posts big blind $0.02
*** HOLE CARDS ***
Dealt to Scaaalll [Ah 8h]
KoAlRy: folds 
Scaaalll: raises $0.04 to $0.06
yeahyeeei: folds 
rekopo203: folds 
stealth_ua: folds 
mheronmagno: calls $0.04
*** FLOP *** [Jd As 7c]
mheronmagno: checks 
Scaaalll: bets $0.08
mheronmagno: calls $0.08
*** TURN *** [Jd As 7c] [4s]
mheronmagno: checks 
Scaaalll: checks 
*** RIVER *** [Jd As 7c 4s] [3s]
mheronmagno: checks 
Scaaalll: bets $0.12
mheronmagno: calls $0.12
*** SHOW DOWN ***
Scaaalll: shows [Ah 8h] (a pair of Aces)
mheronmagno: mucks hand 
Scaaalll collected $0.51 from pot
*** SUMMARY ***
Total pot $0.53 | Rake $0.02 
Board [Jd As 7c 4s 3s]
Seat 1: rekopo203 (button) folded before Flop (didn't bet)
Seat 2: stealth_ua (small blind) folded before Flop
Seat 3: mheronmagno (big blind) mucked [Tc Jc]
Seat 4: KoAlRy folded before Flop (didn't bet)
Seat 5: Scaaalll showed [Ah 8h] and won ($0.51) with a pair of Aces
Seat 6: yeahyeeei folded before Flop (didn't bet)



PokerStars Zoom Hand #229231524480:  Hold'em No Limit ($0.01/$0.02) - 2021/08/21 22:17:23 CET [2021/08/21 16:17:23 ET]
Table 'Halley' 6-max Seat #1 is the button
Seat 1: Scaaalll ($3.29 in chips) 
Seat 2: PapiMik3 ($2.16 in chips) 
Seat 3: benny6692 ($5.03 in chips) 
Seat 4: jamal514 ($2 in chips) 
Seat 5: 888lifeIS ($2.69 in chips) 
Seat 6: Agno$tic ($2.55 in chips) 
PapiMik3: posts small blind $0.01
benny6692: posts big blind $0.02
*** HOLE CARDS ***
Dealt to Scaaalll [6h 5d]
jamal514: folds 
888lifeIS: folds 
Agno$tic: folds 
Scaaalll: folds 
PapiMik3: folds 
Uncalled bet ($0.01) returned to benny6692
benny6692 collected $0.02 from pot
benny6692: doesn't show hand 
*** SUMMARY ***
Total pot $0.02 | Rake $0 
Seat 1: Scaaalll (button) folded before Flop (didn't bet)
Seat 2: PapiMik3 (small blind) folded before Flop
Seat 3: benny6692 (big blind) collected ($0.02)
Seat 4: jamal514 folded before Flop (didn't bet)
Seat 5: 888lifeIS folded before Flop (didn't bet)
Seat 6: Agno$tic folded before Flop (didn't bet)



PokerStars Zoom Hand #229231527244:  Hold'em No Limit ($0.01/$0.02) - 2021/08/21 22:17:29 CET [2021/08/21 16:17:29 ET]
Table 'Halley' 6-max Seat #1 is the button
Seat 1: Colby1771 ($2.02 in chips) 
Seat 2: davidalejag ($2.79 in chips) 
Seat 3: RoughRafff ($3.08 in chips) 
Seat 4: ADWish ($1.52 in chips) 
Seat 5: nV6TR ($5.77 in chips) 
Seat 6: Scaaalll ($3.29 in chips) 
davidalejag: posts small blind $0.01
RoughRafff: posts big blind $0.02
*** HOLE CARDS ***
Dealt to Scaaalll [Ac Kd]
ADWish: folds 
nV6TR: folds 
Scaaalll: raises $0.04 to $0.06
Colby1771: folds 
davidalejag: folds 
RoughRafff: raises $0.20 to $0.26
Scaaalll: calls $0.20
*** FLOP *** [7h 2c 9c]
RoughRafff: bets $0.43
Scaaalll: folds 
Uncalled bet ($0.43) returned to RoughRafff
RoughRafff collected $0.51 from pot
RoughRafff: doesn't show hand 
*** SUMMARY ***
Total pot $0.53 | Rake $0.02 
Board [7h 2c 9c]
Seat 1: Colby1771 (button) folded before Flop (didn't bet)
Seat 2: davidalejag (small blind) folded before Flop
Seat 3: RoughRafff (big blind) collected ($0.51)
Seat 4: ADWish folded before Flop (didn't bet)
Seat 5: nV6TR folded before Flop (didn't bet)
Seat 6: Scaaalll folded on the Flop



PokerStars Zoom Hand #229231546083:  Hold'em No Limit ($0.01/$0.02) - 2021/08/21 22:18:10 CET [2021/08/21 16:18:10 ET]
Table 'Halley' 6-max Seat #1 is the button
Seat 1: Phoenixxxxxxxx ($2 in chips) 
Seat 2: 09mexanik09 ($0.21 in chips) 
Seat 3: Emilmoller1 ($1.54 in chips) 
Seat 4: xxRoseIloveu ($7.87 in chips) 
Seat 5: Scaaalll ($3.01 in chips) 
Seat 6: AndreaBsAs ($2.43 in chips) 
09mexanik09: posts small blind $0.01
Emilmoller1: posts big blind $0.02
*** HOLE CARDS ***
Dealt to Scaaalll [6s 8h]
xxRoseIloveu: folds 
Scaaalll: folds 
AndreaBsAs: raises $0.04 to $0.06
Phoenixxxxxxxx: folds 
09mexanik09: folds 
Emilmoller1: folds 
Uncalled bet ($0.04) returned to AndreaBsAs
AndreaBsAs collected $0.05 from pot
AndreaBsAs: doesn't show hand 
*** SUMMARY ***
Total pot $0.05 | Rake $0 
Seat 1: Phoenixxxxxxxx (button) folded before Flop (didn't bet)
Seat 2: 09mexanik09 (small blind) folded before Flop
Seat 3: Emilmoller1 (big blind) folded before Flop
Seat 4: xxRoseIloveu folded before Flop (didn't bet)
Seat 5: Scaaalll folded before Flop (didn't bet)
Seat 6: AndreaBsAs collected ($0.05)



PokerStars Zoom Hand #229231540550:  Hold'em No Limit ($0.01/$0.02) - 2021/08/21 22:17:58 CET [2021/08/21 16:17:58 ET]
Table 'Halley' 6-max Seat #1 is the button
Seat 1: SIGREX ($3.18 in chips) 
Seat 2: BigTestIcicle ($2.05 in chips) 
Seat 3: Scaaalll ($3.03 in chips) 
Seat 4: Flankeris ($11.51 in chips) 
Seat 5: Henry Chinasky ($1.02 in chips) 
Seat 6: 77omsk ($2.63 in chips) 
BigTestIcicle: posts small blind $0.01
Scaaalll: posts big blind $0.02
*** HOLE CARDS ***
Dealt to Scaaalll [9h 4c]
Flankeris: raises $0.04 to $0.06
Henry Chinasky: raises $0.15 to $0.21
77omsk: folds 
SIGREX: raises $0.24 to $0.45
BigTestIcicle: folds 
Scaaalll: folds 
Flankeris: folds 
Henry Chinasky: raises $0.57 to $1.02 and is all-in
SIGREX: calls $0.57
*** FLOP *** [Kc 9c 5d]
*** TURN *** [Kc 9c 5d] [As]
*** RIVER *** [Kc 9c 5d As] [Tc]
*** SHOW DOWN ***
Henry Chinasky: shows [Kh Ad] (two pair, Aces and Kings)
SIGREX: shows [Jc Jd] (a pair of Jacks)
Henry Chinasky collected $2.06 from pot
*** SUMMARY ***
Total pot $2.13 | Rake $0.07 
Board [Kc 9c 5d As Tc]
Seat 1: SIGREX (button) showed [Jc Jd] and lost with a pair of Jacks
Seat 2: BigTestIcicle (small blind) folded before Flop
Seat 3: Scaaalll (big blind) folded before Flop
Seat 4: Flankeris folded before Flop
Seat 5: Henry Chinasky showed [Kh Ad] and won ($2.06) with two pair, Aces and Kings
Seat 6: 77omsk folded before Flop (didn't bet)



PokerStars Zoom Hand #229231547894:  Hold'em No Limit ($0.01/$0.02) - 2021/08/21 22:18:14 CET [2021/08/21 16:18:14 ET]
Table 'Halley' 6-max Seat #1 is the button
Seat 1: Tacojesuscrisp ($3.45 in chips) 
Seat 2: Scaaalll ($3.01 in chips) 
Seat 3: ser313131 ($2.07 in chips) 
Seat 4: Healthys07 ($5.45 in chips) 
Seat 5: Nihility77 ($2.84 in chips) 
Seat 6: Kreodont1987 ($5.56 in chips) 
Scaaalll: posts small blind $0.01
ser313131: posts big blind $0.02
*** HOLE CARDS ***
Dealt to Scaaalll [Qs 7d]
Healthys07: folds 
Nihility77: raises $0.03 to $0.05
Kreodont1987: folds 
Tacojesuscrisp: folds 
Scaaalll: folds 
ser313131: folds 
Uncalled bet ($0.03) returned to Nihility77
Nihility77 collected $0.05 from pot
Nihility77: doesn't show hand 
*** SUMMARY ***
Total pot $0.05 | Rake $0 
Seat 1: Tacojesuscrisp (button) folded before Flop (didn't bet)
Seat 2: Scaaalll (small blind) folded before Flop
Seat 3: ser313131 (big blind) folded before Flop
Seat 4: Healthys07 folded before Flop (didn't bet)
Seat 5: Nihility77 collected ($0.05)
Seat 6: Kreodont1987 folded before Flop (didn't bet)



PokerStars Zoom Hand #229231544232:  Hold'em No Limit ($0.01/$0.02) - 2021/08/21 22:18:06 CET [2021/08/21 16:18:06 ET]
Table 'Halley' 6-max Seat #1 is the button
Seat 1: estelionat171 ($0.92 in chips) 
Seat 2: wieksi9845 ($0.65 in chips) 
Seat 3: Tabitaji ($2.61 in chips) 
Seat 4: Scaaalll ($3.01 in chips) 
Seat 5: maliniak75 ($1.63 in chips) 
Seat 6: willmorel ($2 in chips) 
wieksi9845: posts small blind $0.01
Tabitaji: posts big blind $0.02
*** HOLE CARDS ***
Dealt to Scaaalll [3c 9s]
Scaaalll: folds 
maliniak75: folds 
willmorel: folds 
estelionat171: folds 
wieksi9845: calls $0.01
Tabitaji: checks 
*** FLOP *** [2d 9c Js]
wieksi9845: bets $0.04
Tabitaji: folds 
Uncalled bet ($0.04) returned to wieksi9845
wieksi9845 collected $0.04 from pot
wieksi9845: doesn't show hand 
*** SUMMARY ***
Total pot $0.04 | Rake $0 
Board [2d 9c Js]
Seat 1: estelionat171 (button) folded before Flop (didn't bet)
Seat 2: wieksi9845 (small blind) collected ($0.04)
Seat 3: Tabitaji (big blind) folded on the Flop
Seat 4: Scaaalll folded before Flop (didn't bet)
Seat 5: maliniak75 folded before Flop (didn't bet)
Seat 6: willmorel folded before Flop (didn't bet)



PokerStars Zoom Hand #229231554787:  Hold'em No Limit ($0.01/$0.02) - 2021/08/21 22:18:29 CET [2021/08/21 16:18:29 ET]
Table 'Halley' 6-max Seat #1 is the button
Seat 1: Scaaalll ($3 in chips) 
Seat 2: pphit ($2 in chips) 
Seat 3: IWMTW ($1.04 in chips) 
Seat 4: Nihility77 ($5.62 in chips) 
Seat 5: ugi-dugi ($2.78 in chips) 
Seat 6: Kkamm ($2.22 in chips) 
pphit: posts small blind $0.01
IWMTW: posts big blind $0.02
*** HOLE CARDS ***
Dealt to Scaaalll [4c Ad]
Nihility77: folds 
ugi-dugi: folds 
Kkamm: folds 
Scaaalll: raises $0.02 to $0.04
pphit: folds 
IWMTW: folds 
Uncalled bet ($0.02) returned to Scaaalll
Scaaalll collected $0.05 from pot
Scaaalll: doesn't show hand 
*** SUMMARY ***
Total pot $0.05 | Rake $0 
Seat 1: Scaaalll (button) collected ($0.05)
Seat 2: pphit (small blind) folded before Flop
Seat 3: IWMTW (big blind) folded before Flop
Seat 4: Nihility77 folded before Flop (didn't bet)
Seat 5: ugi-dugi folded before Flop (didn't bet)
Seat 6: Kkamm folded before Flop (didn't bet)



PokerStars Zoom Hand #229231565437:  Hold'em No Limit ($0.01/$0.02) - 2021/08/21 22:18:52 CET [2021/08/21 16:18:52 ET]
Table 'Halley' 6-max Seat #1 is the button
Seat 1: KatedratiK ($1.99 in chips) 
Seat 2: sewq55 ($1.03 in chips) 
Seat 3: Vanekakqj ($1.82 in chips) 
Seat 4: shingo594 ($3.61 in chips) 
Seat 5: ppluiaule ($4.23 in chips) 
Seat 6: Scaaalll ($3.03 in chips) 
sewq55: posts small blind $0.01
Vanekakqj: posts big blind $0.02
*** HOLE CARDS ***
Dealt to Scaaalll [Qd Th]
shingo594: folds 
ppluiaule: folds 
shingo594 is disconnected 
Scaaalll: raises $0.04 to $0.06
KatedratiK: folds 
sewq55: folds 
Vanekakqj: folds 
Uncalled bet ($0.04) returned to Scaaalll
Scaaalll collected $0.05 from pot
Scaaalll: doesn't show hand 
*** SUMMARY ***
Total pot $0.05 | Rake $0 
Seat 1: KatedratiK (button) folded before Flop (didn't bet)
Seat 2: sewq55 (small blind) folded before Flop
Seat 3: Vanekakqj (big blind) folded before Flop
Seat 4: shingo594 folded before Flop (didn't bet)
Seat 5: ppluiaule folded before Flop (didn't bet)
Seat 6: Scaaalll collected ($0.05)



PokerStars Zoom Hand #229231583918:  Hold'em No Limit ($0.01/$0.02) - 2021/08/21 22:19:32 CET [2021/08/21 16:19:32 ET]
Table 'Halley' 6-max Seat #1 is the button
Seat 1: xmaksimus ($3.80 in chips) 
Seat 2: MATIdf365 ($2.22 in chips) 
Seat 3: Scaaalll ($3.06 in chips) 
Seat 4: NoLuckLeck ($2.68 in chips) 
Seat 5: OFSHOR ($3.16 in chips) 
Seat 6: igara tigara ($7.09 in chips) 
MATIdf365: posts small blind $0.01
Scaaalll: posts big blind $0.02
*** HOLE CARDS ***
Dealt to Scaaalll [2d Ks]
NoLuckLeck: folds 
OFSHOR: folds 
igara tigara: folds 
xmaksimus: raises $0.04 to $0.06
MATIdf365: folds 
Scaaalll: folds 
Uncalled bet ($0.04) returned to xmaksimus
xmaksimus collected $0.05 from pot
xmaksimus: doesn't show hand 
*** SUMMARY ***
Total pot $0.05 | Rake $0 
Seat 1: xmaksimus (button) collected ($0.05)
Seat 2: MATIdf365 (small blind) folded before Flop
Seat 3: Scaaalll (big blind) folded before Flop
Seat 4: NoLuckLeck folded before Flop (didn't bet)
Seat 5: OFSHOR folded before Flop (didn't bet)
Seat 6: igara tigara folded before Flop (didn't bet)



PokerStars Zoom Hand #229231572894:  Hold'em No Limit ($0.01/$0.02) - 2021/08/21 22:19:08 CET [2021/08/21 16:19:08 ET]
Table 'Halley' 6-max Seat #1 is the button
Seat 1: viktor2935 ($0.94 in chips) 
Seat 2: KRITAYA ($1.20 in chips) 
Seat 3: Kreodont1987 ($3.05 in chips) 
Seat 4: guntren.ps ($2 in chips) 
Seat 5: Scaaalll ($3.06 in chips) 
Seat 6: vovo4kapooh ($2.72 in chips) 
KRITAYA: posts small blind $0.01
Kreodont1987: posts big blind $0.02
*** HOLE CARDS ***
Dealt to Scaaalll [6h 2s]
guntren.ps: folds 
Scaaalll: folds 
vovo4kapooh: folds 
viktor2935: raises $0.06 to $0.08
KRITAYA: folds 
Kreodont1987: calls $0.06
*** FLOP *** [Qc 4s 2h]
Kreodont1987: checks 
viktor2935: bets $0.06
Kreodont1987: raises $0.16 to $0.22
viktor2935: calls $0.16
*** TURN *** [Qc 4s 2h] [5d]
Kreodont1987: checks 
viktor2935: checks 
*** RIVER *** [Qc 4s 2h 5d] [Kd]
Kreodont1987: checks 
viktor2935: checks 
*** SHOW DOWN ***
Kreodont1987: shows [Td 9d] (high card King)
viktor2935: shows [8s 8d] (a pair of Eights)
viktor2935 collected $0.59 from pot
*** SUMMARY ***
Total pot $0.61 | Rake $0.02 
Board [Qc 4s 2h 5d Kd]
Seat 1: viktor2935 (button) showed [8s 8d] and won ($0.59) with a pair of Eights
Seat 2: KRITAYA (small blind) folded before Flop
Seat 3: Kreodont1987 (big blind) showed [Td 9d] and lost with high card King
Seat 4: guntren.ps folded before Flop (didn't bet)
Seat 5: Scaaalll folded before Flop (didn't bet)
Seat 6: vovo4kapooh folded before Flop (didn't bet)



PokerStars Zoom Hand #229231589853:  Hold'em No Limit ($0.01/$0.02) - 2021/08/21 22:19:45 CET [2021/08/21 16:19:45 ET]
Table 'Halley' 6-max Seat #1 is the button
Seat 1: Daino G ($2.03 in chips) 
Seat 2: Scaaalll ($3.04 in chips) 
Seat 3: rodrigovini ($2.22 in chips) 
Seat 4: KRITAYA ($1.20 in chips) 
Seat 5: xmaksimus ($3.83 in chips) 
Seat 6: Healthys07 ($4.92 in chips) 
Scaaalll: posts small blind $0.01
rodrigovini: posts big blind $0.02
*** HOLE CARDS ***
Dealt to Scaaalll [3s 5c]
KRITAYA: folds 
xmaksimus: folds 
Healthys07: raises $0.03 to $0.05
Daino G: folds 
Scaaalll: folds 
rodrigovini: folds 
Uncalled bet ($0.03) returned to Healthys07
Healthys07 collected $0.05 from pot
Healthys07: doesn't show hand 
*** SUMMARY ***
Total pot $0.05 | Rake $0 
Seat 1: Daino G (button) folded before Flop (didn't bet)
Seat 2: Scaaalll (small blind) folded before Flop
Seat 3: rodrigovini (big blind) folded before Flop
Seat 4: KRITAYA folded before Flop (didn't bet)
Seat 5: xmaksimus folded before Flop (didn't bet)
Seat 6: Healthys07 collected ($0.05)



PokerStars Zoom Hand #229231603195:  Hold'em No Limit ($0.01/$0.02) - 2021/08/21 22:20:14 CET [2021/08/21 16:20:14 ET]
Table 'Halley' 6-max Seat #1 is the button
Seat 1: robokop358 ($1.15 in chips) 
Seat 2: causavera ($4.09 in chips) 
Seat 3: Herr.Hikke ($2.74 in chips) 
Seat 4: Scaaalll ($3.03 in chips) 
Seat 5: malandro733 ($2 in chips) 
Seat 6: ZNFR77 ($0.81 in chips) 
causavera: posts small blind $0.01
Herr.Hikke: posts big blind $0.02
*** HOLE CARDS ***
Dealt to Scaaalll [7c 8d]
Scaaalll: folds 
malandro733: folds 
ZNFR77: folds 
robokop358: folds 
causavera: folds 
Uncalled bet ($0.01) returned to Herr.Hikke
Herr.Hikke collected $0.02 from pot
Herr.Hikke: doesn't show hand 
*** SUMMARY ***
Total pot $0.02 | Rake $0 
Seat 1: robokop358 (button) folded before Flop (didn't bet)
Seat 2: causavera (small blind) folded before Flop
Seat 3: Herr.Hikke (big blind) collected ($0.02)
Seat 4: Scaaalll folded before Flop (didn't bet)
Seat 5: malandro733 folded before Flop (didn't bet)
Seat 6: ZNFR77 folded before Flop (didn't bet)



PokerStars Zoom Hand #229231597188:  Hold'em No Limit ($0.01/$0.02) - 2021/08/21 22:20:01 CET [2021/08/21 16:20:01 ET]
Table 'Halley' 6-max Seat #1 is the button
Seat 1: Scaaalll ($3.03 in chips) 
Seat 2: Kreodont1987 ($2.75 in chips) 
Seat 3: Red Sky 15 ($9.14 in chips) 
Seat 4: Colby1771 ($2 in chips) 
Seat 5: keb1981 ($2.87 in chips) 
Seat 6: ARTMVSLV ($4.19 in chips) 
Kreodont1987: posts small blind $0.01
Red Sky 15: posts big blind $0.02
*** HOLE CARDS ***
Dealt to Scaaalll [2c 3d]
Colby1771: folds 
keb1981: folds 
ARTMVSLV: raises $0.02 to $0.04
Scaaalll: folds 
Kreodont1987: folds 
Red Sky 15: calls $0.02
*** FLOP *** [9h 6c Ac]
Red Sky 15: checks 
ARTMVSLV: checks 
*** TURN *** [9h 6c Ac] [9d]
Red Sky 15: bets $0.06
ARTMVSLV: folds 
Uncalled bet ($0.06) returned to Red Sky 15
Red Sky 15 collected $0.09 from pot
Red Sky 15: doesn't show hand 
*** SUMMARY ***
Total pot $0.09 | Rake $0 
Board [9h 6c Ac 9d]
Seat 1: Scaaalll (button) folded before Flop (didn't bet)
Seat 2: Kreodont1987 (small blind) folded before Flop
Seat 3: Red Sky 15 (big blind) collected ($0.09)
Seat 4: Colby1771 folded before Flop (didn't bet)
Seat 5: keb1981 folded before Flop (didn't bet)
Seat 6: ARTMVSLV folded on the Turn



PokerStars Zoom Hand #229231579377:  Hold'em No Limit ($0.01/$0.02) - 2021/08/21 22:19:22 CET [2021/08/21 16:19:22 ET]
Table 'Halley' 6-max Seat #1 is the button
Seat 1: RaulacateFolds ($2.05 in chips) 
Seat 2: juraa14 ($1.59 in chips) 
Seat 3: GVMELLO ($2 in chips) 
Seat 4: Scaaalll ($3.06 in chips) 
Seat 5: Xlavariable ($2.05 in chips) 
Seat 6: HWalshy ($1.95 in chips) 
juraa14: posts small blind $0.01
GVMELLO: posts big blind $0.02
*** HOLE CARDS ***
Dealt to Scaaalll [7s Ks]
Scaaalll: folds 
Xlavariable: folds 
HWalshy: raises $0.02 to $0.04
RaulacateFolds: raises $0.14 to $0.18
juraa14: folds 
GVMELLO: folds 
HWalshy: calls $0.14
*** FLOP *** [Ac 6d 5s]
HWalshy: checks 
RaulacateFolds: bets $0.13
HWalshy: calls $0.13
*** TURN *** [Ac 6d 5s] [6c]
HWalshy: bets $1.64 and is all-in
RaulacateFolds: folds 
Uncalled bet ($1.64) returned to HWalshy
HWalshy collected $0.63 from pot
HWalshy: doesn't show hand 
*** SUMMARY ***
Total pot $0.65 | Rake $0.02 
Board [Ac 6d 5s 6c]
Seat 1: RaulacateFolds (button) folded on the Turn
Seat 2: juraa14 (small blind) folded before Flop
Seat 3: GVMELLO (big blind) folded before Flop
Seat 4: Scaaalll folded before Flop (didn't bet)
Seat 5: Xlavariable folded before Flop (didn't bet)
Seat 6: HWalshy collected ($0.63)



PokerStars Zoom Hand #229231600480:  Hold'em No Limit ($0.01/$0.02) - 2021/08/21 22:20:08 CET [2021/08/21 16:20:08 ET]
Table 'Halley' 6-max Seat #1 is the button
Seat 1: zinho_83 ($0.97 in chips) 
Seat 2: Nihility77 ($4.63 in chips) 
Seat 3: Dr.stromg ($2 in chips) 
Seat 4: Blaackie ($2.34 in chips) 
Seat 5: Ne0net ($2.08 in chips) 
Seat 6: Scaaalll ($3.03 in chips) 
Nihility77: posts small blind $0.01
Dr.stromg: posts big blind $0.02
*** HOLE CARDS ***
Dealt to Scaaalll [2c 4c]
Blaackie: raises $0.03 to $0.05
Ne0net: folds 
Scaaalll: folds 
zinho_83: calls $0.05
Nihility77: calls $0.04
Dr.stromg: folds 
*** FLOP *** [Jd 8h Js]
Nihility77: bets $0.10
zinho_83 is disconnected 
Blaackie: folds 
zinho_83: folds 
Uncalled bet ($0.10) returned to Nihility77
Nihility77 collected $0.16 from pot
Nihility77: doesn't show hand 
*** SUMMARY ***
Total pot $0.17 | Rake $0.01 
Board [Jd 8h Js]
Seat 1: zinho_83 (button) folded on the Flop
Seat 2: Nihility77 (small blind) collected ($0.16)
Seat 3: Dr.stromg (big blind) folded before Flop
Seat 4: Blaackie folded on the Flop
Seat 5: Ne0net folded before Flop (didn't bet)
Seat 6: Scaaalll folded before Flop (didn't bet)



PokerStars Zoom Hand #229231606329:  Hold'em No Limit ($0.01/$0.02) - 2021/08/21 22:20:21 CET [2021/08/21 16:20:21 ET]
Table 'Halley' 6-max Seat #1 is the button
Seat 1: Clavis Noa ($3.06 in chips) 
Seat 2: orang_dragon ($2.42 in chips) 
Seat 3: PapiMik3 ($2.03 in chips) 
Seat 4: Scaaalll ($3.03 in chips) 
Seat 5: FabOliveira9 ($2 in chips) 
Seat 6: Kreodont1987 ($5.81 in chips) 
orang_dragon: posts small blind $0.01
PapiMik3: posts big blind $0.02
*** HOLE CARDS ***
Dealt to Scaaalll [3h 3c]
Scaaalll: raises $0.04 to $0.06
FabOliveira9: calls $0.06
Kreodont1987: folds 
Clavis Noa: folds 
orang_dragon: raises $0.24 to $0.30
PapiMik3: folds 
Scaaalll: folds 
FabOliveira9: folds 
Uncalled bet ($0.24) returned to orang_dragon
orang_dragon collected $0.20 from pot
orang_dragon: doesn't show hand 
*** SUMMARY ***
Total pot $0.20 | Rake $0 
Seat 1: Clavis Noa (button) folded before Flop (didn't bet)
Seat 2: orang_dragon (small blind) collected ($0.20)
Seat 3: PapiMik3 (big blind) folded before Flop
Seat 4: Scaaalll folded before Flop
Seat 5: FabOliveira9 folded before Flop
Seat 6: Kreodont1987 folded before Flop (didn't bet)



PokerStars Zoom Hand #229231615540:  Hold'em No Limit ($0.01/$0.02) - 2021/08/21 22:20:41 CET [2021/08/21 16:20:41 ET]
Table 'Halley' 6-max Seat #1 is the button
Seat 1: 888lifeIS ($2.35 in chips) 
Seat 2: RomiSex ($3.84 in chips) 
Seat 3: Scaaalll ($2.97 in chips) 
Seat 4: Dr.stromg ($2.02 in chips) 
Seat 5: sewq55 ($1.29 in chips) 
Seat 6: ugi-dugi ($2.73 in chips) 
RomiSex: posts small blind $0.01
Scaaalll: posts big blind $0.02
*** HOLE CARDS ***
Dealt to Scaaalll [Qh Ad]
Dr.stromg: folds 
sewq55: folds 
ugi-dugi: raises $0.04 to $0.06
888lifeIS: raises $0.18 to $0.24
RomiSex: folds 
Scaaalll: folds 
ugi-dugi: folds 
Uncalled bet ($0.18) returned to 888lifeIS
888lifeIS collected $0.15 from pot
888lifeIS: doesn't show hand 
*** SUMMARY ***
Total pot $0.15 | Rake $0 
Seat 1: 888lifeIS (button) collected ($0.15)
Seat 2: RomiSex (small blind) folded before Flop
Seat 3: Scaaalll (big blind) folded before Flop
Seat 4: Dr.stromg folded before Flop (didn't bet)
Seat 5: sewq55 folded before Flop (didn't bet)
Seat 6: ugi-dugi folded before Flop



PokerStars Zoom Hand #229231623655:  Hold'em No Limit ($0.01/$0.02) - 2021/08/21 22:20:59 CET [2021/08/21 16:20:59 ET]
Table 'Halley' 6-max Seat #1 is the button
Seat 1: amario89 ($5.48 in chips) 
Seat 2: Dron1985 ($2.81 in chips) 
Seat 3: MATIdf365 ($2.47 in chips) 
Seat 4: lumpek1112 ($2.08 in chips) 
Seat 5: Scaaalll ($2.95 in chips) 
Seat 6: gy67 ($1.91 in chips) 
Dron1985: posts small blind $0.01
MATIdf365: posts big blind $0.02
*** HOLE CARDS ***
Dealt to Scaaalll [Qh As]
lumpek1112: folds 
Dron1985 is disconnected 
Scaaalll: raises $0.04 to $0.06
gy67: calls $0.06
amario89: folds 
Dron1985: folds 
MATIdf365: folds 
*** FLOP *** [Kh 9c 5d]
Scaaalll: bets $0.08
gy67: folds 
Uncalled bet ($0.08) returned to Scaaalll
Scaaalll collected $0.14 from pot
Scaaalll: doesn't show hand 
*** SUMMARY ***
Total pot $0.15 | Rake $0.01 
Board [Kh 9c 5d]
Seat 1: amario89 (button) folded before Flop (didn't bet)
Seat 2: Dron1985 (small blind) folded before Flop
Seat 3: MATIdf365 (big blind) folded before Flop
Seat 4: lumpek1112 folded before Flop (didn't bet)
Seat 5: Scaaalll collected ($0.14)
Seat 6: gy67 folded on the Flop



PokerStars Zoom Hand #229231638841:  Hold'em No Limit ($0.01/$0.02) - 2021/08/21 22:21:32 CET [2021/08/21 16:21:32 ET]
Table 'Halley' 6-max Seat #1 is the button
Seat 1: Scaaalll ($3.02 in chips) 
Seat 2: FabOliveira9 ($2 in chips) 
Seat 3: HirotoBeats ($1.82 in chips) 
Seat 4: elmex886 ($2.02 in chips) 
Seat 5: KareAAAA ($1.75 in chips) 
Seat 6: 9zocker9 ($2.59 in chips) 
FabOliveira9: posts small blind $0.01
HirotoBeats: posts big blind $0.02
*** HOLE CARDS ***
Dealt to Scaaalll [4h 9h]
KareAAAA is disconnected 
elmex886: folds 
KareAAAA: folds 
9zocker9: folds 
Scaaalll: folds 
FabOliveira9: folds 
Uncalled bet ($0.01) returned to HirotoBeats
HirotoBeats collected $0.02 from pot
HirotoBeats: doesn't show hand 
*** SUMMARY ***
Total pot $0.02 | Rake $0 
Seat 1: Scaaalll (button) folded before Flop (didn't bet)
Seat 2: FabOliveira9 (small blind) folded before Flop
Seat 3: HirotoBeats (big blind) collected ($0.02)
Seat 4: elmex886 folded before Flop (didn't bet)
Seat 5: KareAAAA folded before Flop (didn't bet)
Seat 6: 9zocker9 folded before Flop (didn't bet)



PokerStars Zoom Hand #229231635189:  Hold'em No Limit ($0.01/$0.02) - 2021/08/21 22:21:24 CET [2021/08/21 16:21:24 ET]
Table 'Halley' 6-max Seat #1 is the button
Seat 1: 365p2eva ($3.11 in chips) 
Seat 2: Scaaalll ($3.03 in chips) 
Seat 3: wstanula ($2.10 in chips) 
Seat 4: BendixSenior ($2.09 in chips) 
Seat 5: Demidov V.S. ($1.76 in chips) 
Seat 6: Kreodont1987 ($5.70 in chips) 
Scaaalll: posts small blind $0.01
wstanula: posts big blind $0.02
*** HOLE CARDS ***
Dealt to Scaaalll [2s Td]
Demidov V.S. is disconnected 
BendixSenior: calls $0.02
Demidov V.S.: folds 
Kreodont1987: folds 
365p2eva: raises $0.06 to $0.08
Scaaalll: folds 
wstanula: folds 
BendixSenior: calls $0.06
*** FLOP *** [8s 3d As]
BendixSenior: checks 
365p2eva: bets $0.09
BendixSenior: folds 
Uncalled bet ($0.09) returned to 365p2eva
365p2eva collected $0.18 from pot
365p2eva: doesn't show hand 
BendixSenior is disconnected 
*** SUMMARY ***
Total pot $0.19 | Rake $0.01 
Board [8s 3d As]
Seat 1: 365p2eva (button) collected ($0.18)
Seat 2: Scaaalll (small blind) folded before Flop
Seat 3: wstanula (big blind) folded before Flop
Seat 4: BendixSenior folded on the Flop
Seat 5: Demidov V.S. folded before Flop (didn't bet)
Seat 6: Kreodont1987 folded before Flop (didn't bet)



PokerStars Zoom Hand #229231643827:  Hold'em No Limit ($0.01/$0.02) - 2021/08/21 22:21:43 CET [2021/08/21 16:21:43 ET]
Table 'Halley' 6-max Seat #1 is the button
Seat 1: GVMELLO ($2 in chips) 
Seat 2: KoAlRy ($2 in chips) 
Seat 3: Scaaalll ($3.02 in chips) 
Seat 4: guntren.ps ($2.10 in chips) 
Seat 5: pavlo8855 ($2 in chips) 
Seat 6: kboskov123 ($1.64 in chips) 
KoAlRy: posts small blind $0.01
Scaaalll: posts big blind $0.02
*** HOLE CARDS ***
Dealt to Scaaalll [7c Qh]
guntren.ps: folds 
pavlo8855: folds 
kboskov123: calls $0.02
GVMELLO: folds 
KoAlRy: folds 
Scaaalll: checks 
*** FLOP *** [Td Jc Ts]
Scaaalll: checks 
kboskov123: checks 
*** TURN *** [Td Jc Ts] [Jh]
Scaaalll: checks 
kboskov123: checks 
*** RIVER *** [Td Jc Ts Jh] [2d]
Scaaalll: checks 
kboskov123: checks 
*** SHOW DOWN ***
Scaaalll: shows [7c Qh] (two pair, Jacks and Tens)
kboskov123: shows [9d Qd] (two pair, Jacks and Tens)
Scaaalll collected $0.03 from pot
kboskov123 collected $0.02 from pot
*** SUMMARY ***
Total pot $0.05 | Rake $0 
Board [Td Jc Ts Jh 2d]
Seat 1: GVMELLO (button) folded before Flop (didn't bet)
Seat 2: KoAlRy (small blind) folded before Flop
Seat 3: Scaaalll (big blind) showed [7c Qh] and won ($0.03) with two pair, Jacks and Tens
Seat 4: guntren.ps folded before Flop (didn't bet)
Seat 5: pavlo8855 folded before Flop (didn't bet)
Seat 6: kboskov123 showed [9d Qd] and won ($0.02) with two pair, Jacks and Tens



PokerStars Zoom Hand #229231658825:  Hold'em No Limit ($0.01/$0.02) - 2021/08/21 22:22:16 CET [2021/08/21 16:22:16 ET]
Table 'Halley' 6-max Seat #1 is the button
Seat 1: Allekccc ($2.02 in chips) 
Seat 2: Finkey99 ($6.85 in chips) 
Seat 3: Laonikos ($8.51 in chips) 
Seat 4: sewq55 ($1.18 in chips) 
Seat 5: yeahyeeei ($0.49 in chips) 
Seat 6: Scaaalll ($3.03 in chips) 
Finkey99: posts small blind $0.01
Laonikos: posts big blind $0.02
*** HOLE CARDS ***
Dealt to Scaaalll [5h 5c]
sewq55: folds 
yeahyeeei has timed out
yeahyeeei: folds 
Scaaalll: raises $0.04 to $0.06
Allekccc: folds 
Finkey99: folds 
Laonikos: calls $0.04
*** FLOP *** [Qd 9h 7h]
Laonikos: checks 
Scaaalll: checks 
*** TURN *** [Qd 9h 7h] [2h]
Laonikos: checks 
Scaaalll: checks 
*** RIVER *** [Qd 9h 7h 2h] [5d]
Laonikos: checks 
Scaaalll: bets $0.09
Laonikos: folds 
Uncalled bet ($0.09) returned to Scaaalll
Scaaalll collected $0.13 from pot
Scaaalll: doesn't show hand 
*** SUMMARY ***
Total pot $0.13 | Rake $0 
Board [Qd 9h 7h 2h 5d]
Seat 1: Allekccc (button) folded before Flop (didn't bet)
Seat 2: Finkey99 (small blind) folded before Flop
Seat 3: Laonikos (big blind) folded on the River
Seat 4: sewq55 folded before Flop (didn't bet)
Seat 5: yeahyeeei folded before Flop (didn't bet)
Seat 6: Scaaalll collected ($0.13)



PokerStars Zoom Hand #229231689064:  Hold'em No Limit ($0.01/$0.02) - 2021/08/21 22:23:22 CET [2021/08/21 16:23:22 ET]
Table 'Halley' 6-max Seat #1 is the button
Seat 1: Nancy_88 ($2.28 in chips) 
Seat 2: KonopDima ($2.17 in chips) 
Seat 3: rodrigovini ($2.20 in chips) 
Seat 4: amario89 ($5.56 in chips) 
Seat 5: Scaaalll ($3.10 in chips) 
Seat 6: kahzura ($2.99 in chips) 
KonopDima: posts small blind $0.01
rodrigovini: posts big blind $0.02
*** HOLE CARDS ***
Dealt to Scaaalll [5h 7c]
amario89: folds 
Scaaalll: folds 
kahzura: folds 
Nancy_88: folds 
KonopDima: folds 
Uncalled bet ($0.01) returned to rodrigovini
Nancy_88 is disconnected 
rodrigovini collected $0.02 from pot
rodrigovini: doesn't show hand 
*** SUMMARY ***
Total pot $0.02 | Rake $0 
Seat 1: Nancy_88 (button) folded before Flop (didn't bet)
Seat 2: KonopDima (small blind) folded before Flop
Seat 3: rodrigovini (big blind) collected ($0.02)
Seat 4: amario89 folded before Flop (didn't bet)
Seat 5: Scaaalll folded before Flop (didn't bet)
Seat 6: kahzura folded before Flop (didn't bet)



PokerStars Zoom Hand #229231692716:  Hold'em No Limit ($0.01/$0.02) - 2021/08/21 22:23:30 CET [2021/08/21 16:23:30 ET]
Table 'Halley' 6-max Seat #1 is the button
Seat 1: krowio ($3.11 in chips) 
Seat 2: Scaaalll ($3.10 in chips) 
Seat 3: RaulacateFolds ($2.17 in chips) 
Seat 4: pavlo8855 ($2.23 in chips) 
Seat 5: Lacitoo ($2.03 in chips) 
Seat 6: 4umi4ev ($2.06 in chips) 
Scaaalll: posts small blind $0.01
RaulacateFolds: posts big blind $0.02
*** HOLE CARDS ***
Dealt to Scaaalll [7d 4d]
4umi4ev is disconnected 
pavlo8855: folds 
Lacitoo: folds 
4umi4ev: folds 
krowio: folds 
Lacitoo is disconnected 
Scaaalll: folds 
Uncalled bet ($0.01) returned to RaulacateFolds
RaulacateFolds collected $0.02 from pot
RaulacateFolds: doesn't show hand 
*** SUMMARY ***
Total pot $0.02 | Rake $0 
Seat 1: krowio (button) folded before Flop (didn't bet)
Seat 2: Scaaalll (small blind) folded before Flop
Seat 3: RaulacateFolds (big blind) collected ($0.02)
Seat 4: pavlo8855 folded before Flop (didn't bet)
Seat 5: Lacitoo folded before Flop (didn't bet)
Seat 6: 4umi4ev folded before Flop (didn't bet)



PokerStars Zoom Hand #229231697696:  Hold'em No Limit ($0.01/$0.02) - 2021/08/21 22:23:41 CET [2021/08/21 16:23:41 ET]
Table 'Halley' 6-max Seat #1 is the button
Seat 1: Scaaalll ($3.09 in chips) 
Seat 2: RrriotGrrrl ($5.42 in chips) 
Seat 3: Vanekakqj ($1.53 in chips) 
Seat 4: 21041956 ($1.80 in chips) 
Seat 5: ricske68 ($4.24 in chips) 
Seat 6: A.luckebeggr ($2.87 in chips) 
RrriotGrrrl: posts small blind $0.01
Vanekakqj: posts big blind $0.02
*** HOLE CARDS ***
Dealt to Scaaalll [4s Kh]
21041956: folds 
ricske68: folds 
A.luckebeggr: folds 
Scaaalll: folds 
RrriotGrrrl: raises $0.04 to $0.06
Vanekakqj: folds 
Uncalled bet ($0.04) returned to RrriotGrrrl
RrriotGrrrl collected $0.04 from pot
RrriotGrrrl: doesn't show hand 
*** SUMMARY ***
Total pot $0.04 | Rake $0 
Seat 1: Scaaalll (button) folded before Flop (didn't bet)
Seat 2: RrriotGrrrl (small blind) collected ($0.04)
Seat 3: Vanekakqj (big blind) folded before Flop
Seat 4: 21041956 folded before Flop (didn't bet)
Seat 5: ricske68 folded before Flop (didn't bet)
Seat 6: A.luckebeggr folded before Flop (didn't bet)



PokerStars Zoom Hand #229231700432:  Hold'em No Limit ($0.01/$0.02) - 2021/08/21 22:23:47 CET [2021/08/21 16:23:47 ET]
Table 'Halley' 6-max Seat #1 is the button
Seat 1: AlexGTPS ($3.42 in chips) 
Seat 2: WellWell57 ($3.45 in chips) 
Seat 3: Scaaalll ($3.09 in chips) 
Seat 4: Jujiluju ($1.89 in chips) 
Seat 5: LucasG155 ($3.11 in chips) 
Seat 6: RonilsonCosta ($2.30 in chips) 
WellWell57: posts small blind $0.01
Scaaalll: posts big blind $0.02
*** HOLE CARDS ***
Dealt to Scaaalll [6s Ah]
Jujiluju: folds 
LucasG155: folds 
RonilsonCosta: folds 
AlexGTPS: folds 
WellWell57: folds 
Uncalled bet ($0.01) returned to Scaaalll
Scaaalll collected $0.02 from pot
Scaaalll: doesn't show hand 
*** SUMMARY ***
Total pot $0.02 | Rake $0 
Seat 1: AlexGTPS (button) folded before Flop (didn't bet)
Seat 2: WellWell57 (small blind) folded before Flop
Seat 3: Scaaalll (big blind) collected ($0.02)
Seat 4: Jujiluju folded before Flop (didn't bet)
Seat 5: LucasG155 folded before Flop (didn't bet)
Seat 6: RonilsonCosta folded before Flop (didn't bet)



PokerStars Zoom Hand #229231705430:  Hold'em No Limit ($0.01/$0.02) - 2021/08/21 22:23:58 CET [2021/08/21 16:23:58 ET]
Table 'Halley' 6-max Seat #1 is the button
Seat 1: keb1981 ($2.70 in chips) 
Seat 2: zergmiky ($2 in chips) 
Seat 3: BadBeat Bert ($2.17 in chips) 
Seat 4: gerrit688 ($1.01 in chips) 
Seat 5: dinoVIEIRA ($2.05 in chips) 
Seat 6: Scaaalll ($3.10 in chips) 
zergmiky: posts small blind $0.01
BadBeat Bert: posts big blind $0.02
*** HOLE CARDS ***
Dealt to Scaaalll [4s Jh]
gerrit688: raises $0.05 to $0.07
dinoVIEIRA: folds 
Scaaalll: folds 
keb1981: folds 
zergmiky: folds 
BadBeat Bert: folds 
Uncalled bet ($0.05) returned to gerrit688
gerrit688 collected $0.05 from pot
gerrit688: doesn't show hand 
*** SUMMARY ***
Total pot $0.05 | Rake $0 
Seat 1: keb1981 (button) folded before Flop (didn't bet)
Seat 2: zergmiky (small blind) folded before Flop
Seat 3: BadBeat Bert (big blind) folded before Flop
Seat 4: gerrit688 collected ($0.05)
Seat 5: dinoVIEIRA folded before Flop (didn't bet)
Seat 6: Scaaalll folded before Flop (didn't bet)



PokerStars Zoom Hand #229231690883:  Hold'em No Limit ($0.01/$0.02) - 2021/08/21 22:23:26 CET [2021/08/21 16:23:26 ET]
Table 'Halley' 6-max Seat #1 is the button
Seat 1: volf55321 ($1.62 in chips) 
Seat 2: ser313131 ($3.34 in chips) 
Seat 3: balalaikaRUS47 ($0.90 in chips) 
Seat 4: Scaaalll ($3.10 in chips) 
Seat 5: amario89 ($5.56 in chips) 
Seat 6: feybys ($1.99 in chips) 
ser313131: posts small blind $0.01
balalaikaRUS47: posts big blind $0.02
*** HOLE CARDS ***
Dealt to Scaaalll [2s Qs]
Scaaalll: folds 
amario89: folds 
feybys: folds 
volf55321: calls $0.02
ser313131: folds 
balalaikaRUS47: raises $0.05 to $0.07
volf55321: calls $0.05
*** FLOP *** [8d 7s 5s]
balalaikaRUS47: checks 
volf55321: bets $0.04
balalaikaRUS47: calls $0.04
*** TURN *** [8d 7s 5s] [Jc]
balalaikaRUS47: checks 
volf55321: bets $0.04
balalaikaRUS47: calls $0.04
*** RIVER *** [8d 7s 5s Jc] [8h]
balalaikaRUS47: checks 
volf55321: checks 
*** SHOW DOWN ***
balalaikaRUS47: shows [Ah Tc] (a pair of Eights)
volf55321: mucks hand 
balalaikaRUS47 collected $0.30 from pot
*** SUMMARY ***
Total pot $0.31 | Rake $0.01 
Board [8d 7s 5s Jc 8h]
Seat 1: volf55321 (button) mucked [6d Ad]
Seat 2: ser313131 (small blind) folded before Flop
Seat 3: balalaikaRUS47 (big blind) showed [Ah Tc] and won ($0.30) with a pair of Eights
Seat 4: Scaaalll folded before Flop (didn't bet)
Seat 5: amario89 folded before Flop (didn't bet)
Seat 6: feybys folded before Flop (didn't bet)



PokerStars Zoom Hand #229231709609:  Hold'em No Limit ($0.01/$0.02) - 2021/08/21 22:24:07 CET [2021/08/21 16:24:07 ET]
Table 'Halley' 6-max Seat #1 is the button
Seat 1: Espartacus5222 ($3.65 in chips) 
Seat 2: Jujiluju ($1.90 in chips) 
Seat 3: alecha11 ($3.36 in chips) 
Seat 4: KonopDima ($2.10 in chips) 
Seat 5: Scaaalll ($3.10 in chips) 
Seat 6: mati-face ($0.98 in chips) 
Jujiluju: posts small blind $0.01
alecha11: posts big blind $0.02
*** HOLE CARDS ***
Dealt to Scaaalll [Ah 9h]
KonopDima has timed out
KonopDima: folds 
Scaaalll: raises $0.04 to $0.06
mati-face: folds 
Espartacus5222: folds 
Jujiluju: folds 
alecha11: folds 
Uncalled bet ($0.04) returned to Scaaalll
Scaaalll collected $0.05 from pot
Scaaalll: doesn't show hand 
*** SUMMARY ***
Total pot $0.05 | Rake $0 
Seat 1: Espartacus5222 (button) folded before Flop (didn't bet)
Seat 2: Jujiluju (small blind) folded before Flop
Seat 3: alecha11 (big blind) folded before Flop
Seat 4: KonopDima folded before Flop (didn't bet)
Seat 5: Scaaalll collected ($0.05)
Seat 6: mati-face folded before Flop (didn't bet)



PokerStars Zoom Hand #229231707771:  Hold'em No Limit ($0.01/$0.02) - 2021/08/21 22:24:03 CET [2021/08/21 16:24:03 ET]
Table 'Halley' 6-max Seat #1 is the button
Seat 1: Scaaalll ($3.10 in chips) 
Seat 2: IamFixxed ($3.81 in chips) 
Seat 3: Finkey99 ($6.76 in chips) 
Seat 4: queen830 ($9.33 in chips) 
Seat 5: RrriotGrrrl ($9.30 in chips) 
Seat 6: lucksuckdonk ($4.22 in chips) 
IamFixxed: posts small blind $0.01
Finkey99: posts big blind $0.02
*** HOLE CARDS ***
Dealt to Scaaalll [8c 6d]
queen830: raises $0.03 to $0.05
RrriotGrrrl: calls $0.05
lucksuckdonk: folds 
Scaaalll: folds 
IamFixxed: folds 
Finkey99: calls $0.03
*** FLOP *** [Ts Ac Jh]
Finkey99: checks 
queen830: checks 
RrriotGrrrl: bets $0.11
Finkey99: calls $0.11
queen830: calls $0.11
*** TURN *** [Ts Ac Jh] [2c]
Finkey99: checks 
queen830: checks 
RrriotGrrrl: bets $0.35
Finkey99: folds 
queen830: folds 
Uncalled bet ($0.35) returned to RrriotGrrrl
RrriotGrrrl collected $0.47 from pot
RrriotGrrrl: doesn't show hand 
*** SUMMARY ***
Total pot $0.49 | Rake $0.02 
Board [Ts Ac Jh 2c]
Seat 1: Scaaalll (button) folded before Flop (didn't bet)
Seat 2: IamFixxed (small blind) folded before Flop
Seat 3: Finkey99 (big blind) folded on the Turn
Seat 4: queen830 folded on the Turn
Seat 5: RrriotGrrrl collected ($0.47)
Seat 6: lucksuckdonk folded before Flop (didn't bet)



PokerStars Zoom Hand #229231722305:  Hold'em No Limit ($0.01/$0.02) - 2021/08/21 22:24:35 CET [2021/08/21 16:24:35 ET]
Table 'Halley' 6-max Seat #1 is the button
Seat 1: Daino G ($2.17 in chips) 
Seat 2: Koldun 2636 ($3.08 in chips) 
Seat 3: RomiSex ($2.08 in chips) 
Seat 4: Scaaalll ($3.13 in chips) 
Seat 5: Iwanb4 ($2.13 in chips) 
Seat 6: 77omsk ($1.92 in chips) 
Koldun 2636: posts small blind $0.01
RomiSex: posts big blind $0.02
*** HOLE CARDS ***
Dealt to Scaaalll [Ac Ks]
Scaaalll: raises $0.04 to $0.06
Iwanb4: raises $0.06 to $0.12
77omsk: folds 
Daino G: folds 
Koldun 2636: folds 
RomiSex: folds 
Scaaalll: calls $0.06
*** FLOP *** [6c 2c 2s]
Scaaalll: checks 
Iwanb4: bets $0.13
Scaaalll: folds 
Uncalled bet ($0.13) returned to Iwanb4
Iwanb4 collected $0.26 from pot
Iwanb4: doesn't show hand 
*** SUMMARY ***
Total pot $0.27 | Rake $0.01 
Board [6c 2c 2s]
Seat 1: Daino G (button) folded before Flop (didn't bet)
Seat 2: Koldun 2636 (small blind) folded before Flop
Seat 3: RomiSex (big blind) folded before Flop
Seat 4: Scaaalll folded on the Flop
Seat 5: Iwanb4 collected ($0.26)
Seat 6: 77omsk folded before Flop (didn't bet)



PokerStars Zoom Hand #229231737463:  Hold'em No Limit ($0.01/$0.02) - 2021/08/21 22:25:08 CET [2021/08/21 16:25:08 ET]
Table 'Halley' 6-max Seat #1 is the button
Seat 1: Diegor1924 ($2.51 in chips) 
Seat 2: Scaaalll ($3.01 in chips) 
Seat 3: estelionat171 ($1.32 in chips) 
Seat 4: EmperorKurr ($3.70 in chips) 
Seat 5: 888lifeIS ($2 in chips) 
Seat 6: storo98 ($14.53 in chips) 
Scaaalll: posts small blind $0.01
estelionat171: posts big blind $0.02
*** HOLE CARDS ***
Dealt to Scaaalll [8c Jd]
EmperorKurr: folds 
888lifeIS: folds 
storo98: folds 
Diegor1924: raises $0.02 to $0.04
Scaaalll: folds 
estelionat171: folds 
Uncalled bet ($0.02) returned to Diegor1924
Diegor1924 collected $0.05 from pot
Diegor1924: doesn't show hand 
*** SUMMARY ***
Total pot $0.05 | Rake $0 
Seat 1: Diegor1924 (button) collected ($0.05)
Seat 2: Scaaalll (small blind) folded before Flop
Seat 3: estelionat171 (big blind) folded before Flop
Seat 4: EmperorKurr folded before Flop (didn't bet)
Seat 5: 888lifeIS folded before Flop (didn't bet)
Seat 6: storo98 folded before Flop (didn't bet)



PokerStars Zoom Hand #229231742772:  Hold'em No Limit ($0.01/$0.02) - 2021/08/21 22:25:20 CET [2021/08/21 16:25:20 ET]
Table 'Halley' 6-max Seat #1 is the button
Seat 1: Red Sky 15 ($8.68 in chips) 
Seat 2: BigTestIcicle ($5.43 in chips) 
Seat 3: HWalshy ($1.29 in chips) 
Seat 4: uniicecube ($4.84 in chips) 
Seat 5: GVMELLO ($1.98 in chips) 
Seat 6: Scaaalll ($3 in chips) 
BigTestIcicle: posts small blind $0.01
HWalshy: posts big blind $0.02
*** HOLE CARDS ***
Dealt to Scaaalll [Qd 4c]
uniicecube: folds 
GVMELLO: folds 
Scaaalll: folds 
Red Sky 15: raises $0.04 to $0.06
BigTestIcicle: folds 
HWalshy: folds 
Uncalled bet ($0.04) returned to Red Sky 15
Red Sky 15 collected $0.05 from pot
Red Sky 15: doesn't show hand 
*** SUMMARY ***
Total pot $0.05 | Rake $0 
Seat 1: Red Sky 15 (button) collected ($0.05)
Seat 2: BigTestIcicle (small blind) folded before Flop
Seat 3: HWalshy (big blind) folded before Flop
Seat 4: uniicecube folded before Flop (didn't bet)
Seat 5: GVMELLO folded before Flop (didn't bet)
Seat 6: Scaaalll folded before Flop (didn't bet)



PokerStars Zoom Hand #229231746905:  Hold'em No Limit ($0.01/$0.02) - 2021/08/21 22:25:29 CET [2021/08/21 16:25:29 ET]
Table 'Halley' 6-max Seat #1 is the button
Seat 1: Dr.stromg ($2.28 in chips) 
Seat 2: Axel201388 ($1.42 in chips) 
Seat 3: Scaaalll ($3 in chips) 
Seat 4: estelionat171 ($1.04 in chips) 
Seat 5: Demidov V.S. ($1.55 in chips) 
Seat 6: Mikeloko182 ($2.09 in chips) 
Axel201388: posts small blind $0.01
Scaaalll: posts big blind $0.02
*** HOLE CARDS ***
Dealt to Scaaalll [7c 8d]
estelionat171: folds 
Demidov V.S.: folds 
Demidov V.S. is disconnected 
Mikeloko182: folds 
Dr.stromg: folds 
Axel201388: folds 
Uncalled bet ($0.01) returned to Scaaalll
Scaaalll collected $0.02 from pot
Scaaalll: doesn't show hand 
*** SUMMARY ***
Total pot $0.02 | Rake $0 
Seat 1: Dr.stromg (button) folded before Flop (didn't bet)
Seat 2: Axel201388 (small blind) folded before Flop
Seat 3: Scaaalll (big blind) collected ($0.02)
Seat 4: estelionat171 folded before Flop (didn't bet)
Seat 5: Demidov V.S. folded before Flop (didn't bet)
Seat 6: Mikeloko182 folded before Flop (didn't bet)



PokerStars Zoom Hand #229231753694:  Hold'em No Limit ($0.01/$0.02) - 2021/08/21 22:25:44 CET [2021/08/21 16:25:44 ET]
Table 'Halley' 6-max Seat #1 is the button
Seat 1: Daino G ($2.31 in chips) 
Seat 2: Umnik_M ($1.98 in chips) 
Seat 3: xxRoseIloveu ($8.38 in chips) 
Seat 4: Scaaalll ($3.01 in chips) 
Seat 5: ray147741 ($1.49 in chips) 
Seat 6: Lacitoo ($2.09 in chips) 
Umnik_M: posts small blind $0.01
xxRoseIloveu: posts big blind $0.02
*** HOLE CARDS ***
Dealt to Scaaalll [8h Jh]
Scaaalll: folds 
ray147741: folds 
Lacitoo: folds 
Lacitoo is disconnected 
Daino G: raises $0.03 to $0.05
Umnik_M: folds 
xxRoseIloveu: folds 
Uncalled bet ($0.03) returned to Daino G
Daino G collected $0.05 from pot
Daino G: doesn't show hand 
*** SUMMARY ***
Total pot $0.05 | Rake $0 
Seat 1: Daino G (button) collected ($0.05)
Seat 2: Umnik_M (small blind) folded before Flop
Seat 3: xxRoseIloveu (big blind) folded before Flop
Seat 4: Scaaalll folded before Flop (didn't bet)
Seat 5: ray147741 folded before Flop (didn't bet)
Seat 6: Lacitoo folded before Flop (didn't bet)



PokerStars Zoom Hand #229231745032:  Hold'em No Limit ($0.01/$0.02) - 2021/08/21 22:25:25 CET [2021/08/21 16:25:25 ET]
Table 'Halley' 6-max Seat #1 is the button
Seat 1: satti1337 ($2 in chips) 
Seat 2: japoneis mt ($2.50 in chips) 
Seat 3: pipecmolodec ($2.06 in chips) 
Seat 4: pescador2 ($1.11 in chips) 
Seat 5: Scaaalll ($3 in chips) 
Seat 6: BigTestIcicle ($2.38 in chips) 
japoneis mt: posts small blind $0.01
pipecmolodec: posts big blind $0.02
*** HOLE CARDS ***
Dealt to Scaaalll [8d 7c]
pescador2: calls $0.02
Scaaalll: folds 
japoneis mt is disconnected 
BigTestIcicle: raises $0.06 to $0.08
satti1337: folds 
japoneis mt: folds 
pipecmolodec: folds 
pescador2: calls $0.06
*** FLOP *** [6d Kh 8c]
pescador2: bets $0.06
BigTestIcicle: calls $0.06
*** TURN *** [6d Kh 8c] [2c]
pescador2: bets $0.06
BigTestIcicle: raises $0.21 to $0.27
pescador2: calls $0.21
*** RIVER *** [6d Kh 8c 2c] [4d]
pescador2: bets $0.08
BigTestIcicle: raises $0.49 to $0.57
pescador2: calls $0.49
*** SHOW DOWN ***
BigTestIcicle: shows [As Ad] (a pair of Aces)
pescador2: mucks hand 
BigTestIcicle collected $1.92 from pot
*** SUMMARY ***
Total pot $1.99 | Rake $0.07 
Board [6d Kh 8c 2c 4d]
Seat 1: satti1337 (button) folded before Flop (didn't bet)
Seat 2: japoneis mt (small blind) folded before Flop
Seat 3: pipecmolodec (big blind) folded before Flop
Seat 4: pescador2 mucked [Kd Qd]
Seat 5: Scaaalll folded before Flop (didn't bet)
Seat 6: BigTestIcicle showed [As Ad] and won ($1.92) with a pair of Aces



PokerStars Zoom Hand #229231755485:  Hold'em No Limit ($0.01/$0.02) - 2021/08/21 22:25:48 CET [2021/08/21 16:25:48 ET]
Table 'Halley' 6-max Seat #1 is the button
Seat 1: Scaaalll ($3.01 in chips) 
Seat 2: KareAAAA ($1.77 in chips) 
Seat 3: polymorhp ($3.92 in chips) 
Seat 4: Begon505 ($0.75 in chips) 
Seat 5: Hallyson_23 ($3.60 in chips) 
Seat 6: pipecmolodec ($2.02 in chips) 
KareAAAA: posts small blind $0.01
polymorhp: posts big blind $0.02
*** HOLE CARDS ***
Dealt to Scaaalll [Kc Jd]
Begon505: folds 
KareAAAA is disconnected 
Hallyson_23: folds 
pipecmolodec: raises $0.02 to $0.04
Scaaalll: calls $0.04
KareAAAA: folds 
polymorhp: calls $0.02
*** FLOP *** [Ac 5d Qd]
polymorhp: checks 
pipecmolodec: checks 
Scaaalll: bets $0.08
polymorhp: folds 
pipecmolodec: folds 
Uncalled bet ($0.08) returned to Scaaalll
Scaaalll collected $0.13 from pot
Scaaalll: doesn't show hand 
*** SUMMARY ***
Total pot $0.13 | Rake $0 
Board [Ac 5d Qd]
Seat 1: Scaaalll (button) collected ($0.13)
Seat 2: KareAAAA (small blind) folded before Flop
Seat 3: polymorhp (big blind) folded on the Flop
Seat 4: Begon505 folded before Flop (didn't bet)
Seat 5: Hallyson_23 folded before Flop (didn't bet)
Seat 6: pipecmolodec folded on the Flop



PokerStars Zoom Hand #229231795480:  Hold'em No Limit ($0.01/$0.02) - 2021/08/21 22:27:08 CET [2021/08/21 16:27:08 ET]
Table 'Halley' 6-max Seat #1 is the button
Seat 1: Chapaev136 ($2.97 in chips) 
Seat 2: 78joniboy ($2 in chips) 
Seat 3: AlexGTPS ($3.70 in chips) 
Seat 4: A.luckebeggr ($3.25 in chips) 
Seat 5: Simon190713 ($5.37 in chips) 
Seat 6: Scaaalll ($3.09 in chips) 
78joniboy: posts small blind $0.01
AlexGTPS: posts big blind $0.02
*** HOLE CARDS ***
Dealt to Scaaalll [9c Qh]
A.luckebeggr: folds 
Simon190713: folds 
Scaaalll: folds 
Simon190713 is disconnected 
Chapaev136: folds 
78joniboy: folds 
Uncalled bet ($0.01) returned to AlexGTPS
AlexGTPS collected $0.02 from pot
AlexGTPS: doesn't show hand 
*** SUMMARY ***
Total pot $0.02 | Rake $0 
Seat 1: Chapaev136 (button) folded before Flop (didn't bet)
Seat 2: 78joniboy (small blind) folded before Flop
Seat 3: AlexGTPS (big blind) collected ($0.02)
Seat 4: A.luckebeggr folded before Flop (didn't bet)
Seat 5: Simon190713 folded before Flop (didn't bet)
Seat 6: Scaaalll folded before Flop (didn't bet)



PokerStars Zoom Hand #229231791433:  Hold'em No Limit ($0.01/$0.02) - 2021/08/21 22:26:59 CET [2021/08/21 16:26:59 ET]
Table 'Halley' 6-max Seat #1 is the button
Seat 1: EevAA190 ($2.33 in chips) 
Seat 2: Scaaalll ($3.10 in chips) 
Seat 3: Fanatspartak ($1.23 in chips) 
Seat 4: NoLuckLeck ($3.50 in chips) 
Seat 5: fellowes1 ($2.33 in chips) 
Seat 6: dominik7315 ($3.31 in chips) 
Scaaalll: posts small blind $0.01
Fanatspartak: posts big blind $0.02
*** HOLE CARDS ***
Dealt to Scaaalll [3d 5h]
dominik7315 is disconnected 
NoLuckLeck: folds 
fellowes1: raises $0.02 to $0.04
dominik7315: folds 
EevAA190: folds 
Scaaalll: folds 
Fanatspartak: calls $0.02
*** FLOP *** [6d As Kc]
Fanatspartak: bets $0.05
fellowes1: folds 
Uncalled bet ($0.05) returned to Fanatspartak
Fanatspartak collected $0.09 from pot
Fanatspartak: doesn't show hand 
*** SUMMARY ***
Total pot $0.09 | Rake $0 
Board [6d As Kc]
Seat 1: EevAA190 (button) folded before Flop (didn't bet)
Seat 2: Scaaalll (small blind) folded before Flop
Seat 3: Fanatspartak (big blind) collected ($0.09)
Seat 4: NoLuckLeck folded before Flop (didn't bet)
Seat 5: fellowes1 folded on the Flop
Seat 6: dominik7315 folded before Flop (didn't bet)



PokerStars Zoom Hand #229231797327:  Hold'em No Limit ($0.01/$0.02) - 2021/08/21 22:27:12 CET [2021/08/21 16:27:12 ET]
Table 'Halley' 6-max Seat #1 is the button
Seat 1: Axel201388 ($1.37 in chips) 
Seat 2: Blaackie ($2.03 in chips) 
Seat 3: CordiPS ($5.30 in chips) 
Seat 4: zergmiky ($2 in chips) 
Seat 5: Scaaalll ($3.09 in chips) 
Seat 6: Kb013497 ($1.61 in chips) 
Blaackie: posts small blind $0.01
CordiPS: posts big blind $0.02
*** HOLE CARDS ***
Dealt to Scaaalll [4c As]
zergmiky: folds 
Scaaalll: folds 
Kb013497: folds 
Axel201388: raises $0.04 to $0.06
Blaackie: folds 
CordiPS: folds 
Uncalled bet ($0.04) returned to Axel201388
Axel201388 collected $0.05 from pot
Axel201388: doesn't show hand 
*** SUMMARY ***
Total pot $0.05 | Rake $0 
Seat 1: Axel201388 (button) collected ($0.05)
Seat 2: Blaackie (small blind) folded before Flop
Seat 3: CordiPS (big blind) folded before Flop
Seat 4: zergmiky folded before Flop (didn't bet)
Seat 5: Scaaalll folded before Flop (didn't bet)
Seat 6: Kb013497 folded before Flop (didn't bet)



PokerStars Zoom Hand #229231803201:  Hold'em No Limit ($0.01/$0.02) - 2021/08/21 22:27:25 CET [2021/08/21 16:27:25 ET]
Table 'Halley' 6-max Seat #1 is the button
Seat 1: BigTestIcicle ($3.32 in chips) 
Seat 2: kahzura ($2.53 in chips) 
Seat 3: Scaaalll ($3.09 in chips) 
Seat 4: Pulp Hands ($1.79 in chips) 
Seat 5: Mikeloko182 ($2.01 in chips) 
Seat 6: TomoKondo ($2.20 in chips) 
kahzura: posts small blind $0.01
Scaaalll: posts big blind $0.02
*** HOLE CARDS ***
Dealt to Scaaalll [9c 4h]
Pulp Hands: raises $0.04 to $0.06
Mikeloko182: folds 
TomoKondo: folds 
BigTestIcicle: folds 
kahzura: folds 
Scaaalll: folds 
Uncalled bet ($0.04) returned to Pulp Hands
Pulp Hands collected $0.05 from pot
Pulp Hands: doesn't show hand 
*** SUMMARY ***
Total pot $0.05 | Rake $0 
Seat 1: BigTestIcicle (button) folded before Flop (didn't bet)
Seat 2: kahzura (small blind) folded before Flop
Seat 3: Scaaalll (big blind) folded before Flop
Seat 4: Pulp Hands collected ($0.05)
Seat 5: Mikeloko182 folded before Flop (didn't bet)
Seat 6: TomoKondo folded before Flop (didn't bet)



PokerStars Zoom Hand #229231807706:  Hold'em No Limit ($0.01/$0.02) - 2021/08/21 22:27:35 CET [2021/08/21 16:27:35 ET]
Table 'Halley' 6-max Seat #1 is the button
Seat 1: Scaaalll ($3.07 in chips) 
Seat 2: NoEff0rt2w1n ($2.03 in chips) 
Seat 3: kboskov123 ($1.35 in chips) 
Seat 4: Lamro50 ($10.39 in chips) 
Seat 5: Dr.stromg ($2.03 in chips) 
Seat 6: RaulacateFolds ($2.50 in chips) 
NoEff0rt2w1n: posts small blind $0.01
kboskov123: posts big blind $0.02
*** HOLE CARDS ***
Dealt to Scaaalll [7c 3c]
Lamro50: calls $0.02
Dr.stromg: folds 
RaulacateFolds: folds 
Scaaalll: folds 
NoEff0rt2w1n: folds 
kboskov123: checks 
*** FLOP *** [Qd Ks 2h]
kboskov123: checks 
Lamro50: bets $0.02
kboskov123: folds 
Uncalled bet ($0.02) returned to Lamro50
Lamro50 collected $0.05 from pot
Lamro50: doesn't show hand 
*** SUMMARY ***
Total pot $0.05 | Rake $0 
Board [Qd Ks 2h]
Seat 1: Scaaalll (button) folded before Flop (didn't bet)
Seat 2: NoEff0rt2w1n (small blind) folded before Flop
Seat 3: kboskov123 (big blind) folded on the Flop
Seat 4: Lamro50 collected ($0.05)
Seat 5: Dr.stromg folded before Flop (didn't bet)
Seat 6: RaulacateFolds folded before Flop (didn't bet)



PokerStars Zoom Hand #229231809977:  Hold'em No Limit ($0.01/$0.02) - 2021/08/21 22:27:40 CET [2021/08/21 16:27:40 ET]
Table 'Halley' 6-max Seat #1 is the button
Seat 1: Fanatspartak ($3.05 in chips) 
Seat 2: texashenry2 ($2.29 in chips) 
Seat 3: Ebbelwoiexp ($2 in chips) 
Seat 4: Scaaalll ($3.07 in chips) 
Seat 5: ded serch ($2 in chips) 
Seat 6: Tacojesuscrisp ($2 in chips) 
texashenry2: posts small blind $0.01
Ebbelwoiexp: posts big blind $0.02
*** HOLE CARDS ***
Dealt to Scaaalll [9h 8h]
Scaaalll: raises $0.04 to $0.06
ded serch: folds 
Ebbelwoiexp is disconnected 
Tacojesuscrisp: folds 
Fanatspartak: raises $0.15 to $0.21
texashenry2: folds 
Ebbelwoiexp: folds 
Scaaalll: folds 
Uncalled bet ($0.15) returned to Fanatspartak
Fanatspartak collected $0.15 from pot
Fanatspartak: doesn't show hand 
*** SUMMARY ***
Total pot $0.15 | Rake $0 
Seat 1: Fanatspartak (button) collected ($0.15)
Seat 2: texashenry2 (small blind) folded before Flop
Seat 3: Ebbelwoiexp (big blind) folded before Flop
Seat 4: Scaaalll folded before Flop
Seat 5: ded serch folded before Flop (didn't bet)
Seat 6: Tacojesuscrisp folded before Flop (didn't bet)



PokerStars Zoom Hand #229231800899:  Hold'em No Limit ($0.01/$0.02) - 2021/08/21 22:27:20 CET [2021/08/21 16:27:20 ET]
Table 'Halley' 6-max Seat #1 is the button
Seat 1: 48159348 ($3.24 in chips) 
Seat 2: rekopo203 ($6.01 in chips) 
Seat 3: olcham7 ($2.70 in chips) 
Seat 4: Scaaalll ($3.09 in chips) 
Seat 5: ninja9919 ($1.62 in chips) 
Seat 6: Tn 939 ($2.06 in chips) 
rekopo203: posts small blind $0.01
olcham7: posts big blind $0.02
*** HOLE CARDS ***
Dealt to Scaaalll [7c Ks]
Scaaalll: folds 
ninja9919: calls $0.02
Tn 939: folds 
48159348: folds 
rekopo203: folds 
olcham7: checks 
*** FLOP *** [3c 6h 6c]
olcham7: checks 
ninja9919: checks 
*** TURN *** [3c 6h 6c] [Kh]
olcham7: checks 
ninja9919: checks 
*** RIVER *** [3c 6h 6c Kh] [Kd]
olcham7: checks 
ninja9919: checks 
*** SHOW DOWN ***
olcham7: shows [8s Jc] (two pair, Kings and Sixes)
ninja9919: shows [4s Ac] (two pair, Kings and Sixes - Ace kicker)
ninja9919 collected $0.05 from pot
*** SUMMARY ***
Total pot $0.05 | Rake $0 
Board [3c 6h 6c Kh Kd]
Seat 1: 48159348 (button) folded before Flop (didn't bet)
Seat 2: rekopo203 (small blind) folded before Flop
Seat 3: olcham7 (big blind) showed [8s Jc] and lost with two pair, Kings and Sixes
Seat 4: Scaaalll folded before Flop (didn't bet)
Seat 5: ninja9919 showed [4s Ac] and won ($0.05) with two pair, Kings and Sixes
Seat 6: Tn 939 folded before Flop (didn't bet)



PokerStars Zoom Hand #229231818603:  Hold'em No Limit ($0.01/$0.02) - 2021/08/21 22:27:59 CET [2021/08/21 16:27:59 ET]
Table 'Halley' 6-max Seat #1 is the button
Seat 1: HirotoBeats ($1.52 in chips) 
Seat 2: Scaaalll ($3.01 in chips) 
Seat 3: csmall14 ($2 in chips) 
Seat 4: rodrigoasor ($1.15 in chips) 
Seat 5: HubertFroh ($4.27 in chips) 
Seat 6: Treadero ($3.60 in chips) 
Scaaalll: posts small blind $0.01
csmall14: posts big blind $0.02
*** HOLE CARDS ***
Dealt to Scaaalll [5d 7d]
rodrigoasor has timed out
rodrigoasor: folds 
HubertFroh: folds 
Treadero: folds 
HirotoBeats: folds 
Scaaalll: folds 
Uncalled bet ($0.01) returned to csmall14
csmall14 collected $0.02 from pot
csmall14: doesn't show hand 
*** SUMMARY ***
Total pot $0.02 | Rake $0 
Seat 1: HirotoBeats (button) folded before Flop (didn't bet)
Seat 2: Scaaalll (small blind) folded before Flop
Seat 3: csmall14 (big blind) collected ($0.02)
Seat 4: rodrigoasor folded before Flop (didn't bet)
Seat 5: HubertFroh folded before Flop (didn't bet)
Seat 6: Treadero folded before Flop (didn't bet)



PokerStars Zoom Hand #229231822732:  Hold'em No Limit ($0.01/$0.02) - 2021/08/21 22:28:08 CET [2021/08/21 16:28:08 ET]
Table 'Halley' 6-max Seat #1 is the button
Seat 1: vovo4kapooh ($4.64 in chips) 
Seat 2: lexus00174 ($3.61 in chips) 
Seat 3: Scaaalll ($3 in chips) 
Seat 4: HubertFroh ($4.26 in chips) 
Seat 5: Lamro50 ($10.40 in chips) 
Seat 6: ChuckGaylordIII ($2.01 in chips) 
lexus00174: posts small blind $0.01
Scaaalll: posts big blind $0.02
*** HOLE CARDS ***
Dealt to Scaaalll [5s 7s]
ChuckGaylordIII is disconnected 
HubertFroh: raises $0.06 to $0.08
Lamro50: folds 
ChuckGaylordIII: folds 
vovo4kapooh: folds 
lexus00174: folds 
Scaaalll: folds 
Uncalled bet ($0.06) returned to HubertFroh
HubertFroh collected $0.05 from pot
HubertFroh: doesn't show hand 
*** SUMMARY ***
Total pot $0.05 | Rake $0 
Seat 1: vovo4kapooh (button) folded before Flop (didn't bet)
Seat 2: lexus00174 (small blind) folded before Flop
Seat 3: Scaaalll (big blind) folded before Flop
Seat 4: HubertFroh collected ($0.05)
Seat 5: Lamro50 folded before Flop (didn't bet)
Seat 6: ChuckGaylordIII folded before Flop (didn't bet)



PokerStars Zoom Hand #229231820441:  Hold'em No Limit ($0.01/$0.02) - 2021/08/21 22:28:03 CET [2021/08/21 16:28:03 ET]
Table 'Halley' 6-max Seat #1 is the button
Seat 1: snowy_96 ($2 in chips) 
Seat 2: pipecmolodec ($2.20 in chips) 
Seat 3: felipeciji ($2.27 in chips) 
Seat 4: djewlz ($3.69 in chips) 
Seat 5: Scaaalll ($3 in chips) 
Seat 6: kboskov123 ($1.87 in chips) 
pipecmolodec: posts small blind $0.01
felipeciji: posts big blind $0.02
*** HOLE CARDS ***
Dealt to Scaaalll [3c 5c]
djewlz: folds 
Scaaalll: folds 
kboskov123: folds 
snowy_96: folds 
pipecmolodec: raises $0.03 to $0.05
felipeciji: calls $0.03
*** FLOP *** [8d 2h 4h]
pipecmolodec: bets $0.03
felipeciji: calls $0.03
*** TURN *** [8d 2h 4h] [Ah]
pipecmolodec: checks 
felipeciji: bets $0.10
pipecmolodec: folds 
Uncalled bet ($0.10) returned to felipeciji
felipeciji collected $0.15 from pot
felipeciji: doesn't show hand 
*** SUMMARY ***
Total pot $0.16 | Rake $0.01 
Board [8d 2h 4h Ah]
Seat 1: snowy_96 (button) folded before Flop (didn't bet)
Seat 2: pipecmolodec (small blind) folded on the Turn
Seat 3: felipeciji (big blind) collected ($0.15)
Seat 4: djewlz folded before Flop (didn't bet)
Seat 5: Scaaalll folded before Flop (didn't bet)
Seat 6: kboskov123 folded before Flop (didn't bet)



PokerStars Zoom Hand #229231831798:  Hold'em No Limit ($0.01/$0.02) - 2021/08/21 22:28:28 CET [2021/08/21 16:28:28 ET]
Table 'Halley' 6-max Seat #1 is the button
Seat 1: EdwardF95 ($2.40 in chips) 
Seat 2: ash1448 ($10.23 in chips) 
Seat 3: anes.v. ($2.12 in chips) 
Seat 4: romul795 ($0.20 in chips) 
Seat 5: arturtsutsaev ($1.13 in chips) 
Seat 6: Scaaalll ($2.98 in chips) 
ash1448: posts small blind $0.01
anes.v.: posts big blind $0.02
*** HOLE CARDS ***
Dealt to Scaaalll [Jd As]
romul795: raises $0.02 to $0.04
arturtsutsaev: folds 
arturtsutsaev is disconnected 
Scaaalll: calls $0.04
EdwardF95: folds 
ash1448: folds 
anes.v.: calls $0.02
*** FLOP *** [Jc 3s 5d]
anes.v.: checks 
romul795: checks 
Scaaalll: bets $0.09
anes.v.: folds 
romul795: folds 
Uncalled bet ($0.09) returned to Scaaalll
Scaaalll collected $0.13 from pot
Scaaalll: doesn't show hand 
romul795 is disconnected 
*** SUMMARY ***
Total pot $0.13 | Rake $0 
Board [Jc 3s 5d]
Seat 1: EdwardF95 (button) folded before Flop (didn't bet)
Seat 2: ash1448 (small blind) folded before Flop
Seat 3: anes.v. (big blind) folded on the Flop
Seat 4: romul795 folded on the Flop
Seat 5: arturtsutsaev folded before Flop (didn't bet)
Seat 6: Scaaalll collected ($0.13)



PokerStars Zoom Hand #229231858148:  Hold'em No Limit ($0.01/$0.02) - 2021/08/21 22:29:27 CET [2021/08/21 16:29:27 ET]
Table 'Halley' 6-max Seat #1 is the button
Seat 1: Scaaalll ($3.07 in chips) 
Seat 2: marios199922 ($1.98 in chips) 
Seat 3: shingo594 ($4.69 in chips) 
Seat 4: tazar34_777 ($3.31 in chips) 
Seat 5: Misteltje ($1.13 in chips) 
Seat 6: Koldun 2636 ($3.45 in chips) 
marios199922: posts small blind $0.01
shingo594: posts big blind $0.02
*** HOLE CARDS ***
Dealt to Scaaalll [5h 2d]
tazar34_777: folds 
Misteltje: folds 
Koldun 2636 has timed out
Koldun 2636: folds 
Scaaalll: folds 
marios199922: folds 
Uncalled bet ($0.01) returned to shingo594
shingo594 collected $0.02 from pot
shingo594: doesn't show hand 
*** SUMMARY ***
Total pot $0.02 | Rake $0 
Seat 1: Scaaalll (button) folded before Flop (didn't bet)
Seat 2: marios199922 (small blind) folded before Flop
Seat 3: shingo594 (big blind) collected ($0.02)
Seat 4: tazar34_777 folded before Flop (didn't bet)
Seat 5: Misteltje folded before Flop (didn't bet)
Seat 6: Koldun 2636 folded before Flop (didn't bet)



PokerStars Zoom Hand #229231859968:  Hold'em No Limit ($0.01/$0.02) - 2021/08/21 22:29:31 CET [2021/08/21 16:29:31 ET]
Table 'Halley' 6-max Seat #1 is the button
Seat 1: EevAA190 ($3.06 in chips) 
Seat 2: skhmel77 ($0.94 in chips) 
Seat 3: 8Bullseye8 ($2.57 in chips) 
Seat 4: dkno77 ($5.31 in chips) 
Seat 5: zergmiky ($2.03 in chips) 
Seat 6: Scaaalll ($3.07 in chips) 
skhmel77: posts small blind $0.01
8Bullseye8: posts big blind $0.02
*** HOLE CARDS ***
Dealt to Scaaalll [6h 5h]
dkno77: folds 
zergmiky: folds 
Scaaalll: raises $0.04 to $0.06
EevAA190: folds 
skhmel77: folds 
8Bullseye8: calls $0.04
*** FLOP *** [Jc 8c 4c]
8Bullseye8: checks 
Scaaalll: checks 
*** TURN *** [Jc 8c 4c] [Jd]
8Bullseye8: checks 
Scaaalll: checks 
*** RIVER *** [Jc 8c 4c Jd] [Qd]
8Bullseye8: checks 
Scaaalll: checks 
*** SHOW DOWN ***
8Bullseye8: shows [Kd Td] (a pair of Jacks)
Scaaalll: mucks hand 
8Bullseye8 collected $0.13 from pot
*** SUMMARY ***
Total pot $0.13 | Rake $0 
Board [Jc 8c 4c Jd Qd]
Seat 1: EevAA190 (button) folded before Flop (didn't bet)
Seat 2: skhmel77 (small blind) folded before Flop
Seat 3: 8Bullseye8 (big blind) showed [Kd Td] and won ($0.13) with a pair of Jacks
Seat 4: dkno77 folded before Flop (didn't bet)
Seat 5: zergmiky folded before Flop (didn't bet)
Seat 6: Scaaalll mucked [6h 5h]



PokerStars Zoom Hand #229231881407:  Hold'em No Limit ($0.01/$0.02) - 2021/08/21 22:30:18 CET [2021/08/21 16:30:18 ET]
Table 'Halley' 6-max Seat #1 is the button
Seat 1: 8Bullseye8 ($2.64 in chips) 
Seat 2: Scaaalll ($3.01 in chips) 
Seat 3: Capitaine Pat ($1.43 in chips) 
Seat 4: nV6TR ($6.99 in chips) 
Seat 5: so0love ($7.12 in chips) 
Seat 6: Earl_greyPL ($1.58 in chips) 
Scaaalll: posts small blind $0.01
Capitaine Pat: posts big blind $0.02
*** HOLE CARDS ***
Dealt to Scaaalll [Ah As]
nV6TR: raises $0.02 to $0.04
so0love: folds 
Earl_greyPL: folds 
8Bullseye8: folds 
Scaaalll: raises $0.14 to $0.18
Capitaine Pat: folds 
nV6TR: calls $0.14
*** FLOP *** [4s 3d 8d]
Scaaalll: bets $0.22
nV6TR: folds 
Uncalled bet ($0.22) returned to Scaaalll
Scaaalll collected $0.37 from pot
Scaaalll: doesn't show hand 
*** SUMMARY ***
Total pot $0.38 | Rake $0.01 
Board [4s 3d 8d]
Seat 1: 8Bullseye8 (button) folded before Flop (didn't bet)
Seat 2: Scaaalll (small blind) collected ($0.37)
Seat 3: Capitaine Pat (big blind) folded before Flop
Seat 4: nV6TR folded on the Flop
Seat 5: so0love folded before Flop (didn't bet)
Seat 6: Earl_greyPL folded before Flop (didn't bet)



PokerStars Zoom Hand #229231901078:  Hold'em No Limit ($0.01/$0.02) - 2021/08/21 22:31:02 CET [2021/08/21 16:31:02 ET]
Table 'Halley' 6-max Seat #1 is the button
Seat 1: Scaaalll ($3.20 in chips) 
Seat 2: Koldun 2636 ($3.92 in chips) 
Seat 3: bbarao ($1.37 in chips) 
Seat 4: gasmar_29 ($2.03 in chips) 
Seat 5: caiolima99 ($8.08 in chips) 
Seat 6: estelionat171 ($1.16 in chips) 
Koldun 2636: posts small blind $0.01
bbarao: posts big blind $0.02
*** HOLE CARDS ***
Dealt to Scaaalll [Td 7h]
gasmar_29: raises $0.04 to $0.06
caiolima99: folds 
estelionat171: folds 
Scaaalll: folds 
Koldun 2636: folds 
bbarao: folds 
Uncalled bet ($0.04) returned to gasmar_29
gasmar_29 collected $0.05 from pot
gasmar_29: doesn't show hand 
*** SUMMARY ***
Total pot $0.05 | Rake $0 
Seat 1: Scaaalll (button) folded before Flop (didn't bet)
Seat 2: Koldun 2636 (small blind) folded before Flop
Seat 3: bbarao (big blind) folded before Flop
Seat 4: gasmar_29 collected ($0.05)
Seat 5: caiolima99 folded before Flop (didn't bet)
Seat 6: estelionat171 folded before Flop (didn't bet)



PokerStars Zoom Hand #229231902894:  Hold'em No Limit ($0.01/$0.02) - 2021/08/21 22:31:06 CET [2021/08/21 16:31:06 ET]
Table 'Halley' 6-max Seat #1 is the button
Seat 1: Reipinguimm ($2.09 in chips) 
Seat 2: Sinad1302 ($3.94 in chips) 
Seat 3: S.P.S...99 ($1 in chips) 
Seat 4: julioseth ($0.93 in chips) 
Seat 5: Scaaalll ($3.20 in chips) 
Seat 6: VasquezSancho96 ($6.90 in chips) 
Sinad1302: posts small blind $0.01
S.P.S...99: posts big blind $0.02
*** HOLE CARDS ***
Dealt to Scaaalll [Qs Kh]
julioseth: folds 
Sinad1302 is disconnected 
Scaaalll: raises $0.04 to $0.06
VasquezSancho96: folds 
Reipinguimm: folds 
Sinad1302: folds 
S.P.S...99: raises $0.04 to $0.10
Scaaalll: calls $0.04
*** FLOP *** [9d Ac Jd]
S.P.S...99: bets $0.20
Scaaalll: folds 
Uncalled bet ($0.20) returned to S.P.S...99
S.P.S...99 collected $0.20 from pot
S.P.S...99: doesn't show hand 
*** SUMMARY ***
Total pot $0.21 | Rake $0.01 
Board [9d Ac Jd]
Seat 1: Reipinguimm (button) folded before Flop (didn't bet)
Seat 2: Sinad1302 (small blind) folded before Flop
Seat 3: S.P.S...99 (big blind) collected ($0.20)
Seat 4: julioseth folded before Flop (didn't bet)
Seat 5: Scaaalll folded on the Flop
Seat 6: VasquezSancho96 folded before Flop (didn't bet)



PokerStars Zoom Hand #229231917609:  Hold'em No Limit ($0.01/$0.02) - 2021/08/21 22:31:39 CET [2021/08/21 16:31:39 ET]
Table 'Halley' 6-max Seat #1 is the button
Seat 1: GVMELLO ($2 in chips) 
Seat 2: Emilmoller1 ($3.17 in chips) 
Seat 3: Scaaalll ($3.10 in chips) 
Seat 4: BlackhawKK's ($3.14 in chips) 
Seat 5: alexan00 ($2.98 in chips) 
Seat 6: Daino G ($2 in chips) 
Emilmoller1: posts small blind $0.01
Scaaalll: posts big blind $0.02
*** HOLE CARDS ***
Dealt to Scaaalll [8h 2h]
BlackhawKK's: raises $0.06 to $0.08
alexan00: folds 
Daino G: folds 
GVMELLO: folds 
Emilmoller1: folds 
Scaaalll: folds 
Uncalled bet ($0.06) returned to BlackhawKK's
BlackhawKK's collected $0.05 from pot
BlackhawKK's: doesn't show hand 
*** SUMMARY ***
Total pot $0.05 | Rake $0 
Seat 1: GVMELLO (button) folded before Flop (didn't bet)
Seat 2: Emilmoller1 (small blind) folded before Flop
Seat 3: Scaaalll (big blind) folded before Flop
Seat 4: BlackhawKK's collected ($0.05)
Seat 5: alexan00 folded before Flop (didn't bet)
Seat 6: Daino G folded before Flop (didn't bet)



PokerStars Zoom Hand #229231924990:  Hold'em No Limit ($0.01/$0.02) - 2021/08/21 22:31:55 CET [2021/08/21 16:31:55 ET]
Table 'Halley' 6-max Seat #1 is the button
Seat 1: pipecmolodec ($2.04 in chips) 
Seat 2: tazar34_777 ($5.20 in chips) 
Seat 3: Richaud ($2.98 in chips) 
Seat 4: LSDenny ($1.93 in chips) 
Seat 5: 8Bullseye8 ($2.78 in chips) 
Seat 6: Scaaalll ($3.08 in chips) 
tazar34_777: posts small blind $0.01
Richaud: posts big blind $0.02
*** HOLE CARDS ***
Dealt to Scaaalll [2d 6h]
LSDenny: folds 
8Bullseye8: folds 
LSDenny is disconnected 
Scaaalll: folds 
pipecmolodec: folds 
tazar34_777: folds 
Uncalled bet ($0.01) returned to Richaud
Richaud collected $0.02 from pot
Richaud: doesn't show hand 
*** SUMMARY ***
Total pot $0.02 | Rake $0 
Seat 1: pipecmolodec (button) folded before Flop (didn't bet)
Seat 2: tazar34_777 (small blind) folded before Flop
Seat 3: Richaud (big blind) collected ($0.02)
Seat 4: LSDenny folded before Flop (didn't bet)
Seat 5: 8Bullseye8 folded before Flop (didn't bet)
Seat 6: Scaaalll folded before Flop (didn't bet)



PokerStars Zoom Hand #229231929522:  Hold'em No Limit ($0.01/$0.02) - 2021/08/21 22:32:05 CET [2021/08/21 16:32:05 ET]
Table 'Halley' 6-max Seat #1 is the button
Seat 1: ded serch ($2 in chips) 
Seat 2: Scaaalll ($3.08 in chips) 
Seat 3: new face onl ($1.95 in chips) 
Seat 4: Nancy_88 ($2.32 in chips) 
Seat 5: RaulacateFolds ($2 in chips) 
Seat 6: tazar34_777 ($5.19 in chips) 
Scaaalll: posts small blind $0.01
new face onl: posts big blind $0.02
*** HOLE CARDS ***
Dealt to Scaaalll [4h Ts]
Nancy_88: folds 
Nancy_88 is disconnected 
RaulacateFolds: folds 
tazar34_777: folds 
ded serch: folds 
Scaaalll: folds 
Uncalled bet ($0.01) returned to new face onl
new face onl collected $0.02 from pot
new face onl: doesn't show hand 
*** SUMMARY ***
Total pot $0.02 | Rake $0 
Seat 1: ded serch (button) folded before Flop (didn't bet)
Seat 2: Scaaalll (small blind) folded before Flop
Seat 3: new face onl (big blind) collected ($0.02)
Seat 4: Nancy_88 folded before Flop (didn't bet)
Seat 5: RaulacateFolds folded before Flop (didn't bet)
Seat 6: tazar34_777 folded before Flop (didn't bet)



PokerStars Zoom Hand #229231933955:  Hold'em No Limit ($0.01/$0.02) - 2021/08/21 22:32:15 CET [2021/08/21 16:32:15 ET]
Table 'Halley' 6-max Seat #1 is the button
Seat 1: DaBaDaBaDooo ($2 in chips) 
Seat 2: Enoffllescini ($2.31 in chips) 
Seat 3: Dima11321 ($0.76 in chips) 
Seat 4: dkno77 ($5.40 in chips) 
Seat 5: Scaaalll ($3.07 in chips) 
Seat 6: RaulacateFolds ($2.73 in chips) 
Enoffllescini: posts small blind $0.01
Dima11321: posts big blind $0.02
*** HOLE CARDS ***
Dealt to Scaaalll [Qc 3h]
dkno77: folds 
Scaaalll: folds 
RaulacateFolds: folds 
DaBaDaBaDooo: folds 
Enoffllescini: folds 
Uncalled bet ($0.01) returned to Dima11321
Dima11321 collected $0.02 from pot
Dima11321: doesn't show hand 
*** SUMMARY ***
Total pot $0.02 | Rake $0 
Seat 1: DaBaDaBaDooo (button) folded before Flop (didn't bet)
Seat 2: Enoffllescini (small blind) folded before Flop
Seat 3: Dima11321 (big blind) collected ($0.02)
Seat 4: dkno77 folded before Flop (didn't bet)
Seat 5: Scaaalll folded before Flop (didn't bet)
Seat 6: RaulacateFolds folded before Flop (didn't bet)



PokerStars Zoom Hand #229231936632:  Hold'em No Limit ($0.01/$0.02) - 2021/08/21 22:32:21 CET [2021/08/21 16:32:21 ET]
Table 'Halley' 6-max Seat #1 is the button
Seat 1: Scaaalll ($3.07 in chips) 
Seat 2: zallav ($2.69 in chips) 
Seat 3: polymorhp ($3.61 in chips) 
Seat 4: Kreodont1987 ($2 in chips) 
Seat 5: ppluiaule ($5.96 in chips) 
Seat 6: Finderra ($2.94 in chips) 
zallav: posts small blind $0.01
polymorhp: posts big blind $0.02
*** HOLE CARDS ***
Dealt to Scaaalll [4c 7s]
Kreodont1987: folds 
ppluiaule: folds 
Finderra: folds 
Scaaalll: folds 
zallav: raises $0.04 to $0.06
polymorhp: folds 
Uncalled bet ($0.04) returned to zallav
zallav collected $0.04 from pot
zallav: doesn't show hand 
*** SUMMARY ***
Total pot $0.04 | Rake $0 
Seat 1: Scaaalll (button) folded before Flop (didn't bet)
Seat 2: zallav (small blind) collected ($0.04)
Seat 3: polymorhp (big blind) folded before Flop
Seat 4: Kreodont1987 folded before Flop (didn't bet)
Seat 5: ppluiaule folded before Flop (didn't bet)
Seat 6: Finderra folded before Flop (didn't bet)



PokerStars Zoom Hand #229231927745:  Hold'em No Limit ($0.01/$0.02) - 2021/08/21 22:32:01 CET [2021/08/21 16:32:01 ET]
Table 'Halley' 6-max Seat #1 is the button
Seat 1: 78joniboy ($2.43 in chips) 
Seat 2: bach444 ($4.41 in chips) 
Seat 3: astapowitsch ($2 in chips) 
Seat 4: Scaaalll ($3.08 in chips) 
Seat 5: Earl_greyPL ($1.59 in chips) 
Seat 6: mnozz83 ($1.31 in chips) 
bach444: posts small blind $0.01
astapowitsch: posts big blind $0.02
*** HOLE CARDS ***
Dealt to Scaaalll [Ks 4s]
Scaaalll: folds 
Earl_greyPL: folds 
mnozz83: calls $0.02
78joniboy: folds 
bach444: calls $0.01
astapowitsch: checks 
*** FLOP *** [4d 2s 8s]
bach444: checks 
astapowitsch: checks 
mnozz83: checks 
*** TURN *** [4d 2s 8s] [7d]
bach444: checks 
astapowitsch: bets $0.02
mnozz83: raises $0.05 to $0.07
bach444: folds 
bach444 is disconnected 
astapowitsch: calls $0.05
*** RIVER *** [4d 2s 8s 7d] [6h]
astapowitsch: checks 
mnozz83: bets $0.10
astapowitsch: folds 
Uncalled bet ($0.10) returned to mnozz83
mnozz83 collected $0.19 from pot
mnozz83: doesn't show hand 
*** SUMMARY ***
Total pot $0.20 | Rake $0.01 
Board [4d 2s 8s 7d 6h]
Seat 1: 78joniboy (button) folded before Flop (didn't bet)
Seat 2: bach444 (small blind) folded on the Turn
Seat 3: astapowitsch (big blind) folded on the River
Seat 4: Scaaalll folded before Flop (didn't bet)
Seat 5: Earl_greyPL folded before Flop (didn't bet)
Seat 6: mnozz83 collected ($0.19)



PokerStars Zoom Hand #229231944225:  Hold'em No Limit ($0.01/$0.02) - 2021/08/21 22:32:38 CET [2021/08/21 16:32:38 ET]
Table 'Halley' 6-max Seat #1 is the button
Seat 1: stealth_ua ($2 in chips) 
Seat 2: Buwa_Mika ($1.78 in chips) 
Seat 3: Tacojesuscrisp ($2.14 in chips) 
Seat 4: Scaaalll ($3.07 in chips) 
Seat 5: NOLUWDtC ($2.11 in chips) 
Seat 6: KonopDima ($2.59 in chips) 
Buwa_Mika: posts small blind $0.01
Tacojesuscrisp: posts big blind $0.02
*** HOLE CARDS ***
Dealt to Scaaalll [Tc Qd]
Buwa_Mika is disconnected 
Scaaalll: raises $0.04 to $0.06
NOLUWDtC: folds 
KonopDima: folds 
stealth_ua: folds 
Buwa_Mika: folds 
Tacojesuscrisp: folds 
Uncalled bet ($0.04) returned to Scaaalll
NOLUWDtC is disconnected 
Scaaalll collected $0.05 from pot
Scaaalll: doesn't show hand 
*** SUMMARY ***
Total pot $0.05 | Rake $0 
Seat 1: stealth_ua (button) folded before Flop (didn't bet)
Seat 2: Buwa_Mika (small blind) folded before Flop
Seat 3: Tacojesuscrisp (big blind) folded before Flop
Seat 4: Scaaalll collected ($0.05)
Seat 5: NOLUWDtC folded before Flop (didn't bet)
Seat 6: KonopDima folded before Flop (didn't bet)



PokerStars Zoom Hand #229231949261:  Hold'em No Limit ($0.01/$0.02) - 2021/08/21 22:32:49 CET [2021/08/21 16:32:49 ET]
Table 'Halley' 6-max Seat #1 is the button
Seat 1: gilberto98 ($1.88 in chips) 
Seat 2: Ahoy_04 ($0.70 in chips) 
Seat 3: Scaaalll ($3.10 in chips) 
Seat 4: vovo4kapooh ($2.06 in chips) 
Seat 5: fishh_play ($3.95 in chips) 
Seat 6: polymorhp ($3.58 in chips) 
Ahoy_04: posts small blind $0.01
Scaaalll: posts big blind $0.02
*** HOLE CARDS ***
Dealt to Scaaalll [8s Ac]
vovo4kapooh: folds 
fishh_play: folds 
polymorhp: folds 
gilberto98: raises $0.04 to $0.06
Ahoy_04: calls $0.05
Scaaalll: folds 
*** FLOP *** [9h 8d As]
Ahoy_04: checks 
gilberto98: bets $0.07
Ahoy_04: folds 
Uncalled bet ($0.07) returned to gilberto98
gilberto98 collected $0.14 from pot
gilberto98: doesn't show hand 
*** SUMMARY ***
Total pot $0.14 | Rake $0 
Board [9h 8d As]
Seat 1: gilberto98 (button) collected ($0.14)
Seat 2: Ahoy_04 (small blind) folded on the Flop
Seat 3: Scaaalll (big blind) folded before Flop
Seat 4: vovo4kapooh folded before Flop (didn't bet)
Seat 5: fishh_play folded before Flop (didn't bet)
Seat 6: polymorhp folded before Flop (didn't bet)



PokerStars Zoom Hand #229231958674:  Hold'em No Limit ($0.01/$0.02) - 2021/08/21 22:33:10 CET [2021/08/21 16:33:10 ET]
Table 'Halley' 6-max Seat #1 is the button
Seat 1: fishh_play ($3.25 in chips) 
Seat 2: Scaaalll ($3.08 in chips) 
Seat 3: Sinad1302 ($3.95 in chips) 
Seat 4: ADWish ($1.23 in chips) 
Seat 5: Kb013497 ($1.60 in chips) 
Seat 6: Axel201388 ($0.77 in chips) 
Scaaalll: posts small blind $0.01
Sinad1302: posts big blind $0.02
*** HOLE CARDS ***
Dealt to Scaaalll [As Jc]
ADWish: folds 
Kb013497: folds 
Axel201388: folds 
fishh_play: folds 
Scaaalll: raises $0.04 to $0.06
Sinad1302: calls $0.04
*** FLOP *** [9h 9s Kc]
Scaaalll: bets $0.07
Sinad1302: raises $0.13 to $0.20
Scaaalll: folds 
Uncalled bet ($0.13) returned to Sinad1302
Sinad1302 collected $0.25 from pot
Sinad1302: doesn't show hand 
*** SUMMARY ***
Total pot $0.26 | Rake $0.01 
Board [9h 9s Kc]
Seat 1: fishh_play (button) folded before Flop (didn't bet)
Seat 2: Scaaalll (small blind) folded on the Flop
Seat 3: Sinad1302 (big blind) collected ($0.25)
Seat 4: ADWish folded before Flop (didn't bet)
Seat 5: Kb013497 folded before Flop (didn't bet)
Seat 6: Axel201388 folded before Flop (didn't bet)



PokerStars Zoom Hand #229231971771:  Hold'em No Limit ($0.01/$0.02) - 2021/08/21 22:33:39 CET [2021/08/21 16:33:39 ET]
Table 'Halley' 6-max Seat #1 is the button
Seat 1: GUN118 ($1.81 in chips) 
Seat 2: Earl_greyPL ($1.57 in chips) 
Seat 3: KonopDima ($2 in chips) 
Seat 4: dcd113 ($0.78 in chips) 
Seat 5: elmex886 ($2.59 in chips) 
Seat 6: Scaaalll ($2.95 in chips) 
Earl_greyPL: posts small blind $0.01
KonopDima: posts big blind $0.02
*** HOLE CARDS ***
Dealt to Scaaalll [7c Kc]
dcd113: folds 
elmex886: folds 
Scaaalll: folds 
GUN118: folds 
Earl_greyPL: folds 
Uncalled bet ($0.01) returned to KonopDima
KonopDima collected $0.02 from pot
KonopDima: doesn't show hand 
*** SUMMARY ***
Total pot $0.02 | Rake $0 
Seat 1: GUN118 (button) folded before Flop (didn't bet)
Seat 2: Earl_greyPL (small blind) folded before Flop
Seat 3: KonopDima (big blind) collected ($0.02)
Seat 4: dcd113 folded before Flop (didn't bet)
Seat 5: elmex886 folded before Flop (didn't bet)
Seat 6: Scaaalll folded before Flop (didn't bet)



PokerStars Zoom Hand #229231975876:  Hold'em No Limit ($0.01/$0.02) - 2021/08/21 22:33:48 CET [2021/08/21 16:33:48 ET]
Table 'Halley' 6-max Seat #1 is the button
Seat 1: Posaunengodi ($2 in chips) 
Seat 2: HirotoBeats ($2.29 in chips) 
Seat 3: alecha11 ($3.61 in chips) 
Seat 4: Scaaalll ($2.95 in chips) 
Seat 5: bananAAbandit ($2.04 in chips) 
Seat 6: Busya777 ($1.79 in chips) 
HirotoBeats: posts small blind $0.01
alecha11: posts big blind $0.02
*** HOLE CARDS ***
Dealt to Scaaalll [As Qs]
Scaaalll: raises $0.04 to $0.06
bananAAbandit: folds 
Busya777: calls $0.06
Posaunengodi: folds 
HirotoBeats: folds 
alecha11: folds 
*** FLOP *** [3s 2h 7h]
Scaaalll: bets $0.09
Busya777: folds 
Uncalled bet ($0.09) returned to Scaaalll
Scaaalll collected $0.14 from pot
Scaaalll: doesn't show hand 
Busya777 is disconnected 
*** SUMMARY ***
Total pot $0.15 | Rake $0.01 
Board [3s 2h 7h]
Seat 1: Posaunengodi (button) folded before Flop (didn't bet)
Seat 2: HirotoBeats (small blind) folded before Flop
Seat 3: alecha11 (big blind) folded before Flop
Seat 4: Scaaalll collected ($0.14)
Seat 5: bananAAbandit folded before Flop (didn't bet)
Seat 6: Busya777 folded on the Flop



PokerStars Zoom Hand #229231985849:  Hold'em No Limit ($0.01/$0.02) - 2021/08/21 22:34:10 CET [2021/08/21 16:34:10 ET]
Table 'Halley' 6-max Seat #1 is the button
Seat 1: PEDACIT0 ($2.22 in chips) 
Seat 2: NickAlex18 ($2.15 in chips) 
Seat 3: ChuckGaylordIII ($2.75 in chips) 
Seat 4: Daino G ($3.24 in chips) 
Seat 5: Scaaalll ($3.03 in chips) 
Seat 6: BexleyBoy ($1.91 in chips) 
NickAlex18: posts small blind $0.01
ChuckGaylordIII: posts big blind $0.02
*** HOLE CARDS ***
Dealt to Scaaalll [4s 4d]
Daino G: folds 
Scaaalll: raises $0.04 to $0.06
BexleyBoy: folds 
PEDACIT0: folds 
NickAlex18: folds 
ChuckGaylordIII: calls $0.04
*** FLOP *** [Th 2s 2d]
ChuckGaylordIII: bets $0.13
Scaaalll: folds 
Uncalled bet ($0.13) returned to ChuckGaylordIII
ChuckGaylordIII collected $0.13 from pot
ChuckGaylordIII: doesn't show hand 
*** SUMMARY ***
Total pot $0.13 | Rake $0 
Board [Th 2s 2d]
Seat 1: PEDACIT0 (button) folded before Flop (didn't bet)
Seat 2: NickAlex18 (small blind) folded before Flop
Seat 3: ChuckGaylordIII (big blind) collected ($0.13)
Seat 4: Daino G folded before Flop (didn't bet)
Seat 5: Scaaalll folded on the Flop
Seat 6: BexleyBoy folded before Flop (didn't bet)



PokerStars Zoom Hand #229231999545:  Hold'em No Limit ($0.01/$0.02) - 2021/08/21 22:34:41 CET [2021/08/21 16:34:41 ET]
Table 'Halley' 6-max Seat #1 is the button
Seat 1: AlexGTPS ($2.29 in chips) 
Seat 2: Luben_76 ($2.42 in chips) 
Seat 3: LSDenny ($1.83 in chips) 
Seat 4: Scaaalll ($2.97 in chips) 
Seat 5: Gamer577 ($2 in chips) 
Seat 6: alexan00 ($3.17 in chips) 
Luben_76: posts small blind $0.01
LSDenny: posts big blind $0.02
*** HOLE CARDS ***
Dealt to Scaaalll [8c 2c]
Scaaalll: folds 
Gamer577: folds 
alexan00: folds 
AlexGTPS: folds 
Luben_76: raises $0.04 to $0.06
LSDenny: folds 
Uncalled bet ($0.04) returned to Luben_76
Luben_76 collected $0.04 from pot
Luben_76: doesn't show hand 
LSDenny is disconnected 
*** SUMMARY ***
Total pot $0.04 | Rake $0 
Seat 1: AlexGTPS (button) folded before Flop (didn't bet)
Seat 2: Luben_76 (small blind) collected ($0.04)
Seat 3: LSDenny (big blind) folded before Flop
Seat 4: Scaaalll folded before Flop (didn't bet)
Seat 5: Gamer577 folded before Flop (didn't bet)
Seat 6: alexan00 folded before Flop (didn't bet)



PokerStars Zoom Hand #229232001803:  Hold'em No Limit ($0.01/$0.02) - 2021/08/21 22:34:46 CET [2021/08/21 16:34:46 ET]
Table 'Halley' 6-max Seat #1 is the button
Seat 1: Luettefee ($3.68 in chips) 
Seat 2: weire99 ($3.76 in chips) 
Seat 3: Scaaalll ($2.97 in chips) 
Seat 4: tazar34_777 ($5.63 in chips) 
Seat 5: Iwanb4 ($3.16 in chips) 
Seat 6: AlexGTPS ($2.29 in chips) 
weire99: posts small blind $0.01
Scaaalll: posts big blind $0.02
*** HOLE CARDS ***
Dealt to Scaaalll [2s 6h]
tazar34_777: folds 
Iwanb4: raises $0.04 to $0.06
AlexGTPS: folds 
Luettefee: folds 
weire99: calls $0.05
Scaaalll: folds 
*** FLOP *** [8d 9c 4h]
weire99: checks 
Iwanb4: bets $0.11
weire99: folds 
Uncalled bet ($0.11) returned to Iwanb4
Iwanb4 collected $0.14 from pot
Iwanb4: doesn't show hand 
weire99 is disconnected 
*** SUMMARY ***
Total pot $0.14 | Rake $0 
Board [8d 9c 4h]
Seat 1: Luettefee (button) folded before Flop (didn't bet)
Seat 2: weire99 (small blind) folded on the Flop
Seat 3: Scaaalll (big blind) folded before Flop
Seat 4: tazar34_777 folded before Flop (didn't bet)
Seat 5: Iwanb4 collected ($0.14)
Seat 6: AlexGTPS folded before Flop (didn't bet)



PokerStars Zoom Hand #229232009389:  Hold'em No Limit ($0.01/$0.02) - 2021/08/21 22:35:03 CET [2021/08/21 16:35:03 ET]
Table 'Halley' 6-max Seat #1 is the button
Seat 1: Scaaalll ($2.95 in chips) 
Seat 2: Mikeloko182 ($2.11 in chips) 
Seat 3: bbarao ($3.44 in chips) 
Seat 4: so0love ($2 in chips) 
Seat 5: El Chicha.CL ($2 in chips) 
Seat 6: ChowMangao ($2 in chips) 
Mikeloko182: posts small blind $0.01
bbarao: posts big blind $0.02
*** HOLE CARDS ***
Dealt to Scaaalll [Jd 9h]
so0love: folds 
El Chicha.CL: raises $0.04 to $0.06
ChowMangao: folds 
Scaaalll: folds 
Mikeloko182: folds 
bbarao: folds 
Uncalled bet ($0.04) returned to El Chicha.CL
El Chicha.CL collected $0.05 from pot
El Chicha.CL: doesn't show hand 
*** SUMMARY ***
Total pot $0.05 | Rake $0 
Seat 1: Scaaalll (button) folded before Flop (didn't bet)
Seat 2: Mikeloko182 (small blind) folded before Flop
Seat 3: bbarao (big blind) folded before Flop
Seat 4: so0love folded before Flop (didn't bet)
Seat 5: El Chicha.CL collected ($0.05)
Seat 6: ChowMangao folded before Flop (didn't bet)



PokerStars Zoom Hand #229232014739:  Hold'em No Limit ($0.01/$0.02) - 2021/08/21 22:35:15 CET [2021/08/21 16:35:15 ET]
Table 'Halley' 6-max Seat #1 is the button
Seat 1: HellNative ($3.75 in chips) 
Seat 2: Koldun 2636 ($3.73 in chips) 
Seat 3: estelionat171 ($0.99 in chips) 
Seat 4: Summerstrike ($3.70 in chips) 
Seat 5: astapowitsch ($2.06 in chips) 
Seat 6: Scaaalll ($2.95 in chips) 
Koldun 2636: posts small blind $0.01
estelionat171: posts big blind $0.02
*** HOLE CARDS ***
Dealt to Scaaalll [Qs Kh]
Summerstrike: raises $0.04 to $0.06
astapowitsch: folds 
Scaaalll: calls $0.06
HellNative: folds 
Koldun 2636: folds 
estelionat171: folds 
*** FLOP *** [9d 8h 6d]
Summerstrike: checks 
Scaaalll: checks 
*** TURN *** [9d 8h 6d] [Kc]
Summerstrike: checks 
Scaaalll: bets $0.09
Summerstrike: folds 
Uncalled bet ($0.09) returned to Scaaalll
Scaaalll collected $0.14 from pot
Scaaalll: doesn't show hand 
Summerstrike is disconnected 
*** SUMMARY ***
Total pot $0.15 | Rake $0.01 
Board [9d 8h 6d Kc]
Seat 1: HellNative (button) folded before Flop (didn't bet)
Seat 2: Koldun 2636 (small blind) folded before Flop
Seat 3: estelionat171 (big blind) folded before Flop
Seat 4: Summerstrike folded on the Turn
Seat 5: astapowitsch folded before Flop (didn't bet)
Seat 6: Scaaalll collected ($0.14)



PokerStars Zoom Hand #229232046445:  Hold'em No Limit ($0.01/$0.02) - 2021/08/21 22:36:26 CET [2021/08/21 16:36:26 ET]
Table 'Halley' 6-max Seat #1 is the button
Seat 1: Agno$tic ($6.05 in chips) 
Seat 2: Scaaalll ($3.03 in chips) 
Seat 3: dorro61966 ($1.92 in chips) 
Seat 4: gesaes ($1.23 in chips) 
Seat 5: Axel201388 ($2.06 in chips) 
Seat 6: ricske68 ($3.35 in chips) 
Scaaalll: posts small blind $0.01
dorro61966: posts big blind $0.02
*** HOLE CARDS ***
Dealt to Scaaalll [7s 3s]
gesaes: calls $0.02
Axel201388: folds 
ricske68: folds 
Agno$tic: folds 
Scaaalll: calls $0.01
dorro61966: checks 
*** FLOP *** [7c 2d 2h]
Scaaalll: bets $0.02
dorro61966: calls $0.02
gesaes: calls $0.02
*** TURN *** [7c 2d 2h] [3c]
Scaaalll: bets $0.06
dorro61966: calls $0.06
gesaes: folds 
*** RIVER *** [7c 2d 2h 3c] [6h]
Scaaalll: bets $0.14
dorro61966: folds 
Uncalled bet ($0.14) returned to Scaaalll
Scaaalll collected $0.23 from pot
Scaaalll: doesn't show hand 
*** SUMMARY ***
Total pot $0.24 | Rake $0.01 
Board [7c 2d 2h 3c 6h]
Seat 1: Agno$tic (button) folded before Flop (didn't bet)
Seat 2: Scaaalll (small blind) collected ($0.23)
Seat 3: dorro61966 (big blind) folded on the River
Seat 4: gesaes folded on the Turn
Seat 5: Axel201388 folded before Flop (didn't bet)
Seat 6: ricske68 folded before Flop (didn't bet)



PokerStars Zoom Hand #229232065309:  Hold'em No Limit ($0.01/$0.02) - 2021/08/21 22:37:08 CET [2021/08/21 16:37:08 ET]
Table 'Halley' 6-max Seat #1 is the button
Seat 1: Reipinguimm ($2.01 in chips) 
Seat 2: keldh ($2.51 in chips) 
Seat 3: Scaaalll ($3.16 in chips) 
Seat 4: Koldun 2636 ($2.69 in chips) 
Seat 5: elmex886 ($2.21 in chips) 
Seat 6: bananAAbandit ($2 in chips) 
keldh: posts small blind $0.01
Scaaalll: posts big blind $0.02
*** HOLE CARDS ***
Dealt to Scaaalll [3d 3h]
Koldun 2636: folds 
elmex886: raises $0.03 to $0.05
bananAAbandit: folds 
Reipinguimm: folds 
keldh: calls $0.04
Scaaalll: calls $0.03
*** FLOP *** [7s Kc 4d]
keldh: checks 
Scaaalll: checks 
elmex886: checks 
*** TURN *** [7s Kc 4d] [9h]
keldh: bets $0.09
Scaaalll: folds 
elmex886: calls $0.09
*** RIVER *** [7s Kc 4d 9h] [9c]
keldh: bets $0.21
elmex886: folds 
Uncalled bet ($0.21) returned to keldh
keldh collected $0.32 from pot
keldh: doesn't show hand 
*** SUMMARY ***
Total pot $0.33 | Rake $0.01 
Board [7s Kc 4d 9h 9c]
Seat 1: Reipinguimm (button) folded before Flop (didn't bet)
Seat 2: keldh (small blind) collected ($0.32)
Seat 3: Scaaalll (big blind) folded on the Turn
Seat 4: Koldun 2636 folded before Flop (didn't bet)
Seat 5: elmex886 folded on the River
Seat 6: bananAAbandit folded before Flop (didn't bet)



PokerStars Zoom Hand #229232075557:  Hold'em No Limit ($0.01/$0.02) - 2021/08/21 22:37:31 CET [2021/08/21 16:37:31 ET]
Table 'Halley' 6-max Seat #1 is the button
Seat 1: Scaaalll ($3.11 in chips) 
Seat 2: vovo4kapooh ($4.80 in chips) 
Seat 3: zbixxx ($4.34 in chips) 
Seat 4: Umnik_M ($2.06 in chips) 
Seat 5: Finderra ($2 in chips) 
Seat 6: LijanaV ($5.85 in chips) 
vovo4kapooh: posts small blind $0.01
zbixxx: posts big blind $0.02
*** HOLE CARDS ***
Dealt to Scaaalll [8c Qs]
LijanaV is disconnected 
Umnik_M: folds 
Finderra: folds 
LijanaV: folds 
Scaaalll: raises $0.02 to $0.04
vovo4kapooh: folds 
zbixxx: folds 
Uncalled bet ($0.02) returned to Scaaalll
Scaaalll collected $0.05 from pot
Scaaalll: doesn't show hand 
*** SUMMARY ***
Total pot $0.05 | Rake $0 
Seat 1: Scaaalll (button) collected ($0.05)
Seat 2: vovo4kapooh (small blind) folded before Flop
Seat 3: zbixxx (big blind) folded before Flop
Seat 4: Umnik_M folded before Flop (didn't bet)
Seat 5: Finderra folded before Flop (didn't bet)
Seat 6: LijanaV folded before Flop (didn't bet)



PokerStars Zoom Hand #229232082196:  Hold'em No Limit ($0.01/$0.02) - 2021/08/21 22:37:46 CET [2021/08/21 16:37:46 ET]
Table 'Halley' 6-max Seat #1 is the button
Seat 1: ser313131 ($6.03 in chips) 
Seat 2: JBPY ($1.95 in chips) 
Seat 3: Demidov V.S. ($0.62 in chips) 
Seat 4: Clavis Noa ($4.07 in chips) 
Seat 5: XHerrTUMNUSX ($8.61 in chips) 
Seat 6: Scaaalll ($3.14 in chips) 
JBPY: posts small blind $0.01
Demidov V.S.: posts big blind $0.02
*** HOLE CARDS ***
Dealt to Scaaalll [7h 5d]
Clavis Noa: folds 
XHerrTUMNUSX: raises $0.03 to $0.05
Scaaalll: folds 
Demidov V.S. is disconnected 
ser313131: folds 
JBPY: folds 
Demidov V.S.: folds 
Uncalled bet ($0.03) returned to XHerrTUMNUSX
XHerrTUMNUSX collected $0.05 from pot
XHerrTUMNUSX: doesn't show hand 
*** SUMMARY ***
Total pot $0.05 | Rake $0 
Seat 1: ser313131 (button) folded before Flop (didn't bet)
Seat 2: JBPY (small blind) folded before Flop
Seat 3: Demidov V.S. (big blind) folded before Flop
Seat 4: Clavis Noa folded before Flop (didn't bet)
Seat 5: XHerrTUMNUSX collected ($0.05)
Seat 6: Scaaalll folded before Flop (didn't bet)



PokerStars Zoom Hand #229232084445:  Hold'em No Limit ($0.01/$0.02) - 2021/08/21 22:37:51 CET [2021/08/21 16:37:51 ET]
Table 'Halley' 6-max Seat #1 is the button
Seat 1: NIK1973 23 ($2.39 in chips) 
Seat 2: NoEff0rt2w1n ($2 in chips) 
Seat 3: leeroy818 ($2.33 in chips) 
Seat 4: dcd113 ($1.91 in chips) 
Seat 5: Scaaalll ($3.14 in chips) 
Seat 6: Tobyellie ($3.15 in chips) 
NoEff0rt2w1n: posts small blind $0.01
leeroy818: posts big blind $0.02
*** HOLE CARDS ***
Dealt to Scaaalll [Td 4s]
dcd113: raises $0.06 to $0.08
Tobyellie is disconnected 
Scaaalll: folds 
Tobyellie: folds 
NIK1973 23: folds 
NoEff0rt2w1n: calls $0.07
leeroy818: folds 
*** FLOP *** [9c 8d 7d]
NoEff0rt2w1n: checks 
dcd113: checks 
*** TURN *** [9c 8d 7d] [Js]
NoEff0rt2w1n: checks 
dcd113: checks 
*** RIVER *** [9c 8d 7d Js] [Kd]
NoEff0rt2w1n: checks 
dcd113: checks 
*** SHOW DOWN ***
NoEff0rt2w1n: shows [3h 4h] (high card King)
dcd113: shows [As Kh] (a pair of Kings)
dcd113 collected $0.17 from pot
*** SUMMARY ***
Total pot $0.18 | Rake $0.01 
Board [9c 8d 7d Js Kd]
Seat 1: NIK1973 23 (button) folded before Flop (didn't bet)
Seat 2: NoEff0rt2w1n (small blind) showed [3h 4h] and lost with high card King
Seat 3: leeroy818 (big blind) folded before Flop
Seat 4: dcd113 showed [As Kh] and won ($0.17) with a pair of Kings
Seat 5: Scaaalll folded before Flop (didn't bet)
Seat 6: Tobyellie folded before Flop (didn't bet)



PokerStars Zoom Hand #229232092469:  Hold'em No Limit ($0.01/$0.02) - 2021/08/21 22:38:09 CET [2021/08/21 16:38:09 ET]
Table 'Halley' 6-max Seat #1 is the button
Seat 1: Scaaalll ($3.13 in chips) 
Seat 2: orlovac1995 ($2.18 in chips) 
Seat 3: rodrigovini ($2.03 in chips) 
Seat 4: KochetovAN ($0.62 in chips) 
Seat 5: ADWish ($1.35 in chips) 
Seat 6: gasmar_29 ($2.07 in chips) 
orlovac1995: posts small blind $0.01
rodrigovini: posts big blind $0.02
*** HOLE CARDS ***
Dealt to Scaaalll [5c 4s]
KochetovAN: folds 
ADWish: raises $0.04 to $0.06
gasmar_29: folds 
Scaaalll: folds 
orlovac1995: folds 
rodrigovini: folds 
Uncalled bet ($0.04) returned to ADWish
ADWish collected $0.05 from pot
ADWish: doesn't show hand 
*** SUMMARY ***
Total pot $0.05 | Rake $0 
Seat 1: Scaaalll (button) folded before Flop (didn't bet)
Seat 2: orlovac1995 (small blind) folded before Flop
Seat 3: rodrigovini (big blind) folded before Flop
Seat 4: KochetovAN folded before Flop (didn't bet)
Seat 5: ADWish collected ($0.05)
Seat 6: gasmar_29 folded before Flop (didn't bet)



PokerStars Zoom Hand #229232089772:  Hold'em No Limit ($0.01/$0.02) - 2021/08/21 22:38:03 CET [2021/08/21 16:38:03 ET]
Table 'Halley' 6-max Seat #1 is the button
Seat 1: 888lifeIS ($2 in chips) 
Seat 2: auxy89 ($2.67 in chips) 
Seat 3: Fedor_Gar ($4.23 in chips) 
Seat 4: Scaaalll ($3.13 in chips) 
Seat 5: kalina998 ($2 in chips) 
Seat 6: Dr.stromg ($2.79 in chips) 
auxy89: posts small blind $0.01
Fedor_Gar: posts big blind $0.02
*** HOLE CARDS ***
Dealt to Scaaalll [Qs 3h]
Scaaalll: folds 
kalina998: folds 
Dr.stromg: folds 
888lifeIS: folds 
auxy89: calls $0.01
Fedor_Gar: checks 
*** FLOP *** [4s Kh 6c]
auxy89: checks 
Fedor_Gar: checks 
*** TURN *** [4s Kh 6c] [Kc]
auxy89: checks 
Fedor_Gar: checks 
*** RIVER *** [4s Kh 6c Kc] [8c]
auxy89: checks 
Fedor_Gar: checks 
*** SHOW DOWN ***
auxy89: shows [3s 2d] (a pair of Kings)
Fedor_Gar: shows [5h 4h] (two pair, Kings and Fours)
Fedor_Gar collected $0.04 from pot
*** SUMMARY ***
Total pot $0.04 | Rake $0 
Board [4s Kh 6c Kc 8c]
Seat 1: 888lifeIS (button) folded before Flop (didn't bet)
Seat 2: auxy89 (small blind) showed [3s 2d] and lost with a pair of Kings
Seat 3: Fedor_Gar (big blind) showed [5h 4h] and won ($0.04) with two pair, Kings and Fours
Seat 4: Scaaalll folded before Flop (didn't bet)
Seat 5: kalina998 folded before Flop (didn't bet)
Seat 6: Dr.stromg folded before Flop (didn't bet)



PokerStars Zoom Hand #229232087614:  Hold'em No Limit ($0.01/$0.02) - 2021/08/21 22:37:58 CET [2021/08/21 16:37:58 ET]
Table 'Halley' 6-max Seat #1 is the button
Seat 1: pavlo8855 ($2 in chips) 
Seat 2: Scaaalll ($3.14 in chips) 
Seat 3: Kreodont1987 ($2 in chips) 
Seat 4: neo1200 ($3.83 in chips) 
Seat 5: pipecmolodec ($2 in chips) 
Seat 6: Bubobubob ($3.17 in chips) 
Scaaalll: posts small blind $0.01
Kreodont1987: posts big blind $0.02
*** HOLE CARDS ***
Dealt to Scaaalll [8c Ts]
neo1200: raises $0.02 to $0.04
pipecmolodec: folds 
Bubobubob: folds 
pavlo8855: folds 
Scaaalll: folds 
Kreodont1987: calls $0.02
*** FLOP *** [4d 2d 6d]
Kreodont1987: checks 
neo1200: bets $0.02
Kreodont1987: raises $0.10 to $0.12
neo1200: calls $0.10
*** TURN *** [4d 2d 6d] [Qd]
Kreodont1987: checks 
neo1200: bets $0.32
Kreodont1987: calls $0.32
*** RIVER *** [4d 2d 6d Qd] [4h]
Kreodont1987: bets $1.52 and is all-in
neo1200: calls $1.52
*** SHOW DOWN ***
Kreodont1987: shows [Ad 6c] (a flush, Ace high)
neo1200: shows [Jd Qh] (a flush, Queen high)
Kreodont1987 collected $3.87 from pot
*** SUMMARY ***
Total pot $4.01 | Rake $0.14 
Board [4d 2d 6d Qd 4h]
Seat 1: pavlo8855 (button) folded before Flop (didn't bet)
Seat 2: Scaaalll (small blind) folded before Flop
Seat 3: Kreodont1987 (big blind) showed [Ad 6c] and won ($3.87) with a flush, Ace high
Seat 4: neo1200 showed [Jd Qh] and lost with a flush, Queen high
Seat 5: pipecmolodec folded before Flop (didn't bet)
Seat 6: Bubobubob folded before Flop (didn't bet)



PokerStars Zoom Hand #229232099070:  Hold'em No Limit ($0.01/$0.02) - 2021/08/21 22:38:24 CET [2021/08/21 16:38:24 ET]
Table 'Halley' 6-max Seat #1 is the button
Seat 1: stipe 31 ($2.86 in chips) 
Seat 2: Kkamm ($2.22 in chips) 
Seat 3: egroj1700 ($2 in chips) 
Seat 4: EzukoChan ($0.43 in chips) 
Seat 5: Scaaalll ($3.13 in chips) 
Seat 6: 09mexanik09 ($1.63 in chips) 
Kkamm: posts small blind $0.01
egroj1700: posts big blind $0.02
*** HOLE CARDS ***
Dealt to Scaaalll [2h 3c]
EzukoChan: raises $0.03 to $0.05
Scaaalll: folds 
09mexanik09: folds 
stipe 31: folds 
Kkamm: folds 
egroj1700: folds 
Uncalled bet ($0.03) returned to EzukoChan
EzukoChan collected $0.05 from pot
EzukoChan: doesn't show hand 
*** SUMMARY ***
Total pot $0.05 | Rake $0 
Seat 1: stipe 31 (button) folded before Flop (didn't bet)
Seat 2: Kkamm (small blind) folded before Flop
Seat 3: egroj1700 (big blind) folded before Flop
Seat 4: EzukoChan collected ($0.05)
Seat 5: Scaaalll folded before Flop (didn't bet)
Seat 6: 09mexanik09 folded before Flop (didn't bet)



PokerStars Zoom Hand #229232100915:  Hold'em No Limit ($0.01/$0.02) - 2021/08/21 22:38:28 CET [2021/08/21 16:38:28 ET]
Table 'Halley' 6-max Seat #1 is the button
Seat 1: furgalik ($0.69 in chips) 
Seat 2: zergmiky ($2.11 in chips) 
Seat 3: yannikdaehne ($6.59 in chips) 
Seat 4: Scaaalll ($3.13 in chips) 
Seat 5: orang_dragon ($1.31 in chips) 
Seat 6: Alex Koshva1 ($3.33 in chips) 
zergmiky: posts small blind $0.01
yannikdaehne: posts big blind $0.02
*** HOLE CARDS ***
Dealt to Scaaalll [Ac Ad]
Scaaalll: raises $0.04 to $0.06
orang_dragon: folds 
Alex Koshva1: folds 
furgalik: calls $0.06
zergmiky: folds 
yannikdaehne: calls $0.04
*** FLOP *** [Ah 4s Js]
yannikdaehne: checks 
Scaaalll: bets $0.12
furgalik: folds 
yannikdaehne: folds 
Uncalled bet ($0.12) returned to Scaaalll
Scaaalll collected $0.18 from pot
Scaaalll: doesn't show hand 
*** SUMMARY ***
Total pot $0.19 | Rake $0.01 
Board [Ah 4s Js]
Seat 1: furgalik (button) folded on the Flop
Seat 2: zergmiky (small blind) folded before Flop
Seat 3: yannikdaehne (big blind) folded on the Flop
Seat 4: Scaaalll collected ($0.18)
Seat 5: orang_dragon folded before Flop (didn't bet)
Seat 6: Alex Koshva1 folded before Flop (didn't bet)



PokerStars Zoom Hand #229232111500:  Hold'em No Limit ($0.01/$0.02) - 2021/08/21 22:38:52 CET [2021/08/21 16:38:52 ET]
Table 'Halley' 6-max Seat #1 is the button
Seat 1: sal_sagev41 ($2.50 in chips) 
Seat 2: neo1200 ($1.81 in chips) 
Seat 3: Scaaalll ($3.25 in chips) 
Seat 4: 888lifeIS ($2 in chips) 
Seat 5: mheronmagno ($0.99 in chips) 
Seat 6: CRODeny ($2 in chips) 
neo1200: posts small blind $0.01
Scaaalll: posts big blind $0.02
*** HOLE CARDS ***
Dealt to Scaaalll [9d Ks]
888lifeIS: folds 
mheronmagno: folds 
CRODeny: folds 
sal_sagev41: folds 
neo1200: folds 
Uncalled bet ($0.01) returned to Scaaalll
Scaaalll collected $0.02 from pot
Scaaalll: doesn't show hand 
*** SUMMARY ***
Total pot $0.02 | Rake $0 
Seat 1: sal_sagev41 (button) folded before Flop (didn't bet)
Seat 2: neo1200 (small blind) folded before Flop
Seat 3: Scaaalll (big blind) collected ($0.02)
Seat 4: 888lifeIS folded before Flop (didn't bet)
Seat 5: mheronmagno folded before Flop (didn't bet)
Seat 6: CRODeny folded before Flop (didn't bet)



PokerStars Zoom Hand #229232120655:  Hold'em No Limit ($0.01/$0.02) - 2021/08/21 22:39:11 CET [2021/08/21 16:39:11 ET]
Table 'Halley' 6-max Seat #1 is the button
Seat 1: rancing87 ($2 in chips) 
Seat 2: pavlo8855 ($2 in chips) 
Seat 3: tindecastex ($1.57 in chips) 
Seat 4: Canoinhas37 ($5.25 in chips) 
Seat 5: Scaaalll ($3.26 in chips) 
Seat 6: ChowMangao ($3.93 in chips) 
pavlo8855: posts small blind $0.01
tindecastex: posts big blind $0.02
*** HOLE CARDS ***
Dealt to Scaaalll [Qh Ac]
Canoinhas37: raises $0.02 to $0.04
Scaaalll: calls $0.04
ChowMangao: folds 
rancing87: folds 
pavlo8855: folds 
tindecastex: folds 
*** FLOP *** [Kc Qd 8c]
tindecastex is disconnected 
Canoinhas37: bets $0.06
Scaaalll: calls $0.06
*** TURN *** [Kc Qd 8c] [Tc]
Canoinhas37: bets $0.11
Scaaalll: calls $0.11
*** RIVER *** [Kc Qd 8c Tc] [5d]
Canoinhas37: checks 
Scaaalll: checks 
*** SHOW DOWN ***
Canoinhas37: shows [Ks Kh] (three of a kind, Kings)
Scaaalll: mucks hand 
Canoinhas37 collected $0.43 from pot
*** SUMMARY ***
Total pot $0.45 | Rake $0.02 
Board [Kc Qd 8c Tc 5d]
Seat 1: rancing87 (button) folded before Flop (didn't bet)
Seat 2: pavlo8855 (small blind) folded before Flop
Seat 3: tindecastex (big blind) folded before Flop
Seat 4: Canoinhas37 showed [Ks Kh] and won ($0.43) with three of a kind, Kings
Seat 5: Scaaalll mucked [Qh Ac]
Seat 6: ChowMangao folded before Flop (didn't bet)



PokerStars Zoom Hand #229232115449:  Hold'em No Limit ($0.01/$0.02) - 2021/08/21 22:39:01 CET [2021/08/21 16:39:01 ET]
Table 'Halley' 6-max Seat #1 is the button
Seat 1: NickAlex18 ($2 in chips) 
Seat 2: HellNative ($5.30 in chips) 
Seat 3: Diegor1924 ($2.13 in chips) 
Seat 4: wieksi9845 ($0.18 in chips) 
Seat 5: SideshowPen ($4.39 in chips) 
Seat 6: Scaaalll ($3.26 in chips) 
HellNative: posts small blind $0.01
Diegor1924: posts big blind $0.02
*** HOLE CARDS ***
Dealt to Scaaalll [4s 7d]
wieksi9845: folds 
wieksi9845 is disconnected 
SideshowPen: raises $0.04 to $0.06
Scaaalll: folds 
NickAlex18: folds 
HellNative: raises $0.58 to $0.64
Diegor1924: folds 
SideshowPen: calls $0.58
*** FLOP *** [6c Qh 2s]
HellNative: bets $0.69
SideshowPen: raises $3.06 to $3.75 and is all-in
HellNative: calls $3.06
*** TURN *** [6c Qh 2s] [Ac]
*** RIVER *** [6c Qh 2s Ac] [2c]
*** SHOW DOWN ***
HellNative: shows [Ah Ad] (a full house, Aces full of Deuces)
SideshowPen: shows [Jd As] (two pair, Aces and Deuces)
HellNative collected $8.50 from pot
*** SUMMARY ***
Total pot $8.80 | Rake $0.30 
Board [6c Qh 2s Ac 2c]
Seat 1: NickAlex18 (button) folded before Flop (didn't bet)
Seat 2: HellNative (small blind) showed [Ah Ad] and won ($8.50) with a full house, Aces full of Deuces
Seat 3: Diegor1924 (big blind) folded before Flop
Seat 4: wieksi9845 folded before Flop (didn't bet)
Seat 5: SideshowPen showed [Jd As] and lost with two pair, Aces and Deuces
Seat 6: Scaaalll folded before Flop (didn't bet)



PokerStars Zoom Hand #229232140862:  Hold'em No Limit ($0.01/$0.02) - 2021/08/21 22:39:57 CET [2021/08/21 16:39:57 ET]
Table 'Halley' 6-max Seat #1 is the button
Seat 1: Nancy_88 ($4.24 in chips) 
Seat 2: Scaaalll ($3.05 in chips) 
Seat 3: Fanatspartak ($0.80 in chips) 
Seat 4: alexan00 ($4.27 in chips) 
Seat 5: KatedratiK ($2.07 in chips) 
Seat 6: rpycmbEM ($4.60 in chips) 
Scaaalll: posts small blind $0.01
Fanatspartak: posts big blind $0.02
*** HOLE CARDS ***
Dealt to Scaaalll [9s 7s]
Nancy_88 is disconnected 
alexan00: folds 
KatedratiK: folds 
rpycmbEM: folds 
Nancy_88: folds 
Scaaalll: raises $0.04 to $0.06
Fanatspartak: folds 
Uncalled bet ($0.04) returned to Scaaalll
Scaaalll collected $0.04 from pot
Scaaalll: doesn't show hand 
*** SUMMARY ***
Total pot $0.04 | Rake $0 
Seat 1: Nancy_88 (button) folded before Flop (didn't bet)
Seat 2: Scaaalll (small blind) collected ($0.04)
Seat 3: Fanatspartak (big blind) folded before Flop
Seat 4: alexan00 folded before Flop (didn't bet)
Seat 5: KatedratiK folded before Flop (didn't bet)
Seat 6: rpycmbEM folded before Flop (didn't bet)



PokerStars Zoom Hand #229232150081:  Hold'em No Limit ($0.01/$0.02) - 2021/08/21 22:40:18 CET [2021/08/21 16:40:18 ET]
Table 'Halley' 6-max Seat #1 is the button
Seat 1: plmanuelpl ($0.49 in chips) 
Seat 2: Fedor_Gar ($4.05 in chips) 
Seat 3: Scaaalll ($3.07 in chips) 
Seat 4: polymorhp ($2.87 in chips) 
Seat 5: z3317111711 ($6.01 in chips) 
Seat 6: zbixxx ($3.87 in chips) 
Fedor_Gar: posts small blind $0.01
Scaaalll: posts big blind $0.02
*** HOLE CARDS ***
Dealt to Scaaalll [Qs 5s]
polymorhp: folds 
plmanuelpl is disconnected 
z3317111711: raises $0.03 to $0.05
zbixxx: folds 
plmanuelpl: folds 
Fedor_Gar: folds 
Scaaalll: folds 
Uncalled bet ($0.03) returned to z3317111711
z3317111711 collected $0.05 from pot
z3317111711: doesn't show hand 
*** SUMMARY ***
Total pot $0.05 | Rake $0 
Seat 1: plmanuelpl (button) folded before Flop (didn't bet)
Seat 2: Fedor_Gar (small blind) folded before Flop
Seat 3: Scaaalll (big blind) folded before Flop
Seat 4: polymorhp folded before Flop (didn't bet)
Seat 5: z3317111711 collected ($0.05)
Seat 6: zbixxx folded before Flop (didn't bet)



PokerStars Zoom Hand #229232148330:  Hold'em No Limit ($0.01/$0.02) - 2021/08/21 22:40:14 CET [2021/08/21 16:40:14 ET]
Table 'Halley' 6-max Seat #1 is the button
Seat 1: Scaaalll ($3.07 in chips) 
Seat 2: Koldun 2636 ($3.66 in chips) 
Seat 3: The-End-snglr ($0.28 in chips) 
Seat 4: sewq55 ($1.40 in chips) 
Seat 5: OmahaWheels ($4.21 in chips) 
Seat 6: mnozz83 ($1.33 in chips) 
Koldun 2636: posts small blind $0.01
The-End-snglr: posts big blind $0.02
*** HOLE CARDS ***
Dealt to Scaaalll [7s Kc]
sewq55: raises $0.02 to $0.04
OmahaWheels: folds 
mnozz83: folds 
Scaaalll: folds 
Koldun 2636: calls $0.03
The-End-snglr: folds 
*** FLOP *** [Qs Th 5s]
Koldun 2636: checks 
sewq55: bets $0.06
Koldun 2636: folds 
Uncalled bet ($0.06) returned to sewq55
sewq55 collected $0.10 from pot
sewq55: doesn't show hand 
*** SUMMARY ***
Total pot $0.10 | Rake $0 
Board [Qs Th 5s]
Seat 1: Scaaalll (button) folded before Flop (didn't bet)
Seat 2: Koldun 2636 (small blind) folded on the Flop
Seat 3: The-End-snglr (big blind) folded before Flop
Seat 4: sewq55 collected ($0.10)
Seat 5: OmahaWheels folded before Flop (didn't bet)
Seat 6: mnozz83 folded before Flop (didn't bet)



PokerStars Zoom Hand #229232156812:  Hold'em No Limit ($0.01/$0.02) - 2021/08/21 22:40:33 CET [2021/08/21 16:40:33 ET]
Table 'Halley' 6-max Seat #1 is the button
Seat 1: estelionat171 ($1.20 in chips) 
Seat 2: Busya777 ($1.39 in chips) 
Seat 3: Clownyara ($2.36 in chips) 
Seat 4: Scaaalll ($3.05 in chips) 
Seat 5: tittenholmes ($2.02 in chips) 
Seat 6: anes.v. ($2.83 in chips) 
Busya777: posts small blind $0.01
Clownyara: posts big blind $0.02
*** HOLE CARDS ***
Dealt to Scaaalll [4h 9s]
Busya777 is disconnected 
Scaaalll: folds 
tittenholmes: folds 
anes.v.: folds 
estelionat171: folds 
Busya777 has timed out while disconnected
Busya777: folds 
Uncalled bet ($0.01) returned to Clownyara
Clownyara collected $0.02 from pot
Clownyara: doesn't show hand 
*** SUMMARY ***
Total pot $0.02 | Rake $0 
Seat 1: estelionat171 (button) folded before Flop (didn't bet)
Seat 2: Busya777 (small blind) folded before Flop
Seat 3: Clownyara (big blind) collected ($0.02)
Seat 4: Scaaalll folded before Flop (didn't bet)
Seat 5: tittenholmes folded before Flop (didn't bet)
Seat 6: anes.v. folded before Flop (didn't bet)



PokerStars Zoom Hand #229232158999:  Hold'em No Limit ($0.01/$0.02) - 2021/08/21 22:40:38 CET [2021/08/21 16:40:38 ET]
Table 'Halley' 6-max Seat #1 is the button
Seat 1: boa juice ($1.87 in chips) 
Seat 2: Scaaalll ($3.05 in chips) 
Seat 3: Red Sky 15 ($10.39 in chips) 
Seat 4: NoEff0rt2w1n ($3.43 in chips) 
Seat 5: ciucibaby ($4.67 in chips) 
Seat 6: BlackhawKK's ($2.06 in chips) 
Scaaalll: posts small blind $0.01
Red Sky 15: posts big blind $0.02
*** HOLE CARDS ***
Dealt to Scaaalll [9d Jd]
NoEff0rt2w1n: folds 
ciucibaby: folds 
BlackhawKK's: folds 
boa juice: raises $0.02 to $0.04
Scaaalll: calls $0.03
Red Sky 15: calls $0.02
*** FLOP *** [4h 2c 4s]
Scaaalll: checks 
Red Sky 15: bets $0.06
boa juice: folds 
boa juice is disconnected 
Scaaalll: folds 
Uncalled bet ($0.06) returned to Red Sky 15
Red Sky 15 collected $0.12 from pot
Red Sky 15: doesn't show hand 
*** SUMMARY ***
Total pot $0.12 | Rake $0 
Board [4h 2c 4s]
Seat 1: boa juice (button) folded on the Flop
Seat 2: Scaaalll (small blind) folded on the Flop
Seat 3: Red Sky 15 (big blind) collected ($0.12)
Seat 4: NoEff0rt2w1n folded before Flop (didn't bet)
Seat 5: ciucibaby folded before Flop (didn't bet)
Seat 6: BlackhawKK's folded before Flop (didn't bet)



PokerStars Zoom Hand #229232172304:  Hold'em No Limit ($0.01/$0.02) - 2021/08/21 22:41:05 CET [2021/08/21 16:41:05 ET]
Table 'Halley' 6-max Seat #1 is the button
Seat 1: Kkamm ($2 in chips) 
Seat 2: znak312 ($2.11 in chips) 
Seat 3: pepope ($2 in chips) 
Seat 4: dinoVIEIRA ($2 in chips) 
Seat 5: Koldun 2636 ($3.69 in chips) 
Seat 6: Scaaalll ($3.01 in chips) 
znak312: posts small blind $0.01
pepope: posts big blind $0.02
*** HOLE CARDS ***
Dealt to Scaaalll [Jh 5d]
dinoVIEIRA has timed out while disconnected
dinoVIEIRA: folds 
Koldun 2636: folds 
Scaaalll: folds 
Kkamm: folds 
znak312: raises $0.03 to $0.05
pepope: folds 
Uncalled bet ($0.03) returned to znak312
znak312 collected $0.04 from pot
znak312: doesn't show hand 
*** SUMMARY ***
Total pot $0.04 | Rake $0 
Seat 1: Kkamm (button) folded before Flop (didn't bet)
Seat 2: znak312 (small blind) collected ($0.04)
Seat 3: pepope (big blind) folded before Flop
Seat 4: dinoVIEIRA folded before Flop (didn't bet)
Seat 5: Koldun 2636 folded before Flop (didn't bet)
Seat 6: Scaaalll folded before Flop (didn't bet)



PokerStars Zoom Hand #229232174450:  Hold'em No Limit ($0.01/$0.02) - 2021/08/21 22:41:10 CET [2021/08/21 16:41:10 ET]
Table 'Halley' 6-max Seat #1 is the button
Seat 1: Scaaalll ($3.01 in chips) 
Seat 2: KRITAYA ($1.02 in chips) 
Seat 3: Enoffllescini ($2.18 in chips) 
Seat 4: SirBatish ($2.39 in chips) 
Seat 5: ZNFR77 ($0.70 in chips) 
Seat 6: slipknot956 ($2.70 in chips) 
KRITAYA: posts small blind $0.01
Enoffllescini: posts big blind $0.02
*** HOLE CARDS ***
Dealt to Scaaalll [Ks Jd]
SirBatish: folds 
ZNFR77: calls $0.02
slipknot956: folds 
Scaaalll: raises $0.06 to $0.08
KRITAYA: calls $0.07
Enoffllescini: folds 
ZNFR77: raises $0.06 to $0.14
Scaaalll: calls $0.06
KRITAYA: calls $0.06
*** FLOP *** [Td Jc Th]
KRITAYA: checks 
ZNFR77: bets $0.06
Scaaalll: calls $0.06
KRITAYA: calls $0.06
*** TURN *** [Td Jc Th] [Kh]
KRITAYA: checks 
ZNFR77: bets $0.02
Scaaalll: calls $0.02
KRITAYA: raises $0.33 to $0.35
ZNFR77: folds 
Scaaalll: calls $0.33
*** RIVER *** [Td Jc Th Kh] [Qd]
KRITAYA: bets $0.47 and is all-in
Scaaalll: folds 
Uncalled bet ($0.47) returned to KRITAYA
KRITAYA collected $1.29 from pot
KRITAYA: doesn't show hand 
*** SUMMARY ***
Total pot $1.34 | Rake $0.05 
Board [Td Jc Th Kh Qd]
Seat 1: Scaaalll (button) folded on the River
Seat 2: KRITAYA (small blind) collected ($1.29)
Seat 3: Enoffllescini (big blind) folded before Flop
Seat 4: SirBatish folded before Flop (didn't bet)
Seat 5: ZNFR77 folded on the Turn
Seat 6: slipknot956 folded before Flop (didn't bet)



PokerStars Zoom Hand #229232200294:  Hold'em No Limit ($0.01/$0.02) - 2021/08/21 22:42:09 CET [2021/08/21 16:42:09 ET]
Table 'Halley' 6-max Seat #1 is the button
Seat 1: LuckyCheewey ($11.26 in chips) 
Seat 2: KoAlRy ($2.15 in chips) 
Seat 3: fishh_play ($5.11 in chips) 
Seat 4: innexplus ($3.70 in chips) 
Seat 5: Scaaalll ($2.46 in chips) 
Seat 6: Espartacus5222 ($2.63 in chips) 
KoAlRy: posts small blind $0.01
fishh_play: posts big blind $0.02
*** HOLE CARDS ***
Dealt to Scaaalll [Kh 7d]
innexplus: folds 
Scaaalll: folds 
Espartacus5222 has timed out
Espartacus5222: folds 
LuckyCheewey: folds 
KoAlRy: folds 
Uncalled bet ($0.01) returned to fishh_play
fishh_play collected $0.02 from pot
fishh_play: doesn't show hand 
*** SUMMARY ***
Total pot $0.02 | Rake $0 
Seat 1: LuckyCheewey (button) folded before Flop (didn't bet)
Seat 2: KoAlRy (small blind) folded before Flop
Seat 3: fishh_play (big blind) collected ($0.02)
Seat 4: innexplus folded before Flop (didn't bet)
Seat 5: Scaaalll folded before Flop (didn't bet)
Seat 6: Espartacus5222 folded before Flop (didn't bet)



PokerStars Zoom Hand #229232205062:  Hold'em No Limit ($0.01/$0.02) - 2021/08/21 22:42:20 CET [2021/08/21 16:42:20 ET]
Table 'Halley' 6-max Seat #1 is the button
Seat 1: uniicecube ($5.54 in chips) 
Seat 2: znak312 ($2.32 in chips) 
Seat 3: golfffffer ($1.09 in chips) 
Seat 4: Scaaalll ($2.46 in chips) 
Seat 5: alexmpokes ($1.56 in chips) 
Seat 6: stealth_ua ($2.32 in chips) 
znak312: posts small blind $0.01
golfffffer: posts big blind $0.02
*** HOLE CARDS ***
Dealt to Scaaalll [3s As]
Scaaalll: raises $0.04 to $0.06
golfffffer is disconnected 
alexmpokes: calls $0.06
stealth_ua: folds 
uniicecube: calls $0.06
znak312: folds 
golfffffer: folds 
*** FLOP *** [9c 2c Jh]
Scaaalll: checks 
alexmpokes: checks 
uniicecube: checks 
*** TURN *** [9c 2c Jh] [7c]
Scaaalll: checks 
alexmpokes: checks 
uniicecube: checks 
*** RIVER *** [9c 2c Jh 7c] [Qc]
Scaaalll: checks 
alexmpokes: bets $0.10
uniicecube: folds 
Scaaalll: folds 
Uncalled bet ($0.10) returned to alexmpokes
alexmpokes collected $0.20 from pot
alexmpokes: doesn't show hand 
*** SUMMARY ***
Total pot $0.21 | Rake $0.01 
Board [9c 2c Jh 7c Qc]
Seat 1: uniicecube (button) folded on the River
Seat 2: znak312 (small blind) folded before Flop
Seat 3: golfffffer (big blind) folded before Flop
Seat 4: Scaaalll folded on the River
Seat 5: alexmpokes collected ($0.20)
Seat 6: stealth_ua folded before Flop (didn't bet)



PokerStars Zoom Hand #229232233695:  Hold'em No Limit ($0.01/$0.02) - 2021/08/21 22:43:26 CET [2021/08/21 16:43:26 ET]
Table 'Halley' 6-max Seat #1 is the button
Seat 1: gasmar_29 ($2 in chips) 
Seat 2: KoAlRy ($2.15 in chips) 
Seat 3: Scaaalll ($2.40 in chips) 
Seat 4: DaBaDaBaDooo ($2.81 in chips) 
Seat 5: happyboom80 ($2.18 in chips) 
Seat 6: pepope ($2.04 in chips) 
KoAlRy: posts small blind $0.01
Scaaalll: posts big blind $0.02
*** HOLE CARDS ***
Dealt to Scaaalll [3s 8d]
DaBaDaBaDooo: folds 
happyboom80: folds 
pepope: folds 
gasmar_29: folds 
KoAlRy: folds 
Uncalled bet ($0.01) returned to Scaaalll
Scaaalll collected $0.02 from pot
Scaaalll: doesn't show hand 
*** SUMMARY ***
Total pot $0.02 | Rake $0 
Seat 1: gasmar_29 (button) folded before Flop (didn't bet)
Seat 2: KoAlRy (small blind) folded before Flop
Seat 3: Scaaalll (big blind) collected ($0.02)
Seat 4: DaBaDaBaDooo folded before Flop (didn't bet)
Seat 5: happyboom80 folded before Flop (didn't bet)
Seat 6: pepope folded before Flop (didn't bet)



PokerStars Zoom Hand #229232240646:  Hold'em No Limit ($0.01/$0.02) - 2021/08/21 22:43:42 CET [2021/08/21 16:43:42 ET]
Table 'Halley' 6-max Seat #1 is the button
Seat 1: xxVanquishxx ($8.80 in chips) 
Seat 2: Scaaalll ($2.41 in chips) 
Seat 3: LSDenny ($2.68 in chips) 
Seat 4: alphabeta1d ($2.09 in chips) 
Seat 5: Agno$tic ($2.38 in chips) 
Seat 6: EzukoChan ($1.18 in chips) 
Scaaalll: posts small blind $0.01
LSDenny: posts big blind $0.02
*** HOLE CARDS ***
Dealt to Scaaalll [As Qs]
alphabeta1d: folds 
Agno$tic: folds 
LSDenny is disconnected 
EzukoChan: raises $0.03 to $0.05
xxVanquishxx: folds 
LSDenny is disconnected 
Scaaalll: raises $0.13 to $0.18
LSDenny: folds 
EzukoChan: calls $0.13
*** FLOP *** [4c 3d Jd]
Scaaalll: bets $0.24
EzukoChan: calls $0.24
*** TURN *** [4c 3d Jd] [7c]
Scaaalll: checks 
EzukoChan: checks 
*** RIVER *** [4c 3d Jd 7c] [6c]
Scaaalll: checks 
EzukoChan: checks 
*** SHOW DOWN ***
Scaaalll: shows [As Qs] (high card Ace)
EzukoChan: shows [Tc Td] (a pair of Tens)
EzukoChan collected $0.83 from pot
*** SUMMARY ***
Total pot $0.86 | Rake $0.03 
Board [4c 3d Jd 7c 6c]
Seat 1: xxVanquishxx (button) folded before Flop (didn't bet)
Seat 2: Scaaalll (small blind) showed [As Qs] and lost with high card Ace
Seat 3: LSDenny (big blind) folded before Flop
Seat 4: alphabeta1d folded before Flop (didn't bet)
Seat 5: Agno$tic folded before Flop (didn't bet)
Seat 6: EzukoChan showed [Tc Td] and won ($0.83) with a pair of Tens



PokerStars Zoom Hand #229232266595:  Hold'em No Limit ($0.01/$0.02) - 2021/08/21 22:44:43 CET [2021/08/21 16:44:43 ET]
Table 'Halley' 6-max Seat #1 is the button
Seat 1: Tobyellie ($3.97 in chips) 
Seat 2: KRITAYA ($1.21 in chips) 
Seat 3: olga3021221 ($2.03 in chips) 
Seat 4: EdwardF95 ($2 in chips) 
Seat 5: pavlo8855 ($2.03 in chips) 
Seat 6: Scaaalll ($2 in chips) 
KRITAYA: posts small blind $0.01
olga3021221: posts big blind $0.02
*** HOLE CARDS ***
Dealt to Scaaalll [5c 2d]
EdwardF95: folds 
Tobyellie is disconnected 
pavlo8855: folds 
Scaaalll: folds 
Tobyellie: folds 
KRITAYA: folds 
Uncalled bet ($0.01) returned to olga3021221
olga3021221 collected $0.02 from pot
olga3021221: doesn't show hand 
*** SUMMARY ***
Total pot $0.02 | Rake $0 
Seat 1: Tobyellie (button) folded before Flop (didn't bet)
Seat 2: KRITAYA (small blind) folded before Flop
Seat 3: olga3021221 (big blind) collected ($0.02)
Seat 4: EdwardF95 folded before Flop (didn't bet)
Seat 5: pavlo8855 folded before Flop (didn't bet)
Seat 6: Scaaalll folded before Flop (didn't bet)



PokerStars Zoom Hand #229232268337:  Hold'em No Limit ($0.01/$0.02) - 2021/08/21 22:44:47 CET [2021/08/21 16:44:47 ET]
Table 'Halley' 6-max Seat #1 is the button
Seat 1: Scaaalll ($2 in chips) 
Seat 2: nemat_g ($2.31 in chips) 
Seat 3: pescador2 ($0.51 in chips) 
Seat 4: castrosis ($3.18 in chips) 
Seat 5: Busya777 ($2 in chips) 
Seat 6: vxDARK_CATxv ($1.03 in chips) 
nemat_g: posts small blind $0.01
pescador2: posts big blind $0.02
*** HOLE CARDS ***
Dealt to Scaaalll [Qh Th]
nemat_g is disconnected 
vxDARK_CATxv is disconnected 
castrosis: folds 
Busya777: calls $0.02
vxDARK_CATxv: folds 
Scaaalll: raises $0.06 to $0.08
nemat_g: folds 
Busya777 is disconnected 
pescador2: calls $0.06
Busya777: folds 
*** FLOP *** [8h Jd Ks]
pescador2: bets $0.08
Scaaalll: calls $0.08
*** TURN *** [8h Jd Ks] [9c]
pescador2: bets $0.10
Scaaalll: calls $0.10
*** RIVER *** [8h Jd Ks 9c] [Qd]
pescador2: bets $0.25 and is all-in
Scaaalll: calls $0.25
*** SHOW DOWN ***
pescador2: shows [9h Tc] (a straight, Nine to King)
Scaaalll: shows [Qh Th] (a straight, Nine to King)
pescador2 collected $0.51 from pot
Scaaalll collected $0.50 from pot
*** SUMMARY ***
Total pot $1.05 | Rake $0.04 
Board [8h Jd Ks 9c Qd]
Seat 1: Scaaalll (button) showed [Qh Th] and won ($0.50) with a straight, Nine to King
Seat 2: nemat_g (small blind) folded before Flop
Seat 3: pescador2 (big blind) showed [9h Tc] and won ($0.51) with a straight, Nine to King
Seat 4: castrosis folded before Flop (didn't bet)
Seat 5: Busya777 folded before Flop
Seat 6: vxDARK_CATxv folded before Flop (didn't bet)



PokerStars Zoom Hand #229232284466:  Hold'em No Limit ($0.01/$0.02) - 2021/08/21 22:45:24 CET [2021/08/21 16:45:24 ET]
Table 'Halley' 6-max Seat #1 is the button
Seat 1: Yangyang1407 ($2.11 in chips) 
Seat 2: EdwardF95 ($3.12 in chips) 
Seat 3: Vitalyi1970 ($1.87 in chips) 
Seat 4: ash1448 ($10.98 in chips) 
Seat 5: Scaaalll ($2 in chips) 
Seat 6: Fanatspartak ($2.94 in chips) 
EdwardF95: posts small blind $0.01
Vitalyi1970: posts big blind $0.02
*** HOLE CARDS ***
Dealt to Scaaalll [9s 4c]
ash1448: folds 
Scaaalll: folds 
Fanatspartak: folds 
Yangyang1407: folds 
EdwardF95: folds 
Uncalled bet ($0.01) returned to Vitalyi1970
Vitalyi1970 collected $0.02 from pot
Vitalyi1970: doesn't show hand 
*** SUMMARY ***
Total pot $0.02 | Rake $0 
Seat 1: Yangyang1407 (button) folded before Flop (didn't bet)
Seat 2: EdwardF95 (small blind) folded before Flop
Seat 3: Vitalyi1970 (big blind) collected ($0.02)
Seat 4: ash1448 folded before Flop (didn't bet)
Seat 5: Scaaalll folded before Flop (didn't bet)
Seat 6: Fanatspartak folded before Flop (didn't bet)



PokerStars Zoom Hand #229232286662:  Hold'em No Limit ($0.01/$0.02) - 2021/08/21 22:45:29 CET [2021/08/21 16:45:29 ET]
Table 'Halley' 6-max Seat #1 is the button
Seat 1: lucksuckdonk ($3.55 in chips) 
Seat 2: sg.32rus ($1.01 in chips) 
Seat 3: Scaaalll ($2 in chips) 
Seat 4: Fmk0786 ($0.91 in chips) 
Seat 5: AlexGTPS ($2.06 in chips) 
Seat 6: DiPchable ($0.78 in chips) 
sg.32rus: posts small blind $0.01
Scaaalll: posts big blind $0.02
*** HOLE CARDS ***
Dealt to Scaaalll [Kh 7s]
Fmk0786: folds 
AlexGTPS: folds 
Fmk0786 is disconnected 
DiPchable: calls $0.02
lucksuckdonk: folds 
sg.32rus: raises $0.06 to $0.08
Scaaalll: folds 
DiPchable: calls $0.06
*** FLOP *** [4h As 6h]
sg.32rus: bets $0.14
DiPchable: calls $0.14
*** TURN *** [4h As 6h] [Qc]
sg.32rus: bets $0.35
DiPchable: calls $0.35
*** RIVER *** [4h As 6h Qc] [5s]
sg.32rus: bets $0.44 and is all-in
DiPchable: folds 
Uncalled bet ($0.44) returned to sg.32rus
sg.32rus collected $1.12 from pot
sg.32rus: doesn't show hand 
DiPchable is disconnected 
*** SUMMARY ***
Total pot $1.16 | Rake $0.04 
Board [4h As 6h Qc 5s]
Seat 1: lucksuckdonk (button) folded before Flop (didn't bet)
Seat 2: sg.32rus (small blind) collected ($1.12)
Seat 3: Scaaalll (big blind) folded before Flop
Seat 4: Fmk0786 folded before Flop (didn't bet)
Seat 5: AlexGTPS folded before Flop (didn't bet)
Seat 6: DiPchable folded on the River



PokerStars Zoom Hand #229232304114:  Hold'em No Limit ($0.01/$0.02) - 2021/08/21 22:45:46 CET [2021/08/21 16:45:46 ET]
Table 'Halley' 6-max Seat #1 is the button
Seat 1: The-End-snglr ($1.88 in chips) 
Seat 2: Earl_greyPL ($1.40 in chips) 
Seat 3: lucksuckdonk ($3.54 in chips) 
Seat 4: lumpek1112 ($3.44 in chips) 
Seat 5: Scaaalll ($2 in chips) 
Seat 6: Reipinguimm ($2.45 in chips) 
Earl_greyPL: posts small blind $0.01
lucksuckdonk: posts big blind $0.02
*** HOLE CARDS ***
Dealt to Scaaalll [Js Th]
lumpek1112: folds 
Scaaalll: raises $0.04 to $0.06
Reipinguimm: folds 
The-End-snglr: folds 
Earl_greyPL: folds 
lucksuckdonk: folds 
Uncalled bet ($0.04) returned to Scaaalll
Scaaalll collected $0.05 from pot
Scaaalll: doesn't show hand 
*** SUMMARY ***
Total pot $0.05 | Rake $0 
Seat 1: The-End-snglr (button) folded before Flop (didn't bet)
Seat 2: Earl_greyPL (small blind) folded before Flop
Seat 3: lucksuckdonk (big blind) folded before Flop
Seat 4: lumpek1112 folded before Flop (didn't bet)
Seat 5: Scaaalll collected ($0.05)
Seat 6: Reipinguimm folded before Flop (didn't bet)



PokerStars Zoom Hand #229232320672:  Hold'em No Limit ($0.01/$0.02) - 2021/08/21 22:46:17 CET [2021/08/21 16:46:17 ET]
Table 'Halley' 6-max Seat #1 is the button
Seat 1: Enoffllescini ($2.03 in chips) 
Seat 2: Scaaalll ($2.03 in chips) 
Seat 3: NoEff0rt2w1n ($2.43 in chips) 
Seat 4: QCcumm ($3.21 in chips) 
Seat 5: HDYD18 ($5.61 in chips) 
Seat 6: sg.32rus ($1.10 in chips) 
Scaaalll: posts small blind $0.01
NoEff0rt2w1n: posts big blind $0.02
*** HOLE CARDS ***
Dealt to Scaaalll [Ad 2d]
QCcumm: calls $0.02
HDYD18: folds 
sg.32rus: folds 
Enoffllescini: folds 
Scaaalll: calls $0.01
NoEff0rt2w1n: checks 
*** FLOP *** [8d Ah 9d]
Scaaalll: bets $0.04
NoEff0rt2w1n: calls $0.04
QCcumm: calls $0.04
*** TURN *** [8d Ah 9d] [4d]
Scaaalll: bets $0.13
QCcumm is disconnected 
NoEff0rt2w1n: folds 
QCcumm: folds 
Uncalled bet ($0.13) returned to Scaaalll
Scaaalll collected $0.17 from pot
Scaaalll: doesn't show hand 
*** SUMMARY ***
Total pot $0.18 | Rake $0.01 
Board [8d Ah 9d 4d]
Seat 1: Enoffllescini (button) folded before Flop (didn't bet)
Seat 2: Scaaalll (small blind) collected ($0.17)
Seat 3: NoEff0rt2w1n (big blind) folded on the Turn
Seat 4: QCcumm folded on the Turn
Seat 5: HDYD18 folded before Flop (didn't bet)
Seat 6: sg.32rus folded before Flop (didn't bet)



PokerStars Zoom Hand #229232334609:  Hold'em No Limit ($0.01/$0.02) - 2021/08/21 22:46:49 CET [2021/08/21 16:46:49 ET]
Table 'Halley' 6-max Seat #1 is the button
Seat 1: WITKOW_AV ($2.13 in chips) 
Seat 2: HDYD18 ($6.72 in chips) 
Seat 3: plmanuelpl ($1 in chips) 
Seat 4: Bufre ($2.94 in chips) 
Seat 5: zergmiky ($2.03 in chips) 
Seat 6: Scaaalll ($2.14 in chips) 
HDYD18: posts small blind $0.01
plmanuelpl: posts big blind $0.02
*** HOLE CARDS ***
Dealt to Scaaalll [4h 2s]
Bufre: raises $0.03 to $0.05
zergmiky: folds 
Scaaalll: folds 
WITKOW_AV: folds 
HDYD18: folds 
plmanuelpl: calls $0.03
*** FLOP *** [Ah 4d 9h]
plmanuelpl: checks 
Bufre: bets $0.04
plmanuelpl: folds 
Uncalled bet ($0.04) returned to Bufre
Bufre collected $0.11 from pot
Bufre: doesn't show hand 
plmanuelpl is disconnected 
*** SUMMARY ***
Total pot $0.11 | Rake $0 
Board [Ah 4d 9h]
Seat 1: WITKOW_AV (button) folded before Flop (didn't bet)
Seat 2: HDYD18 (small blind) folded before Flop
Seat 3: plmanuelpl (big blind) folded on the Flop
Seat 4: Bufre collected ($0.11)
Seat 5: zergmiky folded before Flop (didn't bet)
Seat 6: Scaaalll folded before Flop (didn't bet)



PokerStars Zoom Hand #229232340364:  Hold'em No Limit ($0.01/$0.02) - 2021/08/21 22:47:02 CET [2021/08/21 16:47:02 ET]
Table 'Halley' 6-max Seat #1 is the button
Seat 1: Scaaalll ($2.14 in chips) 
Seat 2: De@dmou5e ($1.62 in chips) 
Seat 3: Tabitaji ($2.50 in chips) 
Seat 4: EdwardF95 ($2.05 in chips) 
Seat 5: Gek77 ($5.43 in chips) 
Seat 6: YGrandmaster ($2.09 in chips) 
De@dmou5e: posts small blind $0.01
Tabitaji: posts big blind $0.02
*** HOLE CARDS ***
Dealt to Scaaalll [Qc 2s]
EdwardF95: folds 
YGrandmaster is disconnected 
De@dmou5e is disconnected 
Gek77: raises $0.04 to $0.06
YGrandmaster: folds 
Scaaalll: folds 
De@dmou5e: folds 
Tabitaji: folds 
Uncalled bet ($0.04) returned to Gek77
Gek77 collected $0.05 from pot
Gek77: doesn't show hand 
*** SUMMARY ***
Total pot $0.05 | Rake $0 
Seat 1: Scaaalll (button) folded before Flop (didn't bet)
Seat 2: De@dmou5e (small blind) folded before Flop
Seat 3: Tabitaji (big blind) folded before Flop
Seat 4: EdwardF95 folded before Flop (didn't bet)
Seat 5: Gek77 collected ($0.05)
Seat 6: YGrandmaster folded before Flop (didn't bet)



PokerStars Zoom Hand #229232342106:  Hold'em No Limit ($0.01/$0.02) - 2021/08/21 22:47:06 CET [2021/08/21 16:47:06 ET]
Table 'Halley' 6-max Seat #1 is the button
Seat 1: Akrobat94 ($1.23 in chips) 
Seat 2: Axel201388 ($0.71 in chips) 
Seat 3: VovaU164 ($1.13 in chips) 
Seat 4: Scaaalll ($2.14 in chips) 
Seat 5: GVMELLO ($2.06 in chips) 
Seat 6: Colby1771 ($3.07 in chips) 
Axel201388: posts small blind $0.01
VovaU164: posts big blind $0.02
*** HOLE CARDS ***
Dealt to Scaaalll [Kh 5d]
Scaaalll: folds 
GVMELLO: folds 
Colby1771: folds 
Akrobat94: folds 
Axel201388: folds 
Uncalled bet ($0.01) returned to VovaU164
Akrobat94 is disconnected 
VovaU164 collected $0.02 from pot
VovaU164: doesn't show hand 
*** SUMMARY ***
Total pot $0.02 | Rake $0 
Seat 1: Akrobat94 (button) folded before Flop (didn't bet)
Seat 2: Axel201388 (small blind) folded before Flop
Seat 3: VovaU164 (big blind) collected ($0.02)
Seat 4: Scaaalll folded before Flop (didn't bet)
Seat 5: GVMELLO folded before Flop (didn't bet)
Seat 6: Colby1771 folded before Flop (didn't bet)



PokerStars Zoom Hand #229232338588:  Hold'em No Limit ($0.01/$0.02) - 2021/08/21 22:46:58 CET [2021/08/21 16:46:58 ET]
Table 'Halley' 6-max Seat #1 is the button
Seat 1: new face onl ($3.20 in chips) 
Seat 2: udav26 ($2.01 in chips) 
Seat 3: ded serch ($2 in chips) 
Seat 4: Scaaalll ($2.14 in chips) 
Seat 5: sakourtele ($2.64 in chips) 
Seat 6: Pulp Hands ($1.88 in chips) 
udav26: posts small blind $0.01
ded serch: posts big blind $0.02
*** HOLE CARDS ***
Dealt to Scaaalll [Ts Kh]
Scaaalll: folds 
sakourtele: raises $0.02 to $0.04
Pulp Hands: folds 
new face onl: calls $0.04
udav26: calls $0.03
ded serch: raises $0.24 to $0.28
sakourtele: folds 
new face onl: folds 
udav26: folds 
Uncalled bet ($0.24) returned to ded serch
ded serch collected $0.16 from pot
ded serch: doesn't show hand 
*** SUMMARY ***
Total pot $0.16 | Rake $0 
Seat 1: new face onl (button) folded before Flop
Seat 2: udav26 (small blind) folded before Flop
Seat 3: ded serch (big blind) collected ($0.16)
Seat 4: Scaaalll folded before Flop (didn't bet)
Seat 5: sakourtele folded before Flop
Seat 6: Pulp Hands folded before Flop (didn't bet)



PokerStars Zoom Hand #229232343780:  Hold'em No Limit ($0.01/$0.02) - 2021/08/21 22:47:10 CET [2021/08/21 16:47:10 ET]
Table 'Halley' 6-max Seat #1 is the button
Seat 1: Kreodont1987 ($5.16 in chips) 
Seat 2: TomoKondo ($2.99 in chips) 
Seat 3: Scaaalll ($2.14 in chips) 
Seat 4: NIK1973 23 ($2.07 in chips) 
Seat 5: nippurkaunas ($1.94 in chips) 
Seat 6: IceTdannyB ($2.81 in chips) 
TomoKondo: posts small blind $0.01
Scaaalll: posts big blind $0.02
*** HOLE CARDS ***
Dealt to Scaaalll [2c Ts]
IceTdannyB is disconnected 
NIK1973 23: folds 
nippurkaunas: calls $0.02
IceTdannyB: folds 
Kreodont1987: folds 
TomoKondo: folds 
Scaaalll: checks 
*** FLOP *** [2s Kc Qs]
Scaaalll: checks 
nippurkaunas: checks 
*** TURN *** [2s Kc Qs] [4d]
Scaaalll: checks 
nippurkaunas: checks 
*** RIVER *** [2s Kc Qs 4d] [Kd]
Scaaalll: checks 
nippurkaunas: checks 
*** SHOW DOWN ***
Scaaalll: shows [2c Ts] (two pair, Kings and Deuces)
nippurkaunas: shows [2d Ah] (two pair, Kings and Deuces - Ace kicker)
nippurkaunas collected $0.05 from pot
*** SUMMARY ***
Total pot $0.05 | Rake $0 
Board [2s Kc Qs 4d Kd]
Seat 1: Kreodont1987 (button) folded before Flop (didn't bet)
Seat 2: TomoKondo (small blind) folded before Flop
Seat 3: Scaaalll (big blind) showed [2c Ts] and lost with two pair, Kings and Deuces
Seat 4: NIK1973 23 folded before Flop (didn't bet)
Seat 5: nippurkaunas showed [2d Ah] and won ($0.05) with two pair, Kings and Deuces
Seat 6: IceTdannyB folded before Flop (didn't bet)



PokerStars Zoom Hand #229232359231:  Hold'em No Limit ($0.01/$0.02) - 2021/08/21 22:47:45 CET [2021/08/21 16:47:45 ET]
Table 'Halley' 6-max Seat #1 is the button
Seat 1: Smailodon ($0.73 in chips) 
Seat 2: Scaaalll ($2.12 in chips) 
Seat 3: NIK1973 23 ($2.04 in chips) 
Seat 4: gasmar_29 ($4.24 in chips) 
Seat 5: Treadero ($2.32 in chips) 
Seat 6: WITKOW_AV ($2.28 in chips) 
Scaaalll: posts small blind $0.01
NIK1973 23: posts big blind $0.02
*** HOLE CARDS ***
Dealt to Scaaalll [Qh 7s]
gasmar_29: folds 
Treadero: raises $0.02 to $0.04
WITKOW_AV: folds 
Smailodon: calls $0.04
Scaaalll: folds 
NIK1973 23: folds 
*** FLOP *** [5s Jh 5c]
Treadero: bets $0.06
Smailodon: folds 
Uncalled bet ($0.06) returned to Treadero
Treadero collected $0.11 from pot
Treadero: doesn't show hand 
*** SUMMARY ***
Total pot $0.11 | Rake $0 
Board [5s Jh 5c]
Seat 1: Smailodon (button) folded on the Flop
Seat 2: Scaaalll (small blind) folded before Flop
Seat 3: NIK1973 23 (big blind) folded before Flop
Seat 4: gasmar_29 folded before Flop (didn't bet)
Seat 5: Treadero collected ($0.11)
Seat 6: WITKOW_AV folded before Flop (didn't bet)



PokerStars Zoom Hand #229232363732:  Hold'em No Limit ($0.01/$0.02) - 2021/08/21 22:47:55 CET [2021/08/21 16:47:55 ET]
Table 'Halley' 6-max Seat #1 is the button
Seat 1: XHerrTUMNUSX ($8.01 in chips) 
Seat 2: Koldun 2636 ($2.69 in chips) 
Seat 3: baksu12 ($2.94 in chips) 
Seat 4: kukulagosleep ($2.16 in chips) 
Seat 5: WITKOW_AV ($2.08 in chips) 
Seat 6: Scaaalll ($2.11 in chips) 
Koldun 2636: posts small blind $0.01
baksu12: posts big blind $0.02
*** HOLE CARDS ***
Dealt to Scaaalll [9h 9c]
kukulagosleep: folds 
WITKOW_AV: folds 
Scaaalll: raises $0.04 to $0.06
XHerrTUMNUSX: folds 
Koldun 2636: folds 
baksu12: calls $0.04
*** FLOP *** [6d Ks 5d]
baksu12: bets $0.07
Scaaalll: calls $0.07
*** TURN *** [6d Ks 5d] [5h]
baksu12: bets $0.09
Scaaalll: calls $0.09
*** RIVER *** [6d Ks 5d 5h] [7h]
baksu12: checks 
Scaaalll: bets $0.12
baksu12: calls $0.12
*** SHOW DOWN ***
Scaaalll: shows [9h 9c] (two pair, Nines and Fives)
baksu12: mucks hand 
Scaaalll collected $0.67 from pot
*** SUMMARY ***
Total pot $0.69 | Rake $0.02 
Board [6d Ks 5d 5h 7h]
Seat 1: XHerrTUMNUSX (button) folded before Flop (didn't bet)
Seat 2: Koldun 2636 (small blind) folded before Flop
Seat 3: baksu12 (big blind) mucked [8h 6h]
Seat 4: kukulagosleep folded before Flop (didn't bet)
Seat 5: WITKOW_AV folded before Flop (didn't bet)
Seat 6: Scaaalll showed [9h 9c] and won ($0.67) with two pair, Nines and Fives



PokerStars Zoom Hand #229232390911:  Hold'em No Limit ($0.01/$0.02) - 2021/08/21 22:48:57 CET [2021/08/21 16:48:57 ET]
Table 'Halley' 6-max Seat #1 is the button
Seat 1: Scaaalll ($2.44 in chips) 
Seat 2: Pechorin.G ($2.05 in chips) 
Seat 3: RChinenov ($2.46 in chips) 
Seat 4: SaRCh_Ale ($2.73 in chips) 
Seat 5: plmanuelpl ($1.28 in chips) 
Seat 6: 78joniboy ($2.68 in chips) 
Pechorin.G: posts small blind $0.01
RChinenov: posts big blind $0.02
*** HOLE CARDS ***
Dealt to Scaaalll [7c 8s]
SaRCh_Ale: raises $0.04 to $0.06
plmanuelpl: calls $0.06
78joniboy: folds 
Scaaalll: folds 
Pechorin.G: folds 
RChinenov: folds 
*** FLOP *** [9h Jd Ts]
SaRCh_Ale: bets $0.04
plmanuelpl: folds 
Uncalled bet ($0.04) returned to SaRCh_Ale
SaRCh_Ale collected $0.14 from pot
SaRCh_Ale: doesn't show hand 
plmanuelpl is disconnected 
*** SUMMARY ***
Total pot $0.15 | Rake $0.01 
Board [9h Jd Ts]
Seat 1: Scaaalll (button) folded before Flop (didn't bet)
Seat 2: Pechorin.G (small blind) folded before Flop
Seat 3: RChinenov (big blind) folded before Flop
Seat 4: SaRCh_Ale collected ($0.14)
Seat 5: plmanuelpl folded on the Flop
Seat 6: 78joniboy folded before Flop (didn't bet)



PokerStars Zoom Hand #229232397560:  Hold'em No Limit ($0.01/$0.02) - 2021/08/21 22:49:12 CET [2021/08/21 16:49:12 ET]
Table 'Halley' 6-max Seat #1 is the button
Seat 1: NIK1973 23 ($2.13 in chips) 
Seat 2: Gamer577 ($4.01 in chips) 
Seat 3: slipknot956 ($2.09 in chips) 
Seat 4: Scaaalll ($2.44 in chips) 
Seat 5: IceTdannyB ($3.78 in chips) 
Seat 6: estelionat171 ($1.02 in chips) 
Gamer577: posts small blind $0.01
slipknot956: posts big blind $0.02
*** HOLE CARDS ***
Dealt to Scaaalll [4c 5c]
IceTdannyB is disconnected 
Scaaalll: folds 
IceTdannyB: folds 
estelionat171: folds 
NIK1973 23: folds 
Gamer577: raises $0.04 to $0.06
slipknot956: folds 
Uncalled bet ($0.04) returned to Gamer577
Gamer577 collected $0.04 from pot
Gamer577: doesn't show hand 
*** SUMMARY ***
Total pot $0.04 | Rake $0 
Seat 1: NIK1973 23 (button) folded before Flop (didn't bet)
Seat 2: Gamer577 (small blind) collected ($0.04)
Seat 3: slipknot956 (big blind) folded before Flop
Seat 4: Scaaalll folded before Flop (didn't bet)
Seat 5: IceTdannyB folded before Flop (didn't bet)
Seat 6: estelionat171 folded before Flop (didn't bet)



PokerStars Zoom Hand #229232394434:  Hold'em No Limit ($0.01/$0.02) - 2021/08/21 22:49:05 CET [2021/08/21 16:49:05 ET]
Table 'Halley' 6-max Seat #1 is the button
Seat 1: KonopDima ($2 in chips) 
Seat 2: KRITAYA ($1.25 in chips) 
Seat 3: udav26 ($1.76 in chips) 
Seat 4: TheW3irdo ($2.32 in chips) 
Seat 5: Scaaalll ($2.44 in chips) 
Seat 6: tuolau ($1.62 in chips) 
KRITAYA: posts small blind $0.01
udav26: posts big blind $0.02
*** HOLE CARDS ***
Dealt to Scaaalll [Ac 2h]
TheW3irdo: folds 
Scaaalll: folds 
tuolau: raises $0.04 to $0.06
KonopDima: folds 
KRITAYA: folds 
udav26: calls $0.04
*** FLOP *** [3s Qd Th]
udav26: checks 
tuolau: bets $0.06
udav26: calls $0.06
*** TURN *** [3s Qd Th] [Ts]
udav26: checks 
tuolau: checks 
*** RIVER *** [3s Qd Th Ts] [Ah]
udav26: checks 
tuolau: checks 
*** SHOW DOWN ***
udav26: shows [8s 9s] (a pair of Tens)
tuolau: shows [Jc Js] (two pair, Jacks and Tens)
tuolau collected $0.24 from pot
*** SUMMARY ***
Total pot $0.25 | Rake $0.01 
Board [3s Qd Th Ts Ah]
Seat 1: KonopDima (button) folded before Flop (didn't bet)
Seat 2: KRITAYA (small blind) folded before Flop
Seat 3: udav26 (big blind) showed [8s 9s] and lost with a pair of Tens
Seat 4: TheW3irdo folded before Flop (didn't bet)
Seat 5: Scaaalll folded before Flop (didn't bet)
Seat 6: tuolau showed [Jc Js] and won ($0.24) with two pair, Jacks and Tens



PokerStars Zoom Hand #229232401992:  Hold'em No Limit ($0.01/$0.02) - 2021/08/21 22:49:22 CET [2021/08/21 16:49:22 ET]
Table 'Halley' 6-max Seat #1 is the button
Seat 1: BexleyBoy ($3.09 in chips) 
Seat 2: Scaaalll ($2.44 in chips) 
Seat 3: CrazyyParis ($2 in chips) 
Seat 4: Reipinguimm ($3.56 in chips) 
Seat 5: Ogni ($5.69 in chips) 
Seat 6: gasmar_29 ($2.66 in chips) 
Scaaalll: posts small blind $0.01
CrazyyParis: posts big blind $0.02
*** HOLE CARDS ***
Dealt to Scaaalll [5c 9h]
Reipinguimm: folds 
Ogni: folds 
gasmar_29: folds 
BexleyBoy: folds 
Scaaalll: folds 
Uncalled bet ($0.01) returned to CrazyyParis
CrazyyParis collected $0.02 from pot
CrazyyParis: doesn't show hand 
*** SUMMARY ***
Total pot $0.02 | Rake $0 
Seat 1: BexleyBoy (button) folded before Flop (didn't bet)
Seat 2: Scaaalll (small blind) folded before Flop
Seat 3: CrazyyParis (big blind) collected ($0.02)
Seat 4: Reipinguimm folded before Flop (didn't bet)
Seat 5: Ogni folded before Flop (didn't bet)
Seat 6: gasmar_29 folded before Flop (didn't bet)



PokerStars Zoom Hand #229232415284:  Hold'em No Limit ($0.01/$0.02) - 2021/08/21 22:49:52 CET [2021/08/21 16:49:52 ET]
Table 'Halley' 6-max Seat #1 is the button
Seat 1: ser313131 ($4.52 in chips) 
Seat 2: XHerrTUMNUSX ($7.32 in chips) 
Seat 3: Scaaalll ($2.43 in chips) 
Seat 4: derry,me ($3.27 in chips) 
Seat 5: wieksi9845 ($1.01 in chips) 
Seat 6: slipknot956 ($2.07 in chips) 
XHerrTUMNUSX: posts small blind $0.01
Scaaalll: posts big blind $0.02
*** HOLE CARDS ***
Dealt to Scaaalll [5c 4c]
derry,me: folds 
derry,me is disconnected 
wieksi9845: folds 
slipknot956: folds 
ser313131: folds 
wieksi9845 is disconnected 
XHerrTUMNUSX: raises $0.04 to $0.06
Scaaalll: calls $0.04
*** FLOP *** [Kd 5s 2h]
XHerrTUMNUSX: bets $0.10
Scaaalll: calls $0.10
*** TURN *** [Kd 5s 2h] [8d]
XHerrTUMNUSX: bets $0.24
Scaaalll: folds 
Uncalled bet ($0.24) returned to XHerrTUMNUSX
XHerrTUMNUSX collected $0.31 from pot
XHerrTUMNUSX: doesn't show hand 
*** SUMMARY ***
Total pot $0.32 | Rake $0.01 
Board [Kd 5s 2h 8d]
Seat 1: ser313131 (button) folded before Flop (didn't bet)
Seat 2: XHerrTUMNUSX (small blind) collected ($0.31)
Seat 3: Scaaalll (big blind) folded on the Turn
Seat 4: derry,me folded before Flop (didn't bet)
Seat 5: wieksi9845 folded before Flop (didn't bet)
Seat 6: slipknot956 folded before Flop (didn't bet)



PokerStars Zoom Hand #229232432509:  Hold'em No Limit ($0.01/$0.02) - 2021/08/21 22:50:31 CET [2021/08/21 16:50:31 ET]
Table 'Halley' 6-max Seat #1 is the button
Seat 1: Scaaalll ($2.27 in chips) 
Seat 2: RomiSex ($5.30 in chips) 
Seat 3: olga3021221 ($2 in chips) 
Seat 4: martoniv ($2.82 in chips) 
Seat 5: Apollonnn_13 ($1.89 in chips) 
Seat 6: Gamer577 ($2.32 in chips) 
RomiSex: posts small blind $0.01
olga3021221: posts big blind $0.02
*** HOLE CARDS ***
Dealt to Scaaalll [3c Kd]
martoniv: folds 
Apollonnn_13: folds 
Gamer577: folds 
Scaaalll: folds 
RomiSex: raises $0.04 to $0.06
olga3021221: folds 
Uncalled bet ($0.04) returned to RomiSex
RomiSex collected $0.04 from pot
RomiSex: doesn't show hand 
*** SUMMARY ***
Total pot $0.04 | Rake $0 
Seat 1: Scaaalll (button) folded before Flop (didn't bet)
Seat 2: RomiSex (small blind) collected ($0.04)
Seat 3: olga3021221 (big blind) folded before Flop
Seat 4: martoniv folded before Flop (didn't bet)
Seat 5: Apollonnn_13 folded before Flop (didn't bet)
Seat 6: Gamer577 folded before Flop (didn't bet)



PokerStars Zoom Hand #229232430752:  Hold'em No Limit ($0.01/$0.02) - 2021/08/21 22:50:27 CET [2021/08/21 16:50:27 ET]
Table 'Halley' 6-max Seat #1 is the button
Seat 1: kresooo ($0.81 in chips) 
Seat 2: Kreodont1987 ($6.02 in chips) 
Seat 3: dkno77 ($1.46 in chips) 
Seat 4: rpycmbEM ($4.05 in chips) 
Seat 5: BlackhawKK's ($2 in chips) 
Seat 6: Scaaalll ($2.27 in chips) 
Kreodont1987: posts small blind $0.01
dkno77: posts big blind $0.02
*** HOLE CARDS ***
Dealt to Scaaalll [6h Qc]
rpycmbEM: raises $0.04 to $0.06
BlackhawKK's: folds 
Scaaalll: folds 
kresooo: calls $0.06
Kreodont1987: folds 
dkno77: folds 
*** FLOP *** [7c 6c 3h]
rpycmbEM: bets $0.05
kresooo: calls $0.05
*** TURN *** [7c 6c 3h] [3d]
rpycmbEM: checks 
kresooo: checks 
*** RIVER *** [7c 6c 3h 3d] [3c]
rpycmbEM: checks 
kresooo: bets $0.24
rpycmbEM: folds 
Uncalled bet ($0.24) returned to kresooo
kresooo collected $0.24 from pot
kresooo: doesn't show hand 
*** SUMMARY ***
Total pot $0.25 | Rake $0.01 
Board [7c 6c 3h 3d 3c]
Seat 1: kresooo (button) collected ($0.24)
Seat 2: Kreodont1987 (small blind) folded before Flop
Seat 3: dkno77 (big blind) folded before Flop
Seat 4: rpycmbEM folded on the River
Seat 5: BlackhawKK's folded before Flop (didn't bet)
Seat 6: Scaaalll folded before Flop (didn't bet)



PokerStars Zoom Hand #229232434275:  Hold'em No Limit ($0.01/$0.02) - 2021/08/21 22:50:35 CET [2021/08/21 16:50:35 ET]
Table 'Halley' 6-max Seat #1 is the button
Seat 1: teutonknight ($0.34 in chips) 
Seat 2: Scaaalll ($2.27 in chips) 
Seat 3: RomiSex ($2 in chips) 
Seat 4: Reipinguimm ($3.47 in chips) 
Seat 5: jens 305 ($0.88 in chips) 
Seat 6: Kergie ($16.08 in chips) 
Scaaalll: posts small blind $0.01
RomiSex: posts big blind $0.02
*** HOLE CARDS ***
Dealt to Scaaalll [7c 7d]
Reipinguimm: raises $0.03 to $0.05
jens 305: folds 
Kergie: folds 
teutonknight: folds 
Scaaalll: calls $0.04
RomiSex: folds 
*** FLOP *** [9c 9h 8d]
Scaaalll: checks 
Reipinguimm: bets $0.06
Scaaalll: calls $0.06
*** TURN *** [9c 9h 8d] [Qh]
Scaaalll: checks 
Reipinguimm: bets $0.12
Scaaalll: folds 
Uncalled bet ($0.12) returned to Reipinguimm
Reipinguimm collected $0.23 from pot
Reipinguimm: doesn't show hand 
*** SUMMARY ***
Total pot $0.24 | Rake $0.01 
Board [9c 9h 8d Qh]
Seat 1: teutonknight (button) folded before Flop (didn't bet)
Seat 2: Scaaalll (small blind) folded on the Turn
Seat 3: RomiSex (big blind) folded before Flop
Seat 4: Reipinguimm collected ($0.23)
Seat 5: jens 305 folded before Flop (didn't bet)
Seat 6: Kergie folded before Flop (didn't bet)



PokerStars Zoom Hand #229232448342:  Hold'em No Limit ($0.01/$0.02) - 2021/08/21 22:51:07 CET [2021/08/21 16:51:07 ET]
Table 'Halley' 6-max Seat #1 is the button
Seat 1: vovo4kapooh ($3.08 in chips) 
Seat 2: gasmar_29 ($2.07 in chips) 
Seat 3: HDYD18 ($2.53 in chips) 
Seat 4: Scaaalll ($2.16 in chips) 
Seat 5: SaRCh_Ale ($2.17 in chips) 
Seat 6: Ar xxx ($1.24 in chips) 
gasmar_29: posts small blind $0.01
HDYD18: posts big blind $0.02
*** HOLE CARDS ***
Dealt to Scaaalll [2d 3s]
Scaaalll: folds 
SaRCh_Ale: folds 
Ar xxx: folds 
vovo4kapooh: folds 
gasmar_29: folds 
Uncalled bet ($0.01) returned to HDYD18
HDYD18 collected $0.02 from pot
HDYD18: doesn't show hand 
*** SUMMARY ***
Total pot $0.02 | Rake $0 
Seat 1: vovo4kapooh (button) folded before Flop (didn't bet)
Seat 2: gasmar_29 (small blind) folded before Flop
Seat 3: HDYD18 (big blind) collected ($0.02)
Seat 4: Scaaalll folded before Flop (didn't bet)
Seat 5: SaRCh_Ale folded before Flop (didn't bet)
Seat 6: Ar xxx folded before Flop (didn't bet)



PokerStars Zoom Hand #229232446592:  Hold'em No Limit ($0.01/$0.02) - 2021/08/21 22:51:03 CET [2021/08/21 16:51:03 ET]
Table 'Halley' 6-max Seat #1 is the button
Seat 1: Xlavariable ($2.03 in chips) 
Seat 2: zbixxx ($4.79 in chips) 
Seat 3: CordiPS ($3.17 in chips) 
Seat 4: boa juice ($2.84 in chips) 
Seat 5: Scaaalll ($2.16 in chips) 
Seat 6: TheW3irdo ($2.03 in chips) 
zbixxx: posts small blind $0.01
CordiPS: posts big blind $0.02
*** HOLE CARDS ***
Dealt to Scaaalll [8s Td]
boa juice: folds 
Scaaalll: folds 
TheW3irdo: folds 
boa juice is disconnected 
Xlavariable: folds 
zbixxx: folds 
Uncalled bet ($0.01) returned to CordiPS
CordiPS collected $0.02 from pot
CordiPS: doesn't show hand 
*** SUMMARY ***
Total pot $0.02 | Rake $0 
Seat 1: Xlavariable (button) folded before Flop (didn't bet)
Seat 2: zbixxx (small blind) folded before Flop
Seat 3: CordiPS (big blind) collected ($0.02)
Seat 4: boa juice folded before Flop (didn't bet)
Seat 5: Scaaalll folded before Flop (didn't bet)
Seat 6: TheW3irdo folded before Flop (didn't bet)



PokerStars Zoom Hand #229232465928:  Hold'em No Limit ($0.01/$0.02) - 2021/08/21 22:51:47 CET [2021/08/21 16:51:47 ET]
Table 'Halley' 6-max Seat #1 is the button
Seat 1: Scaaalll ($2.14 in chips) 
Seat 2: elmex886 ($2.01 in chips) 
Seat 3: HDYD18 ($2.53 in chips) 
Seat 4: igara tigara ($0.86 in chips) 
Seat 5: Jellycube ($4.40 in chips) 
Seat 6: sg.32rus ($1.67 in chips) 
elmex886: posts small blind $0.01
HDYD18: posts big blind $0.02
*** HOLE CARDS ***
Dealt to Scaaalll [Ts 3c]
igara tigara: folds 
Jellycube: raises $0.03 to $0.05
sg.32rus: folds 
Scaaalll: folds 
elmex886: folds 
HDYD18: folds 
Uncalled bet ($0.03) returned to Jellycube
Jellycube collected $0.05 from pot
Jellycube: doesn't show hand 
*** SUMMARY ***
Total pot $0.05 | Rake $0 
Seat 1: Scaaalll (button) folded before Flop (didn't bet)
Seat 2: elmex886 (small blind) folded before Flop
Seat 3: HDYD18 (big blind) folded before Flop
Seat 4: igara tigara folded before Flop (didn't bet)
Seat 5: Jellycube collected ($0.05)
Seat 6: sg.32rus folded before Flop (didn't bet)



PokerStars Zoom Hand #229232450510:  Hold'em No Limit ($0.01/$0.02) - 2021/08/21 22:51:12 CET [2021/08/21 16:51:12 ET]
Table 'Halley' 6-max Seat #1 is the button
Seat 1: MarioDios ($2 in chips) 
Seat 2: storo98 ($15.31 in chips) 
Seat 3: Scaaalll ($2.16 in chips) 
Seat 4: stanthema661 ($2.55 in chips) 
Seat 5: Apollonnn_13 ($1.78 in chips) 
Seat 6: Hallyson_23 ($4.45 in chips) 
storo98: posts small blind $0.01
Scaaalll: posts big blind $0.02
*** HOLE CARDS ***
Dealt to Scaaalll [8c Jh]
stanthema661: calls $0.02
Apollonnn_13: calls $0.02
Hallyson_23: folds 
MarioDios: folds 
storo98: calls $0.01
Scaaalll: checks 
*** FLOP *** [Th 4h 2s]
storo98: checks 
Scaaalll: checks 
stanthema661: bets $0.04
Apollonnn_13: calls $0.04
storo98: folds 
Scaaalll: folds 
*** TURN *** [Th 4h 2s] [As]
stanthema661: checks 
Apollonnn_13: checks 
*** RIVER *** [Th 4h 2s As] [4d]
stanthema661: bets $0.15
Apollonnn_13: folds 
Uncalled bet ($0.15) returned to stanthema661
stanthema661 collected $0.15 from pot
stanthema661: doesn't show hand 
*** SUMMARY ***
Total pot $0.16 | Rake $0.01 
Board [Th 4h 2s As 4d]
Seat 1: MarioDios (button) folded before Flop (didn't bet)
Seat 2: storo98 (small blind) folded on the Flop
Seat 3: Scaaalll (big blind) folded on the Flop
Seat 4: stanthema661 collected ($0.15)
Seat 5: Apollonnn_13 folded on the River
Seat 6: Hallyson_23 folded before Flop (didn't bet)



PokerStars Zoom Hand #229232472608:  Hold'em No Limit ($0.01/$0.02) - 2021/08/21 22:52:02 CET [2021/08/21 16:52:02 ET]
Table 'Halley' 6-max Seat #1 is the button
Seat 1: bananAAbandit ($5.29 in chips) 
Seat 2: Ramirres ($2.23 in chips) 
Seat 3: znak312 ($2 in chips) 
Seat 4: cr@sh test ($2.15 in chips) 
Seat 5: Scaaalll ($2.14 in chips) 
Seat 6: boa juice ($2.78 in chips) 
Ramirres: posts small blind $0.01
znak312: posts big blind $0.02
*** HOLE CARDS ***
Dealt to Scaaalll [4c 7h]
cr@sh test: folds 
Scaaalll: folds 
boa juice: folds 
boa juice is disconnected 
bananAAbandit: raises $0.04 to $0.06
Ramirres: folds 
znak312: folds 
Uncalled bet ($0.04) returned to bananAAbandit
bananAAbandit collected $0.05 from pot
bananAAbandit: doesn't show hand 
*** SUMMARY ***
Total pot $0.05 | Rake $0 
Seat 1: bananAAbandit (button) collected ($0.05)
Seat 2: Ramirres (small blind) folded before Flop
Seat 3: znak312 (big blind) folded before Flop
Seat 4: cr@sh test folded before Flop (didn't bet)
Seat 5: Scaaalll folded before Flop (didn't bet)
Seat 6: boa juice folded before Flop (didn't bet)



PokerStars Zoom Hand #229232469090:  Hold'em No Limit ($0.01/$0.02) - 2021/08/21 22:51:54 CET [2021/08/21 16:51:54 ET]
Table 'Halley' 6-max Seat #1 is the button
Seat 1: kukulagosleep ($2.01 in chips) 
Seat 2: Castor1 ($1.05 in chips) 
Seat 3: keldh ($3.22 in chips) 
Seat 4: pipecmolodec ($2 in chips) 
Seat 5: Dr.stromg ($5.85 in chips) 
Seat 6: Scaaalll ($2.14 in chips) 
Castor1: posts small blind $0.01
keldh: posts big blind $0.02
*** HOLE CARDS ***
Dealt to Scaaalll [Qs 6c]
pipecmolodec: folds 
Dr.stromg: folds 
Scaaalll: folds 
kukulagosleep: folds 
Castor1: calls $0.01
keldh: checks 
*** FLOP *** [5c 9h 7c]
Castor1: checks 
keldh: bets $0.03
Castor1: folds 
Uncalled bet ($0.03) returned to keldh
keldh collected $0.04 from pot
keldh: doesn't show hand 
*** SUMMARY ***
Total pot $0.04 | Rake $0 
Board [5c 9h 7c]
Seat 1: kukulagosleep (button) folded before Flop (didn't bet)
Seat 2: Castor1 (small blind) folded on the Flop
Seat 3: keldh (big blind) collected ($0.04)
Seat 4: pipecmolodec folded before Flop (didn't bet)
Seat 5: Dr.stromg folded before Flop (didn't bet)
Seat 6: Scaaalll folded before Flop (didn't bet)



PokerStars Zoom Hand #229232474803:  Hold'em No Limit ($0.01/$0.02) - 2021/08/21 22:52:07 CET [2021/08/21 16:52:07 ET]
Table 'Halley' 6-max Seat #1 is the button
Seat 1: Kb013497 ($1.59 in chips) 
Seat 2: Tacojesuscrisp ($2.34 in chips) 
Seat 3: eutepegu ($1.73 in chips) 
Seat 4: Scaaalll ($2.14 in chips) 
Seat 5: Knutzers ($2.38 in chips) 
Seat 6: Dr.stromg ($3.97 in chips) 
Tacojesuscrisp: posts small blind $0.01
eutepegu: posts big blind $0.02
*** HOLE CARDS ***
Dealt to Scaaalll [Js 9c]
Scaaalll: folds 
Knutzers: folds 
Dr.stromg: folds 
Kb013497: folds 
Tacojesuscrisp: folds 
Uncalled bet ($0.01) returned to eutepegu
eutepegu collected $0.02 from pot
eutepegu: doesn't show hand 
*** SUMMARY ***
Total pot $0.02 | Rake $0 
Seat 1: Kb013497 (button) folded before Flop (didn't bet)
Seat 2: Tacojesuscrisp (small blind) folded before Flop
Seat 3: eutepegu (big blind) collected ($0.02)
Seat 4: Scaaalll folded before Flop (didn't bet)
Seat 5: Knutzers folded before Flop (didn't bet)
Seat 6: Dr.stromg folded before Flop (didn't bet)



PokerStars Zoom Hand #229232478298:  Hold'em No Limit ($0.01/$0.02) - 2021/08/21 22:52:15 CET [2021/08/21 16:52:15 ET]
Table 'Halley' 6-max Seat #1 is the button
Seat 1: 888lifeIS ($2.25 in chips) 
Seat 2: Ne0net ($2.14 in chips) 
Seat 3: Apollonnn_13 ($2.01 in chips) 
Seat 4: Scaaalll ($2.14 in chips) 
Seat 5: alexmpokes ($2.31 in chips) 
Seat 6: JaguarAndy17 ($2.30 in chips) 
Ne0net: posts small blind $0.01
Apollonnn_13: posts big blind $0.02
*** HOLE CARDS ***
Dealt to Scaaalll [4s 4d]
JaguarAndy17 is disconnected 
Scaaalll: raises $0.04 to $0.06
alexmpokes: calls $0.06
JaguarAndy17: folds 
888lifeIS: folds 
Ne0net: folds 
Apollonnn_13: folds 
*** FLOP *** [Js Jh Qc]
Scaaalll: bets $0.09
alexmpokes: calls $0.09
*** TURN *** [Js Jh Qc] [5h]
Scaaalll: checks 
alexmpokes: checks 
*** RIVER *** [Js Jh Qc 5h] [Th]
Scaaalll: checks 
alexmpokes: bets $0.32
Scaaalll: folds 
Uncalled bet ($0.32) returned to alexmpokes
alexmpokes collected $0.32 from pot
alexmpokes: doesn't show hand 
*** SUMMARY ***
Total pot $0.33 | Rake $0.01 
Board [Js Jh Qc 5h Th]
Seat 1: 888lifeIS (button) folded before Flop (didn't bet)
Seat 2: Ne0net (small blind) folded before Flop
Seat 3: Apollonnn_13 (big blind) folded before Flop
Seat 4: Scaaalll folded on the River
Seat 5: alexmpokes collected ($0.32)
Seat 6: JaguarAndy17 folded before Flop (didn't bet)



PokerStars Zoom Hand #229232494678:  Hold'em No Limit ($0.01/$0.02) - 2021/08/21 22:52:52 CET [2021/08/21 16:52:52 ET]
Table 'Halley' 6-max Seat #1 is the button
Seat 1: Merlin_Arg ($2.03 in chips) 
Seat 2: pavlo8855 ($2.23 in chips) 
Seat 3: Scaaalll ($2 in chips) 
Seat 4: 888lifeIS ($2.07 in chips) 
Seat 5: kahzura ($2 in chips) 
Seat 6: giselerebelo ($2.42 in chips) 
pavlo8855: posts small blind $0.01
Scaaalll: posts big blind $0.02
*** HOLE CARDS ***
Dealt to Scaaalll [3s 8d]
888lifeIS: folds 
kahzura: folds 
giselerebelo: folds 
Merlin_Arg: folds 
pavlo8855: raises $0.04 to $0.06
Scaaalll: folds 
Uncalled bet ($0.04) returned to pavlo8855
pavlo8855 collected $0.04 from pot
pavlo8855: doesn't show hand 
*** SUMMARY ***
Total pot $0.04 | Rake $0 
Seat 1: Merlin_Arg (button) folded before Flop (didn't bet)
Seat 2: pavlo8855 (small blind) collected ($0.04)
Seat 3: Scaaalll (big blind) folded before Flop
Seat 4: 888lifeIS folded before Flop (didn't bet)
Seat 5: kahzura folded before Flop (didn't bet)
Seat 6: giselerebelo folded before Flop (didn't bet)



PokerStars Zoom Hand #229232503091:  Hold'em No Limit ($0.01/$0.02) - 2021/08/21 22:53:11 CET [2021/08/21 16:53:11 ET]
Table 'Halley' 6-max Seat #1 is the button
Seat 1: Scaaalll ($2 in chips) 
Seat 2: T-saitama ($2 in chips) 
Seat 3: TomoKondo ($3.72 in chips) 
Seat 4: lumpek1112 ($2.67 in chips) 
Seat 5: STE1NBERG ($3.11 in chips) 
Seat 6: BlackhawKK's ($3.16 in chips) 
T-saitama: posts small blind $0.01
TomoKondo: posts big blind $0.02
*** HOLE CARDS ***
Dealt to Scaaalll [8s 6h]
lumpek1112: folds 
STE1NBERG: folds 
BlackhawKK's: folds 
Scaaalll: folds 
T-saitama: raises $0.04 to $0.06
TomoKondo: folds 
Uncalled bet ($0.04) returned to T-saitama
T-saitama collected $0.04 from pot
T-saitama: doesn't show hand 
*** SUMMARY ***
Total pot $0.04 | Rake $0 
Seat 1: Scaaalll (button) folded before Flop (didn't bet)
Seat 2: T-saitama (small blind) collected ($0.04)
Seat 3: TomoKondo (big blind) folded before Flop
Seat 4: lumpek1112 folded before Flop (didn't bet)
Seat 5: STE1NBERG folded before Flop (didn't bet)
Seat 6: BlackhawKK's folded before Flop (didn't bet)



PokerStars Zoom Hand #229232501344:  Hold'em No Limit ($0.01/$0.02) - 2021/08/21 22:53:07 CET [2021/08/21 16:53:07 ET]
Table 'Halley' 6-max Seat #1 is the button
Seat 1: NoEff0rt2w1n ($2.83 in chips) 
Seat 2: Scaaalll ($2 in chips) 
Seat 3: Thaleshs ($3.84 in chips) 
Seat 4: FabOliveira9 ($2.16 in chips) 
Seat 5: polymorhp ($3.95 in chips) 
Seat 6: Hantsirg ($0.74 in chips) 
Scaaalll: posts small blind $0.01
Thaleshs: posts big blind $0.02
*** HOLE CARDS ***
Dealt to Scaaalll [8s Qd]
FabOliveira9: folds 
polymorhp: folds 
Hantsirg: raises $0.02 to $0.04
NoEff0rt2w1n: raises $0.11 to $0.15
Scaaalll: folds 
Thaleshs: folds 
Hantsirg: folds 
Uncalled bet ($0.11) returned to NoEff0rt2w1n
NoEff0rt2w1n collected $0.11 from pot
NoEff0rt2w1n: doesn't show hand 
Hantsirg is disconnected 
*** SUMMARY ***
Total pot $0.11 | Rake $0 
Seat 1: NoEff0rt2w1n (button) collected ($0.11)
Seat 2: Scaaalll (small blind) folded before Flop
Seat 3: Thaleshs (big blind) folded before Flop
Seat 4: FabOliveira9 folded before Flop (didn't bet)
Seat 5: polymorhp folded before Flop (didn't bet)
Seat 6: Hantsirg folded before Flop



PokerStars Zoom Hand #229232512765:  Hold'em No Limit ($0.01/$0.02) - 2021/08/21 22:53:33 CET [2021/08/21 16:53:33 ET]
Table 'Halley' 6-max Seat #1 is the button
Seat 1: BlackhawKK's ($3.97 in chips) 
Seat 2: CrazyyParis ($2 in chips) 
Seat 3: kawish ($1.02 in chips) 
Seat 4: VaanKroenen ($5.25 in chips) 
Seat 5: Scaaalll ($2 in chips) 
Seat 6: Soko 1381 ($2 in chips) 
CrazyyParis: posts small blind $0.01
kawish: posts big blind $0.02
*** HOLE CARDS ***
Dealt to Scaaalll [3s Jh]
VaanKroenen: folds 
Scaaalll: folds 
Soko 1381: folds 
BlackhawKK's: folds 
CrazyyParis: folds 
Uncalled bet ($0.01) returned to kawish
kawish collected $0.02 from pot
kawish: doesn't show hand 
*** SUMMARY ***
Total pot $0.02 | Rake $0 
Seat 1: BlackhawKK's (button) folded before Flop (didn't bet)
Seat 2: CrazyyParis (small blind) folded before Flop
Seat 3: kawish (big blind) collected ($0.02)
Seat 4: VaanKroenen folded before Flop (didn't bet)
Seat 5: Scaaalll folded before Flop (didn't bet)
Seat 6: Soko 1381 folded before Flop (didn't bet)



PokerStars Zoom Hand #229232504804:  Hold'em No Limit ($0.01/$0.02) - 2021/08/21 22:53:15 CET [2021/08/21 16:53:15 ET]
Table 'Halley' 6-max Seat #1 is the button
Seat 1: sal_sagev41 ($2.56 in chips) 
Seat 2: yurkaa_pf ($2.01 in chips) 
Seat 3: keb1981 ($2.12 in chips) 
Seat 4: twiti174 ($2.41 in chips) 
Seat 5: Hallyson_23 ($4.60 in chips) 
Seat 6: Scaaalll ($2 in chips) 
yurkaa_pf: posts small blind $0.01
keb1981: posts big blind $0.02
*** HOLE CARDS ***
Dealt to Scaaalll [As 9d]
twiti174: raises $0.02 to $0.04
Hallyson_23: folds 
Scaaalll: folds 
sal_sagev41: folds 
yurkaa_pf: calls $0.03
keb1981: folds 
*** FLOP *** [2d 2c Ah]
yurkaa_pf: bets $0.06
twiti174: raises $0.22 to $0.28
yurkaa_pf: folds 
Uncalled bet ($0.22) returned to twiti174
twiti174 collected $0.21 from pot
twiti174: doesn't show hand 
yurkaa_pf is disconnected 
*** SUMMARY ***
Total pot $0.22 | Rake $0.01 
Board [2d 2c Ah]
Seat 1: sal_sagev41 (button) folded before Flop (didn't bet)
Seat 2: yurkaa_pf (small blind) folded on the Flop
Seat 3: keb1981 (big blind) folded before Flop
Seat 4: twiti174 collected ($0.21)
Seat 5: Hallyson_23 folded before Flop (didn't bet)
Seat 6: Scaaalll folded before Flop (didn't bet)



PokerStars Zoom Hand #229232514558:  Hold'em No Limit ($0.01/$0.02) - 2021/08/21 22:53:37 CET [2021/08/21 16:53:37 ET]
Table 'Halley' 6-max Seat #1 is the button
Seat 1: Larson_mfk ($0.49 in chips) 
Seat 2: Scaaalll ($2 in chips) 
Seat 3: Hallyson_23 ($4.92 in chips) 
Seat 4: lucksuckdonk ($6.25 in chips) 
Seat 5: zallav ($3.29 in chips) 
Seat 6: Yangyang1407 ($2.06 in chips) 
Scaaalll: posts small blind $0.01
Hallyson_23: posts big blind $0.02
*** HOLE CARDS ***
Dealt to Scaaalll [Kd 9s]
zallav is disconnected 
lucksuckdonk: folds 
zallav: folds 
Yangyang1407: raises $0.03 to $0.05
Larson_mfk: raises $0.11 to $0.16
Scaaalll: folds 
Hallyson_23: folds 
Yangyang1407: folds 
Uncalled bet ($0.11) returned to Larson_mfk
Larson_mfk collected $0.13 from pot
Larson_mfk: doesn't show hand 
*** SUMMARY ***
Total pot $0.13 | Rake $0 
Seat 1: Larson_mfk (button) collected ($0.13)
Seat 2: Scaaalll (small blind) folded before Flop
Seat 3: Hallyson_23 (big blind) folded before Flop
Seat 4: lucksuckdonk folded before Flop (didn't bet)
Seat 5: zallav folded before Flop (didn't bet)
Seat 6: Yangyang1407 folded before Flop



PokerStars Zoom Hand #229232516369:  Hold'em No Limit ($0.01/$0.02) - 2021/08/21 22:53:41 CET [2021/08/21 16:53:41 ET]
Table 'Halley' 6-max Seat #1 is the button
Seat 1: NoEff0rt2w1n ($2.02 in chips) 
Seat 2: Z0omer_420 ($2 in chips) 
Seat 3: Scaaalll ($2 in chips) 
Seat 4: DaBaDaBaDooo ($2.24 in chips) 
Seat 5: KonopDima ($3.29 in chips) 
Seat 6: so0love ($7.43 in chips) 
Z0omer_420: posts small blind $0.01
Scaaalll: posts big blind $0.02
*** HOLE CARDS ***
Dealt to Scaaalll [5d Tc]
DaBaDaBaDooo: folds 
KonopDima: folds 
so0love: folds 
NoEff0rt2w1n: folds 
Z0omer_420: folds 
Uncalled bet ($0.01) returned to Scaaalll
Scaaalll collected $0.02 from pot
Scaaalll: doesn't show hand 
*** SUMMARY ***
Total pot $0.02 | Rake $0 
Seat 1: NoEff0rt2w1n (button) folded before Flop (didn't bet)
Seat 2: Z0omer_420 (small blind) folded before Flop
Seat 3: Scaaalll (big blind) collected ($0.02)
Seat 4: DaBaDaBaDooo folded before Flop (didn't bet)
Seat 5: KonopDima folded before Flop (didn't bet)
Seat 6: so0love folded before Flop (didn't bet)



PokerStars Zoom Hand #229232523487:  Hold'em No Limit ($0.01/$0.02) - 2021/08/21 22:53:57 CET [2021/08/21 16:53:57 ET]
Table 'Halley' 6-max Seat #1 is the button
Seat 1: OGTripleOG247 ($1.93 in chips) 
Seat 2: Merlin_Arg ($2 in chips) 
Seat 3: Akrobat94 ($1.60 in chips) 
Seat 4: Rafa13brr ($3.68 in chips) 
Seat 5: Scaaalll ($2.01 in chips) 
Seat 6: cr@sh test ($2 in chips) 
Merlin_Arg: posts small blind $0.01
Akrobat94: posts big blind $0.02
*** HOLE CARDS ***
Dealt to Scaaalll [2c 2h]
Rafa13brr: calls $0.02
Scaaalll: calls $0.02
cr@sh test: folds 
OGTripleOG247: folds 
Merlin_Arg: folds 
Akrobat94: checks 
*** FLOP *** [Ks 8c Ac]
Akrobat94: checks 
Rafa13brr: checks 
Scaaalll: checks 
*** TURN *** [Ks 8c Ac] [Ah]
Akrobat94: checks 
Rafa13brr: bets $0.04
Akrobat94 is disconnected 
Scaaalll: folds 
Akrobat94: folds 
Uncalled bet ($0.04) returned to Rafa13brr
Rafa13brr collected $0.07 from pot
Rafa13brr: doesn't show hand 
*** SUMMARY ***
Total pot $0.07 | Rake $0 
Board [Ks 8c Ac Ah]
Seat 1: OGTripleOG247 (button) folded before Flop (didn't bet)
Seat 2: Merlin_Arg (small blind) folded before Flop
Seat 3: Akrobat94 (big blind) folded on the Turn
Seat 4: Rafa13brr collected ($0.07)
Seat 5: Scaaalll folded on the Turn
Seat 6: cr@sh test folded before Flop (didn't bet)



PokerStars Zoom Hand #229232535878:  Hold'em No Limit ($0.01/$0.02) - 2021/08/21 22:54:25 CET [2021/08/21 16:54:25 ET]
Table 'Halley' 6-max Seat #1 is the button
Seat 1: Coldact ($1.42 in chips) 
Seat 2: pavlo8855 ($2.01 in chips) 
Seat 3: lackymad ($1 in chips) 
Seat 4: squidy4 ($1.14 in chips) 
Seat 5: Apollonnn_13 ($1.68 in chips) 
Seat 6: Scaaalll ($2 in chips) 
pavlo8855: posts small blind $0.01
lackymad: posts big blind $0.02
*** HOLE CARDS ***
Dealt to Scaaalll [4d 5d]
squidy4: folds 
Apollonnn_13: folds 
squidy4 is disconnected 
Scaaalll: raises $0.04 to $0.06
Coldact: folds 
pavlo8855: folds 
lackymad: raises $0.13 to $0.19
Scaaalll: calls $0.13
*** FLOP *** [Kc 4h Qc]
lackymad: checks 
Scaaalll: checks 
*** TURN *** [Kc 4h Qc] [2d]
lackymad: checks 
Scaaalll: checks 
*** RIVER *** [Kc 4h Qc 2d] [5s]
lackymad: checks 
Scaaalll: bets $0.28
lackymad: folds 
Uncalled bet ($0.28) returned to Scaaalll
Scaaalll collected $0.38 from pot
Scaaalll: doesn't show hand 
*** SUMMARY ***
Total pot $0.39 | Rake $0.01 
Board [Kc 4h Qc 2d 5s]
Seat 1: Coldact (button) folded before Flop (didn't bet)
Seat 2: pavlo8855 (small blind) folded before Flop
Seat 3: lackymad (big blind) folded on the River
Seat 4: squidy4 folded before Flop (didn't bet)
Seat 5: Apollonnn_13 folded before Flop (didn't bet)
Seat 6: Scaaalll collected ($0.38)



PokerStars Zoom Hand #229232551669:  Hold'em No Limit ($0.01/$0.02) - 2021/08/21 22:55:01 CET [2021/08/21 16:55:01 ET]
Table 'Halley' 6-max Seat #1 is the button
Seat 1: olga3021221 ($2.44 in chips) 
Seat 2: Scaaalll ($2.19 in chips) 
Seat 3: Pechorin.G ($2.41 in chips) 
Seat 4: udav26 ($2.64 in chips) 
Seat 5: znak312 ($2 in chips) 
Seat 6: fishh_play ($3.27 in chips) 
Scaaalll: posts small blind $0.01
Pechorin.G: posts big blind $0.02
*** HOLE CARDS ***
Dealt to Scaaalll [5s Qh]
udav26: folds 
znak312: folds 
fishh_play: folds 
olga3021221: folds 
Scaaalll: folds 
Uncalled bet ($0.01) returned to Pechorin.G
Pechorin.G collected $0.02 from pot
Pechorin.G: doesn't show hand 
*** SUMMARY ***
Total pot $0.02 | Rake $0 
Seat 1: olga3021221 (button) folded before Flop (didn't bet)
Seat 2: Scaaalll (small blind) folded before Flop
Seat 3: Pechorin.G (big blind) collected ($0.02)
Seat 4: udav26 folded before Flop (didn't bet)
Seat 5: znak312 folded before Flop (didn't bet)
Seat 6: fishh_play folded before Flop (didn't bet)



PokerStars Zoom Hand #229232553480:  Hold'em No Limit ($0.01/$0.02) - 2021/08/21 22:55:06 CET [2021/08/21 16:55:06 ET]
Table 'Halley' 6-max Seat #1 is the button
Seat 1: Scaaalll ($2.18 in chips) 
Seat 2: Jackb9908 ($1.95 in chips) 
Seat 3: Jellycube ($5.62 in chips) 
Seat 4: Herr.Hikke ($2.15 in chips) 
Seat 5: F_oksi(BLR) ($3.88 in chips) 
Seat 6: znak312 ($2 in chips) 
Jackb9908: posts small blind $0.01
Jellycube: posts big blind $0.02
*** HOLE CARDS ***
Dealt to Scaaalll [6d 7c]
Herr.Hikke: folds 
F_oksi(BLR): folds 
znak312: folds 
Scaaalll: folds 
Jackb9908: folds 
Uncalled bet ($0.01) returned to Jellycube
Jellycube collected $0.02 from pot
Jellycube: doesn't show hand 
*** SUMMARY ***
Total pot $0.02 | Rake $0 
Seat 1: Scaaalll (button) folded before Flop (didn't bet)
Seat 2: Jackb9908 (small blind) folded before Flop
Seat 3: Jellycube (big blind) collected ($0.02)
Seat 4: Herr.Hikke folded before Flop (didn't bet)
Seat 5: F_oksi(BLR) folded before Flop (didn't bet)
Seat 6: znak312 folded before Flop (didn't bet)



PokerStars Zoom Hand #229232555122:  Hold'em No Limit ($0.01/$0.02) - 2021/08/21 22:55:11 CET [2021/08/21 16:55:11 ET]
Table 'Halley' 6-max Seat #1 is the button
Seat 1: Dershura1989 ($5.36 in chips) 
Seat 2: AlexGTPS ($1.97 in chips) 
Seat 3: maressen ($2.24 in chips) 
Seat 4: BlackhawKK's ($3.01 in chips) 
Seat 5: Scaaalll ($2.18 in chips) 
Seat 6: vvk22 ($2.26 in chips) 
AlexGTPS: posts small blind $0.01
maressen: posts big blind $0.02
*** HOLE CARDS ***
Dealt to Scaaalll [4h Ks]
BlackhawKK's: folds 
Scaaalll: folds 
vvk22: folds 
Dershura1989: folds 
AlexGTPS: folds 
Uncalled bet ($0.01) returned to maressen
maressen collected $0.02 from pot
maressen: doesn't show hand 
*** SUMMARY ***
Total pot $0.02 | Rake $0 
Seat 1: Dershura1989 (button) folded before Flop (didn't bet)
Seat 2: AlexGTPS (small blind) folded before Flop
Seat 3: maressen (big blind) collected ($0.02)
Seat 4: BlackhawKK's folded before Flop (didn't bet)
Seat 5: Scaaalll folded before Flop (didn't bet)
Seat 6: vvk22 folded before Flop (didn't bet)



PokerStars Zoom Hand #229232556411:  Hold'em No Limit ($0.01/$0.02) - 2021/08/21 22:55:15 CET [2021/08/21 16:55:15 ET]
Table 'Halley' 6-max Seat #1 is the button
Seat 1: ChowMangao ($3.92 in chips) 
Seat 2: so0love ($2.89 in chips) 
Seat 3: Scaaalll ($2.18 in chips) 
Seat 4: Healthys07 ($3.38 in chips) 
Seat 5: ARS_POLI13 ($1.95 in chips) 
Seat 6: eastcoast777 ($1.81 in chips) 
so0love: posts small blind $0.01
Scaaalll: posts big blind $0.02
*** HOLE CARDS ***
Dealt to Scaaalll [Kc 7c]
Healthys07: folds 
ARS_POLI13: folds 
eastcoast777: calls $0.02
ChowMangao: folds 
so0love: folds 
Scaaalll: checks 
*** FLOP *** [2s Kd Jh]
Scaaalll: checks 
eastcoast777: checks 
*** TURN *** [2s Kd Jh] [7h]
Scaaalll: bets $0.04
eastcoast777: calls $0.04
*** RIVER *** [2s Kd Jh 7h] [4s]
Scaaalll: bets $0.11
eastcoast777: folds 
Uncalled bet ($0.11) returned to Scaaalll
Scaaalll collected $0.13 from pot
Scaaalll: doesn't show hand 
*** SUMMARY ***
Total pot $0.13 | Rake $0 
Board [2s Kd Jh 7h 4s]
Seat 1: ChowMangao (button) folded before Flop (didn't bet)
Seat 2: so0love (small blind) folded before Flop
Seat 3: Scaaalll (big blind) collected ($0.13)
Seat 4: Healthys07 folded before Flop (didn't bet)
Seat 5: ARS_POLI13 folded before Flop (didn't bet)
Seat 6: eastcoast777 folded on the River



PokerStars Zoom Hand #229232572196:  Hold'em No Limit ($0.01/$0.02) - 2021/08/21 22:56:04 CET [2021/08/21 16:56:04 ET]
Table 'Halley' 6-max Seat #1 is the button
Seat 1: ASAjr ($2.31 in chips) 
Seat 2: kukulagosleep ($2.73 in chips) 
Seat 3: alphabeta1d ($2.03 in chips) 
Seat 4: ca$hmeoutsid ($2 in chips) 
Seat 5: so0love ($2.62 in chips) 
Seat 6: Scaaalll ($2.25 in chips) 
kukulagosleep: posts small blind $0.01
alphabeta1d: posts big blind $0.02
*** HOLE CARDS ***
Dealt to Scaaalll [Jd 5h]
ca$hmeoutsid: folds 
so0love: raises $0.03 to $0.05
Scaaalll: folds 
ASAjr: folds 
kukulagosleep: folds 
alphabeta1d: folds 
Uncalled bet ($0.03) returned to so0love
so0love collected $0.05 from pot
so0love: doesn't show hand 
*** SUMMARY ***
Total pot $0.05 | Rake $0 
Seat 1: ASAjr (button) folded before Flop (didn't bet)
Seat 2: kukulagosleep (small blind) folded before Flop
Seat 3: alphabeta1d (big blind) folded before Flop
Seat 4: ca$hmeoutsid folded before Flop (didn't bet)
Seat 5: so0love collected ($0.05)
Seat 6: Scaaalll folded before Flop (didn't bet)



PokerStars Zoom Hand #229232573477:  Hold'em No Limit ($0.01/$0.02) - 2021/08/21 22:56:08 CET [2021/08/21 16:56:08 ET]
Table 'Halley' 6-max Seat #1 is the button
Seat 1: Dr.stromg ($3.25 in chips) 
Seat 2: Thaleshs ($3.70 in chips) 
Seat 3: Osetrov.A.A ($2.31 in chips) 
Seat 4: Scaaalll ($2.25 in chips) 
Seat 5: BadBeat Bert ($1.10 in chips) 
Seat 6: vikasatinova ($1.48 in chips) 
Thaleshs: posts small blind $0.01
Osetrov.A.A: posts big blind $0.02
*** HOLE CARDS ***
Dealt to Scaaalll [3s 5s]
Scaaalll: folds 
BadBeat Bert: folds 
vikasatinova: raises $0.02 to $0.04
Dr.stromg: folds 
Thaleshs: folds 
Osetrov.A.A: calls $0.02
*** FLOP *** [4d 6s 7c]
Osetrov.A.A: bets $0.08
vikasatinova: folds 
Uncalled bet ($0.08) returned to Osetrov.A.A
Osetrov.A.A collected $0.09 from pot
Osetrov.A.A: doesn't show hand 
vikasatinova is disconnected 
*** SUMMARY ***
Total pot $0.09 | Rake $0 
Board [4d 6s 7c]
Seat 1: Dr.stromg (button) folded before Flop (didn't bet)
Seat 2: Thaleshs (small blind) folded before Flop
Seat 3: Osetrov.A.A (big blind) collected ($0.09)
Seat 4: Scaaalll folded before Flop (didn't bet)
Seat 5: BadBeat Bert folded before Flop (didn't bet)
Seat 6: vikasatinova folded on the Flop



PokerStars Zoom Hand #229232582997:  Hold'em No Limit ($0.01/$0.02) - 2021/08/21 22:56:19 CET [2021/08/21 16:56:19 ET]
Table 'Halley' 6-max Seat #1 is the button
Seat 1: fishh_play ($3.23 in chips) 
Seat 2: NecromiconP ($2.13 in chips) 
Seat 3: Gamer577 ($2 in chips) 
Seat 4: Scaaalll ($2.25 in chips) 
Seat 5: ytras ($1.54 in chips) 
Seat 6: KonopDima ($3.41 in chips) 
NecromiconP: posts small blind $0.01
Gamer577: posts big blind $0.02
*** HOLE CARDS ***
Dealt to Scaaalll [4s Jc]
Scaaalll: folds 
ytras: raises $0.03 to $0.05
KonopDima: folds 
fishh_play: folds 
NecromiconP: folds 
Gamer577: folds 
Uncalled bet ($0.03) returned to ytras
ytras collected $0.05 from pot
ytras: doesn't show hand 
*** SUMMARY ***
Total pot $0.05 | Rake $0 
Seat 1: fishh_play (button) folded before Flop (didn't bet)
Seat 2: NecromiconP (small blind) folded before Flop
Seat 3: Gamer577 (big blind) folded before Flop
Seat 4: Scaaalll folded before Flop (didn't bet)
Seat 5: ytras collected ($0.05)
Seat 6: KonopDima folded before Flop (didn't bet)



PokerStars Zoom Hand #229232580705:  Hold'em No Limit ($0.01/$0.02) - 2021/08/21 22:56:12 CET [2021/08/21 16:56:12 ET]
Table 'Halley' 6-max Seat #1 is the button
Seat 1: Attention1909 ($2.28 in chips) 
Seat 2: Apollonnn_13 ($1.78 in chips) 
Seat 3: VovaU164 ($1.94 in chips) 
Seat 4: Scaaalll ($2.25 in chips) 
Seat 5: XHerrTUMNUSX ($8.19 in chips) 
Seat 6: Koldun 2636 ($4.01 in chips) 
Apollonnn_13: posts small blind $0.01
VovaU164: posts big blind $0.02
*** HOLE CARDS ***
Dealt to Scaaalll [Td As]
Scaaalll: folds 
XHerrTUMNUSX: folds 
Koldun 2636: folds 
Attention1909: raises $0.07 to $0.09
Apollonnn_13: folds 
VovaU164: calls $0.07
*** FLOP *** [6d Jd 8d]
VovaU164: checks 
Attention1909: bets $0.02
VovaU164: calls $0.02
*** TURN *** [6d Jd 8d] [3s]
VovaU164: checks 
Attention1909: bets $0.11
VovaU164: calls $0.11
*** RIVER *** [6d Jd 8d 3s] [2d]
VovaU164: checks 
Attention1909: checks 
*** SHOW DOWN ***
VovaU164: shows [7s 8c] (a pair of Eights)
Attention1909: shows [3d Ah] (a flush, Jack high)
Attention1909 collected $0.43 from pot
*** SUMMARY ***
Total pot $0.45 | Rake $0.02 
Board [6d Jd 8d 3s 2d]
Seat 1: Attention1909 (button) showed [3d Ah] and won ($0.43) with a flush, Jack high
Seat 2: Apollonnn_13 (small blind) folded before Flop
Seat 3: VovaU164 (big blind) showed [7s 8c] and lost with a pair of Eights
Seat 4: Scaaalll folded before Flop (didn't bet)
Seat 5: XHerrTUMNUSX folded before Flop (didn't bet)
Seat 6: Koldun 2636 folded before Flop (didn't bet)



PokerStars Zoom Hand #229232590785:  Hold'em No Limit ($0.01/$0.02) - 2021/08/21 22:56:23 CET [2021/08/21 16:56:23 ET]
Table 'Halley' 6-max Seat #1 is the button
Seat 1: Scaaalll ($2.25 in chips) 
Seat 2: znak312 ($2.01 in chips) 
Seat 3: ca$hmeoutsid ($2 in chips) 
Seat 4: Axel201388 ($0.63 in chips) 
Seat 5: Davingo25 ($1.81 in chips) 
Seat 6: Vitalyi1970 ($3.71 in chips) 
znak312: posts small blind $0.01
ca$hmeoutsid: posts big blind $0.02
*** HOLE CARDS ***
Dealt to Scaaalll [8h Qh]
Davingo25 is disconnected 
Axel201388: folds 
Davingo25: folds 
Vitalyi1970: raises $0.02 to $0.04
Scaaalll: calls $0.04
znak312: calls $0.03
ca$hmeoutsid: folds 
*** FLOP *** [9c 3h Th]
znak312: checks 
Vitalyi1970: bets $0.04
Scaaalll: raises $0.13 to $0.17
znak312: folds 
Vitalyi1970: folds 
Uncalled bet ($0.13) returned to Scaaalll
Scaaalll collected $0.21 from pot
Scaaalll: doesn't show hand 
*** SUMMARY ***
Total pot $0.22 | Rake $0.01 
Board [9c 3h Th]
Seat 1: Scaaalll (button) collected ($0.21)
Seat 2: znak312 (small blind) folded on the Flop
Seat 3: ca$hmeoutsid (big blind) folded before Flop
Seat 4: Axel201388 folded before Flop (didn't bet)
Seat 5: Davingo25 folded before Flop (didn't bet)
Seat 6: Vitalyi1970 folded on the Flop



PokerStars Zoom Hand #229232602828:  Hold'em No Limit ($0.01/$0.02) - 2021/08/21 22:57:00 CET [2021/08/21 16:57:00 ET]
Table 'Halley' 6-max Seat #1 is the button
Seat 1: ciucibaby ($3.52 in chips) 
Seat 2: Scaaalll ($2.38 in chips) 
Seat 3: rodrigoasor ($4.68 in chips) 
Seat 4: znak312 ($2 in chips) 
Seat 5: Yangyang1407 ($2.10 in chips) 
Seat 6: tuolau ($1.92 in chips) 
Scaaalll: posts small blind $0.01
rodrigoasor: posts big blind $0.02
*** HOLE CARDS ***
Dealt to Scaaalll [7h Jh]
znak312: folds 
Yangyang1407: folds 
tuolau: folds 
ciucibaby: folds 
Scaaalll: folds 
Uncalled bet ($0.01) returned to rodrigoasor
tuolau is disconnected 
rodrigoasor collected $0.02 from pot
rodrigoasor: doesn't show hand 
*** SUMMARY ***
Total pot $0.02 | Rake $0 
Seat 1: ciucibaby (button) folded before Flop (didn't bet)
Seat 2: Scaaalll (small blind) folded before Flop
Seat 3: rodrigoasor (big blind) collected ($0.02)
Seat 4: znak312 folded before Flop (didn't bet)
Seat 5: Yangyang1407 folded before Flop (didn't bet)
Seat 6: tuolau folded before Flop (didn't bet)



PokerStars Zoom Hand #229232604158:  Hold'em No Limit ($0.01/$0.02) - 2021/08/21 22:57:04 CET [2021/08/21 16:57:04 ET]
Table 'Halley' 6-max Seat #1 is the button
Seat 1: maurivispa10 ($1.47 in chips) 
Seat 2: Xlavariable ($2.07 in chips) 
Seat 3: Scaaalll ($2.37 in chips) 
Seat 4: Earl_greyPL ($1.16 in chips) 
Seat 5: RrriotGrrrl ($9.16 in chips) 
Seat 6: BlackhawKK's ($3.49 in chips) 
Xlavariable: posts small blind $0.01
Scaaalll: posts big blind $0.02
*** HOLE CARDS ***
Dealt to Scaaalll [4c Kh]
Earl_greyPL: folds 
RrriotGrrrl: folds 
BlackhawKK's: folds 
maurivispa10: raises $0.03 to $0.05
Xlavariable: folds 
Scaaalll: folds 
Uncalled bet ($0.03) returned to maurivispa10
maurivispa10 collected $0.05 from pot
maurivispa10: doesn't show hand 
*** SUMMARY ***
Total pot $0.05 | Rake $0 
Seat 1: maurivispa10 (button) collected ($0.05)
Seat 2: Xlavariable (small blind) folded before Flop
Seat 3: Scaaalll (big blind) folded before Flop
Seat 4: Earl_greyPL folded before Flop (didn't bet)
Seat 5: RrriotGrrrl folded before Flop (didn't bet)
Seat 6: BlackhawKK's folded before Flop (didn't bet)



PokerStars Zoom Hand #229232608328:  Hold'em No Limit ($0.01/$0.02) - 2021/08/21 22:57:17 CET [2021/08/21 16:57:17 ET]
Table 'Halley' 6-max Seat #1 is the button
Seat 1: lucksuckdonk ($3.48 in chips) 
Seat 2: Dakosm ($1.95 in chips) 
Seat 3: shingo594 ($4.05 in chips) 
Seat 4: kukulagosleep ($2.78 in chips) 
Seat 5: Scaaalll ($2.35 in chips) 
Seat 6: AAnt0nius ($1.97 in chips) 
Dakosm: posts small blind $0.01
shingo594: posts big blind $0.02
*** HOLE CARDS ***
Dealt to Scaaalll [3d 6d]
kukulagosleep: folds 
Scaaalll: folds 
AAnt0nius: raises $0.04 to $0.06
shingo594 is disconnected 
lucksuckdonk: raises $0.18 to $0.24
Dakosm: folds 
shingo594: folds 
AAnt0nius: folds 
Uncalled bet ($0.18) returned to lucksuckdonk
lucksuckdonk collected $0.15 from pot
lucksuckdonk: doesn't show hand 
*** SUMMARY ***
Total pot $0.15 | Rake $0 
Seat 1: lucksuckdonk (button) collected ($0.15)
Seat 2: Dakosm (small blind) folded before Flop
Seat 3: shingo594 (big blind) folded before Flop
Seat 4: kukulagosleep folded before Flop (didn't bet)
Seat 5: Scaaalll folded before Flop (didn't bet)
Seat 6: AAnt0nius folded before Flop



PokerStars Zoom Hand #229232607008:  Hold'em No Limit ($0.01/$0.02) - 2021/08/21 22:57:13 CET [2021/08/21 16:57:13 ET]
Table 'Halley' 6-max Seat #1 is the button
Seat 1: Red Sky 15 ($10.38 in chips) 
Seat 2: Ehrewind ($2.04 in chips) 
Seat 3: stUPolak ($2.08 in chips) 
Seat 4: spinaq ($1.74 in chips) 
Seat 5: Nolimit.208 ($3.20 in chips) 
Seat 6: Scaaalll ($2.35 in chips) 
Ehrewind: posts small blind $0.01
stUPolak: posts big blind $0.02
*** HOLE CARDS ***
Dealt to Scaaalll [9s Kc]
spinaq: folds 
Nolimit.208: raises $0.02 to $0.04
Scaaalll: folds 
Red Sky 15: calls $0.04
Ehrewind: folds 
stUPolak: folds 
*** FLOP *** [5d Ah 3c]
Nolimit.208: bets $0.02
Red Sky 15: calls $0.02
*** TURN *** [5d Ah 3c] [Qs]
Nolimit.208: bets $0.02
Red Sky 15: calls $0.02
*** RIVER *** [5d Ah 3c Qs] [9d]
Nolimit.208: bets $0.02
Red Sky 15: folds 
Uncalled bet ($0.02) returned to Nolimit.208
Nolimit.208 collected $0.18 from pot
Nolimit.208: doesn't show hand 
Red Sky 15 is disconnected 
*** SUMMARY ***
Total pot $0.19 | Rake $0.01 
Board [5d Ah 3c Qs 9d]
Seat 1: Red Sky 15 (button) folded on the River
Seat 2: Ehrewind (small blind) folded before Flop
Seat 3: stUPolak (big blind) folded before Flop
Seat 4: spinaq folded before Flop (didn't bet)
Seat 5: Nolimit.208 collected ($0.18)
Seat 6: Scaaalll folded before Flop (didn't bet)



PokerStars Zoom Hand #229232610338:  Hold'em No Limit ($0.01/$0.02) - 2021/08/21 22:57:23 CET [2021/08/21 16:57:23 ET]
Table 'Halley' 6-max Seat #1 is the button
Seat 1: Scaaalll ($2.35 in chips) 
Seat 2: HDYD18 ($3.25 in chips) 
Seat 3: CrazyyParis ($2 in chips) 
Seat 4: tassy237 ($0.96 in chips) 
Seat 5: zbixxx ($2 in chips) 
Seat 6: sinkthe8 ($0.52 in chips) 
HDYD18: posts small blind $0.01
CrazyyParis: posts big blind $0.02
*** HOLE CARDS ***
Dealt to Scaaalll [Jh 3h]
sinkthe8 is disconnected 
tassy237: folds 
zbixxx: folds 
sinkthe8: folds 
tassy237 is disconnected 
Scaaalll: raises $0.02 to $0.04
HDYD18: folds 
CrazyyParis: calls $0.02
*** FLOP *** [Kd Ts 7h]
CrazyyParis: checks 
Scaaalll: bets $0.05
CrazyyParis: calls $0.05
*** TURN *** [Kd Ts 7h] [Ad]
CrazyyParis: checks 
Scaaalll: bets $0.13
CrazyyParis: folds 
Uncalled bet ($0.13) returned to Scaaalll
Scaaalll collected $0.18 from pot
Scaaalll: doesn't show hand 
*** SUMMARY ***
Total pot $0.19 | Rake $0.01 
Board [Kd Ts 7h Ad]
Seat 1: Scaaalll (button) collected ($0.18)
Seat 2: HDYD18 (small blind) folded before Flop
Seat 3: CrazyyParis (big blind) folded on the Turn
Seat 4: tassy237 folded before Flop (didn't bet)
Seat 5: zbixxx folded before Flop (didn't bet)
Seat 6: sinkthe8 folded before Flop (didn't bet)



PokerStars Zoom Hand #229232619199:  Hold'em No Limit ($0.01/$0.02) - 2021/08/21 22:57:50 CET [2021/08/21 16:57:50 ET]
Table 'Halley' 6-max Seat #1 is the button
Seat 1: Koldun 2636 ($2.86 in chips) 
Seat 2: PapiMik3 ($6.24 in chips) 
Seat 3: Apollonnn_13 ($1.79 in chips) 
Seat 4: ytras ($1.46 in chips) 
Seat 5: Scaaalll ($2.44 in chips) 
Seat 6: STE1NBERG ($2.66 in chips) 
PapiMik3: posts small blind $0.01
Apollonnn_13: posts big blind $0.02
*** HOLE CARDS ***
Dealt to Scaaalll [5d 8h]
ytras: raises $0.03 to $0.05
Scaaalll: folds 
STE1NBERG: folds 
Koldun 2636: folds 
PapiMik3: folds 
Apollonnn_13: folds 
Uncalled bet ($0.03) returned to ytras
ytras collected $0.05 from pot
ytras: doesn't show hand 
*** SUMMARY ***
Total pot $0.05 | Rake $0 
Seat 1: Koldun 2636 (button) folded before Flop (didn't bet)
Seat 2: PapiMik3 (small blind) folded before Flop
Seat 3: Apollonnn_13 (big blind) folded before Flop
Seat 4: ytras collected ($0.05)
Seat 5: Scaaalll folded before Flop (didn't bet)
Seat 6: STE1NBERG folded before Flop (didn't bet)



PokerStars Zoom Hand #229232621808:  Hold'em No Limit ($0.01/$0.02) - 2021/08/21 22:57:58 CET [2021/08/21 16:57:58 ET]
Table 'Halley' 6-max Seat #1 is the button
Seat 1: keb1981 ($2 in chips) 
Seat 2: NetoFLX ($2.01 in chips) 
Seat 3: Scaaalll ($2.44 in chips) 
Seat 4: Vahenta ($2.26 in chips) 
Seat 5: Canoinhas37 ($6.38 in chips) 
Seat 6: smileakafray ($4.36 in chips) 
NetoFLX: posts small blind $0.01
Scaaalll: posts big blind $0.02
*** HOLE CARDS ***
Dealt to Scaaalll [8c Ts]
Vahenta: folds 
Vahenta is disconnected 
Canoinhas37: folds 
smileakafray: folds 
keb1981: folds 
NetoFLX has timed out while disconnected
NetoFLX: folds 
Uncalled bet ($0.01) returned to Scaaalll
Scaaalll collected $0.02 from pot
Scaaalll: doesn't show hand 
*** SUMMARY ***
Total pot $0.02 | Rake $0 
Seat 1: keb1981 (button) folded before Flop (didn't bet)
Seat 2: NetoFLX (small blind) folded before Flop
Seat 3: Scaaalll (big blind) collected ($0.02)
Seat 4: Vahenta folded before Flop (didn't bet)
Seat 5: Canoinhas37 folded before Flop (didn't bet)
Seat 6: smileakafray folded before Flop (didn't bet)



PokerStars Zoom Hand #229232620454:  Hold'em No Limit ($0.01/$0.02) - 2021/08/21 22:57:54 CET [2021/08/21 16:57:54 ET]
Table 'Halley' 6-max Seat #1 is the button
Seat 1: Pulp Hands ($1.88 in chips) 
Seat 2: AAnt0nius ($1.89 in chips) 
Seat 3: BadBeat Bert ($1.15 in chips) 
Seat 4: SIGREX ($2.09 in chips) 
Seat 5: innexplus ($4.29 in chips) 
Seat 6: Scaaalll ($2.44 in chips) 
AAnt0nius: posts small blind $0.01
BadBeat Bert: posts big blind $0.02
*** HOLE CARDS ***
Dealt to Scaaalll [5d 3h]
SIGREX: raises $0.02 to $0.04
innexplus: folds 
Scaaalll: folds 
Pulp Hands: raises $0.02 to $0.06
AAnt0nius: folds 
BadBeat Bert: folds 
SIGREX: calls $0.02
*** FLOP *** [2d Tc Jh]
SIGREX: checks 
Pulp Hands: bets $0.07
SIGREX: calls $0.07
*** TURN *** [2d Tc Jh] [Kd]
SIGREX: checks 
Pulp Hands: checks 
*** RIVER *** [2d Tc Jh Kd] [7c]
SIGREX: bets $0.21
Pulp Hands: folds 
Uncalled bet ($0.21) returned to SIGREX
SIGREX collected $0.28 from pot
SIGREX: doesn't show hand 
*** SUMMARY ***
Total pot $0.29 | Rake $0.01 
Board [2d Tc Jh Kd 7c]
Seat 1: Pulp Hands (button) folded on the River
Seat 2: AAnt0nius (small blind) folded before Flop
Seat 3: BadBeat Bert (big blind) folded before Flop
Seat 4: SIGREX collected ($0.28)
Seat 5: innexplus folded before Flop (didn't bet)
Seat 6: Scaaalll folded before Flop (didn't bet)



PokerStars Zoom Hand #229232627345:  Hold'em No Limit ($0.01/$0.02) - 2021/08/21 22:58:15 CET [2021/08/21 16:58:15 ET]
Table 'Halley' 6-max Seat #1 is the button
Seat 1: HubertFroh ($4.94 in chips) 
Seat 2: Scaaalll ($2.45 in chips) 
Seat 3: Rin97 ($2.04 in chips) 
Seat 4: didiclavi777 ($1.86 in chips) 
Seat 5: xxRoseIloveu ($9.61 in chips) 
Seat 6: MEZz828 ($2.08 in chips) 
Scaaalll: posts small blind $0.01
Rin97: posts big blind $0.02
*** HOLE CARDS ***
Dealt to Scaaalll [4c Ac]
didiclavi777: folds 
xxRoseIloveu: folds 
MEZz828: folds 
HubertFroh: folds 
Scaaalll: raises $0.04 to $0.06
Rin97: calls $0.04
*** FLOP *** [Jc Td Qc]
Scaaalll: bets $0.08
Rin97: folds 
Uncalled bet ($0.08) returned to Scaaalll
Scaaalll collected $0.12 from pot
Scaaalll: doesn't show hand 
*** SUMMARY ***
Total pot $0.12 | Rake $0 
Board [Jc Td Qc]
Seat 1: HubertFroh (button) folded before Flop (didn't bet)
Seat 2: Scaaalll (small blind) collected ($0.12)
Seat 3: Rin97 (big blind) folded on the Flop
Seat 4: didiclavi777 folded before Flop (didn't bet)
Seat 5: xxRoseIloveu folded before Flop (didn't bet)
Seat 6: MEZz828 folded before Flop (didn't bet)



PokerStars Zoom Hand #229232635065:  Hold'em No Limit ($0.01/$0.02) - 2021/08/21 22:58:39 CET [2021/08/21 16:58:39 ET]
Table 'Halley' 6-max Seat #1 is the button
Seat 1: squidy4 ($2.59 in chips) 
Seat 2: lucksuckdonk ($6.77 in chips) 
Seat 3: MKIronCrAAzy ($4.08 in chips) 
Seat 4: Scaaalll ($2.51 in chips) 
Seat 5: alexan00 ($2.03 in chips) 
Seat 6: japoneis mt ($1.92 in chips) 
lucksuckdonk: posts small blind $0.01
MKIronCrAAzy: posts big blind $0.02
*** HOLE CARDS ***
Dealt to Scaaalll [2d Td]
Scaaalll: folds 
japoneis mt is disconnected 
alexan00: raises $0.04 to $0.06
japoneis mt: folds 
squidy4: folds 
lucksuckdonk: folds 
squidy4 is disconnected 
MKIronCrAAzy: folds 
Uncalled bet ($0.04) returned to alexan00
alexan00 collected $0.05 from pot
alexan00: doesn't show hand 
*** SUMMARY ***
Total pot $0.05 | Rake $0 
Seat 1: squidy4 (button) folded before Flop (didn't bet)
Seat 2: lucksuckdonk (small blind) folded before Flop
Seat 3: MKIronCrAAzy (big blind) folded before Flop
Seat 4: Scaaalll folded before Flop (didn't bet)
Seat 5: alexan00 collected ($0.05)
Seat 6: japoneis mt folded before Flop (didn't bet)



PokerStars Zoom Hand #229232633792:  Hold'em No Limit ($0.01/$0.02) - 2021/08/21 22:58:35 CET [2021/08/21 16:58:35 ET]
Table 'Halley' 6-max Seat #1 is the button
Seat 1: Scaaalll ($2.51 in chips) 
Seat 2: Misteltje ($4.09 in chips) 
Seat 3: Gamer577 ($6.16 in chips) 
Seat 4: olga3021221 ($2.45 in chips) 
Seat 5: anes.v. ($3.41 in chips) 
Seat 6: F_oksi(BLR) ($4.45 in chips) 
Misteltje: posts small blind $0.01
Gamer577: posts big blind $0.02
*** HOLE CARDS ***
Dealt to Scaaalll [4c Qd]
olga3021221: folds 
anes.v.: folds 
F_oksi(BLR): folds 
Scaaalll: folds 
Misteltje: raises $0.02 to $0.04
Gamer577: calls $0.02
*** FLOP *** [5s Qs Tc]
Misteltje: bets $0.06
Gamer577: folds 
Uncalled bet ($0.06) returned to Misteltje
Misteltje collected $0.08 from pot
Misteltje: doesn't show hand 
*** SUMMARY ***
Total pot $0.08 | Rake $0 
Board [5s Qs Tc]
Seat 1: Scaaalll (button) folded before Flop (didn't bet)
Seat 2: Misteltje (small blind) collected ($0.08)
Seat 3: Gamer577 (big blind) folded on the Flop
Seat 4: olga3021221 folded before Flop (didn't bet)
Seat 5: anes.v. folded before Flop (didn't bet)
Seat 6: F_oksi(BLR) folded before Flop (didn't bet)



PokerStars Zoom Hand #229232636358:  Hold'em No Limit ($0.01/$0.02) - 2021/08/21 22:58:43 CET [2021/08/21 16:58:43 ET]
Table 'Halley' 6-max Seat #1 is the button
Seat 1: Posaunengodi ($2.46 in chips) 
Seat 2: SaRCh_Ale ($3.43 in chips) 
Seat 3: onno978 ($2.75 in chips) 
Seat 4: lumpek1112 ($2.57 in chips) 
Seat 5: polymorhp ($4.27 in chips) 
Seat 6: Scaaalll ($2.51 in chips) 
SaRCh_Ale: posts small blind $0.01
onno978: posts big blind $0.02
*** HOLE CARDS ***
Dealt to Scaaalll [4s 5s]
lumpek1112: raises $0.05 to $0.07
polymorhp: folds 
Scaaalll: folds 
Posaunengodi: folds 
SaRCh_Ale: folds 
onno978: calls $0.05
*** FLOP *** [3s 2c 3c]
onno978: bets $0.07
lumpek1112: folds 
Uncalled bet ($0.07) returned to onno978
onno978 collected $0.14 from pot
onno978: doesn't show hand 
*** SUMMARY ***
Total pot $0.15 | Rake $0.01 
Board [3s 2c 3c]
Seat 1: Posaunengodi (button) folded before Flop (didn't bet)
Seat 2: SaRCh_Ale (small blind) folded before Flop
Seat 3: onno978 (big blind) collected ($0.14)
Seat 4: lumpek1112 folded on the Flop
Seat 5: polymorhp folded before Flop (didn't bet)
Seat 6: Scaaalll folded before Flop (didn't bet)



PokerStars Zoom Hand #229232638933:  Hold'em No Limit ($0.01/$0.02) - 2021/08/21 22:58:51 CET [2021/08/21 16:58:51 ET]
Table 'Halley' 6-max Seat #1 is the button
Seat 1: Koldun 2636 ($2.80 in chips) 
Seat 2: Scaaalll ($2.51 in chips) 
Seat 3: cbbbka ($2 in chips) 
Seat 4: RrriotGrrrl ($2 in chips) 
Seat 5: orlovac1995 ($4.19 in chips) 
Seat 6: olga3021221 ($2.44 in chips) 
Scaaalll: posts small blind $0.01
cbbbka: posts big blind $0.02
*** HOLE CARDS ***
Dealt to Scaaalll [4c Tc]
RrriotGrrrl: folds 
orlovac1995: folds 
olga3021221: folds 
Koldun 2636: raises $0.03 to $0.05
Scaaalll: folds 
cbbbka: folds 
Uncalled bet ($0.03) returned to Koldun 2636
Koldun 2636 collected $0.05 from pot
Koldun 2636: doesn't show hand 
cbbbka is disconnected 
*** SUMMARY ***
Total pot $0.05 | Rake $0 
Seat 1: Koldun 2636 (button) collected ($0.05)
Seat 2: Scaaalll (small blind) folded before Flop
Seat 3: cbbbka (big blind) folded before Flop
Seat 4: RrriotGrrrl folded before Flop (didn't bet)
Seat 5: orlovac1995 folded before Flop (didn't bet)
Seat 6: olga3021221 folded before Flop (didn't bet)



PokerStars Zoom Hand #229232641218:  Hold'em No Limit ($0.01/$0.02) - 2021/08/21 22:58:58 CET [2021/08/21 16:58:58 ET]
Table 'Halley' 6-max Seat #1 is the button
Seat 1: egopi ($1.96 in chips) 
Seat 2: znak312 ($2 in chips) 
Seat 3: Scaaalll ($2.50 in chips) 
Seat 4: xxRoseIloveu ($9.63 in chips) 
Seat 5: bossquaid ($3.61 in chips) 
Seat 6: polymorhp ($4.26 in chips) 
znak312: posts small blind $0.01
Scaaalll: posts big blind $0.02
*** HOLE CARDS ***
Dealt to Scaaalll [6c 5h]
egopi is disconnected 
xxRoseIloveu: raises $0.02 to $0.04
bossquaid: folds 
polymorhp: folds 
egopi: folds 
znak312: folds 
Scaaalll: folds 
Uncalled bet ($0.02) returned to xxRoseIloveu
xxRoseIloveu collected $0.05 from pot
xxRoseIloveu: doesn't show hand 
*** SUMMARY ***
Total pot $0.05 | Rake $0 
Seat 1: egopi (button) folded before Flop (didn't bet)
Seat 2: znak312 (small blind) folded before Flop
Seat 3: Scaaalll (big blind) folded before Flop
Seat 4: xxRoseIloveu collected ($0.05)
Seat 5: bossquaid folded before Flop (didn't bet)
Seat 6: polymorhp folded before Flop (didn't bet)



PokerStars Zoom Hand #229232645409:  Hold'em No Limit ($0.01/$0.02) - 2021/08/21 22:59:11 CET [2021/08/21 16:59:11 ET]
Table 'Halley' 6-max Seat #1 is the button
Seat 1: rodrigoasor ($3.14 in chips) 
Seat 2: astapowitsch ($2.19 in chips) 
Seat 3: Umnik_M ($1.90 in chips) 
Seat 4: Flo_Ned ($0.78 in chips) 
Seat 5: Scaaalll ($2.48 in chips) 
Seat 6: HubertFroh ($4.93 in chips) 
astapowitsch: posts small blind $0.01
Umnik_M: posts big blind $0.02
*** HOLE CARDS ***
Dealt to Scaaalll [8d 5c]
Flo_Ned: folds 
Scaaalll: folds 
HubertFroh: folds 
rodrigoasor: folds 
astapowitsch: folds 
Uncalled bet ($0.01) returned to Umnik_M
Umnik_M collected $0.02 from pot
Umnik_M: doesn't show hand 
*** SUMMARY ***
Total pot $0.02 | Rake $0 
Seat 1: rodrigoasor (button) folded before Flop (didn't bet)
Seat 2: astapowitsch (small blind) folded before Flop
Seat 3: Umnik_M (big blind) collected ($0.02)
Seat 4: Flo_Ned folded before Flop (didn't bet)
Seat 5: Scaaalll folded before Flop (didn't bet)
Seat 6: HubertFroh folded before Flop (didn't bet)



PokerStars Zoom Hand #229232647702:  Hold'em No Limit ($0.01/$0.02) - 2021/08/21 22:59:18 CET [2021/08/21 16:59:18 ET]
Table 'Halley' 6-max Seat #1 is the button
Seat 1: Scaaalll ($2.48 in chips) 
Seat 2: HDYD18 ($5.66 in chips) 
Seat 3: Astel88 ($2.69 in chips) 
Seat 4: Misteltje ($4.13 in chips) 
Seat 5: storo98 ($14.97 in chips) 
Seat 6: rodrigoasor ($4.70 in chips) 
HDYD18: posts small blind $0.01
Astel88: posts big blind $0.02
*** HOLE CARDS ***
Dealt to Scaaalll [7h 2h]
Misteltje: raises $0.04 to $0.06
storo98: folds 
rodrigoasor: folds 
Scaaalll: folds 
HDYD18: folds 
Astel88: folds 
Uncalled bet ($0.04) returned to Misteltje
Misteltje collected $0.05 from pot
Misteltje: doesn't show hand 
Astel88 is disconnected 
*** SUMMARY ***
Total pot $0.05 | Rake $0 
Seat 1: Scaaalll (button) folded before Flop (didn't bet)
Seat 2: HDYD18 (small blind) folded before Flop
Seat 3: Astel88 (big blind) folded before Flop
Seat 4: Misteltje collected ($0.05)
Seat 5: storo98 folded before Flop (didn't bet)
Seat 6: rodrigoasor folded before Flop (didn't bet)



PokerStars Zoom Hand #229232649337:  Hold'em No Limit ($0.01/$0.02) - 2021/08/21 22:59:23 CET [2021/08/21 16:59:23 ET]
Table 'Halley' 6-max Seat #1 is the button
Seat 1: AtZ3899 ($2.14 in chips) 
Seat 2: fishh_play ($5.05 in chips) 
Seat 3: ISBman ($3.86 in chips) 
Seat 4: Scaaalll ($2.48 in chips) 
Seat 5: vvk22 ($5.05 in chips) 
Seat 6: MattieBOZ ($2 in chips) 
fishh_play: posts small blind $0.01
ISBman: posts big blind $0.02
*** HOLE CARDS ***
Dealt to Scaaalll [As 5s]
Scaaalll: raises $0.04 to $0.06
vvk22: folds 
MattieBOZ: folds 
AtZ3899: folds 
fishh_play: folds 
MattieBOZ is disconnected 
ISBman: folds 
Uncalled bet ($0.04) returned to Scaaalll
Scaaalll collected $0.05 from pot
Scaaalll: doesn't show hand 
*** SUMMARY ***
Total pot $0.05 | Rake $0 
Seat 1: AtZ3899 (button) folded before Flop (didn't bet)
Seat 2: fishh_play (small blind) folded before Flop
Seat 3: ISBman (big blind) folded before Flop
Seat 4: Scaaalll collected ($0.05)
Seat 5: vvk22 folded before Flop (didn't bet)
Seat 6: MattieBOZ folded before Flop (didn't bet)



PokerStars Zoom Hand #229232655407:  Hold'em No Limit ($0.01/$0.02) - 2021/08/21 22:59:42 CET [2021/08/21 16:59:42 ET]
Table 'Halley' 6-max Seat #1 is the button
Seat 1: Healthys07 ($3.78 in chips) 
Seat 2: ISBman ($2.85 in chips) 
Seat 3: Jellycube ($5.43 in chips) 
Seat 4: Scaaalll ($2.51 in chips) 
Seat 5: Mr.Kurier ($2.03 in chips) 
Seat 6: AKATEX55 ($1.83 in chips) 
ISBman: posts small blind $0.01
Jellycube: posts big blind $0.02
*** HOLE CARDS ***
Dealt to Scaaalll [3h 6d]
Scaaalll: folds 
Mr.Kurier: folds 
AKATEX55: folds 
Healthys07: folds 
AKATEX55 is disconnected 
ISBman: folds 
Uncalled bet ($0.01) returned to Jellycube
Jellycube collected $0.02 from pot
Jellycube: doesn't show hand 
*** SUMMARY ***
Total pot $0.02 | Rake $0 
Seat 1: Healthys07 (button) folded before Flop (didn't bet)
Seat 2: ISBman (small blind) folded before Flop
Seat 3: Jellycube (big blind) collected ($0.02)
Seat 4: Scaaalll folded before Flop (didn't bet)
Seat 5: Mr.Kurier folded before Flop (didn't bet)
Seat 6: AKATEX55 folded before Flop (didn't bet)



PokerStars Zoom Hand #229232653507:  Hold'em No Limit ($0.01/$0.02) - 2021/08/21 22:59:36 CET [2021/08/21 16:59:36 ET]
Table 'Halley' 6-max Seat #1 is the button
Seat 1: xxVanquishxx ($15.05 in chips) 
Seat 2: SIGREX ($2 in chips) 
Seat 3: bossquaid ($2.25 in chips) 
Seat 4: vovan100157 ($1.96 in chips) 
Seat 5: japoneis mt ($1.93 in chips) 
Seat 6: Scaaalll ($2.51 in chips) 
SIGREX: posts small blind $0.01
bossquaid: posts big blind $0.02
*** HOLE CARDS ***
Dealt to Scaaalll [Th 5s]
vovan100157: folds 
japoneis mt has timed out
japoneis mt: folds 
Scaaalll: folds 
xxVanquishxx: folds 
SIGREX: folds 
Uncalled bet ($0.01) returned to bossquaid
japoneis mt is disconnected 
bossquaid collected $0.02 from pot
bossquaid: doesn't show hand 
*** SUMMARY ***
Total pot $0.02 | Rake $0 
Seat 1: xxVanquishxx (button) folded before Flop (didn't bet)
Seat 2: SIGREX (small blind) folded before Flop
Seat 3: bossquaid (big blind) collected ($0.02)
Seat 4: vovan100157 folded before Flop (didn't bet)
Seat 5: japoneis mt folded before Flop (didn't bet)
Seat 6: Scaaalll folded before Flop (didn't bet)



PokerStars Zoom Hand #229232656692:  Hold'em No Limit ($0.01/$0.02) - 2021/08/21 22:59:46 CET [2021/08/21 16:59:46 ET]
Table 'Halley' 6-max Seat #1 is the button
Seat 1: kboskov123 ($1.24 in chips) 
Seat 2: Scaaalll ($2.51 in chips) 
Seat 3: Earl_greyPL ($1.40 in chips) 
Seat 4: Manco2010 ($1.30 in chips) 
Seat 5: vipan2011 ($1.32 in chips) 
Seat 6: BMRB1991 ($0.92 in chips) 
Scaaalll: posts small blind $0.01
Earl_greyPL: posts big blind $0.02
*** HOLE CARDS ***
Dealt to Scaaalll [Jd Ks]
Manco2010: folds 
vipan2011: folds 
vipan2011 is disconnected 
Manco2010 is disconnected 
BMRB1991: folds 
kboskov123: calls $0.02
Scaaalll: raises $0.07 to $0.09
Earl_greyPL: folds 
kboskov123: folds 
Uncalled bet ($0.07) returned to Scaaalll
Scaaalll collected $0.06 from pot
Scaaalll: doesn't show hand 
*** SUMMARY ***
Total pot $0.06 | Rake $0 
Seat 1: kboskov123 (button) folded before Flop
Seat 2: Scaaalll (small blind) collected ($0.06)
Seat 3: Earl_greyPL (big blind) folded before Flop
Seat 4: Manco2010 folded before Flop (didn't bet)
Seat 5: vipan2011 folded before Flop (didn't bet)
Seat 6: BMRB1991 folded before Flop (didn't bet)



PokerStars Zoom Hand #229232670128:  Hold'em No Limit ($0.01/$0.02) - 2021/08/21 23:00:26 CET [2021/08/21 17:00:26 ET]
Table 'Halley' 6-max Seat #1 is the button
Seat 1: Apollonnn_13 ($1.82 in chips) 
Seat 2: XaMpLEr ($2.01 in chips) 
Seat 3: udav26 ($2.28 in chips) 
Seat 4: Sinad1302 ($1.86 in chips) 
Seat 5: Scaaalll ($2.53 in chips) 
Seat 6: Sharabora ($1.16 in chips) 
XaMpLEr: posts small blind $0.01
udav26: posts big blind $0.02
*** HOLE CARDS ***
Dealt to Scaaalll [6s Qs]
Sinad1302: raises $0.04 to $0.06
Scaaalll: folds 
Sharabora: folds 
Apollonnn_13: folds 
XaMpLEr: folds 
udav26: folds 
Uncalled bet ($0.04) returned to Sinad1302
Sinad1302 collected $0.05 from pot
Sinad1302: doesn't show hand 
*** SUMMARY ***
Total pot $0.05 | Rake $0 
Seat 1: Apollonnn_13 (button) folded before Flop (didn't bet)
Seat 2: XaMpLEr (small blind) folded before Flop
Seat 3: udav26 (big blind) folded before Flop
Seat 4: Sinad1302 collected ($0.05)
Seat 5: Scaaalll folded before Flop (didn't bet)
Seat 6: Sharabora folded before Flop (didn't bet)



PokerStars Zoom Hand #229232663344:  Hold'em No Limit ($0.01/$0.02) - 2021/08/21 23:00:06 CET [2021/08/21 17:00:06 ET]
Table 'Halley' 6-max Seat #1 is the button
Seat 1: Xlavariable ($2 in chips) 
Seat 2: lucksuckdonk ($4.39 in chips) 
Seat 3: Scaaalll ($2.55 in chips) 
Seat 4: MattieBOZ ($2 in chips) 
Seat 5: Koldun 2636 ($2.84 in chips) 
Seat 6: CordiPS ($5.23 in chips) 
lucksuckdonk: posts small blind $0.01
Scaaalll: posts big blind $0.02
*** HOLE CARDS ***
Dealt to Scaaalll [Tc 2s]
MattieBOZ: calls $0.02
Koldun 2636: calls $0.02
CordiPS: folds 
Xlavariable: raises $0.04 to $0.06
lucksuckdonk: folds 
Scaaalll: folds 
MattieBOZ: calls $0.04
Koldun 2636: calls $0.04
*** FLOP *** [5h Td 7d]
MattieBOZ: checks 
Koldun 2636: checks 
Xlavariable: checks 
*** TURN *** [5h Td 7d] [2c]
MattieBOZ: checks 
Koldun 2636: bets $0.12
Xlavariable: folds 
MattieBOZ: folds 
Uncalled bet ($0.12) returned to Koldun 2636
Koldun 2636 collected $0.20 from pot
Koldun 2636: doesn't show hand 
MattieBOZ is disconnected 
*** SUMMARY ***
Total pot $0.21 | Rake $0.01 
Board [5h Td 7d 2c]
Seat 1: Xlavariable (button) folded on the Turn
Seat 2: lucksuckdonk (small blind) folded before Flop
Seat 3: Scaaalll (big blind) folded before Flop
Seat 4: MattieBOZ folded on the Turn
Seat 5: Koldun 2636 collected ($0.20)
Seat 6: CordiPS folded before Flop (didn't bet)



PokerStars Zoom Hand #229232677947:  Hold'em No Limit ($0.01/$0.02) - 2021/08/21 23:00:48 CET [2021/08/21 17:00:48 ET]
Table 'Halley' 6-max Seat #1 is the button
Seat 1: squidy4 ($1.83 in chips) 
Seat 2: San4oWV ($2.28 in chips) 
Seat 3: slipknot956 ($2.31 in chips) 
Seat 4: golfffffer ($0.62 in chips) 
Seat 5: Scaaalll ($2.53 in chips) 
Seat 6: zaharoff74 ($2.09 in chips) 
San4oWV: posts small blind $0.01
slipknot956: posts big blind $0.02
*** HOLE CARDS ***
Dealt to Scaaalll [Ah Td]
golfffffer: folds 
golfffffer is disconnected 
Scaaalll has timed out
Scaaalll: folds 
zaharoff74: folds 
squidy4: raises $0.05 to $0.07
San4oWV: folds 
slipknot956: folds 
Uncalled bet ($0.05) returned to squidy4
squidy4 collected $0.05 from pot
squidy4: doesn't show hand 
*** SUMMARY ***
Total pot $0.05 | Rake $0 
Seat 1: squidy4 (button) collected ($0.05)
Seat 2: San4oWV (small blind) folded before Flop
Seat 3: slipknot956 (big blind) folded before Flop
Seat 4: golfffffer folded before Flop (didn't bet)
Seat 5: Scaaalll folded before Flop (didn't bet)
Seat 6: zaharoff74 folded before Flop (didn't bet)



PokerStars Zoom Hand #229232674638:  Hold'em No Limit ($0.01/$0.02) - 2021/08/21 23:00:39 CET [2021/08/21 17:00:39 ET]
Table 'Halley' 6-max Seat #1 is the button
Seat 1: Scaaalll ($2.53 in chips) 
Seat 2: TTGemi ($2.09 in chips) 
Seat 3: rpycmbEM ($5.47 in chips) 
Seat 4: PapiMik3 ($5.95 in chips) 
Seat 5: tuolau ($4.12 in chips) 
Seat 6: juraa14 ($2.99 in chips) 
TTGemi: posts small blind $0.01
rpycmbEM: posts big blind $0.02
*** HOLE CARDS ***
Dealt to Scaaalll [4s 3s]
PapiMik3: folds 
tuolau: raises $0.04 to $0.06
juraa14: folds 
Scaaalll: folds 
TTGemi: raises $0.18 to $0.24
rpycmbEM: folds 
tuolau: calls $0.18
*** FLOP *** [8h Th Kc]
TTGemi: checks 
tuolau: bets $0.24
TTGemi: folds 
Uncalled bet ($0.24) returned to tuolau
tuolau collected $0.48 from pot
tuolau: doesn't show hand 
*** SUMMARY ***
Total pot $0.50 | Rake $0.02 
Board [8h Th Kc]
Seat 1: Scaaalll (button) folded before Flop (didn't bet)
Seat 2: TTGemi (small blind) folded on the Flop
Seat 3: rpycmbEM (big blind) folded before Flop
Seat 4: PapiMik3 folded before Flop (didn't bet)
Seat 5: tuolau collected ($0.48)
Seat 6: juraa14 folded before Flop (didn't bet)



PokerStars Zoom Hand #229232685483:  Hold'em No Limit ($0.01/$0.02) - 2021/08/21 23:01:07 CET [2021/08/21 17:01:07 ET]
Table 'Halley' 6-max Seat #1 is the button
Seat 1: Richaud ($2.14 in chips) 
Seat 2: Scaaalll ($2.53 in chips) 
Seat 3: NoEff0rt2w1n ($2 in chips) 
Seat 4: REDCOBRA 1 ($0.56 in chips) 
Seat 5: PapiMik3 ($6.63 in chips) 
Seat 6: pipecmolodec ($2.12 in chips) 
Scaaalll: posts small blind $0.01
NoEff0rt2w1n: posts big blind $0.02
*** HOLE CARDS ***
Dealt to Scaaalll [7c 4c]
REDCOBRA 1: folds 
PapiMik3: folds 
REDCOBRA 1 is disconnected 
pipecmolodec: raises $0.02 to $0.04
Richaud: folds 
Scaaalll: folds 
NoEff0rt2w1n: folds 
Uncalled bet ($0.02) returned to pipecmolodec
pipecmolodec collected $0.05 from pot
pipecmolodec: doesn't show hand 
*** SUMMARY ***
Total pot $0.05 | Rake $0 
Seat 1: Richaud (button) folded before Flop (didn't bet)
Seat 2: Scaaalll (small blind) folded before Flop
Seat 3: NoEff0rt2w1n (big blind) folded before Flop
Seat 4: REDCOBRA 1 folded before Flop (didn't bet)
Seat 5: PapiMik3 folded before Flop (didn't bet)
Seat 6: pipecmolodec collected ($0.05)



PokerStars Zoom Hand #229232689649:  Hold'em No Limit ($0.01/$0.02) - 2021/08/21 23:01:17 CET [2021/08/21 17:01:17 ET]
Table 'Halley' 6-max Seat #1 is the button
Seat 1: Vanekakqj ($1.77 in chips) 
Seat 2: Gamer577 ($2.12 in chips) 
Seat 3: Scaaalll ($2.52 in chips) 
Seat 4: San4oWV ($2.25 in chips) 
Seat 5: ChowMangao ($4.33 in chips) 
Seat 6: eastcoast777 ($0.89 in chips) 
Gamer577: posts small blind $0.01
Scaaalll: posts big blind $0.02
*** HOLE CARDS ***
Dealt to Scaaalll [Ks 7h]
San4oWV: folds 
ChowMangao: folds 
eastcoast777: calls $0.02
Vanekakqj: folds 
Gamer577: folds 
Scaaalll: checks 
*** FLOP *** [Qh 4d 5c]
Scaaalll: checks 
eastcoast777: checks 
*** TURN *** [Qh 4d 5c] [3d]
Scaaalll: checks 
eastcoast777: checks 
*** RIVER *** [Qh 4d 5c 3d] [Qd]
Scaaalll: checks 
eastcoast777: checks 
*** SHOW DOWN ***
Scaaalll: shows [Ks 7h] (a pair of Queens)
eastcoast777: mucks hand 
Scaaalll collected $0.05 from pot
*** SUMMARY ***
Total pot $0.05 | Rake $0 
Board [Qh 4d 5c 3d Qd]
Seat 1: Vanekakqj (button) folded before Flop (didn't bet)
Seat 2: Gamer577 (small blind) folded before Flop
Seat 3: Scaaalll (big blind) showed [Ks 7h] and won ($0.05) with a pair of Queens
Seat 4: San4oWV folded before Flop (didn't bet)
Seat 5: ChowMangao folded before Flop (didn't bet)
Seat 6: eastcoast777 mucked [Jd Tc]



PokerStars Zoom Hand #229232707531:  Hold'em No Limit ($0.01/$0.02) - 2021/08/21 23:02:00 CET [2021/08/21 17:02:00 ET]
Table 'Halley' 6-max Seat #1 is the button
Seat 1: twiti174 ($1.61 in chips) 
Seat 2: astapowitsch ($2 in chips) 
Seat 3: Sergio Rigel ($3.41 in chips) 
Seat 4: Scaaalll ($2.55 in chips) 
Seat 5: Earl_greyPL ($1.45 in chips) 
Seat 6: PEDACIT0 ($2.56 in chips) 
astapowitsch: posts small blind $0.01
Sergio Rigel: posts big blind $0.02
*** HOLE CARDS ***
Dealt to Scaaalll [Jc Ks]
twiti174 is disconnected 
Scaaalll: raises $0.04 to $0.06
Earl_greyPL: folds 
PEDACIT0: folds 
twiti174: folds 
astapowitsch: folds 
Sergio Rigel: folds 
Uncalled bet ($0.04) returned to Scaaalll
Scaaalll collected $0.05 from pot
Scaaalll: doesn't show hand 
*** SUMMARY ***
Total pot $0.05 | Rake $0 
Seat 1: twiti174 (button) folded before Flop (didn't bet)
Seat 2: astapowitsch (small blind) folded before Flop
Seat 3: Sergio Rigel (big blind) folded before Flop
Seat 4: Scaaalll collected ($0.05)
Seat 5: Earl_greyPL folded before Flop (didn't bet)
Seat 6: PEDACIT0 folded before Flop (didn't bet)



PokerStars Zoom Hand #229232705548:  Hold'em No Limit ($0.01/$0.02) - 2021/08/21 23:01:55 CET [2021/08/21 17:01:55 ET]
Table 'Halley' 6-max Seat #1 is the button
Seat 1: punkosk8 ($1.82 in chips) 
Seat 2: Umnik_M ($1.94 in chips) 
Seat 3: F_oksi(BLR) ($4.31 in chips) 
Seat 4: sg.32rus ($1.52 in chips) 
Seat 5: fishh_play ($3.02 in chips) 
Seat 6: Scaaalll ($2.55 in chips) 
Umnik_M: posts small blind $0.01
F_oksi(BLR): posts big blind $0.02
*** HOLE CARDS ***
Dealt to Scaaalll [Js 8d]
sg.32rus: folds 
fishh_play: folds 
Scaaalll: folds 
punkosk8: raises $0.04 to $0.06
Umnik_M: folds 
F_oksi(BLR): calls $0.04
*** FLOP *** [Qh 8c 2h]
F_oksi(BLR): checks 
punkosk8: bets $0.08
F_oksi(BLR): folds 
Uncalled bet ($0.08) returned to punkosk8
punkosk8 collected $0.13 from pot
punkosk8: doesn't show hand 
*** SUMMARY ***
Total pot $0.13 | Rake $0 
Board [Qh 8c 2h]
Seat 1: punkosk8 (button) collected ($0.13)
Seat 2: Umnik_M (small blind) folded before Flop
Seat 3: F_oksi(BLR) (big blind) folded on the Flop
Seat 4: sg.32rus folded before Flop (didn't bet)
Seat 5: fishh_play folded before Flop (didn't bet)
Seat 6: Scaaalll folded before Flop (didn't bet)



PokerStars Zoom Hand #229232718443:  Hold'em No Limit ($0.01/$0.02) - 2021/08/21 23:02:25 CET [2021/08/21 17:02:25 ET]
Table 'Halley' 6-max Seat #1 is the button
Seat 1: Chapaev136 ($6.06 in chips) 
Seat 2: RrriotGrrrl ($6.29 in chips) 
Seat 3: Apollonnn_13 ($2.18 in chips) 
Seat 4: PapiMik3 ($5.76 in chips) 
Seat 5: Scaaalll ($2.58 in chips) 
Seat 6: vovo4kapooh ($2.24 in chips) 
RrriotGrrrl: posts small blind $0.01
Apollonnn_13: posts big blind $0.02
*** HOLE CARDS ***
Dealt to Scaaalll [Qh 5h]
PapiMik3: folds 
Scaaalll: folds 
vovo4kapooh: raises $0.03 to $0.05
Chapaev136: folds 
RrriotGrrrl: folds 
Apollonnn_13: folds 
Uncalled bet ($0.03) returned to vovo4kapooh
vovo4kapooh collected $0.05 from pot
vovo4kapooh: doesn't show hand 
*** SUMMARY ***
Total pot $0.05 | Rake $0 
Seat 1: Chapaev136 (button) folded before Flop (didn't bet)
Seat 2: RrriotGrrrl (small blind) folded before Flop
Seat 3: Apollonnn_13 (big blind) folded before Flop
Seat 4: PapiMik3 folded before Flop (didn't bet)
Seat 5: Scaaalll folded before Flop (didn't bet)
Seat 6: vovo4kapooh collected ($0.05)



PokerStars Zoom Hand #229232715405:  Hold'em No Limit ($0.01/$0.02) - 2021/08/21 23:02:18 CET [2021/08/21 17:02:18 ET]
Table 'Halley' 6-max Seat #1 is the button
Seat 1: znak312 ($2.04 in chips) 
Seat 2: alphabeta1d ($2 in chips) 
Seat 3: Astel88 ($2.59 in chips) 
Seat 4: CrazyyParis ($2 in chips) 
Seat 5: Koldun 2636 ($2.86 in chips) 
Seat 6: Scaaalll ($2.58 in chips) 
alphabeta1d: posts small blind $0.01
Astel88: posts big blind $0.02
*** HOLE CARDS ***
Dealt to Scaaalll [2h Jd]
CrazyyParis: folds 
Koldun 2636: folds 
Scaaalll: folds 
znak312: folds 
alphabeta1d: folds 
Uncalled bet ($0.01) returned to Astel88
Astel88 collected $0.02 from pot
Astel88: doesn't show hand 
*** SUMMARY ***
Total pot $0.02 | Rake $0 
Seat 1: znak312 (button) folded before Flop (didn't bet)
Seat 2: alphabeta1d (small blind) folded before Flop
Seat 3: Astel88 (big blind) collected ($0.02)
Seat 4: CrazyyParis folded before Flop (didn't bet)
Seat 5: Koldun 2636 folded before Flop (didn't bet)
Seat 6: Scaaalll folded before Flop (didn't bet)



PokerStars Zoom Hand #229232720165:  Hold'em No Limit ($0.01/$0.02) - 2021/08/21 23:02:29 CET [2021/08/21 17:02:29 ET]
Table 'Halley' 6-max Seat #1 is the button
Seat 1: YGrandmaster ($3.02 in chips) 
Seat 2: tittenholmes ($2.68 in chips) 
Seat 3: Scaaalll ($2.58 in chips) 
Seat 4: RrriotGrrrl ($6.28 in chips) 
Seat 5: rodrigoasor ($3.13 in chips) 
Seat 6: rpycmbEM ($3.25 in chips) 
tittenholmes: posts small blind $0.01
Scaaalll: posts big blind $0.02
*** HOLE CARDS ***
Dealt to Scaaalll [4d 2c]
RrriotGrrrl: raises $0.04 to $0.06
rodrigoasor: folds 
rpycmbEM: folds 
YGrandmaster: folds 
YGrandmaster is disconnected 
tittenholmes: folds 
Scaaalll: folds 
Uncalled bet ($0.04) returned to RrriotGrrrl
RrriotGrrrl collected $0.05 from pot
RrriotGrrrl: doesn't show hand 
*** SUMMARY ***
Total pot $0.05 | Rake $0 
Seat 1: YGrandmaster (button) folded before Flop (didn't bet)
Seat 2: tittenholmes (small blind) folded before Flop
Seat 3: Scaaalll (big blind) folded before Flop
Seat 4: RrriotGrrrl collected ($0.05)
Seat 5: rodrigoasor folded before Flop (didn't bet)
Seat 6: rpycmbEM folded before Flop (didn't bet)



PokerStars Zoom Hand #229232717091:  Hold'em No Limit ($0.01/$0.02) - 2021/08/21 23:02:22 CET [2021/08/21 17:02:22 ET]
Table 'Halley' 6-max Seat #1 is the button
Seat 1: Scaaalll ($2.58 in chips) 
Seat 2: orlovac1995 ($4.04 in chips) 
Seat 3: OmahaWheels ($4.22 in chips) 
Seat 4: Gamer577 ($2.11 in chips) 
Seat 5: boysDcrye ($2.04 in chips) 
Seat 6: giselerebelo ($3.09 in chips) 
orlovac1995: posts small blind $0.01
OmahaWheels: posts big blind $0.02
*** HOLE CARDS ***
Dealt to Scaaalll [6h 3s]
Gamer577: folds 
boysDcrye: raises $0.04 to $0.06
giselerebelo: raises $0.08 to $0.14
Scaaalll: folds 
orlovac1995: folds 
OmahaWheels: folds 
boysDcrye: calls $0.08
*** FLOP *** [Ad 7h Ts]
boysDcrye: bets $0.15
giselerebelo: calls $0.15
*** TURN *** [Ad 7h Ts] [9h]
boysDcrye: checks 
giselerebelo: checks 
*** RIVER *** [Ad 7h Ts 9h] [4s]
boysDcrye: checks 
giselerebelo: checks 
*** SHOW DOWN ***
boysDcrye: shows [Ah 8s] (a pair of Aces)
giselerebelo: mucks hand 
boysDcrye collected $0.59 from pot
*** SUMMARY ***
Total pot $0.61 | Rake $0.02 
Board [Ad 7h Ts 9h 4s]
Seat 1: Scaaalll (button) folded before Flop (didn't bet)
Seat 2: orlovac1995 (small blind) folded before Flop
Seat 3: OmahaWheels (big blind) folded before Flop
Seat 4: Gamer577 folded before Flop (didn't bet)
Seat 5: boysDcrye showed [Ah 8s] and won ($0.59) with a pair of Aces
Seat 6: giselerebelo mucked [Kh Kd]



PokerStars Zoom Hand #229232731533:  Hold'em No Limit ($0.01/$0.02) - 2021/08/21 23:02:55 CET [2021/08/21 17:02:55 ET]
Table 'Halley' 6-max Seat #1 is the button
Seat 1: Colby1771 ($3.65 in chips) 
Seat 2: Scaaalll ($2.56 in chips) 
Seat 3: pavlo8855 ($2 in chips) 
Seat 4: HDYD18 ($5.41 in chips) 
Seat 5: castrosis ($2 in chips) 
Seat 6: Bol'tazar111 ($3.79 in chips) 
Scaaalll: posts small blind $0.01
pavlo8855: posts big blind $0.02
*** HOLE CARDS ***
Dealt to Scaaalll [4s Js]
HDYD18: folds 
castrosis: folds 
Bol'tazar111: folds 
Colby1771: raises $0.04 to $0.06
Scaaalll: folds 
pavlo8855: folds 
Uncalled bet ($0.04) returned to Colby1771
Colby1771 collected $0.05 from pot
Colby1771: doesn't show hand 
*** SUMMARY ***
Total pot $0.05 | Rake $0 
Seat 1: Colby1771 (button) collected ($0.05)
Seat 2: Scaaalll (small blind) folded before Flop
Seat 3: pavlo8855 (big blind) folded before Flop
Seat 4: HDYD18 folded before Flop (didn't bet)
Seat 5: castrosis folded before Flop (didn't bet)
Seat 6: Bol'tazar111 folded before Flop (didn't bet)



PokerStars Zoom Hand #229232739375:  Hold'em No Limit ($0.01/$0.02) - 2021/08/21 23:03:13 CET [2021/08/21 17:03:13 ET]
Table 'Halley' 6-max Seat #1 is the button
Seat 1: Scaaalll ($2.55 in chips) 
Seat 2: JaguarAndy17 ($1.68 in chips) 
Seat 3: maressen ($2.11 in chips) 
Seat 4: so0love ($7.17 in chips) 
Seat 5: davidalejag ($2.93 in chips) 
Seat 6: Posaunengodi ($2 in chips) 
JaguarAndy17: posts small blind $0.01
maressen: posts big blind $0.02
*** HOLE CARDS ***
Dealt to Scaaalll [7d Qs]
so0love has timed out
so0love: folds 
davidalejag: folds 
Posaunengodi: folds 
Scaaalll: folds 
JaguarAndy17: raises $0.03 to $0.05
maressen: folds 
Uncalled bet ($0.03) returned to JaguarAndy17
JaguarAndy17 collected $0.04 from pot
JaguarAndy17: doesn't show hand 
*** SUMMARY ***
Total pot $0.04 | Rake $0 
Seat 1: Scaaalll (button) folded before Flop (didn't bet)
Seat 2: JaguarAndy17 (small blind) collected ($0.04)
Seat 3: maressen (big blind) folded before Flop
Seat 4: so0love folded before Flop (didn't bet)
Seat 5: davidalejag folded before Flop (didn't bet)
Seat 6: Posaunengodi folded before Flop (didn't bet)



PokerStars Zoom Hand #229232748627:  Hold'em No Limit ($0.01/$0.02) - 2021/08/21 23:03:34 CET [2021/08/21 17:03:34 ET]
Table 'Halley' 6-max Seat #1 is the button
Seat 1: Hallyson_23 ($4.90 in chips) 
Seat 2: Koldun 2636 ($4.05 in chips) 
Seat 3: snowpepsi ($2.31 in chips) 
Seat 4: Scaaalll ($2.55 in chips) 
Seat 5: ciucibaby ($3.76 in chips) 
Seat 6: Caabz ($3.63 in chips) 
Koldun 2636: posts small blind $0.01
snowpepsi: posts big blind $0.02
*** HOLE CARDS ***
Dealt to Scaaalll [3h 6d]
Scaaalll: folds 
ciucibaby: raises $0.03 to $0.05
Caabz: folds 
Hallyson_23: folds 
Koldun 2636: folds 
snowpepsi: folds 
Uncalled bet ($0.03) returned to ciucibaby
ciucibaby collected $0.05 from pot
ciucibaby: doesn't show hand 
*** SUMMARY ***
Total pot $0.05 | Rake $0 
Seat 1: Hallyson_23 (button) folded before Flop (didn't bet)
Seat 2: Koldun 2636 (small blind) folded before Flop
Seat 3: snowpepsi (big blind) folded before Flop
Seat 4: Scaaalll folded before Flop (didn't bet)
Seat 5: ciucibaby collected ($0.05)
Seat 6: Caabz folded before Flop (didn't bet)



PokerStars Zoom Hand #229232742477:  Hold'em No Limit ($0.01/$0.02) - 2021/08/21 23:03:20 CET [2021/08/21 17:03:20 ET]
Table 'Halley' 6-max Seat #1 is the button
Seat 1: RChinenov ($2.25 in chips) 
Seat 2: gasmar_29 ($2 in chips) 
Seat 3: Koldun 2636 ($2.94 in chips) 
Seat 4: Scaaalll ($2.55 in chips) 
Seat 5: gilberto98 ($2.81 in chips) 
Seat 6: Treadero ($3.79 in chips) 
gasmar_29: posts small blind $0.01
Koldun 2636: posts big blind $0.02
*** HOLE CARDS ***
Dealt to Scaaalll [4c Ks]
Scaaalll: folds 
gilberto98: folds 
Treadero: folds 
RChinenov: folds 
gasmar_29: raises $0.04 to $0.06
Koldun 2636: calls $0.04
*** FLOP *** [Jc 2h Qh]
gasmar_29: checks 
Koldun 2636: checks 
*** TURN *** [Jc 2h Qh] [2d]
gasmar_29: checks 
Koldun 2636: checks 
*** RIVER *** [Jc 2h Qh 2d] [6c]
gasmar_29: checks 
Koldun 2636: checks 
*** SHOW DOWN ***
gasmar_29: shows [Kc Ts] (a pair of Deuces)
Koldun 2636: mucks hand 
gasmar_29 collected $0.12 from pot
*** SUMMARY ***
Total pot $0.12 | Rake $0 
Board [Jc 2h Qh 2d 6c]
Seat 1: RChinenov (button) folded before Flop (didn't bet)
Seat 2: gasmar_29 (small blind) showed [Kc Ts] and won ($0.12) with a pair of Deuces
Seat 3: Koldun 2636 (big blind) mucked [9d 8d]
Seat 4: Scaaalll folded before Flop (didn't bet)
Seat 5: gilberto98 folded before Flop (didn't bet)
Seat 6: Treadero folded before Flop (didn't bet)



PokerStars Zoom Hand #229232744234:  Hold'em No Limit ($0.01/$0.02) - 2021/08/21 23:03:24 CET [2021/08/21 17:03:24 ET]
Table 'Halley' 6-max Seat #1 is the button
Seat 1: fishh_play ($2.65 in chips) 
Seat 2: KonopDima ($2.16 in chips) 
Seat 3: keb1981 ($2.04 in chips) 
Seat 4: RChinenov ($2.25 in chips) 
Seat 5: Scaaalll ($2.55 in chips) 
Seat 6: Peimievvt ($2.27 in chips) 
KonopDima: posts small blind $0.01
keb1981: posts big blind $0.02
*** HOLE CARDS ***
Dealt to Scaaalll [9c 4d]
RChinenov: raises $0.04 to $0.06
Scaaalll: folds 
Peimievvt: calls $0.06
fishh_play: folds 
KonopDima: calls $0.05
keb1981: calls $0.04
*** FLOP *** [Jc 4s 5h]
KonopDima: checks 
keb1981: bets $0.12
RChinenov: folds 
Peimievvt: folds 
KonopDima: folds 
Uncalled bet ($0.12) returned to keb1981
keb1981 collected $0.23 from pot
keb1981: doesn't show hand 
*** SUMMARY ***
Total pot $0.24 | Rake $0.01 
Board [Jc 4s 5h]
Seat 1: fishh_play (button) folded before Flop (didn't bet)
Seat 2: KonopDima (small blind) folded on the Flop
Seat 3: keb1981 (big blind) collected ($0.23)
Seat 4: RChinenov folded on the Flop
Seat 5: Scaaalll folded before Flop (didn't bet)
Seat 6: Peimievvt folded on the Flop



PokerStars Zoom Hand #229232754870:  Hold'em No Limit ($0.01/$0.02) - 2021/08/21 23:03:48 CET [2021/08/21 17:03:48 ET]
Table 'Halley' 6-max Seat #1 is the button
Seat 1: tittenholmes ($2.64 in chips) 
Seat 2: Scaaalll ($2.53 in chips) 
Seat 3: cr@sh test ($5.42 in chips) 
Seat 4: Keltu :D ($5.42 in chips) 
Seat 5: Ogni ($5.47 in chips) 
Seat 6: Apollonnn_13 ($1.67 in chips) 
Scaaalll: posts small blind $0.01
cr@sh test: posts big blind $0.02
*** HOLE CARDS ***
Dealt to Scaaalll [Kc 7h]
Keltu :D: folds 
Ogni: folds 
Apollonnn_13: raises $0.04 to $0.06
tittenholmes: folds 
Scaaalll: folds 
cr@sh test: folds 
Uncalled bet ($0.04) returned to Apollonnn_13
Apollonnn_13 collected $0.05 from pot
Apollonnn_13: doesn't show hand 
*** SUMMARY ***
Total pot $0.05 | Rake $0 
Seat 1: tittenholmes (button) folded before Flop (didn't bet)
Seat 2: Scaaalll (small blind) folded before Flop
Seat 3: cr@sh test (big blind) folded before Flop
Seat 4: Keltu :D folded before Flop (didn't bet)
Seat 5: Ogni folded before Flop (didn't bet)
Seat 6: Apollonnn_13 collected ($0.05)



PokerStars Zoom Hand #229232757465:  Hold'em No Limit ($0.01/$0.02) - 2021/08/21 23:03:54 CET [2021/08/21 17:03:54 ET]
Table 'Halley' 6-max Seat #1 is the button
Seat 1: Scaaalll ($2.52 in chips) 
Seat 2: MattieBOZ ($1.84 in chips) 
Seat 3: RChinenov ($2.19 in chips) 
Seat 4: Umnik_M ($1.90 in chips) 
Seat 5: BlackhawKK's ($3.25 in chips) 
Seat 6: Yangyang1407 ($2.05 in chips) 
MattieBOZ: posts small blind $0.01
RChinenov: posts big blind $0.02
*** HOLE CARDS ***
Dealt to Scaaalll [8d 4c]
Umnik_M: folds 
BlackhawKK's: folds 
Yangyang1407: folds 
Scaaalll: folds 
MattieBOZ: folds 
Uncalled bet ($0.01) returned to RChinenov
RChinenov collected $0.02 from pot
RChinenov: doesn't show hand 
MattieBOZ is disconnected 
*** SUMMARY ***
Total pot $0.02 | Rake $0 
Seat 1: Scaaalll (button) folded before Flop (didn't bet)
Seat 2: MattieBOZ (small blind) folded before Flop
Seat 3: RChinenov (big blind) collected ($0.02)
Seat 4: Umnik_M folded before Flop (didn't bet)
Seat 5: BlackhawKK's folded before Flop (didn't bet)
Seat 6: Yangyang1407 folded before Flop (didn't bet)



PokerStars Zoom Hand #229232750429:  Hold'em No Limit ($0.01/$0.02) - 2021/08/21 23:03:38 CET [2021/08/21 17:03:38 ET]
Table 'Halley' 6-max Seat #1 is the button
Seat 1: WITKOW_AV ($2 in chips) 
Seat 2: olga3021221 ($2.34 in chips) 
Seat 3: Scaaalll ($2.55 in chips) 
Seat 4: Gamer577 ($2.10 in chips) 
Seat 5: simensgh ($7.09 in chips) 
Seat 6: joeomeara ($1.87 in chips) 
olga3021221: posts small blind $0.01
Scaaalll: posts big blind $0.02
*** HOLE CARDS ***
Dealt to Scaaalll [5h 8c]
Gamer577: folds 
simensgh: raises $0.03 to $0.05
joeomeara: calls $0.05
WITKOW_AV: folds 
olga3021221: folds 
Scaaalll: folds 
*** FLOP *** [Td Ts Ks]
simensgh: bets $0.08
joeomeara: calls $0.08
*** TURN *** [Td Ts Ks] [8h]
simensgh: checks 
joeomeara: checks 
*** RIVER *** [Td Ts Ks 8h] [4d]
simensgh: checks 
joeomeara: checks 
*** SHOW DOWN ***
simensgh: shows [9s 7s] (a pair of Tens)
joeomeara: shows [9h As] (a pair of Tens - Ace kicker)
joeomeara collected $0.28 from pot
*** SUMMARY ***
Total pot $0.29 | Rake $0.01 
Board [Td Ts Ks 8h 4d]
Seat 1: WITKOW_AV (button) folded before Flop (didn't bet)
Seat 2: olga3021221 (small blind) folded before Flop
Seat 3: Scaaalll (big blind) folded before Flop
Seat 4: Gamer577 folded before Flop (didn't bet)
Seat 5: simensgh showed [9s 7s] and lost with a pair of Tens
Seat 6: joeomeara showed [9h As] and won ($0.28) with a pair of Tens



PokerStars Zoom Hand #229232759265:  Hold'em No Limit ($0.01/$0.02) - 2021/08/21 23:03:58 CET [2021/08/21 17:03:58 ET]
Table 'Halley' 6-max Seat #1 is the button
Seat 1: Espartacus5222 ($5.23 in chips) 
Seat 2: Mikeloko182 ($2 in chips) 
Seat 3: sinkthe8 ($0.27 in chips) 
Seat 4: AbusiveLion ($3.55 in chips) 
Seat 5: causavera ($1.16 in chips) 
Seat 6: Scaaalll ($2.52 in chips) 
Mikeloko182: posts small blind $0.01
sinkthe8: posts big blind $0.02
*** HOLE CARDS ***
Dealt to Scaaalll [8d 3d]
AbusiveLion: raises $0.02 to $0.04
causavera: folds 
Scaaalll has timed out
Scaaalll: folds 
Espartacus5222: raises $0.14 to $0.18
Mikeloko182: folds 
sinkthe8: folds 
sinkthe8 is disconnected 
AbusiveLion: folds 
Uncalled bet ($0.14) returned to Espartacus5222
Espartacus5222 collected $0.11 from pot
Espartacus5222: doesn't show hand 
AbusiveLion is disconnected 
*** SUMMARY ***
Total pot $0.11 | Rake $0 
Seat 1: Espartacus5222 (button) collected ($0.11)
Seat 2: Mikeloko182 (small blind) folded before Flop
Seat 3: sinkthe8 (big blind) folded before Flop
Seat 4: AbusiveLion folded before Flop
Seat 5: causavera folded before Flop (didn't bet)
Seat 6: Scaaalll folded before Flop (didn't bet)



PokerStars Zoom Hand #229232773301:  Hold'em No Limit ($0.01/$0.02) - 2021/08/21 23:04:30 CET [2021/08/21 17:04:30 ET]
Table 'Halley' 6-max Seat #1 is the button
Seat 1: zaharoff74 ($2.10 in chips) 
Seat 2: chigilaci ($5.15 in chips) 
Seat 3: tittenholmes ($2.60 in chips) 
Seat 4: Chapaev136 ($5.91 in chips) 
Seat 5: Kb013497 ($2.80 in chips) 
Seat 6: Scaaalll ($2.52 in chips) 
chigilaci: posts small blind $0.01
tittenholmes: posts big blind $0.02
*** HOLE CARDS ***
Dealt to Scaaalll [9h Qh]
Chapaev136: folds 
Kb013497: folds 
Scaaalll: raises $0.04 to $0.06
zaharoff74: folds 
chigilaci: folds 
tittenholmes: folds 
Uncalled bet ($0.04) returned to Scaaalll
Scaaalll collected $0.05 from pot
Scaaalll: doesn't show hand 
*** SUMMARY ***
Total pot $0.05 | Rake $0 
Seat 1: zaharoff74 (button) folded before Flop (didn't bet)
Seat 2: chigilaci (small blind) folded before Flop
Seat 3: tittenholmes (big blind) folded before Flop
Seat 4: Chapaev136 folded before Flop (didn't bet)
Seat 5: Kb013497 folded before Flop (didn't bet)
Seat 6: Scaaalll collected ($0.05)



PokerStars Zoom Hand #229232771149:  Hold'em No Limit ($0.01/$0.02) - 2021/08/21 23:04:25 CET [2021/08/21 17:04:25 ET]
Table 'Halley' 6-max Seat #1 is the button
Seat 1: xxRoseIloveu ($9.72 in chips) 
Seat 2: KRITAYA ($1.05 in chips) 
Seat 3: NoEff0rt2w1n ($5.66 in chips) 
Seat 4: zaharoff74 ($1.97 in chips) 
Seat 5: Scaaalll ($2.52 in chips) 
Seat 6: kidninja888 ($2.21 in chips) 
KRITAYA: posts small blind $0.01
NoEff0rt2w1n: posts big blind $0.02
*** HOLE CARDS ***
Dealt to Scaaalll [6c Ts]
zaharoff74: folds 
Scaaalll: folds 
kidninja888: raises $0.03 to $0.05
xxRoseIloveu: calls $0.05
KRITAYA: raises $0.15 to $0.20
NoEff0rt2w1n: folds 
kidninja888: calls $0.15
xxRoseIloveu: calls $0.15
*** FLOP *** [6s Ac 5s]
KRITAYA: bets $0.18
kidninja888: calls $0.18
xxRoseIloveu: folds 
*** TURN *** [6s Ac 5s] [6d]
KRITAYA: checks 
kidninja888: bets $0.57
KRITAYA: raises $0.10 to $0.67 and is all-in
kidninja888: calls $0.10
*** RIVER *** [6s Ac 5s 6d] [2d]
*** SHOW DOWN ***
KRITAYA: shows [Qd As] (two pair, Aces and Sixes)
kidninja888: shows [Qs Qc] (two pair, Queens and Sixes)
KRITAYA cashed out the hand for $2.17 | Cash Out Fee $0.02
*** SUMMARY ***
Total pot $2.32 | Rake $0.08 
Board [6s Ac 5s 6d 2d]
Seat 1: xxRoseIloveu (button) folded on the Flop
Seat 2: KRITAYA (small blind) showed [Qd As] and won ($2.24) with two pair, Aces and Sixes (pot not awarded as player cashed out)
Seat 3: NoEff0rt2w1n (big blind) folded before Flop
Seat 4: zaharoff74 folded before Flop (didn't bet)
Seat 5: Scaaalll folded before Flop (didn't bet)
Seat 6: kidninja888 showed [Qs Qc] and lost with two pair, Queens and Sixes



PokerStars Zoom Hand #229232790855:  Hold'em No Limit ($0.01/$0.02) - 2021/08/21 23:05:10 CET [2021/08/21 17:05:10 ET]
Table 'Halley' 6-max Seat #1 is the button
Seat 1: tittenholmes ($2.57 in chips) 
Seat 2: dinoVIEIRA ($2 in chips) 
Seat 3: Scaaalll ($2.55 in chips) 
Seat 4: lucksuckdonk ($3.98 in chips) 
Seat 5: Keltu :D ($2.03 in chips) 
Seat 6: Ck@tih@ ($1.59 in chips) 
dinoVIEIRA: posts small blind $0.01
Scaaalll: posts big blind $0.02
*** HOLE CARDS ***
Dealt to Scaaalll [2s Ad]
lucksuckdonk: folds 
Keltu :D: raises $0.03 to $0.05
Ck@tih@: folds 
tittenholmes: folds 
dinoVIEIRA: folds 
Scaaalll: folds 
Uncalled bet ($0.03) returned to Keltu :D
Keltu :D collected $0.05 from pot
Keltu :D: doesn't show hand 
*** SUMMARY ***
Total pot $0.05 | Rake $0 
Seat 1: tittenholmes (button) folded before Flop (didn't bet)
Seat 2: dinoVIEIRA (small blind) folded before Flop
Seat 3: Scaaalll (big blind) folded before Flop
Seat 4: lucksuckdonk folded before Flop (didn't bet)
Seat 5: Keltu :D collected ($0.05)
Seat 6: Ck@tih@ folded before Flop (didn't bet)



PokerStars Zoom Hand #229232789092:  Hold'em No Limit ($0.01/$0.02) - 2021/08/21 23:05:06 CET [2021/08/21 17:05:06 ET]
Table 'Halley' 6-max Seat #1 is the button
Seat 1: fishh_play ($4.96 in chips) 
Seat 2: kumanotiger ($1.63 in chips) 
Seat 3: znak312 ($2 in chips) 
Seat 4: Scaaalll ($2.55 in chips) 
Seat 5: Ne0net ($6.45 in chips) 
Seat 6: bananAAbandit ($7.58 in chips) 
kumanotiger: posts small blind $0.01
znak312: posts big blind $0.02
*** HOLE CARDS ***
Dealt to Scaaalll [Qs 6s]
Scaaalll: folds 
Ne0net: folds 
bananAAbandit: folds 
fishh_play: folds 
kumanotiger: folds 
Uncalled bet ($0.01) returned to znak312
znak312 collected $0.02 from pot
znak312: doesn't show hand 
*** SUMMARY ***
Total pot $0.02 | Rake $0 
Seat 1: fishh_play (button) folded before Flop (didn't bet)
Seat 2: kumanotiger (small blind) folded before Flop
Seat 3: znak312 (big blind) collected ($0.02)
Seat 4: Scaaalll folded before Flop (didn't bet)
Seat 5: Ne0net folded before Flop (didn't bet)
Seat 6: bananAAbandit folded before Flop (didn't bet)



PokerStars Zoom Hand #229232797951:  Hold'em No Limit ($0.01/$0.02) - 2021/08/21 23:05:26 CET [2021/08/21 17:05:26 ET]
Table 'Halley' 6-max Seat #1 is the button
Seat 1: vikasatinova ($1.39 in chips) 
Seat 2: Scaaalll ($2.53 in chips) 
Seat 3: Apollonnn_13 ($1.06 in chips) 
Seat 4: juraa14 ($4.59 in chips) 
Seat 5: cr@sh test ($2.01 in chips) 
Seat 6: gesaes ($1.17 in chips) 
Scaaalll: posts small blind $0.01
Apollonnn_13: posts big blind $0.02
*** HOLE CARDS ***
Dealt to Scaaalll [2s Td]
juraa14: folds 
vikasatinova is disconnected 
cr@sh test: raises $0.04 to $0.06
gesaes: folds 
vikasatinova: folds 
Scaaalll: folds 
Apollonnn_13: folds 
Uncalled bet ($0.04) returned to cr@sh test
cr@sh test collected $0.05 from pot
cr@sh test: doesn't show hand 
*** SUMMARY ***
Total pot $0.05 | Rake $0 
Seat 1: vikasatinova (button) folded before Flop (didn't bet)
Seat 2: Scaaalll (small blind) folded before Flop
Seat 3: Apollonnn_13 (big blind) folded before Flop
Seat 4: juraa14 folded before Flop (didn't bet)
Seat 5: cr@sh test collected ($0.05)
Seat 6: gesaes folded before Flop (didn't bet)



PokerStars Zoom Hand #229232799747:  Hold'em No Limit ($0.01/$0.02) - 2021/08/21 23:05:30 CET [2021/08/21 17:05:30 ET]
Table 'Halley' 6-max Seat #1 is the button
Seat 1: cutter2468 ($2.02 in chips) 
Seat 2: shingo594 ($4.97 in chips) 
Seat 3: nitzed12 ($2.51 in chips) 
Seat 4: anes.v. ($2.28 in chips) 
Seat 5: Scaaalll ($2.52 in chips) 
Seat 6: Healthys07 ($3.51 in chips) 
shingo594: posts small blind $0.01
nitzed12: posts big blind $0.02
*** HOLE CARDS ***
Dealt to Scaaalll [Kh Td]
anes.v.: folds 
Scaaalll: raises $0.04 to $0.06
Healthys07: folds 
cutter2468: folds 
shingo594: folds 
shingo594 is disconnected 
nitzed12: calls $0.04
*** FLOP *** [5s 4s 4h]
nitzed12: checks 
Scaaalll: bets $0.08
nitzed12: raises $0.16 to $0.24
Scaaalll: folds 
Uncalled bet ($0.16) returned to nitzed12
nitzed12 collected $0.28 from pot
nitzed12: doesn't show hand 
*** SUMMARY ***
Total pot $0.29 | Rake $0.01 
Board [5s 4s 4h]
Seat 1: cutter2468 (button) folded before Flop (didn't bet)
Seat 2: shingo594 (small blind) folded before Flop
Seat 3: nitzed12 (big blind) collected ($0.28)
Seat 4: anes.v. folded before Flop (didn't bet)
Seat 5: Scaaalll folded on the Flop
Seat 6: Healthys07 folded before Flop (didn't bet)



PokerStars Zoom Hand #229232817268:  Hold'em No Limit ($0.01/$0.02) - 2021/08/21 23:06:10 CET [2021/08/21 17:06:10 ET]
Table 'Halley' 6-max Seat #1 is the button
Seat 1: Scaaalll ($2.38 in chips) 
Seat 2: gilberto98 ($2.57 in chips) 
Seat 3: zergmiky ($2 in chips) 
Seat 4: Keltu :D ($2.03 in chips) 
Seat 5: NickAlex18 ($2.06 in chips) 
Seat 6: xxVanquishxx ($14.91 in chips) 
gilberto98: posts small blind $0.01
zergmiky: posts big blind $0.02
*** HOLE CARDS ***
Dealt to Scaaalll [7h 6h]
Keltu :D: folds 
NickAlex18: folds 
xxVanquishxx: folds 
Scaaalll: raises $0.02 to $0.04
gilberto98: folds 
zergmiky: folds 
Uncalled bet ($0.02) returned to Scaaalll
Scaaalll collected $0.05 from pot
Scaaalll: doesn't show hand 
*** SUMMARY ***
Total pot $0.05 | Rake $0 
Seat 1: Scaaalll (button) collected ($0.05)
Seat 2: gilberto98 (small blind) folded before Flop
Seat 3: zergmiky (big blind) folded before Flop
Seat 4: Keltu :D folded before Flop (didn't bet)
Seat 5: NickAlex18 folded before Flop (didn't bet)
Seat 6: xxVanquishxx folded before Flop (didn't bet)



PokerStars Zoom Hand #229232823370:  Hold'em No Limit ($0.01/$0.02) - 2021/08/21 23:06:24 CET [2021/08/21 17:06:24 ET]
Table 'Halley' 6-max Seat #1 is the button
Seat 1: Xlavariable ($2.84 in chips) 
Seat 2: FabOliveira9 ($2.41 in chips) 
Seat 3: Peimievvt ($2.40 in chips) 
Seat 4: Phoenixxxxxxxx ($2 in chips) 
Seat 5: gordoatlantico ($4 in chips) 
Seat 6: Scaaalll ($2.41 in chips) 
FabOliveira9: posts small blind $0.01
Peimievvt: posts big blind $0.02
*** HOLE CARDS ***
Dealt to Scaaalll [2c 2h]
Phoenixxxxxxxx: folds 
gordoatlantico: folds 
Scaaalll: raises $0.04 to $0.06
Xlavariable: folds 
FabOliveira9: folds 
Peimievvt: folds 
Uncalled bet ($0.04) returned to Scaaalll
Scaaalll collected $0.05 from pot
Scaaalll: doesn't show hand 
*** SUMMARY ***
Total pot $0.05 | Rake $0 
Seat 1: Xlavariable (button) folded before Flop (didn't bet)
Seat 2: FabOliveira9 (small blind) folded before Flop
Seat 3: Peimievvt (big blind) folded before Flop
Seat 4: Phoenixxxxxxxx folded before Flop (didn't bet)
Seat 5: gordoatlantico folded before Flop (didn't bet)
Seat 6: Scaaalll collected ($0.05)



PokerStars Zoom Hand #229232833388:  Hold'em No Limit ($0.01/$0.02) - 2021/08/21 23:06:47 CET [2021/08/21 17:06:47 ET]
Table 'Halley' 6-max Seat #1 is the button
Seat 1: Hejpåre ($2.11 in chips) 
Seat 2: Habarovs18 ($1.59 in chips) 
Seat 3: Scaaalll ($2.44 in chips) 
Seat 4: Caabz ($3.56 in chips) 
Seat 5: PapiMik3 ($6.27 in chips) 
Seat 6: ARS_POLI13 ($0.47 in chips) 
Habarovs18: posts small blind $0.01
Scaaalll: posts big blind $0.02
*** HOLE CARDS ***
Dealt to Scaaalll [2h 3d]
Caabz: folds 
Habarovs18 is disconnected 
PapiMik3: raises $0.04 to $0.06
ARS_POLI13: folds 
Hejpåre: folds 
Habarovs18: folds 
Scaaalll: folds 
Uncalled bet ($0.04) returned to PapiMik3
PapiMik3 collected $0.05 from pot
PapiMik3: doesn't show hand 
*** SUMMARY ***
Total pot $0.05 | Rake $0 
Seat 1: Hejpåre (button) folded before Flop (didn't bet)
Seat 2: Habarovs18 (small blind) folded before Flop
Seat 3: Scaaalll (big blind) folded before Flop
Seat 4: Caabz folded before Flop (didn't bet)
Seat 5: PapiMik3 collected ($0.05)
Seat 6: ARS_POLI13 folded before Flop (didn't bet)



PokerStars Zoom Hand #229232831619:  Hold'em No Limit ($0.01/$0.02) - 2021/08/21 23:06:43 CET [2021/08/21 17:06:43 ET]
Table 'Halley' 6-max Seat #1 is the button
Seat 1: Scaaalll ($2.44 in chips) 
Seat 2: rabbitmeat73 ($1.56 in chips) 
Seat 3: gilberto98 ($2.56 in chips) 
Seat 4: dinoVIEIRA ($2 in chips) 
Seat 5: BlackhawKK's ($2.57 in chips) 
Seat 6: zergmiky ($2 in chips) 
rabbitmeat73: posts small blind $0.01
gilberto98: posts big blind $0.02
*** HOLE CARDS ***
Dealt to Scaaalll [7h 6s]
dinoVIEIRA: raises $0.04 to $0.06
BlackhawKK's: folds 
zergmiky: folds 
Scaaalll: folds 
rabbitmeat73: calls $0.05
gilberto98: folds 
*** FLOP *** [Qs 7c 9s]
rabbitmeat73: bets $0.07
dinoVIEIRA: calls $0.07
*** TURN *** [Qs 7c 9s] [5d]
rabbitmeat73: bets $0.14
dinoVIEIRA: calls $0.14
*** RIVER *** [Qs 7c 9s 5d] [7d]
rabbitmeat73: bets $0.20
dinoVIEIRA: calls $0.20
*** SHOW DOWN ***
rabbitmeat73: shows [Jc Qd] (two pair, Queens and Sevens)
dinoVIEIRA: shows [Qc Kd] (two pair, Queens and Sevens - King kicker)
dinoVIEIRA collected $0.93 from pot
*** SUMMARY ***
Total pot $0.96 | Rake $0.03 
Board [Qs 7c 9s 5d 7d]
Seat 1: Scaaalll (button) folded before Flop (didn't bet)
Seat 2: rabbitmeat73 (small blind) showed [Jc Qd] and lost with two pair, Queens and Sevens
Seat 3: gilberto98 (big blind) folded before Flop
Seat 4: dinoVIEIRA showed [Qc Kd] and won ($0.93) with two pair, Queens and Sevens
Seat 5: BlackhawKK's folded before Flop (didn't bet)
Seat 6: zergmiky folded before Flop (didn't bet)



PokerStars Zoom Hand #229232838611:  Hold'em No Limit ($0.01/$0.02) - 2021/08/21 23:06:59 CET [2021/08/21 17:06:59 ET]
Table 'Halley' 6-max Seat #1 is the button
Seat 1: BMRB1991 ($0.38 in chips) 
Seat 2: Scaaalll ($2.42 in chips) 
Seat 3: Ck@tih@ ($1.78 in chips) 
Seat 4: Iv3rson18 ($2 in chips) 
Seat 5: Stryda00 ($3.94 in chips) 
Seat 6: Bol'tazar111 ($3.66 in chips) 
Scaaalll: posts small blind $0.01
Ck@tih@: posts big blind $0.02
*** HOLE CARDS ***
Dealt to Scaaalll [Kd Qd]
Iv3rson18: folds 
Stryda00: folds 
Bol'tazar111: folds 
BMRB1991: calls $0.02
Scaaalll: raises $0.07 to $0.09
Ck@tih@: folds 
BMRB1991: calls $0.07
*** FLOP *** [9h Qs Td]
Scaaalll: bets $0.10
BMRB1991: calls $0.10
*** TURN *** [9h Qs Td] [2h]
Scaaalll: bets $0.20
BMRB1991: calls $0.19 and is all-in
Uncalled bet ($0.01) returned to Scaaalll
*** RIVER *** [9h Qs Td 2h] [7d]
*** SHOW DOWN ***
Scaaalll: shows [Kd Qd] (a pair of Queens)
BMRB1991: shows [Ah 9c] (a pair of Nines)
Scaaalll collected $0.74 from pot
BMRB1991 cashed out the hand for $0.08
*** SUMMARY ***
Total pot $0.78 | Rake $0.04 
Board [9h Qs Td 2h 7d]
Seat 1: BMRB1991 (button) showed [Ah 9c] and lost with a pair of Nines (cashed out).
Seat 2: Scaaalll (small blind) showed [Kd Qd] and won ($0.74) with a pair of Queens
Seat 3: Ck@tih@ (big blind) folded before Flop
Seat 4: Iv3rson18 folded before Flop (didn't bet)
Seat 5: Stryda00 folded before Flop (didn't bet)
Seat 6: Bol'tazar111 folded before Flop (didn't bet)



PokerStars Zoom Hand #229232856875:  Hold'em No Limit ($0.01/$0.02) - 2021/08/21 23:07:41 CET [2021/08/21 17:07:41 ET]
Table 'Halley' 6-max Seat #1 is the button
Seat 1: Gamer577 ($3.86 in chips) 
Seat 2: sg.32rus ($0.98 in chips) 
Seat 3: Yangyang1407 ($2 in chips) 
Seat 4: adrianh2002 ($2.17 in chips) 
Seat 5: nitzed12 ($2.77 in chips) 
Seat 6: Scaaalll ($2.78 in chips) 
sg.32rus: posts small blind $0.01
Yangyang1407: posts big blind $0.02
*** HOLE CARDS ***
Dealt to Scaaalll [3d 9s]
adrianh2002: folds 
nitzed12: raises $0.03 to $0.05
Scaaalll: folds 
Gamer577: folds 
sg.32rus: calls $0.04
Yangyang1407: folds 
*** FLOP *** [Ah 4s 3s]
sg.32rus: bets $0.04
nitzed12: raises $0.08 to $0.12
sg.32rus: folds 
Uncalled bet ($0.08) returned to nitzed12
nitzed12 collected $0.19 from pot
nitzed12: doesn't show hand 
*** SUMMARY ***
Total pot $0.20 | Rake $0.01 
Board [Ah 4s 3s]
Seat 1: Gamer577 (button) folded before Flop (didn't bet)
Seat 2: sg.32rus (small blind) folded on the Flop
Seat 3: Yangyang1407 (big blind) folded before Flop
Seat 4: adrianh2002 folded before Flop (didn't bet)
Seat 5: nitzed12 collected ($0.19)
Seat 6: Scaaalll folded before Flop (didn't bet)



PokerStars Zoom Hand #229232861146:  Hold'em No Limit ($0.01/$0.02) - 2021/08/21 23:07:51 CET [2021/08/21 17:07:51 ET]
Table 'Halley' 6-max Seat #1 is the button
Seat 1: rancing87 ($2.05 in chips) 
Seat 2: alphabeta1d ($2.06 in chips) 
Seat 3: BATAL00001 ($1.16 in chips) 
Seat 4: Ck@tih@ ($5.58 in chips) 
Seat 5: Scaaalll ($2.78 in chips) 
Seat 6: WithMyWalker ($2 in chips) 
alphabeta1d: posts small blind $0.01
BATAL00001: posts big blind $0.02
*** HOLE CARDS ***
Dealt to Scaaalll [Th Qd]
BATAL00001 is disconnected 
Ck@tih@ has timed out
Ck@tih@: folds 
Scaaalll: folds 
WithMyWalker: folds 
rancing87: folds 
alphabeta1d: folds 
Uncalled bet ($0.01) returned to BATAL00001
BATAL00001 collected $0.02 from pot
BATAL00001: doesn't show hand 
*** SUMMARY ***
Total pot $0.02 | Rake $0 
Seat 1: rancing87 (button) folded before Flop (didn't bet)
Seat 2: alphabeta1d (small blind) folded before Flop
Seat 3: BATAL00001 (big blind) collected ($0.02)
Seat 4: Ck@tih@ folded before Flop (didn't bet)
Seat 5: Scaaalll folded before Flop (didn't bet)
Seat 6: WithMyWalker folded before Flop (didn't bet)



PokerStars Zoom Hand #229232871177:  Hold'em No Limit ($0.01/$0.02) - 2021/08/21 23:08:14 CET [2021/08/21 17:08:14 ET]
Table 'Halley' 6-max Seat #1 is the button
Seat 1: YGrandmaster ($3.03 in chips) 
Seat 2: Hope2706 ($3.91 in chips) 
Seat 3: Bobathy ($2 in chips) 
Seat 4: Scaaalll ($2.78 in chips) 
Seat 5: Iv3rson18 ($2 in chips) 
Seat 6: adrianh2002 ($2.04 in chips) 
Hope2706: posts small blind $0.01
Bobathy: posts big blind $0.02
*** HOLE CARDS ***
Dealt to Scaaalll [4c 9c]
YGrandmaster is disconnected 
Scaaalll: folds 
Iv3rson18: folds 
adrianh2002: folds 
YGrandmaster: folds 
Hope2706: folds 
Uncalled bet ($0.01) returned to Bobathy
Bobathy collected $0.02 from pot
Bobathy: doesn't show hand 
Hope2706 is disconnected 
*** SUMMARY ***
Total pot $0.02 | Rake $0 
Seat 1: YGrandmaster (button) folded before Flop (didn't bet)
Seat 2: Hope2706 (small blind) folded before Flop
Seat 3: Bobathy (big blind) collected ($0.02)
Seat 4: Scaaalll folded before Flop (didn't bet)
Seat 5: Iv3rson18 folded before Flop (didn't bet)
Seat 6: adrianh2002 folded before Flop (didn't bet)



PokerStars Zoom Hand #229232875086:  Hold'em No Limit ($0.01/$0.02) - 2021/08/21 23:08:23 CET [2021/08/21 17:08:23 ET]
Table 'Halley' 6-max Seat #1 is the button
Seat 1: volt_by ($1.51 in chips) 
Seat 2: Fanatspartak ($1.62 in chips) 
Seat 3: Scaaalll ($2.78 in chips) 
Seat 4: Bol'tazar111 ($2.63 in chips) 
Seat 5: rekopo203 ($6.46 in chips) 
Seat 6: IceTdannyB ($3.53 in chips) 
Fanatspartak: posts small blind $0.01
Scaaalll: posts big blind $0.02
*** HOLE CARDS ***
Dealt to Scaaalll [Tc 8h]
Bol'tazar111: folds 
rekopo203: folds 
IceTdannyB: raises $0.04 to $0.06
volt_by: raises $0.04 to $0.10
Fanatspartak: folds 
Scaaalll: folds 
IceTdannyB: folds 
Uncalled bet ($0.04) returned to volt_by
volt_by collected $0.15 from pot
volt_by: doesn't show hand 
IceTdannyB is disconnected 
*** SUMMARY ***
Total pot $0.15 | Rake $0 
Seat 1: volt_by (button) collected ($0.15)
Seat 2: Fanatspartak (small blind) folded before Flop
Seat 3: Scaaalll (big blind) folded before Flop
Seat 4: Bol'tazar111 folded before Flop (didn't bet)
Seat 5: rekopo203 folded before Flop (didn't bet)
Seat 6: IceTdannyB folded before Flop



PokerStars Zoom Hand #229232881223:  Hold'em No Limit ($0.01/$0.02) - 2021/08/21 23:08:37 CET [2021/08/21 17:08:37 ET]
Table 'Halley' 6-max Seat #1 is the button
Seat 1: Scaaalll ($2.76 in chips) 
Seat 2: dkno77 ($1.49 in chips) 
Seat 3: SIGREX ($2.50 in chips) 
Seat 4: HDYD18 ($7.81 in chips) 
Seat 5: ctaceo ($2 in chips) 
Seat 6: selinus007 ($1.01 in chips) 
dkno77: posts small blind $0.01
SIGREX: posts big blind $0.02
*** HOLE CARDS ***
Dealt to Scaaalll [8d 2h]
HDYD18: folds 
selinus007 is disconnected 
ctaceo: folds 
selinus007: folds 
Scaaalll: folds 
dkno77: raises $0.02 to $0.04
SIGREX: folds 
Uncalled bet ($0.02) returned to dkno77
dkno77 collected $0.04 from pot
dkno77: doesn't show hand 
*** SUMMARY ***
Total pot $0.04 | Rake $0 
Seat 1: Scaaalll (button) folded before Flop (didn't bet)
Seat 2: dkno77 (small blind) collected ($0.04)
Seat 3: SIGREX (big blind) folded before Flop
Seat 4: HDYD18 folded before Flop (didn't bet)
Seat 5: ctaceo folded before Flop (didn't bet)
Seat 6: selinus007 folded before Flop (didn't bet)



PokerStars Zoom Hand #229232893813:  Hold'em No Limit ($0.01/$0.02) - 2021/08/21 23:09:06 CET [2021/08/21 17:09:06 ET]
Table 'Halley' 6-max Seat #1 is the button
Seat 1: sg.32rus ($0.89 in chips) 
Seat 2: bennodiem ($2.21 in chips) 
Seat 3: BexleyBoy ($2.94 in chips) 
Seat 4: Scaaalll ($2.75 in chips) 
Seat 5: PapiMik3 ($2.93 in chips) 
Seat 6: MetalCrüe ($1.85 in chips) 
bennodiem: posts small blind $0.01
BexleyBoy: posts big blind $0.02
*** HOLE CARDS ***
Dealt to Scaaalll [Kh Qc]
Scaaalll: raises $0.04 to $0.06
PapiMik3: folds 
MetalCrüe: folds 
sg.32rus: folds 
bennodiem: folds 
BexleyBoy: folds 
Uncalled bet ($0.04) returned to Scaaalll
Scaaalll collected $0.05 from pot
Scaaalll: doesn't show hand 
*** SUMMARY ***
Total pot $0.05 | Rake $0 
Seat 1: sg.32rus (button) folded before Flop (didn't bet)
Seat 2: bennodiem (small blind) folded before Flop
Seat 3: BexleyBoy (big blind) folded before Flop
Seat 4: Scaaalll collected ($0.05)
Seat 5: PapiMik3 folded before Flop (didn't bet)
Seat 6: MetalCrüe folded before Flop (didn't bet)



PokerStars Zoom Hand #229232888179:  Hold'em No Limit ($0.01/$0.02) - 2021/08/21 23:08:53 CET [2021/08/21 17:08:53 ET]
Table 'Halley' 6-max Seat #1 is the button
Seat 1: TTGemi ($3.96 in chips) 
Seat 2: ziggystarpoker ($1.46 in chips) 
Seat 3: polymorhp ($3.35 in chips) 
Seat 4: martinob11 ($1.90 in chips) 
Seat 5: Scaaalll ($2.76 in chips) 
Seat 6: Thaleshs ($2 in chips) 
ziggystarpoker: posts small blind $0.01
polymorhp: posts big blind $0.02
*** HOLE CARDS ***
Dealt to Scaaalll [4s 6d]
martinob11: folds 
Scaaalll: folds 
Thaleshs: raises $0.02 to $0.04
TTGemi: raises $0.14 to $0.18
ziggystarpoker: folds 
polymorhp: folds 
ziggystarpoker is disconnected 
Thaleshs: folds 
Uncalled bet ($0.14) returned to TTGemi
TTGemi collected $0.11 from pot
TTGemi: doesn't show hand 
*** SUMMARY ***
Total pot $0.11 | Rake $0 
Seat 1: TTGemi (button) collected ($0.11)
Seat 2: ziggystarpoker (small blind) folded before Flop
Seat 3: polymorhp (big blind) folded before Flop
Seat 4: martinob11 folded before Flop (didn't bet)
Seat 5: Scaaalll folded before Flop (didn't bet)
Seat 6: Thaleshs folded before Flop



PokerStars Zoom Hand #229232892082:  Hold'em No Limit ($0.01/$0.02) - 2021/08/21 23:09:02 CET [2021/08/21 17:09:02 ET]
Table 'Halley' 6-max Seat #1 is the button
Seat 1: Stryda00 ($2.56 in chips) 
Seat 2: Scaaalll ($2.76 in chips) 
Seat 3: gasmar_29 ($2.23 in chips) 
Seat 4: sg.32rus ($0.89 in chips) 
Seat 5: F_oksi(BLR) ($4.26 in chips) 
Seat 6: Smaill174 ($2.09 in chips) 
Scaaalll: posts small blind $0.01
gasmar_29: posts big blind $0.02
*** HOLE CARDS ***
Dealt to Scaaalll [Jh 9c]
sg.32rus: folds 
F_oksi(BLR): folds 
Smaill174: raises $0.04 to $0.06
Stryda00: folds 
Scaaalll: folds 
gasmar_29: calls $0.04
*** FLOP *** [4d 6c 4h]
gasmar_29: checks 
Smaill174: bets $0.07
gasmar_29: folds 
Uncalled bet ($0.07) returned to Smaill174
Smaill174 collected $0.13 from pot
Smaill174: doesn't show hand 
*** SUMMARY ***
Total pot $0.13 | Rake $0 
Board [4d 6c 4h]
Seat 1: Stryda00 (button) folded before Flop (didn't bet)
Seat 2: Scaaalll (small blind) folded before Flop
Seat 3: gasmar_29 (big blind) folded on the Flop
Seat 4: sg.32rus folded before Flop (didn't bet)
Seat 5: F_oksi(BLR) folded before Flop (didn't bet)
Seat 6: Smaill174 collected ($0.13)



PokerStars Zoom Hand #229232899052:  Hold'em No Limit ($0.01/$0.02) - 2021/08/21 23:09:18 CET [2021/08/21 17:09:18 ET]
Table 'Halley' 6-max Seat #1 is the button
Seat 1: EstiBan18 ($2 in chips) 
Seat 2: Stryda00 ($3.86 in chips) 
Seat 3: alphabeta1d ($2.22 in chips) 
Seat 4: pavel play pay ($2.22 in chips) 
Seat 5: Dr.stromg ($5.91 in chips) 
Seat 6: Scaaalll ($2.78 in chips) 
Stryda00: posts small blind $0.01
alphabeta1d: posts big blind $0.02
*** HOLE CARDS ***
Dealt to Scaaalll [5c 8c]
pavel play pay: calls $0.02
Dr.stromg: raises $0.06 to $0.08
Scaaalll: folds 
pavel play pay is disconnected 
EstiBan18: calls $0.08
Stryda00: raises $0.28 to $0.36
alphabeta1d: folds 
pavel play pay: folds 
Dr.stromg: folds 
EstiBan18: folds 
Uncalled bet ($0.28) returned to Stryda00
Stryda00 collected $0.28 from pot
Stryda00: doesn't show hand 
*** SUMMARY ***
Total pot $0.28 | Rake $0 
Seat 1: EstiBan18 (button) folded before Flop
Seat 2: Stryda00 (small blind) collected ($0.28)
Seat 3: alphabeta1d (big blind) folded before Flop
Seat 4: pavel play pay folded before Flop
Seat 5: Dr.stromg folded before Flop
Seat 6: Scaaalll folded before Flop (didn't bet)



PokerStars Zoom Hand #229232900800:  Hold'em No Limit ($0.01/$0.02) - 2021/08/21 23:09:22 CET [2021/08/21 17:09:22 ET]
Table 'Halley' 6-max Seat #1 is the button
Seat 1: Apollonnn_13 ($1.82 in chips) 
Seat 2: 21041956 ($1 in chips) 
Seat 3: Stormzilla ($2.03 in chips) 
Seat 4: Scaaalll ($2.78 in chips) 
Seat 5: tisadaisy ($2.62 in chips) 
Seat 6: Meskalita ($2.25 in chips) 
21041956: posts small blind $0.01
Stormzilla: posts big blind $0.02
*** HOLE CARDS ***
Dealt to Scaaalll [Jd 5h]
Scaaalll: folds 
tisadaisy: folds 
Meskalita: raises $0.03 to $0.05
Apollonnn_13: calls $0.05
21041956: folds 
Stormzilla: folds 
*** FLOP *** [2s Jh Th]
Meskalita: checks 
Apollonnn_13: bets $0.07
Meskalita: calls $0.07
*** TURN *** [2s Jh Th] [4h]
Meskalita: checks 
Apollonnn_13: checks 
*** RIVER *** [2s Jh Th 4h] [3s]
Meskalita: checks 
Apollonnn_13: checks 
*** SHOW DOWN ***
Meskalita: shows [Td 8d] (a pair of Tens)
Apollonnn_13: mucks hand 
Meskalita collected $0.26 from pot
*** SUMMARY ***
Total pot $0.27 | Rake $0.01 
Board [2s Jh Th 4h 3s]
Seat 1: Apollonnn_13 (button) mucked [Kd Qd]
Seat 2: 21041956 (small blind) folded before Flop
Seat 3: Stormzilla (big blind) folded before Flop
Seat 4: Scaaalll folded before Flop (didn't bet)
Seat 5: tisadaisy folded before Flop (didn't bet)
Seat 6: Meskalita showed [Td 8d] and won ($0.26) with a pair of Tens



PokerStars Zoom Hand #229232902464:  Hold'em No Limit ($0.01/$0.02) - 2021/08/21 23:09:26 CET [2021/08/21 17:09:26 ET]
Table 'Halley' 6-max Seat #1 is the button
Seat 1: Scaaalll ($2.78 in chips) 
Seat 2: mleonid315 ($2.75 in chips) 
Seat 3: HubertFroh ($2.09 in chips) 
Seat 4: kresooo ($1.64 in chips) 
Seat 5: Jellycube ($4.45 in chips) 
Seat 6: polymorhp ($2.17 in chips) 
mleonid315: posts small blind $0.01
HubertFroh: posts big blind $0.02
*** HOLE CARDS ***
Dealt to Scaaalll [2d 6s]
kresooo: calls $0.02
Jellycube: folds 
polymorhp: folds 
Scaaalll: folds 
mleonid315: raises $0.06 to $0.08
HubertFroh: folds 
kresooo: calls $0.06
*** FLOP *** [2c Ah 7d]
mleonid315: checks 
kresooo: bets $0.04
mleonid315: calls $0.04
*** TURN *** [2c Ah 7d] [2h]
mleonid315: checks 
kresooo: bets $0.06
mleonid315: calls $0.06
*** RIVER *** [2c Ah 7d 2h] [As]
mleonid315: checks 
kresooo: checks 
*** SHOW DOWN ***
mleonid315: shows [4d 4s] (two pair, Aces and Fours)
kresooo: shows [6d 6c] (two pair, Aces and Sixes)
kresooo collected $0.37 from pot
*** SUMMARY ***
Total pot $0.38 | Rake $0.01 
Board [2c Ah 7d 2h As]
Seat 1: Scaaalll (button) folded before Flop (didn't bet)
Seat 2: mleonid315 (small blind) showed [4d 4s] and lost with two pair, Aces and Fours
Seat 3: HubertFroh (big blind) folded before Flop
Seat 4: kresooo showed [6d 6c] and won ($0.37) with two pair, Aces and Sixes
Seat 5: Jellycube folded before Flop (didn't bet)
Seat 6: polymorhp folded before Flop (didn't bet)



PokerStars Zoom Hand #229232905509:  Hold'em No Limit ($0.01/$0.02) - 2021/08/21 23:09:33 CET [2021/08/21 17:09:33 ET]
Table 'Halley' 6-max Seat #1 is the button
Seat 1: CrazyyParis ($2 in chips) 
Seat 2: Stormzilla ($2.04 in chips) 
Seat 3: Scaaalll ($2.78 in chips) 
Seat 4: plmanuelpl ($0.98 in chips) 
Seat 5: Yangyang1407 ($2.14 in chips) 
Seat 6: Meskalita ($2.14 in chips) 
Stormzilla: posts small blind $0.01
Scaaalll: posts big blind $0.02
*** HOLE CARDS ***
Dealt to Scaaalll [5h 5s]
plmanuelpl: folds 
plmanuelpl is disconnected 
Yangyang1407: folds 
Meskalita: folds 
CrazyyParis: folds 
Stormzilla: raises $0.04 to $0.06
Scaaalll: calls $0.04
*** FLOP *** [9d 9c Kc]
Stormzilla: bets $0.07
Scaaalll: calls $0.07
*** TURN *** [9d 9c Kc] [Tc]
Stormzilla: bets $0.14
Scaaalll: folds 
Uncalled bet ($0.14) returned to Stormzilla
Stormzilla collected $0.25 from pot
Stormzilla: doesn't show hand 
*** SUMMARY ***
Total pot $0.26 | Rake $0.01 
Board [9d 9c Kc Tc]
Seat 1: CrazyyParis (button) folded before Flop (didn't bet)
Seat 2: Stormzilla (small blind) collected ($0.25)
Seat 3: Scaaalll (big blind) folded on the Turn
Seat 4: plmanuelpl folded before Flop (didn't bet)
Seat 5: Yangyang1407 folded before Flop (didn't bet)
Seat 6: Meskalita folded before Flop (didn't bet)



PokerStars Zoom Hand #229232921558:  Hold'em No Limit ($0.01/$0.02) - 2021/08/21 23:10:10 CET [2021/08/21 17:10:10 ET]
Table 'Halley' 6-max Seat #1 is the button
Seat 1: Bluff2WlN ($3.21 in chips) 
Seat 2: Scaaalll ($2.65 in chips) 
Seat 3: WITKOW_AV ($2.06 in chips) 
Seat 4: tisadaisy ($2.76 in chips) 
Seat 5: mleonid315 ($2.57 in chips) 
Seat 6: Sharabora ($1.71 in chips) 
Scaaalll: posts small blind $0.01
WITKOW_AV: posts big blind $0.02
*** HOLE CARDS ***
Dealt to Scaaalll [5c 5d]
mleonid315 is disconnected 
tisadaisy: raises $0.02 to $0.04
mleonid315: folds 
Sharabora: folds 
Bluff2WlN: folds 
Scaaalll: calls $0.03
WITKOW_AV: calls $0.02
*** FLOP *** [2h 7d 9d]
Scaaalll: checks 
WITKOW_AV: checks 
tisadaisy: checks 
*** TURN *** [2h 7d 9d] [8h]
Scaaalll: bets $0.06
WITKOW_AV: calls $0.06
tisadaisy: calls $0.06
*** RIVER *** [2h 7d 9d 8h] [As]
Scaaalll: checks 
WITKOW_AV: checks 
tisadaisy: bets $0.29
Scaaalll: folds 
WITKOW_AV: folds 
Uncalled bet ($0.29) returned to tisadaisy
tisadaisy collected $0.29 from pot
tisadaisy: doesn't show hand 
*** SUMMARY ***
Total pot $0.30 | Rake $0.01 
Board [2h 7d 9d 8h As]
Seat 1: Bluff2WlN (button) folded before Flop (didn't bet)
Seat 2: Scaaalll (small blind) folded on the River
Seat 3: WITKOW_AV (big blind) folded on the River
Seat 4: tisadaisy collected ($0.29)
Seat 5: mleonid315 folded before Flop (didn't bet)
Seat 6: Sharabora folded before Flop (didn't bet)



PokerStars Zoom Hand #229232942769:  Hold'em No Limit ($0.01/$0.02) - 2021/08/21 23:10:59 CET [2021/08/21 17:10:59 ET]
Table 'Halley' 6-max Seat #1 is the button
Seat 1: kukulagosleep ($2 in chips) 
Seat 2: pipecmolodec ($2.14 in chips) 
Seat 3: ivorypiano ($1.06 in chips) 
Seat 4: Scaaalll ($2.55 in chips) 
Seat 5: Dr.stromg ($4.78 in chips) 
Seat 6: HDYD18 ($3.22 in chips) 
pipecmolodec: posts small blind $0.01
ivorypiano: posts big blind $0.02
*** HOLE CARDS ***
Dealt to Scaaalll [8s 3s]
Scaaalll: folds 
Dr.stromg: folds 
HDYD18: folds 
kukulagosleep: folds 
pipecmolodec: folds 
Uncalled bet ($0.01) returned to ivorypiano
ivorypiano collected $0.02 from pot
ivorypiano: doesn't show hand 
*** SUMMARY ***
Total pot $0.02 | Rake $0 
Seat 1: kukulagosleep (button) folded before Flop (didn't bet)
Seat 2: pipecmolodec (small blind) folded before Flop
Seat 3: ivorypiano (big blind) collected ($0.02)
Seat 4: Scaaalll folded before Flop (didn't bet)
Seat 5: Dr.stromg folded before Flop (didn't bet)
Seat 6: HDYD18 folded before Flop (didn't bet)



PokerStars Zoom Hand #229232944544:  Hold'em No Limit ($0.01/$0.02) - 2021/08/21 23:11:03 CET [2021/08/21 17:11:03 ET]
Table 'Halley' 6-max Seat #1 is the button
Seat 1: lukas mlc178 ($1.27 in chips) 
Seat 2: WITKOW_AV ($2 in chips) 
Seat 3: Bobathy ($2 in chips) 
Seat 4: Phoenixxxxxxxx ($2.02 in chips) 
Seat 5: Busya777 ($2.29 in chips) 
Seat 6: Scaaalll ($2.55 in chips) 
WITKOW_AV: posts small blind $0.01
Bobathy: posts big blind $0.02
*** HOLE CARDS ***
Dealt to Scaaalll [Ah 6s]
Busya777 is disconnected 
lukas mlc178 is disconnected 
Phoenixxxxxxxx: folds 
Busya777: folds 
Scaaalll: folds 
lukas mlc178: folds 
WITKOW_AV: folds 
Uncalled bet ($0.01) returned to Bobathy
Bobathy collected $0.02 from pot
Bobathy: doesn't show hand 
*** SUMMARY ***
Total pot $0.02 | Rake $0 
Seat 1: lukas mlc178 (button) folded before Flop (didn't bet)
Seat 2: WITKOW_AV (small blind) folded before Flop
Seat 3: Bobathy (big blind) collected ($0.02)
Seat 4: Phoenixxxxxxxx folded before Flop (didn't bet)
Seat 5: Busya777 folded before Flop (didn't bet)
Seat 6: Scaaalll folded before Flop (didn't bet)



PokerStars Zoom Hand #229232948049:  Hold'em No Limit ($0.01/$0.02) - 2021/08/21 23:11:11 CET [2021/08/21 17:11:11 ET]
Table 'Halley' 6-max Seat #1 is the button
Seat 1: Richaud ($2.51 in chips) 
Seat 2: Xlavariable ($2.25 in chips) 
Seat 3: Scaaalll ($2.55 in chips) 
Seat 4: polymorhp ($3.58 in chips) 
Seat 5: fishh_play ($2.02 in chips) 
Seat 6: GVMELLO ($2.13 in chips) 
Xlavariable: posts small blind $0.01
Scaaalll: posts big blind $0.02
*** HOLE CARDS ***
Dealt to Scaaalll [Jd 9d]
polymorhp: folds 
fishh_play: folds 
GVMELLO: folds 
Richaud: raises $0.04 to $0.06
Xlavariable: folds 
Scaaalll: calls $0.04
*** FLOP *** [Tc Jh 7h]
Scaaalll: checks 
Richaud: bets $0.08
Scaaalll: calls $0.08
*** TURN *** [Tc Jh 7h] [Ac]
Scaaalll: checks 
Richaud: bets $0.21
Scaaalll: folds 
Uncalled bet ($0.21) returned to Richaud
Richaud collected $0.28 from pot
Richaud: doesn't show hand 
*** SUMMARY ***
Total pot $0.29 | Rake $0.01 
Board [Tc Jh 7h Ac]
Seat 1: Richaud (button) collected ($0.28)
Seat 2: Xlavariable (small blind) folded before Flop
Seat 3: Scaaalll (big blind) folded on the Turn
Seat 4: polymorhp folded before Flop (didn't bet)
Seat 5: fishh_play folded before Flop (didn't bet)
Seat 6: GVMELLO folded before Flop (didn't bet)



PokerStars Zoom Hand #229232946388:  Hold'em No Limit ($0.01/$0.02) - 2021/08/21 23:11:07 CET [2021/08/21 17:11:07 ET]
Table 'Halley' 6-max Seat #1 is the button
Seat 1: cbbbka ($3.82 in chips) 
Seat 2: Yangyang1407 ($2.37 in chips) 
Seat 3: Busya777 ($2.29 in chips) 
Seat 4: Bol'tazar111 ($4.02 in chips) 
Seat 5: Scaaalll ($2.55 in chips) 
Seat 6: lukas mlc178 ($1.27 in chips) 
Yangyang1407: posts small blind $0.01
Busya777: posts big blind $0.02
*** HOLE CARDS ***
Dealt to Scaaalll [3h 3s]
cbbbka is disconnected 
Bol'tazar111: folds 
Scaaalll: folds 
lukas mlc178: raises $0.04 to $0.06
cbbbka: folds 
Yangyang1407: folds 
Busya777: calls $0.04
*** FLOP *** [6d 8c 7h]
Busya777: bets $0.06
lukas mlc178: calls $0.06
*** TURN *** [6d 8c 7h] [4c]
Busya777: bets $0.06
lukas mlc178: calls $0.06
*** RIVER *** [6d 8c 7h 4c] [Qc]
Busya777: bets $0.04
lukas mlc178: raises $0.24 to $0.28
Busya777: calls $0.24
*** SHOW DOWN ***
lukas mlc178: shows [6h Ac] (a pair of Sixes)
Busya777: shows [8h 8d] (three of a kind, Eights)
Busya777 collected $0.90 from pot
*** SUMMARY ***
Total pot $0.93 | Rake $0.03 
Board [6d 8c 7h 4c Qc]
Seat 1: cbbbka (button) folded before Flop (didn't bet)
Seat 2: Yangyang1407 (small blind) folded before Flop
Seat 3: Busya777 (big blind) showed [8h 8d] and won ($0.90) with three of a kind, Eights
Seat 4: Bol'tazar111 folded before Flop (didn't bet)
Seat 5: Scaaalll folded before Flop (didn't bet)
Seat 6: lukas mlc178 showed [6h Ac] and lost with a pair of Sixes



PokerStars Zoom Hand #229232963050:  Hold'em No Limit ($0.01/$0.02) - 2021/08/21 23:11:46 CET [2021/08/21 17:11:46 ET]
Table 'Halley' 6-max Seat #1 is the button
Seat 1: LucasLMdS ($2.09 in chips) 
Seat 2: Scaaalll ($2.41 in chips) 
Seat 3: GVMELLO ($2.60 in chips) 
Seat 4: znak312 ($2.05 in chips) 
Seat 5: Traphouse18 ($2 in chips) 
Seat 6: STE1NBERG ($2 in chips) 
Scaaalll: posts small blind $0.01
GVMELLO: posts big blind $0.02
*** HOLE CARDS ***
Dealt to Scaaalll [2s Qc]
znak312: folds 
Traphouse18: folds 
STE1NBERG: raises $0.03 to $0.05
LucasLMdS: raises $0.10 to $0.15
Scaaalll: folds 
GVMELLO: folds 
STE1NBERG: folds 
Uncalled bet ($0.10) returned to LucasLMdS
LucasLMdS collected $0.13 from pot
LucasLMdS: doesn't show hand 
*** SUMMARY ***
Total pot $0.13 | Rake $0 
Seat 1: LucasLMdS (button) collected ($0.13)
Seat 2: Scaaalll (small blind) folded before Flop
Seat 3: GVMELLO (big blind) folded before Flop
Seat 4: znak312 folded before Flop (didn't bet)
Seat 5: Traphouse18 folded before Flop (didn't bet)
Seat 6: STE1NBERG folded before Flop



PokerStars Zoom Hand #229232969504:  Hold'em No Limit ($0.01/$0.02) - 2021/08/21 23:12:01 CET [2021/08/21 17:12:01 ET]
Table 'Halley' 6-max Seat #1 is the button
Seat 1: Scaaalll ($2.40 in chips) 
Seat 2: rabbitmeat73 ($1.18 in chips) 
Seat 3: ibstah ($1.79 in chips) 
Seat 4: alphabeta1d ($2.06 in chips) 
Seat 5: kavli ($3 in chips) 
Seat 6: wrfregati ($1.99 in chips) 
rabbitmeat73: posts small blind $0.01
ibstah: posts big blind $0.02
*** HOLE CARDS ***
Dealt to Scaaalll [Jd 4c]
alphabeta1d: folds 
kavli: raises $0.06 to $0.08
wrfregati: folds 
Scaaalll: folds 
rabbitmeat73: folds 
ibstah: folds 
Uncalled bet ($0.06) returned to kavli
kavli collected $0.05 from pot
kavli: doesn't show hand 
*** SUMMARY ***
Total pot $0.05 | Rake $0 
Seat 1: Scaaalll (button) folded before Flop (didn't bet)
Seat 2: rabbitmeat73 (small blind) folded before Flop
Seat 3: ibstah (big blind) folded before Flop
Seat 4: alphabeta1d folded before Flop (didn't bet)
Seat 5: kavli collected ($0.05)
Seat 6: wrfregati folded before Flop (didn't bet)



PokerStars Zoom Hand #229232973421:  Hold'em No Limit ($0.01/$0.02) - 2021/08/21 23:12:10 CET [2021/08/21 17:12:10 ET]
Table 'Halley' 6-max Seat #1 is the button
Seat 1: Earl_greyPL ($1.47 in chips) 
Seat 2: HeroGarec ($2.01 in chips) 
Seat 3: sg.32rus ($0.63 in chips) 
Seat 4: Scaaalll ($2.40 in chips) 
Seat 5: lucksuckdonk ($2.08 in chips) 
Seat 6: HubertFroh ($4.93 in chips) 
HeroGarec: posts small blind $0.01
sg.32rus: posts big blind $0.02
*** HOLE CARDS ***
Dealt to Scaaalll [Jc As]
HeroGarec is disconnected 
Scaaalll: raises $0.04 to $0.06
lucksuckdonk: folds 
HubertFroh: folds 
Earl_greyPL: folds 
HeroGarec: folds 
sg.32rus: folds 
Uncalled bet ($0.04) returned to Scaaalll
Scaaalll collected $0.05 from pot
Scaaalll: doesn't show hand 
*** SUMMARY ***
Total pot $0.05 | Rake $0 
Seat 1: Earl_greyPL (button) folded before Flop (didn't bet)
Seat 2: HeroGarec (small blind) folded before Flop
Seat 3: sg.32rus (big blind) folded before Flop
Seat 4: Scaaalll collected ($0.05)
Seat 5: lucksuckdonk folded before Flop (didn't bet)
Seat 6: HubertFroh folded before Flop (didn't bet)



PokerStars Zoom Hand #229232983688:  Hold'em No Limit ($0.01/$0.02) - 2021/08/21 23:12:34 CET [2021/08/21 17:12:34 ET]
Table 'Halley' 6-max Seat #1 is the button
Seat 1: Healthys07 ($3.75 in chips) 
Seat 2: egroj1700 ($2.06 in chips) 
Seat 3: FARA1982 ($1.41 in chips) 
Seat 4: owtwilldo ($2 in chips) 
Seat 5: Scaaalll ($2.43 in chips) 
Seat 6: sevenfizzle ($0.74 in chips) 
egroj1700: posts small blind $0.01
FARA1982: posts big blind $0.02
*** HOLE CARDS ***
Dealt to Scaaalll [7c 9c]
owtwilldo: folds 
Scaaalll: folds 
sevenfizzle: folds 
Healthys07: folds 
egroj1700: folds 
Uncalled bet ($0.01) returned to FARA1982
FARA1982 collected $0.02 from pot
FARA1982: doesn't show hand 
*** SUMMARY ***
Total pot $0.02 | Rake $0 
Seat 1: Healthys07 (button) folded before Flop (didn't bet)
Seat 2: egroj1700 (small blind) folded before Flop
Seat 3: FARA1982 (big blind) collected ($0.02)
Seat 4: owtwilldo folded before Flop (didn't bet)
Seat 5: Scaaalll folded before Flop (didn't bet)
Seat 6: sevenfizzle folded before Flop (didn't bet)



PokerStars Zoom Hand #229232978550:  Hold'em No Limit ($0.01/$0.02) - 2021/08/21 23:12:22 CET [2021/08/21 17:12:22 ET]
Table 'Halley' 6-max Seat #1 is the button
Seat 1: GVMELLO ($1.99 in chips) 
Seat 2: bananAAbandit ($2.52 in chips) 
Seat 3: AXXILLES ($1.71 in chips) 
Seat 4: Bol'tazar111 ($2.51 in chips) 
Seat 5: OmahaWheels ($3.38 in chips) 
Seat 6: Scaaalll ($2.43 in chips) 
bananAAbandit: posts small blind $0.01
AXXILLES: posts big blind $0.02
*** HOLE CARDS ***
Dealt to Scaaalll [3c 9h]
Bol'tazar111: folds 
OmahaWheels: raises $0.04 to $0.06
Scaaalll: folds 
GVMELLO: folds 
bananAAbandit: raises $0.15 to $0.21
AXXILLES: folds 
OmahaWheels: calls $0.15
*** FLOP *** [Ks Tc 5h]
bananAAbandit: checks 
OmahaWheels: checks 
*** TURN *** [Ks Tc 5h] [5c]
bananAAbandit: bets $0.21
OmahaWheels: folds 
Uncalled bet ($0.21) returned to bananAAbandit
bananAAbandit collected $0.42 from pot
bananAAbandit: doesn't show hand 
*** SUMMARY ***
Total pot $0.44 | Rake $0.02 
Board [Ks Tc 5h 5c]
Seat 1: GVMELLO (button) folded before Flop (didn't bet)
Seat 2: bananAAbandit (small blind) collected ($0.42)
Seat 3: AXXILLES (big blind) folded before Flop
Seat 4: Bol'tazar111 folded before Flop (didn't bet)
Seat 5: OmahaWheels folded on the Turn
Seat 6: Scaaalll folded before Flop (didn't bet)



PokerStars Zoom Hand #229232990176:  Hold'em No Limit ($0.01/$0.02) - 2021/08/21 23:12:49 CET [2021/08/21 17:12:49 ET]
Table 'Halley' 6-max Seat #1 is the button
Seat 1: tisadaisy ($2.21 in chips) 
Seat 2: Koldun 2636 ($2.09 in chips) 
Seat 3: Scaaalll ($2.43 in chips) 
Seat 4: 21041956 ($0.99 in chips) 
Seat 5: SIGREX ($2.36 in chips) 
Seat 6: KissingTheSun ($2 in chips) 
Koldun 2636: posts small blind $0.01
Scaaalll: posts big blind $0.02
*** HOLE CARDS ***
Dealt to Scaaalll [8d Jh]
21041956: calls $0.02
SIGREX: folds 
KissingTheSun: folds 
tisadaisy: folds 
Koldun 2636: folds 
Scaaalll: checks 
*** FLOP *** [Qh 2c 9d]
Scaaalll: checks 
21041956: bets $0.97 and is all-in
Scaaalll: folds 
Uncalled bet ($0.97) returned to 21041956
21041956 collected $0.05 from pot
21041956: doesn't show hand 
*** SUMMARY ***
Total pot $0.05 | Rake $0 
Board [Qh 2c 9d]
Seat 1: tisadaisy (button) folded before Flop (didn't bet)
Seat 2: Koldun 2636 (small blind) folded before Flop
Seat 3: Scaaalll (big blind) folded on the Flop
Seat 4: 21041956 collected ($0.05)
Seat 5: SIGREX folded before Flop (didn't bet)
Seat 6: KissingTheSun folded before Flop (didn't bet)



PokerStars Zoom Hand #229233000506:  Hold'em No Limit ($0.01/$0.02) - 2021/08/21 23:13:13 CET [2021/08/21 17:13:13 ET]
Table 'Halley' 6-max Seat #1 is the button
Seat 1: WhoBetsWins ($2.64 in chips) 
Seat 2: Xlavariable ($2.12 in chips) 
Seat 3: 888lifeIS ($2.03 in chips) 
Seat 4: Scaaalll ($2.41 in chips) 
Seat 5: Gamer577 ($2 in chips) 
Seat 6: kidninja888 ($2.54 in chips) 
Xlavariable: posts small blind $0.01
888lifeIS: posts big blind $0.02
*** HOLE CARDS ***
Dealt to Scaaalll [Qh 3c]
Scaaalll: folds 
Gamer577: folds 
kidninja888: folds 
WhoBetsWins: folds 
Xlavariable: folds 
Uncalled bet ($0.01) returned to 888lifeIS
888lifeIS collected $0.02 from pot
888lifeIS: doesn't show hand 
*** SUMMARY ***
Total pot $0.02 | Rake $0 
Seat 1: WhoBetsWins (button) folded before Flop (didn't bet)
Seat 2: Xlavariable (small blind) folded before Flop
Seat 3: 888lifeIS (big blind) collected ($0.02)
Seat 4: Scaaalll folded before Flop (didn't bet)
Seat 5: Gamer577 folded before Flop (didn't bet)
Seat 6: kidninja888 folded before Flop (didn't bet)



PokerStars Zoom Hand #229233005541:  Hold'em No Limit ($0.01/$0.02) - 2021/08/21 23:13:25 CET [2021/08/21 17:13:25 ET]
Table 'Halley' 6-max Seat #1 is the button
Seat 1: Scaaalll ($2.41 in chips) 
Seat 2: SIGREX ($2 in chips) 
Seat 3: gasmar_29 ($2.07 in chips) 
Seat 4: jordanzepp ($2.44 in chips) 
Seat 5: babiloniaxxx ($2.42 in chips) 
Seat 6: Phoenixxxxxxxx ($2 in chips) 
SIGREX: posts small blind $0.01
gasmar_29: posts big blind $0.02
*** HOLE CARDS ***
Dealt to Scaaalll [5s 5d]
jordanzepp: folds 
jordanzepp is disconnected 
babiloniaxxx: folds 
Phoenixxxxxxxx: folds 
Scaaalll: raises $0.03 to $0.05
SIGREX: folds 
gasmar_29: calls $0.03
*** FLOP *** [3c 2s Js]
gasmar_29: bets $0.05
Scaaalll: calls $0.05
*** TURN *** [3c 2s Js] [Td]
gasmar_29: checks 
Scaaalll: checks 
*** RIVER *** [3c 2s Js Td] [3s]
gasmar_29: bets $0.14
Scaaalll: calls $0.14
*** SHOW DOWN ***
gasmar_29: shows [6s As] (a flush, Ace high)
Scaaalll: mucks hand 
gasmar_29 collected $0.47 from pot
*** SUMMARY ***
Total pot $0.49 | Rake $0.02 
Board [3c 2s Js Td 3s]
Seat 1: Scaaalll (button) mucked [5s 5d]
Seat 2: SIGREX (small blind) folded before Flop
Seat 3: gasmar_29 (big blind) showed [6s As] and won ($0.47) with a flush, Ace high
Seat 4: jordanzepp folded before Flop (didn't bet)
Seat 5: babiloniaxxx folded before Flop (didn't bet)
Seat 6: Phoenixxxxxxxx folded before Flop (didn't bet)



PokerStars Zoom Hand #229233025699:  Hold'em No Limit ($0.01/$0.02) - 2021/08/21 23:14:12 CET [2021/08/21 17:14:12 ET]
Table 'Halley' 6-max Seat #1 is the button
Seat 1: Vanekakqj ($4.33 in chips) 
Seat 2: Scaaalll ($2.17 in chips) 
Seat 3: YGrandmaster ($2 in chips) 
Seat 4: Alexasha78 ($2.26 in chips) 
Seat 5: rpycmbEM ($5.02 in chips) 
Seat 6: BlackhawKK's ($2 in chips) 
Scaaalll: posts small blind $0.01
YGrandmaster: posts big blind $0.02
*** HOLE CARDS ***
Dealt to Scaaalll [Kh Ks]
Alexasha78: folds 
rpycmbEM: folds 
Alexasha78 is disconnected 
BlackhawKK's: folds 
Vanekakqj: folds 
Scaaalll: raises $0.04 to $0.06
YGrandmaster: raises $0.12 to $0.18
Scaaalll: calls $0.12
*** FLOP *** [6d Qc 6c]
Scaaalll: checks 
YGrandmaster: bets $0.23
Scaaalll: calls $0.23
*** TURN *** [6d Qc 6c] [6h]
Scaaalll: checks 
YGrandmaster: bets $0.53
Scaaalll: raises $1.23 to $1.76 and is all-in
YGrandmaster: calls $1.06 and is all-in
Uncalled bet ($0.17) returned to Scaaalll
*** RIVER *** [6d Qc 6c 6h] [Jd]
*** SHOW DOWN ***
Scaaalll: shows [Kh Ks] (a full house, Sixes full of Kings)
YGrandmaster: shows [Ah 5d] (three of a kind, Sixes)
Scaaalll collected $3.82 from pot
YGrandmaster is disconnected 
*** SUMMARY ***
Total pot $4 | Rake $0.18 
Board [6d Qc 6c 6h Jd]
Seat 1: Vanekakqj (button) folded before Flop (didn't bet)
Seat 2: Scaaalll (small blind) showed [Kh Ks] and won ($3.82) with a full house, Sixes full of Kings
Seat 3: YGrandmaster (big blind) showed [Ah 5d] and lost with three of a kind, Sixes
Seat 4: Alexasha78 folded before Flop (didn't bet)
Seat 5: rpycmbEM folded before Flop (didn't bet)
Seat 6: BlackhawKK's folded before Flop (didn't bet)



PokerStars Zoom Hand #229233046445:  Hold'em No Limit ($0.01/$0.02) - 2021/08/21 23:15:00 CET [2021/08/21 17:15:00 ET]
Table 'Halley' 6-max Seat #1 is the button
Seat 1: 5greenberry4 ($2.13 in chips) 
Seat 2: Astel88 ($3.23 in chips) 
Seat 3: lukas mlc178 ($1.94 in chips) 
Seat 4: RrriotGrrrl ($4.59 in chips) 
Seat 5: Scaaalll ($3.99 in chips) 
Seat 6: Demidov V.S. ($2.42 in chips) 
Astel88: posts small blind $0.01
lukas mlc178: posts big blind $0.02
*** HOLE CARDS ***
Dealt to Scaaalll [4c As]
RrriotGrrrl: folds 
Scaaalll: folds 
Demidov V.S.: folds 
Demidov V.S. is disconnected 
5greenberry4: folds 
Astel88: calls $0.01
lukas mlc178: raises $0.04 to $0.06
Astel88: folds 
Uncalled bet ($0.04) returned to lukas mlc178
lukas mlc178 collected $0.04 from pot
lukas mlc178: doesn't show hand 
Astel88 is disconnected 
*** SUMMARY ***
Total pot $0.04 | Rake $0 
Seat 1: 5greenberry4 (button) folded before Flop (didn't bet)
Seat 2: Astel88 (small blind) folded before Flop
Seat 3: lukas mlc178 (big blind) collected ($0.04)
Seat 4: RrriotGrrrl folded before Flop (didn't bet)
Seat 5: Scaaalll folded before Flop (didn't bet)
Seat 6: Demidov V.S. folded before Flop (didn't bet)



PokerStars Zoom Hand #229233048135:  Hold'em No Limit ($0.01/$0.02) - 2021/08/21 23:15:04 CET [2021/08/21 17:15:04 ET]
Table 'Halley' 6-max Seat #1 is the button
Seat 1: vovan100157 ($2.22 in chips) 
Seat 2: didiclavi777 ($1.51 in chips) 
Seat 3: Yangyang1407 ($2.18 in chips) 
Seat 4: BlackhawKK's ($3.52 in chips) 
Seat 5: Feliciano16 ($4.28 in chips) 
Seat 6: Scaaalll ($3.99 in chips) 
didiclavi777: posts small blind $0.01
Yangyang1407: posts big blind $0.02
*** HOLE CARDS ***
Dealt to Scaaalll [5c 8d]
BlackhawKK's: folds 
Feliciano16: raises $0.04 to $0.06
Scaaalll: folds 
vovan100157: folds 
didiclavi777: folds 
Yangyang1407: folds 
Uncalled bet ($0.04) returned to Feliciano16
Feliciano16 collected $0.05 from pot
Feliciano16: doesn't show hand 
*** SUMMARY ***
Total pot $0.05 | Rake $0 
Seat 1: vovan100157 (button) folded before Flop (didn't bet)
Seat 2: didiclavi777 (small blind) folded before Flop
Seat 3: Yangyang1407 (big blind) folded before Flop
Seat 4: BlackhawKK's folded before Flop (didn't bet)
Seat 5: Feliciano16 collected ($0.05)
Seat 6: Scaaalll folded before Flop (didn't bet)



PokerStars Zoom Hand #229233049884:  Hold'em No Limit ($0.01/$0.02) - 2021/08/21 23:15:08 CET [2021/08/21 17:15:08 ET]
Table 'Halley' 6-max Seat #1 is the button
Seat 1: Gamer577 ($7.94 in chips) 
Seat 2: snowpepsi ($2.27 in chips) 
Seat 3: didiclavi777 ($1.50 in chips) 
Seat 4: rpycmbEM ($1.12 in chips) 
Seat 5: zergmiky ($3.15 in chips) 
Seat 6: Scaaalll ($3.99 in chips) 
snowpepsi: posts small blind $0.01
didiclavi777: posts big blind $0.02
*** HOLE CARDS ***
Dealt to Scaaalll [7h 4h]
rpycmbEM: raises $0.04 to $0.06
zergmiky: folds 
Scaaalll: folds 
Gamer577: folds 
snowpepsi: folds 
didiclavi777: calls $0.04
*** FLOP *** [Js Ts 8c]
didiclavi777: checks 
rpycmbEM: bets $0.07
didiclavi777: folds 
Uncalled bet ($0.07) returned to rpycmbEM
rpycmbEM collected $0.13 from pot
rpycmbEM: doesn't show hand 
*** SUMMARY ***
Total pot $0.13 | Rake $0 
Board [Js Ts 8c]
Seat 1: Gamer577 (button) folded before Flop (didn't bet)
Seat 2: snowpepsi (small blind) folded before Flop
Seat 3: didiclavi777 (big blind) folded on the Flop
Seat 4: rpycmbEM collected ($0.13)
Seat 5: zergmiky folded before Flop (didn't bet)
Seat 6: Scaaalll folded before Flop (didn't bet)



PokerStars Zoom Hand #229233097173:  Hold'em No Limit ($0.01/$0.02) - 2021/08/21 23:16:58 CET [2021/08/21 17:16:58 ET]
Table 'Halley' 6-max Seat #1 is the button
Seat 1: 13Mohican ($2 in chips) 
Seat 2: geo8787891 ($4.41 in chips) 
Seat 3: Scaaalll ($3.99 in chips) 
Seat 4: NeckCarp ($1.17 in chips) 
Seat 5: Richaud ($2.05 in chips) 
Seat 6: Fabi151312 ($1.91 in chips) 
geo8787891: posts small blind $0.01
Scaaalll: posts big blind $0.02
*** HOLE CARDS ***
Dealt to Scaaalll [Ah Qd]
NeckCarp: folds 
Richaud: folds 
Fabi151312: folds 
13Mohican: folds 
NeckCarp is disconnected 
geo8787891: calls $0.01
Scaaalll: raises $0.06 to $0.08
geo8787891: calls $0.06
*** FLOP *** [Jh As Td]
geo8787891: checks 
Scaaalll: bets $0.10
geo8787891: raises $0.10 to $0.20
Scaaalll: calls $0.10
*** TURN *** [Jh As Td] [5s]
geo8787891: bets $0.24
Scaaalll: calls $0.24
*** RIVER *** [Jh As Td 5s] [7h]
geo8787891: bets $0.50
Scaaalll: folds 
Uncalled bet ($0.50) returned to geo8787891
geo8787891 collected $1 from pot
geo8787891: doesn't show hand 
*** SUMMARY ***
Total pot $1.04 | Rake $0.04 
Board [Jh As Td 5s 7h]
Seat 1: 13Mohican (button) folded before Flop (didn't bet)
Seat 2: geo8787891 (small blind) collected ($1)
Seat 3: Scaaalll (big blind) folded on the River
Seat 4: NeckCarp folded before Flop (didn't bet)
Seat 5: Richaud folded before Flop (didn't bet)
Seat 6: Fabi151312 folded before Flop (didn't bet)



PokerStars Zoom Hand #229233126141:  Hold'em No Limit ($0.01/$0.02) - 2021/08/21 23:18:06 CET [2021/08/21 17:18:06 ET]
Table 'Halley' 6-max Seat #1 is the button
Seat 1: Scaaalll ($3.47 in chips) 
Seat 2: KissingTheSun ($2.26 in chips) 
Seat 3: NecromiconP ($9.91 in chips) 
Seat 4: WITKOW_AV ($2.25 in chips) 
Seat 5: estelionat171 ($0.82 in chips) 
Seat 6: Dr.stromg ($6.33 in chips) 
KissingTheSun: posts small blind $0.01
NecromiconP: posts big blind $0.02
*** HOLE CARDS ***
Dealt to Scaaalll [3s 9c]
WITKOW_AV: raises $0.04 to $0.06
estelionat171: folds 
Dr.stromg: folds 
Scaaalll: folds 
KissingTheSun: folds 
NecromiconP: folds 
Uncalled bet ($0.04) returned to WITKOW_AV
WITKOW_AV collected $0.05 from pot
WITKOW_AV: doesn't show hand 
*** SUMMARY ***
Total pot $0.05 | Rake $0 
Seat 1: Scaaalll (button) folded before Flop (didn't bet)
Seat 2: KissingTheSun (small blind) folded before Flop
Seat 3: NecromiconP (big blind) folded before Flop
Seat 4: WITKOW_AV collected ($0.05)
Seat 5: estelionat171 folded before Flop (didn't bet)
Seat 6: Dr.stromg folded before Flop (didn't bet)



PokerStars Zoom Hand #229233130783:  Hold'em No Limit ($0.01/$0.02) - 2021/08/21 23:18:17 CET [2021/08/21 17:18:17 ET]
Table 'Halley' 6-max Seat #1 is the button
Seat 1: Apollonnn_13 ($1.52 in chips) 
Seat 2: Scaaalll ($3.47 in chips) 
Seat 3: Dr.stromg ($5.53 in chips) 
Seat 4: Ck@tih@ ($1.83 in chips) 
Seat 5: 13Mohican ($2.02 in chips) 
Seat 6: Keltu :D ($2.51 in chips) 
Scaaalll: posts small blind $0.01
Dr.stromg: posts big blind $0.02
*** HOLE CARDS ***
Dealt to Scaaalll [5d Ts]
Ck@tih@: folds 
13Mohican: raises $0.04 to $0.06
Keltu :D: folds 
Apollonnn_13: folds 
Scaaalll: folds 
Dr.stromg: folds 
Uncalled bet ($0.04) returned to 13Mohican
13Mohican collected $0.05 from pot
13Mohican: doesn't show hand 
*** SUMMARY ***
Total pot $0.05 | Rake $0 
Seat 1: Apollonnn_13 (button) folded before Flop (didn't bet)
Seat 2: Scaaalll (small blind) folded before Flop
Seat 3: Dr.stromg (big blind) folded before Flop
Seat 4: Ck@tih@ folded before Flop (didn't bet)
Seat 5: 13Mohican collected ($0.05)
Seat 6: Keltu :D folded before Flop (didn't bet)



PokerStars Zoom Hand #229233136250:  Hold'em No Limit ($0.01/$0.02) - 2021/08/21 23:18:30 CET [2021/08/21 17:18:30 ET]
Table 'Halley' 6-max Seat #1 is the button
Seat 1: Knutzers ($2.10 in chips) 
Seat 2: FabOliveira9 ($5.91 in chips) 
Seat 3: Ne0net ($2.53 in chips) 
Seat 4: Dr.stromg ($4.63 in chips) 
Seat 5: Koldun 2636 ($2.93 in chips) 
Seat 6: Scaaalll ($3.46 in chips) 
FabOliveira9: posts small blind $0.01
Ne0net: posts big blind $0.02
*** HOLE CARDS ***
Dealt to Scaaalll [4d As]
Dr.stromg: folds 
Koldun 2636: folds 
Scaaalll: folds 
Knutzers: raises $0.02 to $0.04
FabOliveira9: folds 
Ne0net: folds 
Uncalled bet ($0.02) returned to Knutzers
Knutzers collected $0.05 from pot
Knutzers: doesn't show hand 
*** SUMMARY ***
Total pot $0.05 | Rake $0 
Seat 1: Knutzers (button) collected ($0.05)
Seat 2: FabOliveira9 (small blind) folded before Flop
Seat 3: Ne0net (big blind) folded before Flop
Seat 4: Dr.stromg folded before Flop (didn't bet)
Seat 5: Koldun 2636 folded before Flop (didn't bet)
Seat 6: Scaaalll folded before Flop (didn't bet)



PokerStars Zoom Hand #229233143722:  Hold'em No Limit ($0.01/$0.02) - 2021/08/21 23:18:48 CET [2021/08/21 17:18:48 ET]
Table 'Halley' 6-max Seat #1 is the button
Seat 1: unsuwes ($3.17 in chips) 
Seat 2: WITKOW_AV ($2.67 in chips) 
Seat 3: alphabeta1d ($2 in chips) 
Seat 4: egopi ($0.80 in chips) 
Seat 5: Scaaalll ($3.46 in chips) 
Seat 6: nodtress ($2 in chips) 
WITKOW_AV: posts small blind $0.01
alphabeta1d: posts big blind $0.02
*** HOLE CARDS ***
Dealt to Scaaalll [Ah 9c]
egopi: folds 
egopi is disconnected 
Scaaalll: folds 
nodtress: folds 
unsuwes: raises $0.04 to $0.06
WITKOW_AV: folds 
alphabeta1d: folds 
Uncalled bet ($0.04) returned to unsuwes
unsuwes collected $0.05 from pot
unsuwes: doesn't show hand 
*** SUMMARY ***
Total pot $0.05 | Rake $0 
Seat 1: unsuwes (button) collected ($0.05)
Seat 2: WITKOW_AV (small blind) folded before Flop
Seat 3: alphabeta1d (big blind) folded before Flop
Seat 4: egopi folded before Flop (didn't bet)
Seat 5: Scaaalll folded before Flop (didn't bet)
Seat 6: nodtress folded before Flop (didn't bet)



PokerStars Zoom Hand #229233151318:  Hold'em No Limit ($0.01/$0.02) - 2021/08/21 23:18:56 CET [2021/08/21 17:18:56 ET]
Table 'Halley' 6-max Seat #1 is the button
Seat 1: AXXILLES ($2.27 in chips) 
Seat 2: zergmiky ($2.12 in chips) 
Seat 3: Scaaalll ($3.46 in chips) 
Seat 4: HDYD18 ($8.61 in chips) 
Seat 5: so0love ($2.25 in chips) 
Seat 6: blubfishi Òó ($1.97 in chips) 
zergmiky: posts small blind $0.01
Scaaalll: posts big blind $0.02
*** HOLE CARDS ***
Dealt to Scaaalll [5d 2h]
HDYD18: folds 
so0love: folds 
blubfishi Òó: raises $0.04 to $0.06
AXXILLES: calls $0.06
zergmiky: folds 
Scaaalll: folds 
*** FLOP *** [Ad Kh Th]
blubfishi Òó: bets $0.06
AXXILLES: folds 
Uncalled bet ($0.06) returned to blubfishi Òó
blubfishi Òó collected $0.14 from pot
blubfishi Òó: doesn't show hand 
*** SUMMARY ***
Total pot $0.15 | Rake $0.01 
Board [Ad Kh Th]
Seat 1: AXXILLES (button) folded on the Flop
Seat 2: zergmiky (small blind) folded before Flop
Seat 3: Scaaalll (big blind) folded before Flop
Seat 4: HDYD18 folded before Flop (didn't bet)
Seat 5: so0love folded before Flop (didn't bet)
Seat 6: blubfishi Òó collected ($0.14)



PokerStars Zoom Hand #229233166988:  Hold'em No Limit ($0.01/$0.02) - 2021/08/21 23:19:33 CET [2021/08/21 17:19:33 ET]
Table 'Halley' 6-max Seat #1 is the button
Seat 1: Scaaalll ($3.44 in chips) 
Seat 2: lauti214 ($1.98 in chips) 
Seat 3: AtZ3899 ($2.77 in chips) 
Seat 4: CrazyyParis ($2.06 in chips) 
Seat 5: didiclavi777 ($2.76 in chips) 
Seat 6: roukoun1984 ($1.23 in chips) 
lauti214: posts small blind $0.01
AtZ3899: posts big blind $0.02
*** HOLE CARDS ***
Dealt to Scaaalll [9h Ac]
CrazyyParis: folds 
didiclavi777: folds 
roukoun1984: folds 
roukoun1984 is disconnected 
Scaaalll: raises $0.02 to $0.04
lauti214: folds 
AtZ3899: folds 
Uncalled bet ($0.02) returned to Scaaalll
Scaaalll collected $0.05 from pot
Scaaalll: doesn't show hand 
*** SUMMARY ***
Total pot $0.05 | Rake $0 
Seat 1: Scaaalll (button) collected ($0.05)
Seat 2: lauti214 (small blind) folded before Flop
Seat 3: AtZ3899 (big blind) folded before Flop
Seat 4: CrazyyParis folded before Flop (didn't bet)
Seat 5: didiclavi777 folded before Flop (didn't bet)
Seat 6: roukoun1984 folded before Flop (didn't bet)



PokerStars Zoom Hand #229233160224:  Hold'em No Limit ($0.01/$0.02) - 2021/08/21 23:19:17 CET [2021/08/21 17:19:17 ET]
Table 'Halley' 6-max Seat #1 is the button
Seat 1: fishh_play ($2.29 in chips) 
Seat 2: Misteltje ($0.48 in chips) 
Seat 3: kukulagosleep ($3.59 in chips) 
Seat 4: lumpek1112 ($1.82 in chips) 
Seat 5: ChowMangao ($3.95 in chips) 
Seat 6: Scaaalll ($3.44 in chips) 
Misteltje: posts small blind $0.01
kukulagosleep: posts big blind $0.02
*** HOLE CARDS ***
Dealt to Scaaalll [Ts 9h]
lumpek1112: raises $0.05 to $0.07
ChowMangao: folds 
Scaaalll: folds 
fishh_play: calls $0.07
Misteltje: folds 
kukulagosleep: folds 
*** FLOP *** [5c 5d Ah]
lumpek1112: checks 
fishh_play: bets $0.13
lumpek1112: folds 
Uncalled bet ($0.13) returned to fishh_play
fishh_play collected $0.16 from pot
fishh_play: doesn't show hand 
*** SUMMARY ***
Total pot $0.17 | Rake $0.01 
Board [5c 5d Ah]
Seat 1: fishh_play (button) collected ($0.16)
Seat 2: Misteltje (small blind) folded before Flop
Seat 3: kukulagosleep (big blind) folded before Flop
Seat 4: lumpek1112 folded on the Flop
Seat 5: ChowMangao folded before Flop (didn't bet)
Seat 6: Scaaalll folded before Flop (didn't bet)



PokerStars Zoom Hand #229233176399:  Hold'em No Limit ($0.01/$0.02) - 2021/08/21 23:19:55 CET [2021/08/21 17:19:55 ET]
Table 'Halley' 6-max Seat #1 is the button
Seat 1: Jones278 ($2.20 in chips) 
Seat 2: zergmiky ($2 in chips) 
Seat 3: FabOliveira9 ($2 in chips) 
Seat 4: Xlavariable ($2.83 in chips) 
Seat 5: Scaaalll ($3.46 in chips) 
Seat 6: Caabz ($3.54 in chips) 
zergmiky: posts small blind $0.01
FabOliveira9: posts big blind $0.02
*** HOLE CARDS ***
Dealt to Scaaalll [9c 6d]
Xlavariable: folds 
Scaaalll: folds 
Caabz: folds 
Jones278: folds 
zergmiky: folds 
Uncalled bet ($0.01) returned to FabOliveira9
FabOliveira9 collected $0.02 from pot
FabOliveira9: doesn't show hand 
*** SUMMARY ***
Total pot $0.02 | Rake $0 
Seat 1: Jones278 (button) folded before Flop (didn't bet)
Seat 2: zergmiky (small blind) folded before Flop
Seat 3: FabOliveira9 (big blind) collected ($0.02)
Seat 4: Xlavariable folded before Flop (didn't bet)
Seat 5: Scaaalll folded before Flop (didn't bet)
Seat 6: Caabz folded before Flop (didn't bet)



PokerStars Zoom Hand #229233174283:  Hold'em No Limit ($0.01/$0.02) - 2021/08/21 23:19:50 CET [2021/08/21 17:19:50 ET]
Table 'Halley' 6-max Seat #1 is the button
Seat 1: Koldun 2636 ($2.03 in chips) 
Seat 2: Scaaalll ($3.47 in chips) 
Seat 3: Soko 1381 ($2.21 in chips) 
Seat 4: znak312 ($2.15 in chips) 
Seat 5: sinkthe8 ($0.17 in chips) 
Seat 6: jnbjnb1010 ($1.90 in chips) 
Scaaalll: posts small blind $0.01
Soko 1381: posts big blind $0.02
*** HOLE CARDS ***
Dealt to Scaaalll [8h 6h]
znak312: folds 
sinkthe8: folds 
sinkthe8 is disconnected 
jnbjnb1010: raises $0.02 to $0.04
Koldun 2636: folds 
Scaaalll: folds 
Soko 1381: folds 
Uncalled bet ($0.02) returned to jnbjnb1010
jnbjnb1010 collected $0.05 from pot
jnbjnb1010: doesn't show hand 
*** SUMMARY ***
Total pot $0.05 | Rake $0 
Seat 1: Koldun 2636 (button) folded before Flop (didn't bet)
Seat 2: Scaaalll (small blind) folded before Flop
Seat 3: Soko 1381 (big blind) folded before Flop
Seat 4: znak312 folded before Flop (didn't bet)
Seat 5: sinkthe8 folded before Flop (didn't bet)
Seat 6: jnbjnb1010 collected ($0.05)



PokerStars Zoom Hand #229233184564:  Hold'em No Limit ($0.01/$0.02) - 2021/08/21 23:20:14 CET [2021/08/21 17:20:14 ET]
Table 'Halley' 6-max Seat #1 is the button
Seat 1: zergmiky ($2 in chips) 
Seat 2: Chapaev136 ($10.11 in chips) 
Seat 3: Scaaalll ($3.46 in chips) 
Seat 4: Yangyang1407 ($2.07 in chips) 
Seat 5: Ryan Colls ($1.86 in chips) 
Seat 6: 888lifeIS ($2 in chips) 
Chapaev136: posts small blind $0.01
Scaaalll: posts big blind $0.02
*** HOLE CARDS ***
Dealt to Scaaalll [3s 6s]
Yangyang1407: raises $0.04 to $0.06
Ryan Colls: folds 
888lifeIS: folds 
Ryan Colls is disconnected 
zergmiky: folds 
Chapaev136: folds 
Scaaalll: folds 
Uncalled bet ($0.04) returned to Yangyang1407
Yangyang1407 collected $0.05 from pot
Yangyang1407: doesn't show hand 
*** SUMMARY ***
Total pot $0.05 | Rake $0 
Seat 1: zergmiky (button) folded before Flop (didn't bet)
Seat 2: Chapaev136 (small blind) folded before Flop
Seat 3: Scaaalll (big blind) folded before Flop
Seat 4: Yangyang1407 collected ($0.05)
Seat 5: Ryan Colls folded before Flop (didn't bet)
Seat 6: 888lifeIS folded before Flop (didn't bet)



PokerStars Zoom Hand #229233182900:  Hold'em No Limit ($0.01/$0.02) - 2021/08/21 23:20:10 CET [2021/08/21 17:20:10 ET]
Table 'Halley' 6-max Seat #1 is the button
Seat 1: levachok ($5.19 in chips) 
Seat 2: GrindToGlory ($3.11 in chips) 
Seat 3: romul795 ($0.49 in chips) 
Seat 4: Scaaalll ($3.46 in chips) 
Seat 5: Merlin_Arg ($2.08 in chips) 
Seat 6: egroj1700 ($2 in chips) 
GrindToGlory: posts small blind $0.01
romul795: posts big blind $0.02
*** HOLE CARDS ***
Dealt to Scaaalll [Qh 6c]
Scaaalll: folds 
Merlin_Arg: calls $0.02
egroj1700: folds 
levachok: folds 
GrindToGlory: folds 
romul795: checks 
*** FLOP *** [2c Kd Jh]
romul795: checks 
Merlin_Arg: checks 
*** TURN *** [2c Kd Jh] [6s]
romul795: checks 
Merlin_Arg: checks 
*** RIVER *** [2c Kd Jh 6s] [Jd]
romul795: checks 
Merlin_Arg: checks 
*** SHOW DOWN ***
romul795: shows [3s 4d] (a pair of Jacks)
Merlin_Arg: shows [5s Ts] (a pair of Jacks - King+Ten kicker)
Merlin_Arg collected $0.05 from pot
*** SUMMARY ***
Total pot $0.05 | Rake $0 
Board [2c Kd Jh 6s Jd]
Seat 1: levachok (button) folded before Flop (didn't bet)
Seat 2: GrindToGlory (small blind) folded before Flop
Seat 3: romul795 (big blind) showed [3s 4d] and lost with a pair of Jacks
Seat 4: Scaaalll folded before Flop (didn't bet)
Seat 5: Merlin_Arg showed [5s Ts] and won ($0.05) with a pair of Jacks
Seat 6: egroj1700 folded before Flop (didn't bet)



PokerStars Zoom Hand #229233191348:  Hold'em No Limit ($0.01/$0.02) - 2021/08/21 23:20:30 CET [2021/08/21 17:20:30 ET]
Table 'Halley' 6-max Seat #1 is the button
Seat 1: Cineva81 ($2 in chips) 
Seat 2: WITKOW_AV ($3 in chips) 
Seat 3: didiclavi777 ($2.73 in chips) 
Seat 4: Scaaalll ($3.44 in chips) 
Seat 5: babiloniaxxx ($2.31 in chips) 
Seat 6: Mustang01373 ($1.30 in chips) 
WITKOW_AV: posts small blind $0.01
didiclavi777: posts big blind $0.02
*** HOLE CARDS ***
Dealt to Scaaalll [9d Ad]
Scaaalll: raises $0.04 to $0.06
babiloniaxxx: folds 
Mustang01373: folds 
Cineva81: folds 
WITKOW_AV: folds 
didiclavi777: calls $0.04
*** FLOP *** [Kh 2s Kd]
didiclavi777: checks 
Scaaalll: bets $0.08
didiclavi777: folds 
Uncalled bet ($0.08) returned to Scaaalll
Scaaalll collected $0.13 from pot
Scaaalll: doesn't show hand 
*** SUMMARY ***
Total pot $0.13 | Rake $0 
Board [Kh 2s Kd]
Seat 1: Cineva81 (button) folded before Flop (didn't bet)
Seat 2: WITKOW_AV (small blind) folded before Flop
Seat 3: didiclavi777 (big blind) folded on the Flop
Seat 4: Scaaalll collected ($0.13)
Seat 5: babiloniaxxx folded before Flop (didn't bet)
Seat 6: Mustang01373 folded before Flop (didn't bet)



PokerStars Zoom Hand #229233179852:  Hold'em No Limit ($0.01/$0.02) - 2021/08/21 23:20:03 CET [2021/08/21 17:20:03 ET]
Table 'Halley' 6-max Seat #1 is the button
Seat 1: amario89 ($2.03 in chips) 
Seat 2: Ck@tih@ ($1.76 in chips) 
Seat 3: 888lifeIS ($2 in chips) 
Seat 4: Scaaalll ($3.46 in chips) 
Seat 5: Reipinguimm ($2.36 in chips) 
Seat 6: kidninja888 ($2 in chips) 
Ck@tih@: posts small blind $0.01
888lifeIS: posts big blind $0.02
*** HOLE CARDS ***
Dealt to Scaaalll [8c 4d]
Scaaalll: folds 
Reipinguimm: folds 
kidninja888: folds 
amario89: folds 
Ck@tih@: calls $0.01
888lifeIS: checks 
*** FLOP *** [7c Th 7d]
Ck@tih@: checks 
888lifeIS: checks 
*** TURN *** [7c Th 7d] [7h]
Ck@tih@: checks 
888lifeIS: bets $0.03
Ck@tih@: calls $0.03
*** RIVER *** [7c Th 7d 7h] [8s]
Ck@tih@: bets $0.05
888lifeIS: calls $0.05
*** SHOW DOWN ***
Ck@tih@: shows [6c 6d] (a full house, Sevens full of Sixes)
888lifeIS: shows [Tc 2d] (a full house, Sevens full of Tens)
888lifeIS collected $0.19 from pot
*** SUMMARY ***
Total pot $0.20 | Rake $0.01 
Board [7c Th 7d 7h 8s]
Seat 1: amario89 (button) folded before Flop (didn't bet)
Seat 2: Ck@tih@ (small blind) showed [6c 6d] and lost with a full house, Sevens full of Sixes
Seat 3: 888lifeIS (big blind) showed [Tc 2d] and won ($0.19) with a full house, Sevens full of Tens
Seat 4: Scaaalll folded before Flop (didn't bet)
Seat 5: Reipinguimm folded before Flop (didn't bet)
Seat 6: kidninja888 folded before Flop (didn't bet)



PokerStars Zoom Hand #229233205754:  Hold'em No Limit ($0.01/$0.02) - 2021/08/21 23:21:04 CET [2021/08/21 17:21:04 ET]
Table 'Halley' 6-max Seat #1 is the button
Seat 1: MarselTop ($5.11 in chips) 
Seat 2: Scaaalll ($3.51 in chips) 
Seat 3: dkno77 ($1.80 in chips) 
Seat 4: MATIdf365 ($3.44 in chips) 
Seat 5: Baldisback ($3.30 in chips) 
Seat 6: WITKOW_AV ($3.44 in chips) 
Scaaalll: posts small blind $0.01
dkno77: posts big blind $0.02
*** HOLE CARDS ***
Dealt to Scaaalll [9s Qc]
MATIdf365: folds 
Baldisback: folds 
WITKOW_AV: folds 
MarselTop: raises $0.06 to $0.08
Scaaalll: folds 
dkno77: calls $0.06
*** FLOP *** [4d 5c Ts]
dkno77: checks 
MarselTop: bets $0.06
dkno77: folds 
Uncalled bet ($0.06) returned to MarselTop
MarselTop collected $0.16 from pot
MarselTop: doesn't show hand 
*** SUMMARY ***
Total pot $0.17 | Rake $0.01 
Board [4d 5c Ts]
Seat 1: MarselTop (button) collected ($0.16)
Seat 2: Scaaalll (small blind) folded before Flop
Seat 3: dkno77 (big blind) folded on the Flop
Seat 4: MATIdf365 folded before Flop (didn't bet)
Seat 5: Baldisback folded before Flop (didn't bet)
Seat 6: WITKOW_AV folded before Flop (didn't bet)



PokerStars Zoom Hand #229233211670:  Hold'em No Limit ($0.01/$0.02) - 2021/08/21 23:21:18 CET [2021/08/21 17:21:18 ET]
Table 'Halley' 6-max Seat #1 is the button
Seat 1: Scaaalll ($3.50 in chips) 
Seat 2: Koldun 2636 ($3.37 in chips) 
Seat 3: Reipinguimm ($2.30 in chips) 
Seat 4: Cineva81 ($2 in chips) 
Seat 5: Fenix888888 ($1.05 in chips) 
Seat 6: Shoxuzb ($2.06 in chips) 
Koldun 2636: posts small blind $0.01
Reipinguimm: posts big blind $0.02
*** HOLE CARDS ***
Dealt to Scaaalll [3s 8h]
Cineva81: raises $0.04 to $0.06
Fenix888888: folds 
Shoxuzb: raises $0.15 to $0.21
Scaaalll: folds 
Koldun 2636: folds 
Reipinguimm: calls $0.19
Cineva81: raises $1.79 to $2 and is all-in
Shoxuzb: folds 
Shoxuzb is disconnected 
Reipinguimm: folds 
Uncalled bet ($1.79) returned to Cineva81
Cineva81 collected $0.64 from pot
Cineva81: doesn't show hand 
*** SUMMARY ***
Total pot $0.64 | Rake $0 
Seat 1: Scaaalll (button) folded before Flop (didn't bet)
Seat 2: Koldun 2636 (small blind) folded before Flop
Seat 3: Reipinguimm (big blind) folded before Flop
Seat 4: Cineva81 collected ($0.64)
Seat 5: Fenix888888 folded before Flop (didn't bet)
Seat 6: Shoxuzb folded before Flop



PokerStars Zoom Hand #229233218556:  Hold'em No Limit ($0.01/$0.02) - 2021/08/21 23:21:34 CET [2021/08/21 17:21:34 ET]
Table 'Halley' 6-max Seat #1 is the button
Seat 1: AXXILLES ($3.75 in chips) 
Seat 2: BIITRU ($2.05 in chips) 
Seat 3: Scaaalll ($3.50 in chips) 
Seat 4: handrowan ($0.91 in chips) 
Seat 5: disanddowny ($1.82 in chips) 
Seat 6: Tibeau21 ($1 in chips) 
BIITRU: posts small blind $0.01
Scaaalll: posts big blind $0.02
*** HOLE CARDS ***
Dealt to Scaaalll [Ts Ad]
Tibeau21 is disconnected 
handrowan: raises $0.02 to $0.04
disanddowny: folds 
Tibeau21: folds 
AXXILLES: folds 
BIITRU: folds 
Scaaalll: calls $0.02
*** FLOP *** [7d 2s 2c]
Scaaalll: checks 
handrowan: bets $0.02
Scaaalll: folds 
Uncalled bet ($0.02) returned to handrowan
handrowan collected $0.09 from pot
handrowan: doesn't show hand 
*** SUMMARY ***
Total pot $0.09 | Rake $0 
Board [7d 2s 2c]
Seat 1: AXXILLES (button) folded before Flop (didn't bet)
Seat 2: BIITRU (small blind) folded before Flop
Seat 3: Scaaalll (big blind) folded on the Flop
Seat 4: handrowan collected ($0.09)
Seat 5: disanddowny folded before Flop (didn't bet)
Seat 6: Tibeau21 folded before Flop (didn't bet)



PokerStars Zoom Hand #229233215173:  Hold'em No Limit ($0.01/$0.02) - 2021/08/21 23:21:26 CET [2021/08/21 17:21:26 ET]
Table 'Halley' 6-max Seat #1 is the button
Seat 1: IIDARKROBOTII ($1.97 in chips) 
Seat 2: RomiSex ($2 in chips) 
Seat 3: Roachy 92 ($2.60 in chips) 
Seat 4: 888lifeIS ($2 in chips) 
Seat 5: TM 69 UIE ($2.19 in chips) 
Seat 6: Scaaalll ($3.50 in chips) 
RomiSex: posts small blind $0.01
Roachy 92: posts big blind $0.02
*** HOLE CARDS ***
Dealt to Scaaalll [8d Kc]
888lifeIS: folds 
TM 69 UIE: raises $0.04 to $0.06
Scaaalll: folds 
IIDARKROBOTII: calls $0.06
RomiSex: folds 
Roachy 92: calls $0.04
*** FLOP *** [As Td 5d]
Roachy 92: checks 
TM 69 UIE: checks 
IIDARKROBOTII: bets $0.03
Roachy 92: folds 
TM 69 UIE: calls $0.03
*** TURN *** [As Td 5d] [Kd]
TM 69 UIE: checks 
IIDARKROBOTII: bets $0.04
TM 69 UIE: folds 
Uncalled bet ($0.04) returned to IIDARKROBOTII
IIDARKROBOTII collected $0.24 from pot
IIDARKROBOTII: doesn't show hand 
TM 69 UIE is disconnected 
*** SUMMARY ***
Total pot $0.25 | Rake $0.01 
Board [As Td 5d Kd]
Seat 1: IIDARKROBOTII (button) collected ($0.24)
Seat 2: RomiSex (small blind) folded before Flop
Seat 3: Roachy 92 (big blind) folded on the Flop
Seat 4: 888lifeIS folded before Flop (didn't bet)
Seat 5: TM 69 UIE folded on the Turn
Seat 6: Scaaalll folded before Flop (didn't bet)



PokerStars Zoom Hand #229233228578:  Hold'em No Limit ($0.01/$0.02) - 2021/08/21 23:21:58 CET [2021/08/21 17:21:58 ET]
Table 'Halley' 6-max Seat #1 is the button
Seat 1: Misteltje ($0.33 in chips) 
Seat 2: ulisessoria ($2 in chips) 
Seat 3: Solarios ($4.82 in chips) 
Seat 4: Yangyang1407 ($2.19 in chips) 
Seat 5: elmex886 ($2.23 in chips) 
Seat 6: Scaaalll ($3.46 in chips) 
ulisessoria: posts small blind $0.01
Solarios: posts big blind $0.02
*** HOLE CARDS ***
Dealt to Scaaalll [As 6c]
Yangyang1407: folds 
elmex886: folds 
Scaaalll: folds 
Misteltje: raises $0.02 to $0.04
ulisessoria: folds 
Solarios: calls $0.02
*** FLOP *** [4d 8d Ks]
Solarios: checks 
Misteltje: bets $0.04
Solarios: folds 
Uncalled bet ($0.04) returned to Misteltje
Misteltje collected $0.09 from pot
Misteltje: doesn't show hand 
*** SUMMARY ***
Total pot $0.09 | Rake $0 
Board [4d 8d Ks]
Seat 1: Misteltje (button) collected ($0.09)
Seat 2: ulisessoria (small blind) folded before Flop
Seat 3: Solarios (big blind) folded on the Flop
Seat 4: Yangyang1407 folded before Flop (didn't bet)
Seat 5: elmex886 folded before Flop (didn't bet)
Seat 6: Scaaalll folded before Flop (didn't bet)



PokerStars Zoom Hand #229233234162:  Hold'em No Limit ($0.01/$0.02) - 2021/08/21 23:22:11 CET [2021/08/21 17:22:11 ET]
Table 'Halley' 6-max Seat #1 is the button
Seat 1: Scaaalll ($3.46 in chips) 
Seat 2: PapiMik3 ($7.54 in chips) 
Seat 3: sg.32rus ($1 in chips) 
Seat 4: Xpokerfreak ($1.95 in chips) 
Seat 5: Ogni ($4.91 in chips) 
Seat 6: Mrajax-Beardman ($1.73 in chips) 
PapiMik3: posts small blind $0.01
sg.32rus: posts big blind $0.02
*** HOLE CARDS ***
Dealt to Scaaalll [6d 3s]
Xpokerfreak: folds 
Ogni: folds 
Mrajax-Beardman: folds 
Scaaalll: folds 
PapiMik3: raises $0.04 to $0.06
sg.32rus: raises $0.12 to $0.18
PapiMik3: folds 
Uncalled bet ($0.12) returned to sg.32rus
sg.32rus collected $0.12 from pot
sg.32rus: doesn't show hand 
*** SUMMARY ***
Total pot $0.12 | Rake $0 
Seat 1: Scaaalll (button) folded before Flop (didn't bet)
Seat 2: PapiMik3 (small blind) folded before Flop
Seat 3: sg.32rus (big blind) collected ($0.12)
Seat 4: Xpokerfreak folded before Flop (didn't bet)
Seat 5: Ogni folded before Flop (didn't bet)
Seat 6: Mrajax-Beardman folded before Flop (didn't bet)



PokerStars Zoom Hand #229233237091:  Hold'em No Limit ($0.01/$0.02) - 2021/08/21 23:22:18 CET [2021/08/21 17:22:18 ET]
Table 'Halley' 6-max Seat #1 is the button
Seat 1: polymorhp ($1.97 in chips) 
Seat 2: kcyxa ($1.72 in chips) 
Seat 3: Vanekakqj ($4.49 in chips) 
Seat 4: Shoxuzb ($1.83 in chips) 
Seat 5: Scaaalll ($3.46 in chips) 
Seat 6: Vladimir1954 ($1.86 in chips) 
kcyxa: posts small blind $0.01
Vanekakqj: posts big blind $0.02
*** HOLE CARDS ***
Dealt to Scaaalll [Kh Th]
kcyxa is disconnected 
Shoxuzb: folds 
kcyxa is disconnected 
Shoxuzb is disconnected 
kcyxa is disconnected 
Scaaalll: raises $0.04 to $0.06
Vladimir1954: folds 
polymorhp: folds 
kcyxa: calls $0.05
Vanekakqj: folds 
*** FLOP *** [Tc Ks Ts]
kcyxa: checks 
Scaaalll: bets $0.09
kcyxa is disconnected 
kcyxa: folds 
Uncalled bet ($0.09) returned to Scaaalll
Scaaalll collected $0.14 from pot
Scaaalll: doesn't show hand 
kcyxa is disconnected 
*** SUMMARY ***
Total pot $0.14 | Rake $0 
Board [Tc Ks Ts]
Seat 1: polymorhp (button) folded before Flop (didn't bet)
Seat 2: kcyxa (small blind) folded on the Flop
Seat 3: Vanekakqj (big blind) folded before Flop
Seat 4: Shoxuzb folded before Flop (didn't bet)
Seat 5: Scaaalll collected ($0.14)
Seat 6: Vladimir1954 folded before Flop (didn't bet)



PokerStars Zoom Hand #229233249750:  Hold'em No Limit ($0.01/$0.02) - 2021/08/21 23:22:48 CET [2021/08/21 17:22:48 ET]
Table 'Halley' 6-max Seat #1 is the button
Seat 1: AlienMdeo ($2.05 in chips) 
Seat 2: Scaaalll ($3.54 in chips) 
Seat 3: juelz_ua ($1.47 in chips) 
Seat 4: olga3021221 ($2.03 in chips) 
Seat 5: fishh_play ($3.34 in chips) 
Seat 6: Trembon ($1.58 in chips) 
Scaaalll: posts small blind $0.01
juelz_ua: posts big blind $0.02
*** HOLE CARDS ***
Dealt to Scaaalll [As Ad]
olga3021221: folds 
fishh_play: folds 
Trembon: folds 
AlienMdeo: folds 
Scaaalll: raises $0.04 to $0.06
juelz_ua: calls $0.04
*** FLOP *** [Td Qc Jc]
Scaaalll: bets $0.08
juelz_ua: calls $0.08
*** TURN *** [Td Qc Jc] [9c]
Scaaalll: checks 
juelz_ua: bets $0.17
Scaaalll: folds 
Uncalled bet ($0.17) returned to juelz_ua
juelz_ua collected $0.27 from pot
juelz_ua: doesn't show hand 
*** SUMMARY ***
Total pot $0.28 | Rake $0.01 
Board [Td Qc Jc 9c]
Seat 1: AlienMdeo (button) folded before Flop (didn't bet)
Seat 2: Scaaalll (small blind) folded on the Turn
Seat 3: juelz_ua (big blind) collected ($0.27)
Seat 4: olga3021221 folded before Flop (didn't bet)
Seat 5: fishh_play folded before Flop (didn't bet)
Seat 6: Trembon folded before Flop (didn't bet)



PokerStars Zoom Hand #229233263113:  Hold'em No Limit ($0.01/$0.02) - 2021/08/21 23:23:20 CET [2021/08/21 17:23:20 ET]
Table 'Halley' 6-max Seat #1 is the button
Seat 1: QuienEsDezzed ($1.01 in chips) 
Seat 2: ernmic ($2.43 in chips) 
Seat 3: El Chicha.CL ($2 in chips) 
Seat 4: WITKOW_AV ($3.34 in chips) 
Seat 5: Scaaalll ($3.40 in chips) 
Seat 6: RzkPoker ($0.69 in chips) 
ernmic: posts small blind $0.01
El Chicha.CL: posts big blind $0.02
*** HOLE CARDS ***
Dealt to Scaaalll [5s 2s]
WITKOW_AV: folds 
Scaaalll: folds 
RzkPoker: raises $0.04 to $0.06
QuienEsDezzed: folds 
ernmic: folds 
El Chicha.CL: folds 
Uncalled bet ($0.04) returned to RzkPoker
RzkPoker collected $0.05 from pot
RzkPoker: doesn't show hand 
*** SUMMARY ***
Total pot $0.05 | Rake $0 
Seat 1: QuienEsDezzed (button) folded before Flop (didn't bet)
Seat 2: ernmic (small blind) folded before Flop
Seat 3: El Chicha.CL (big blind) folded before Flop
Seat 4: WITKOW_AV folded before Flop (didn't bet)
Seat 5: Scaaalll folded before Flop (didn't bet)
Seat 6: RzkPoker collected ($0.05)



PokerStars Zoom Hand #229233267275:  Hold'em No Limit ($0.01/$0.02) - 2021/08/21 23:23:30 CET [2021/08/21 17:23:30 ET]
Table 'Halley' 6-max Seat #1 is the button
Seat 1: Taran0001 ($3.38 in chips) 
Seat 2: trickywizard64 ($1.50 in chips) 
Seat 3: Scaaalll ($3.40 in chips) 
Seat 4: rpycmbEM ($5.98 in chips) 
Seat 5: SIGREX ($2.05 in chips) 
Seat 6: Kojak34 ($6.11 in chips) 
trickywizard64: posts small blind $0.01
Scaaalll: posts big blind $0.02
*** HOLE CARDS ***
Dealt to Scaaalll [Td 6c]
rpycmbEM: folds 
SIGREX: raises $0.02 to $0.04
Kojak34: folds 
Taran0001: calls $0.04
trickywizard64: folds 
Scaaalll: folds 
*** FLOP *** [3h 6d 4d]
SIGREX: checks 
Taran0001: checks 
*** TURN *** [3h 6d 4d] [Ks]
SIGREX: bets $0.08
Taran0001: folds 
Uncalled bet ($0.08) returned to SIGREX
SIGREX collected $0.11 from pot
SIGREX: doesn't show hand 
*** SUMMARY ***
Total pot $0.11 | Rake $0 
Board [3h 6d 4d Ks]
Seat 1: Taran0001 (button) folded on the Turn
Seat 2: trickywizard64 (small blind) folded before Flop
Seat 3: Scaaalll (big blind) folded before Flop
Seat 4: rpycmbEM folded before Flop (didn't bet)
Seat 5: SIGREX collected ($0.11)
Seat 6: Kojak34 folded before Flop (didn't bet)



PokerStars Zoom Hand #229233274426:  Hold'em No Limit ($0.01/$0.02) - 2021/08/21 23:23:47 CET [2021/08/21 17:23:47 ET]
Table 'Halley' 6-max Seat #1 is the button
Seat 1: Scaaalll ($3.38 in chips) 
Seat 2: Boris_Garich ($2.09 in chips) 
Seat 3: isurusa ($2.56 in chips) 
Seat 4: Pechorin.G ($2 in chips) 
Seat 5: KonopDima ($2.20 in chips) 
Seat 6: rpycmbEM ($3.65 in chips) 
Boris_Garich: posts small blind $0.01
isurusa: posts big blind $0.02
*** HOLE CARDS ***
Dealt to Scaaalll [9s 5s]
Pechorin.G: folds 
KonopDima: folds 
rpycmbEM: raises $0.03 to $0.05
Scaaalll: folds 
Boris_Garich: folds 
isurusa: folds 
Uncalled bet ($0.03) returned to rpycmbEM
rpycmbEM collected $0.05 from pot
rpycmbEM: doesn't show hand 
*** SUMMARY ***
Total pot $0.05 | Rake $0 
Seat 1: Scaaalll (button) folded before Flop (didn't bet)
Seat 2: Boris_Garich (small blind) folded before Flop
Seat 3: isurusa (big blind) folded before Flop
Seat 4: Pechorin.G folded before Flop (didn't bet)
Seat 5: KonopDima folded before Flop (didn't bet)
Seat 6: rpycmbEM collected ($0.05)



PokerStars Zoom Hand #229233279860:  Hold'em No Limit ($0.01/$0.02) - 2021/08/21 23:24:00 CET [2021/08/21 17:24:00 ET]
Table 'Halley' 6-max Seat #1 is the button
Seat 1: Valansen ($2 in chips) 
Seat 2: Posaunengodi ($2.76 in chips) 
Seat 3: fishh_play ($2.06 in chips) 
Seat 4: Scaaalll ($3.38 in chips) 
Seat 5: ust001 ($1.87 in chips) 
Seat 6: TTGemi ($2.02 in chips) 
Posaunengodi: posts small blind $0.01
fishh_play: posts big blind $0.02
*** HOLE CARDS ***
Dealt to Scaaalll [Qh Ac]
Scaaalll: raises $0.04 to $0.06
ust001: folds 
TTGemi: raises $0.18 to $0.24
Valansen: folds 
Posaunengodi: folds 
fishh_play: folds 
Scaaalll: folds 
Uncalled bet ($0.18) returned to TTGemi
TTGemi collected $0.15 from pot
TTGemi: doesn't show hand 
*** SUMMARY ***
Total pot $0.15 | Rake $0 
Seat 1: Valansen (button) folded before Flop (didn't bet)
Seat 2: Posaunengodi (small blind) folded before Flop
Seat 3: fishh_play (big blind) folded before Flop
Seat 4: Scaaalll folded before Flop
Seat 5: ust001 folded before Flop (didn't bet)
Seat 6: TTGemi collected ($0.15)



PokerStars Zoom Hand #229233292018:  Hold'em No Limit ($0.01/$0.02) - 2021/08/21 23:24:29 CET [2021/08/21 17:24:29 ET]
Table 'Halley' 6-max Seat #1 is the button
Seat 1: rabbitmeat73 ($1.43 in chips) 
Seat 2: Scaaalll ($3.32 in chips) 
Seat 3: ffffj ($0.79 in chips) 
Seat 4: IceTdannyB ($6.39 in chips) 
Seat 5: HubertFroh ($4.67 in chips) 
Seat 6: BIITRU ($2.34 in chips) 
Scaaalll: posts small blind $0.01
ffffj: posts big blind $0.02
*** HOLE CARDS ***
Dealt to Scaaalll [8s Qs]
IceTdannyB: folds 
IceTdannyB is disconnected 
HubertFroh: folds 
BIITRU: raises $0.03 to $0.05
rabbitmeat73: folds 
Scaaalll: folds 
ffffj: folds 
Uncalled bet ($0.03) returned to BIITRU
BIITRU collected $0.05 from pot
BIITRU: doesn't show hand 
*** SUMMARY ***
Total pot $0.05 | Rake $0 
Seat 1: rabbitmeat73 (button) folded before Flop (didn't bet)
Seat 2: Scaaalll (small blind) folded before Flop
Seat 3: ffffj (big blind) folded before Flop
Seat 4: IceTdannyB folded before Flop (didn't bet)
Seat 5: HubertFroh folded before Flop (didn't bet)
Seat 6: BIITRU collected ($0.05)



PokerStars Zoom Hand #229233296215:  Hold'em No Limit ($0.01/$0.02) - 2021/08/21 23:24:39 CET [2021/08/21 17:24:39 ET]
Table 'Halley' 6-max Seat #1 is the button
Seat 1: MetalCrüe ($0.58 in chips) 
Seat 2: FabOliveira9 ($2.29 in chips) 
Seat 3: pavlo8855 ($2 in chips) 
Seat 4: MKIronCrAAzy ($5.93 in chips) 
Seat 5: pv1ch ($2.63 in chips) 
Seat 6: Scaaalll ($3.31 in chips) 
FabOliveira9: posts small blind $0.01
pavlo8855: posts big blind $0.02
*** HOLE CARDS ***
Dealt to Scaaalll [Kc Js]
MKIronCrAAzy: folds 
pv1ch: folds 
Scaaalll: raises $0.04 to $0.06
MetalCrüe: folds 
FabOliveira9: folds 
pavlo8855: folds 
Uncalled bet ($0.04) returned to Scaaalll
Scaaalll collected $0.05 from pot
Scaaalll: doesn't show hand 
*** SUMMARY ***
Total pot $0.05 | Rake $0 
Seat 1: MetalCrüe (button) folded before Flop (didn't bet)
Seat 2: FabOliveira9 (small blind) folded before Flop
Seat 3: pavlo8855 (big blind) folded before Flop
Seat 4: MKIronCrAAzy folded before Flop (didn't bet)
Seat 5: pv1ch folded before Flop (didn't bet)
Seat 6: Scaaalll collected ($0.05)



PokerStars Zoom Hand #229233316030:  Hold'em No Limit ($0.01/$0.02) - 2021/08/21 23:25:13 CET [2021/08/21 17:25:13 ET]
Table 'Halley' 6-max Seat #1 is the button
Seat 1: FARA1982 ($1.19 in chips) 
Seat 2: NoEff0rt2w1n ($7.54 in chips) 
Seat 3: fishh_play ($2.98 in chips) 
Seat 4: LSDenny ($2.63 in chips) 
Seat 5: apadis ($1.04 in chips) 
Seat 6: Scaaalll ($3.34 in chips) 
NoEff0rt2w1n: posts small blind $0.01
fishh_play: posts big blind $0.02
*** HOLE CARDS ***
Dealt to Scaaalll [6d Jh]
LSDenny: folds 
LSDenny is disconnected 
apadis: folds 
apadis is disconnected 
Scaaalll: folds 
FARA1982: folds 
NoEff0rt2w1n: raises $0.03 to $0.05
fishh_play: folds 
Uncalled bet ($0.03) returned to NoEff0rt2w1n
NoEff0rt2w1n collected $0.04 from pot
NoEff0rt2w1n: doesn't show hand 
*** SUMMARY ***
Total pot $0.04 | Rake $0 
Seat 1: FARA1982 (button) folded before Flop (didn't bet)
Seat 2: NoEff0rt2w1n (small blind) collected ($0.04)
Seat 3: fishh_play (big blind) folded before Flop
Seat 4: LSDenny folded before Flop (didn't bet)
Seat 5: apadis folded before Flop (didn't bet)
Seat 6: Scaaalll folded before Flop (didn't bet)



PokerStars Zoom Hand #229233319862:  Hold'em No Limit ($0.01/$0.02) - 2021/08/21 23:25:22 CET [2021/08/21 17:25:22 ET]
Table 'Halley' 6-max Seat #1 is the button
Seat 1: OllieHD ($1.73 in chips) 
Seat 2: Kb013497 ($2.08 in chips) 
Seat 3: Scaaalll ($3.34 in chips) 
Seat 4: punkosk8 ($3.70 in chips) 
Seat 5: LucasLMdS ($2.71 in chips) 
Seat 6: LeoZ77755 ($2.07 in chips) 
Kb013497: posts small blind $0.01
Scaaalll: posts big blind $0.02
*** HOLE CARDS ***
Dealt to Scaaalll [4s 8h]
LeoZ77755 is disconnected 
punkosk8: folds 
LucasLMdS: folds 
LeoZ77755: folds 
punkosk8 is disconnected 
OllieHD: raises $0.04 to $0.06
Kb013497: folds 
Scaaalll: folds 
Uncalled bet ($0.04) returned to OllieHD
OllieHD collected $0.05 from pot
OllieHD: doesn't show hand 
*** SUMMARY ***
Total pot $0.05 | Rake $0 
Seat 1: OllieHD (button) collected ($0.05)
Seat 2: Kb013497 (small blind) folded before Flop
Seat 3: Scaaalll (big blind) folded before Flop
Seat 4: punkosk8 folded before Flop (didn't bet)
Seat 5: LucasLMdS folded before Flop (didn't bet)
Seat 6: LeoZ77755 folded before Flop (didn't bet)



PokerStars Zoom Hand #229233326706:  Hold'em No Limit ($0.01/$0.02) - 2021/08/21 23:25:38 CET [2021/08/21 17:25:38 ET]
Table 'Halley' 6-max Seat #1 is the button
Seat 1: Scaaalll ($3.32 in chips) 
Seat 2: polymorhp ($2.73 in chips) 
Seat 3: KonopDima ($2.17 in chips) 
Seat 4: porcorosso23 ($4.38 in chips) 
Seat 5: gizum17 ($2.04 in chips) 
Seat 6: Rin97 ($2 in chips) 
polymorhp: posts small blind $0.01
KonopDima: posts big blind $0.02
*** HOLE CARDS ***
Dealt to Scaaalll [3d 5h]
porcorosso23: folds 
gizum17: folds 
Rin97: raises $0.04 to $0.06
Scaaalll: folds 
polymorhp: raises $2.67 to $2.73 and is all-in
KonopDima: folds 
Rin97: calls $1.94 and is all-in
Uncalled bet ($0.73) returned to polymorhp
*** FLOP *** [2h Qc 5c]
*** TURN *** [2h Qc 5c] [7d]
*** RIVER *** [2h Qc 5c 7d] [4d]
*** SHOW DOWN ***
polymorhp: shows [Kd Ah] (high card Ace)
Rin97: shows [Ac Kc] (high card Ace)
polymorhp collected $1.94 from pot
Rin97 collected $1.94 from pot
*** SUMMARY ***
Total pot $4.02 | Rake $0.14 
Board [2h Qc 5c 7d 4d]
Seat 1: Scaaalll (button) folded before Flop (didn't bet)
Seat 2: polymorhp (small blind) showed [Kd Ah] and won ($1.94) with high card Ace
Seat 3: KonopDima (big blind) folded before Flop
Seat 4: porcorosso23 folded before Flop (didn't bet)
Seat 5: gizum17 folded before Flop (didn't bet)
Seat 6: Rin97 showed [Ac Kc] and won ($1.94) with high card Ace



PokerStars Zoom Hand #229233331210:  Hold'em No Limit ($0.01/$0.02) - 2021/08/21 23:25:49 CET [2021/08/21 17:25:49 ET]
Table 'Halley' 6-max Seat #1 is the button
Seat 1: Trembon ($1.52 in chips) 
Seat 2: Scaaalll ($3.32 in chips) 
Seat 3: le_vlimeux ($2 in chips) 
Seat 4: josealfredonino ($1.81 in chips) 
Seat 5: Marcus579 ($3.16 in chips) 
Seat 6: volt_by ($0.78 in chips) 
Scaaalll: posts small blind $0.01
le_vlimeux: posts big blind $0.02
*** HOLE CARDS ***
Dealt to Scaaalll [4h Jc]
josealfredonino: raises $0.04 to $0.06
Marcus579: folds 
volt_by: calls $0.06
Trembon: folds 
Scaaalll: folds 
le_vlimeux: folds 
*** FLOP *** [7c Td Tc]
josealfredonino: bets $0.06
volt_by: calls $0.06
*** TURN *** [7c Td Tc] [5h]
josealfredonino: checks 
volt_by: bets $0.13
josealfredonino: folds 
Uncalled bet ($0.13) returned to volt_by
volt_by collected $0.26 from pot
volt_by: doesn't show hand 
*** SUMMARY ***
Total pot $0.27 | Rake $0.01 
Board [7c Td Tc 5h]
Seat 1: Trembon (button) folded before Flop (didn't bet)
Seat 2: Scaaalll (small blind) folded before Flop
Seat 3: le_vlimeux (big blind) folded before Flop
Seat 4: josealfredonino folded on the Turn
Seat 5: Marcus579 folded before Flop (didn't bet)
Seat 6: volt_by collected ($0.26)



PokerStars Zoom Hand #229233312718:  Hold'em No Limit ($0.01/$0.02) - 2021/08/21 23:25:05 CET [2021/08/21 17:25:05 ET]
Table 'Halley' 6-max Seat #1 is the button
Seat 1: MattieBOZ ($1.46 in chips) 
Seat 2: Goingold77 ($1.89 in chips) 
Seat 3: rekopo203 ($7.31 in chips) 
Seat 4: yorkoss ($3.06 in chips) 
Seat 5: Scaaalll ($3.34 in chips) 
Seat 6: djovex ($2 in chips) 
Goingold77: posts small blind $0.01
rekopo203: posts big blind $0.02
*** HOLE CARDS ***
Dealt to Scaaalll [5h Ad]
yorkoss: folds 
MattieBOZ is disconnected 
djovex is disconnected 
Scaaalll: folds 
djovex: folds 
MattieBOZ: folds 
Goingold77: calls $0.01
rekopo203 has timed out
rekopo203: checks 
*** FLOP *** [6d Jc Jh]
Goingold77: checks 
rekopo203: checks 
*** TURN *** [6d Jc Jh] [Kd]
Goingold77: checks 
rekopo203: checks 
*** RIVER *** [6d Jc Jh Kd] [Qd]
Goingold77: bets $0.04
rekopo203: folds 
Uncalled bet ($0.04) returned to Goingold77
Goingold77 collected $0.04 from pot
Goingold77: doesn't show hand 
*** SUMMARY ***
Total pot $0.04 | Rake $0 
Board [6d Jc Jh Kd Qd]
Seat 1: MattieBOZ (button) folded before Flop (didn't bet)
Seat 2: Goingold77 (small blind) collected ($0.04)
Seat 3: rekopo203 (big blind) folded on the River
Seat 4: yorkoss folded before Flop (didn't bet)
Seat 5: Scaaalll folded before Flop (didn't bet)
Seat 6: djovex folded before Flop (didn't bet)



PokerStars Zoom Hand #229233336144:  Hold'em No Limit ($0.01/$0.02) - 2021/08/21 23:26:01 CET [2021/08/21 17:26:01 ET]
Table 'Halley' 6-max Seat #1 is the button
Seat 1: lucksuckdonk ($6.57 in chips) 
Seat 2: Phoenixxxxxxxx ($3.55 in chips) 
Seat 3: Busya777 ($2.74 in chips) 
Seat 4: KKARMELO ($3.38 in chips) 
Seat 5: Scaaalll ($3.31 in chips) 
Seat 6: 21041956 ($1.32 in chips) 
Phoenixxxxxxxx: posts small blind $0.01
Busya777: posts big blind $0.02
*** HOLE CARDS ***
Dealt to Scaaalll [Jd Ts]
KKARMELO: folds 
Scaaalll: folds 
21041956: folds 
lucksuckdonk: folds 
Phoenixxxxxxxx: raises $0.03 to $0.05
Busya777: folds 
Uncalled bet ($0.03) returned to Phoenixxxxxxxx
Phoenixxxxxxxx collected $0.04 from pot
Phoenixxxxxxxx: doesn't show hand 
Busya777 is disconnected 
*** SUMMARY ***
Total pot $0.04 | Rake $0 
Seat 1: lucksuckdonk (button) folded before Flop (didn't bet)
Seat 2: Phoenixxxxxxxx (small blind) collected ($0.04)
Seat 3: Busya777 (big blind) folded before Flop
Seat 4: KKARMELO folded before Flop (didn't bet)
Seat 5: Scaaalll folded before Flop (didn't bet)
Seat 6: 21041956 folded before Flop (didn't bet)



PokerStars Zoom Hand #229233338953:  Hold'em No Limit ($0.01/$0.02) - 2021/08/21 23:26:07 CET [2021/08/21 17:26:07 ET]
Table 'Halley' 6-max Seat #1 is the button
Seat 1: Langusta1 ($1.52 in chips) 
Seat 2: REZAKOV72 ($3.23 in chips) 
Seat 3: NoEff0rt2w1n ($5.83 in chips) 
Seat 4: Scaaalll ($3.31 in chips) 
Seat 5: morpheus206 ($2.17 in chips) 
Seat 6: AbusiveLion ($1.92 in chips) 
REZAKOV72: posts small blind $0.01
NoEff0rt2w1n: posts big blind $0.02
*** HOLE CARDS ***
Dealt to Scaaalll [5s Ts]
AbusiveLion is disconnected 
Scaaalll: folds 
morpheus206: raises $0.04 to $0.06
AbusiveLion: folds 
Langusta1: folds 
REZAKOV72: calls $0.05
NoEff0rt2w1n: folds 
*** FLOP *** [Jh 5h 8h]
REZAKOV72: checks 
morpheus206: bets $0.09
REZAKOV72: calls $0.09
*** TURN *** [Jh 5h 8h] [Qd]
REZAKOV72: checks 
morpheus206: checks 
*** RIVER *** [Jh 5h 8h Qd] [2d]
REZAKOV72: checks 
morpheus206: checks 
*** SHOW DOWN ***
REZAKOV72: shows [6d Ah] (high card Ace)
morpheus206: mucks hand 
REZAKOV72 collected $0.31 from pot
*** SUMMARY ***
Total pot $0.32 | Rake $0.01 
Board [Jh 5h 8h Qd 2d]
Seat 1: Langusta1 (button) folded before Flop (didn't bet)
Seat 2: REZAKOV72 (small blind) showed [6d Ah] and won ($0.31) with high card Ace
Seat 3: NoEff0rt2w1n (big blind) folded before Flop
Seat 4: Scaaalll folded before Flop (didn't bet)
Seat 5: morpheus206 mucked [9c Kc]
Seat 6: AbusiveLion folded before Flop (didn't bet)



PokerStars Zoom Hand #229233342054:  Hold'em No Limit ($0.01/$0.02) - 2021/08/21 23:26:15 CET [2021/08/21 17:26:15 ET]
Table 'Halley' 6-max Seat #1 is the button
Seat 1: Dr.stromg ($4.79 in chips) 
Seat 2: ZermeloFraenkel ($2.29 in chips) 
Seat 3: Scaaalll ($3.31 in chips) 
Seat 4: KKARMELO ($3.37 in chips) 
Seat 5: Pechorin.G ($2.95 in chips) 
Seat 6: FrancoOlmedo ($1.97 in chips) 
ZermeloFraenkel: posts small blind $0.01
Scaaalll: posts big blind $0.02
*** HOLE CARDS ***
Dealt to Scaaalll [9c Qd]
KKARMELO: raises $0.03 to $0.05
Pechorin.G: folds 
FrancoOlmedo: folds 
Dr.stromg: folds 
ZermeloFraenkel: folds 
Scaaalll: folds 
Uncalled bet ($0.03) returned to KKARMELO
KKARMELO collected $0.05 from pot
KKARMELO: doesn't show hand 
*** SUMMARY ***
Total pot $0.05 | Rake $0 
Seat 1: Dr.stromg (button) folded before Flop (didn't bet)
Seat 2: ZermeloFraenkel (small blind) folded before Flop
Seat 3: Scaaalll (big blind) folded before Flop
Seat 4: KKARMELO collected ($0.05)
Seat 5: Pechorin.G folded before Flop (didn't bet)
Seat 6: FrancoOlmedo folded before Flop (didn't bet)



PokerStars Zoom Hand #229233350886:  Hold'em No Limit ($0.01/$0.02) - 2021/08/21 23:26:36 CET [2021/08/21 17:26:36 ET]
Table 'Halley' 6-max Seat #1 is the button
Seat 1: babiloniaxxx ($4.86 in chips) 
Seat 2: ulisessoria ($2.16 in chips) 
Seat 3: keldh ($5.40 in chips) 
Seat 4: isurusa ($2.72 in chips) 
Seat 5: Pizotifen ($2.54 in chips) 
Seat 6: Scaaalll ($3.29 in chips) 
ulisessoria: posts small blind $0.01
keldh: posts big blind $0.02
*** HOLE CARDS ***
Dealt to Scaaalll [Qs Ts]
isurusa: folds 
Pizotifen: raises $0.04 to $0.06
Scaaalll: calls $0.06
babiloniaxxx: folds 
ulisessoria: folds 
keldh: folds 
*** FLOP *** [2c 6h Ac]
Pizotifen: bets $0.05
Scaaalll: folds 
Uncalled bet ($0.05) returned to Pizotifen
Pizotifen collected $0.14 from pot
Pizotifen: doesn't show hand 
*** SUMMARY ***
Total pot $0.15 | Rake $0.01 
Board [2c 6h Ac]
Seat 1: babiloniaxxx (button) folded before Flop (didn't bet)
Seat 2: ulisessoria (small blind) folded before Flop
Seat 3: keldh (big blind) folded before Flop
Seat 4: isurusa folded before Flop (didn't bet)
Seat 5: Pizotifen collected ($0.14)
Seat 6: Scaaalll folded on the Flop



PokerStars Zoom Hand #229233363643:  Hold'em No Limit ($0.01/$0.02) - 2021/08/21 23:27:06 CET [2021/08/21 17:27:06 ET]
Table 'Halley' 6-max Seat #1 is the button
Seat 1: ChowMangao ($3 in chips) 
Seat 2: Scaaalll ($3.23 in chips) 
Seat 3: ZermeloFraenkel ($2.25 in chips) 
Seat 4: OmahaWheels ($3.16 in chips) 
Seat 5: rpycmbEM ($2.42 in chips) 
Seat 6: ash1448 ($6.04 in chips) 
Scaaalll: posts small blind $0.01
ZermeloFraenkel: posts big blind $0.02
*** HOLE CARDS ***
Dealt to Scaaalll [7d 6h]
OmahaWheels: raises $0.04 to $0.06
rpycmbEM: folds 
ash1448: raises $0.12 to $0.18
ChowMangao: folds 
Scaaalll: folds 
ZermeloFraenkel: folds 
OmahaWheels: folds 
Uncalled bet ($0.12) returned to ash1448
ash1448 collected $0.15 from pot
ash1448: doesn't show hand 
*** SUMMARY ***
Total pot $0.15 | Rake $0 
Seat 1: ChowMangao (button) folded before Flop (didn't bet)
Seat 2: Scaaalll (small blind) folded before Flop
Seat 3: ZermeloFraenkel (big blind) folded before Flop
Seat 4: OmahaWheels folded before Flop
Seat 5: rpycmbEM folded before Flop (didn't bet)
Seat 6: ash1448 collected ($0.15)



PokerStars Zoom Hand #229233370778:  Hold'em No Limit ($0.01/$0.02) - 2021/08/21 23:27:23 CET [2021/08/21 17:27:23 ET]
Table 'Halley' 6-max Seat #1 is the button
Seat 1: Scaaalll ($3.22 in chips) 
Seat 2: Bol'tazar111 ($2.33 in chips) 
Seat 3: OmahaWheels ($3.10 in chips) 
Seat 4: cutter2468 ($2.09 in chips) 
Seat 5: 0ofreeo0 ($2.33 in chips) 
Seat 6: Pizotifen ($2.70 in chips) 
Bol'tazar111: posts small blind $0.01
OmahaWheels: posts big blind $0.02
*** HOLE CARDS ***
Dealt to Scaaalll [Qs 4d]
cutter2468: folds 
0ofreeo0: folds 
Pizotifen: folds 
Scaaalll: folds 
Bol'tazar111: folds 
Uncalled bet ($0.01) returned to OmahaWheels
OmahaWheels collected $0.02 from pot
OmahaWheels: doesn't show hand 
*** SUMMARY ***
Total pot $0.02 | Rake $0 
Seat 1: Scaaalll (button) folded before Flop (didn't bet)
Seat 2: Bol'tazar111 (small blind) folded before Flop
Seat 3: OmahaWheels (big blind) collected ($0.02)
Seat 4: cutter2468 folded before Flop (didn't bet)
Seat 5: 0ofreeo0 folded before Flop (didn't bet)
Seat 6: Pizotifen folded before Flop (didn't bet)



PokerStars Zoom Hand #229233378719:  Hold'em No Limit ($0.01/$0.02) - 2021/08/21 23:27:42 CET [2021/08/21 17:27:42 ET]
Table 'Halley' 6-max Seat #1 is the button
Seat 1: GVMELLO ($2.09 in chips) 
Seat 2: estelionat171 ($1.21 in chips) 
Seat 3: Scaaalll ($3.22 in chips) 
Seat 4: Phoenixxxxxxxx ($2 in chips) 
Seat 5: ronald1982 ($2.13 in chips) 
Seat 6: PapiMik3 ($3.24 in chips) 
estelionat171: posts small blind $0.01
Scaaalll: posts big blind $0.02
*** HOLE CARDS ***
Dealt to Scaaalll [8d 9c]
Phoenixxxxxxxx: folds 
ronald1982: folds 
PapiMik3: folds 
GVMELLO: folds 
estelionat171: folds 
Uncalled bet ($0.01) returned to Scaaalll
Scaaalll collected $0.02 from pot
Scaaalll: doesn't show hand 
*** SUMMARY ***
Total pot $0.02 | Rake $0 
Seat 1: GVMELLO (button) folded before Flop (didn't bet)
Seat 2: estelionat171 (small blind) folded before Flop
Seat 3: Scaaalll (big blind) collected ($0.02)
Seat 4: Phoenixxxxxxxx folded before Flop (didn't bet)
Seat 5: ronald1982 folded before Flop (didn't bet)
Seat 6: PapiMik3 folded before Flop (didn't bet)



PokerStars Zoom Hand #229233386266:  Hold'em No Limit ($0.01/$0.02) - 2021/08/21 23:28:00 CET [2021/08/21 17:28:00 ET]
Table 'Halley' 6-max Seat #1 is the button
Seat 1: kidninja888 ($2.06 in chips) 
Seat 2: Busya777 ($2.68 in chips) 
Seat 3: estelionat171 ($1.20 in chips) 
Seat 4: Scaaalll ($3.23 in chips) 
Seat 5: FARA1982 ($1.04 in chips) 
Seat 6: cr@sh test ($4.60 in chips) 
Busya777: posts small blind $0.01
estelionat171: posts big blind $0.02
*** HOLE CARDS ***
Dealt to Scaaalll [3c 7d]
Busya777 is disconnected 
Scaaalll: folds 
FARA1982: folds 
cr@sh test: folds 
kidninja888: raises $0.03 to $0.05
Busya777: folds 
estelionat171: folds 
Uncalled bet ($0.03) returned to kidninja888
kidninja888 collected $0.05 from pot
kidninja888: doesn't show hand 
*** SUMMARY ***
Total pot $0.05 | Rake $0 
Seat 1: kidninja888 (button) collected ($0.05)
Seat 2: Busya777 (small blind) folded before Flop
Seat 3: estelionat171 (big blind) folded before Flop
Seat 4: Scaaalll folded before Flop (didn't bet)
Seat 5: FARA1982 folded before Flop (didn't bet)
Seat 6: cr@sh test folded before Flop (didn't bet)



PokerStars Zoom Hand #229233376172:  Hold'em No Limit ($0.01/$0.02) - 2021/08/21 23:27:36 CET [2021/08/21 17:27:36 ET]
Table 'Halley' 6-max Seat #1 is the button
Seat 1: ffffj ($0.71 in chips) 
Seat 2: kumka8812 ($1.98 in chips) 
Seat 3: Lekcey05 ($2 in chips) 
Seat 4: dannyluijten ($2.40 in chips) 
Seat 5: Scaaalll ($3.22 in chips) 
Seat 6: Kojak34 ($6.03 in chips) 
kumka8812: posts small blind $0.01
Lekcey05: posts big blind $0.02
*** HOLE CARDS ***
Dealt to Scaaalll [2c 6d]
dannyluijten: folds 
Scaaalll: folds 
Kojak34: raises $0.05 to $0.07
ffffj: folds 
kumka8812: calls $0.06
Lekcey05: raises $0.19 to $0.26
Kojak34: folds 
kumka8812: calls $0.19
*** FLOP *** [Tc 8h 2s]
kumka8812: bets $0.28
Lekcey05: raises $0.52 to $0.80
kumka8812: raises $0.92 to $1.72 and is all-in
Lekcey05: calls $0.92
*** TURN *** [Tc 8h 2s] [3c]
*** RIVER *** [Tc 8h 2s 3c] [8s]
*** SHOW DOWN ***
kumka8812: shows [4s Ts] (two pair, Tens and Eights)
Lekcey05: shows [Ah As] (two pair, Aces and Eights)
Lekcey05 collected $3.89 from pot
kumka8812 cashed out the hand for $0.85 | Cash Out Fee $0.01
*** SUMMARY ***
Total pot $4.03 | Rake $0.14 
Board [Tc 8h 2s 3c 8s]
Seat 1: ffffj (button) folded before Flop (didn't bet)
Seat 2: kumka8812 (small blind) showed [4s Ts] and lost with two pair, Tens and Eights (cashed out).
Seat 3: Lekcey05 (big blind) showed [Ah As] and won ($3.89) with two pair, Aces and Eights
Seat 4: dannyluijten folded before Flop (didn't bet)
Seat 5: Scaaalll folded before Flop (didn't bet)
Seat 6: Kojak34 folded before Flop



PokerStars Zoom Hand #229233390049:  Hold'em No Limit ($0.01/$0.02) - 2021/08/21 23:28:09 CET [2021/08/21 17:28:09 ET]
Table 'Halley' 6-max Seat #1 is the button
Seat 1: WaiT4U ($4.40 in chips) 
Seat 2: NoEff0rt2w1n ($7.66 in chips) 
Seat 3: bennodiem ($1.55 in chips) 
Seat 4: Scaaalll ($3.23 in chips) 
Seat 5: cutter2468 ($3.67 in chips) 
Seat 6: Vanekakqj ($2.59 in chips) 
NoEff0rt2w1n: posts small blind $0.01
bennodiem: posts big blind $0.02
*** HOLE CARDS ***
Dealt to Scaaalll [Qs 6d]
Scaaalll: folds 
cutter2468: raises $0.03 to $0.05
Vanekakqj: folds 
WaiT4U: folds 
NoEff0rt2w1n: folds 
bennodiem: calls $0.03
*** FLOP *** [6h Jd 4s]
bennodiem: bets $0.02
cutter2468: calls $0.02
*** TURN *** [6h Jd 4s] [2s]
bennodiem: bets $0.07
cutter2468: raises $0.14 to $0.21
bennodiem: calls $0.14
*** RIVER *** [6h Jd 4s 2s] [8s]
bennodiem: bets $0.28
cutter2468: calls $0.28
*** SHOW DOWN ***
bennodiem: shows [8d 6c] (two pair, Eights and Sixes)
cutter2468: mucks hand 
bennodiem collected $1.09 from pot
*** SUMMARY ***
Total pot $1.13 | Rake $0.04 
Board [6h Jd 4s 2s 8s]
Seat 1: WaiT4U (button) folded before Flop (didn't bet)
Seat 2: NoEff0rt2w1n (small blind) folded before Flop
Seat 3: bennodiem (big blind) showed [8d 6c] and won ($1.09) with two pair, Eights and Sixes
Seat 4: Scaaalll folded before Flop (didn't bet)
Seat 5: cutter2468 mucked [9d 9s]
Seat 6: Vanekakqj folded before Flop (didn't bet)



PokerStars Zoom Hand #229233401921:  Hold'em No Limit ($0.01/$0.02) - 2021/08/21 23:28:37 CET [2021/08/21 17:28:37 ET]
Table 'Halley' 6-max Seat #1 is the button
Seat 1: Scaaalll ($3.21 in chips) 
Seat 2: so0love ($4.50 in chips) 
Seat 3: KonopDima ($2.04 in chips) 
Seat 4: ulisessoria ($2.03 in chips) 
Seat 5: GVMELLO ($2.04 in chips) 
Seat 6: prosto lili ($0.86 in chips) 
so0love: posts small blind $0.01
KonopDima: posts big blind $0.02
*** HOLE CARDS ***
Dealt to Scaaalll [8h 4s]
ulisessoria: folds 
GVMELLO: folds 
prosto lili: folds 
Scaaalll: folds 
so0love: raises $0.02 to $0.04
KonopDima: folds 
Uncalled bet ($0.02) returned to so0love
so0love collected $0.04 from pot
so0love: doesn't show hand 
*** SUMMARY ***
Total pot $0.04 | Rake $0 
Seat 1: Scaaalll (button) folded before Flop (didn't bet)
Seat 2: so0love (small blind) collected ($0.04)
Seat 3: KonopDima (big blind) folded before Flop
Seat 4: ulisessoria folded before Flop (didn't bet)
Seat 5: GVMELLO folded before Flop (didn't bet)
Seat 6: prosto lili folded before Flop (didn't bet)



PokerStars Zoom Hand #229233393016:  Hold'em No Limit ($0.01/$0.02) - 2021/08/21 23:28:16 CET [2021/08/21 17:28:16 ET]
Table 'Halley' 6-max Seat #1 is the button
Seat 1: Vanekakqj ($4.31 in chips) 
Seat 2: Scaaalll ($3.23 in chips) 
Seat 3: ffffj ($0.68 in chips) 
Seat 4: fishh_play ($2.94 in chips) 
Seat 5: kukulagosleep ($3.62 in chips) 
Seat 6: alexchamps ($1.65 in chips) 
Scaaalll: posts small blind $0.01
ffffj: posts big blind $0.02
*** HOLE CARDS ***
Dealt to Scaaalll [Qh 8d]
fishh_play: folds 
kukulagosleep: folds 
alexchamps: calls $0.02
Vanekakqj: folds 
Scaaalll: calls $0.01
ffffj: checks 
*** FLOP *** [Jd Kh 5d]
Scaaalll: checks 
ffffj: checks 
alexchamps: bets $0.06
Scaaalll: folds 
ffffj: raises $0.10 to $0.16
alexchamps: calls $0.10
*** TURN *** [Jd Kh 5d] [8c]
ffffj: bets $0.50 and is all-in
alexchamps: folds 
Uncalled bet ($0.50) returned to ffffj
ffffj collected $0.37 from pot
ffffj: doesn't show hand 
alexchamps is disconnected 
*** SUMMARY ***
Total pot $0.38 | Rake $0.01 
Board [Jd Kh 5d 8c]
Seat 1: Vanekakqj (button) folded before Flop (didn't bet)
Seat 2: Scaaalll (small blind) folded on the Flop
Seat 3: ffffj (big blind) collected ($0.37)
Seat 4: fishh_play folded before Flop (didn't bet)
Seat 5: kukulagosleep folded before Flop (didn't bet)
Seat 6: alexchamps folded on the Turn



PokerStars Zoom Hand #229233410421:  Hold'em No Limit ($0.01/$0.02) - 2021/08/21 23:28:57 CET [2021/08/21 17:28:57 ET]
Table 'Halley' 6-max Seat #1 is the button
Seat 1: Koldun 2636 ($4.78 in chips) 
Seat 2: Mr.Kurier ($4.51 in chips) 
Seat 3: juju868 ($2.09 in chips) 
Seat 4: FabOliveira9 ($2.18 in chips) 
Seat 5: Scaaalll ($3.21 in chips) 
Seat 6: timatrue ($2.05 in chips) 
Mr.Kurier: posts small blind $0.01
juju868: posts big blind $0.02
*** HOLE CARDS ***
Dealt to Scaaalll [4c 9h]
FabOliveira9: folds 
timatrue is disconnected 
Scaaalll: folds 
timatrue: folds 
Koldun 2636: folds 
Mr.Kurier: folds 
Uncalled bet ($0.01) returned to juju868
juju868 collected $0.02 from pot
juju868: doesn't show hand 
*** SUMMARY ***
Total pot $0.02 | Rake $0 
Seat 1: Koldun 2636 (button) folded before Flop (didn't bet)
Seat 2: Mr.Kurier (small blind) folded before Flop
Seat 3: juju868 (big blind) collected ($0.02)
Seat 4: FabOliveira9 folded before Flop (didn't bet)
Seat 5: Scaaalll folded before Flop (didn't bet)
Seat 6: timatrue folded before Flop (didn't bet)



PokerStars Zoom Hand #229233407902:  Hold'em No Limit ($0.01/$0.02) - 2021/08/21 23:28:51 CET [2021/08/21 17:28:51 ET]
Table 'Halley' 6-max Seat #1 is the button
Seat 1: FrancoOlmedo ($1.85 in chips) 
Seat 2: El Chicha.CL ($3.87 in chips) 
Seat 3: Yangyang1407 ($2 in chips) 
Seat 4: pipecmolodec ($2 in chips) 
Seat 5: Feliciano16 ($3.82 in chips) 
Seat 6: Scaaalll ($3.21 in chips) 
El Chicha.CL: posts small blind $0.01
Yangyang1407: posts big blind $0.02
*** HOLE CARDS ***
Dealt to Scaaalll [Ac 3d]
pipecmolodec: folds 
Feliciano16: folds 
Scaaalll: folds 
FrancoOlmedo: raises $0.04 to $0.06
El Chicha.CL: folds 
Yangyang1407: folds 
Uncalled bet ($0.04) returned to FrancoOlmedo
FrancoOlmedo collected $0.05 from pot
FrancoOlmedo: doesn't show hand 
*** SUMMARY ***
Total pot $0.05 | Rake $0 
Seat 1: FrancoOlmedo (button) collected ($0.05)
Seat 2: El Chicha.CL (small blind) folded before Flop
Seat 3: Yangyang1407 (big blind) folded before Flop
Seat 4: pipecmolodec folded before Flop (didn't bet)
Seat 5: Feliciano16 folded before Flop (didn't bet)
Seat 6: Scaaalll folded before Flop (didn't bet)



PokerStars Zoom Hand #229233419258:  Hold'em No Limit ($0.01/$0.02) - 2021/08/21 23:29:18 CET [2021/08/21 17:29:18 ET]
Table 'Halley' 6-max Seat #1 is the button
Seat 1: dannybird1 ($0.69 in chips) 
Seat 2: dinoVIEIRA ($3.19 in chips) 
Seat 3: Scaaalll ($3.21 in chips) 
Seat 4: Sadikson ($2.19 in chips) 
Seat 5: Doktor Yes ($2.08 in chips) 
Seat 6: KissingTheSun ($2 in chips) 
dinoVIEIRA: posts small blind $0.01
Scaaalll: posts big blind $0.02
*** HOLE CARDS ***
Dealt to Scaaalll [2h 8c]
Sadikson: folds 
Sadikson is disconnected 
Doktor Yes: raises $0.04 to $0.06
KissingTheSun: folds 
dannybird1: folds 
dinoVIEIRA: folds 
Scaaalll: folds 
Uncalled bet ($0.04) returned to Doktor Yes
Doktor Yes collected $0.05 from pot
Doktor Yes: doesn't show hand 
*** SUMMARY ***
Total pot $0.05 | Rake $0 
Seat 1: dannybird1 (button) folded before Flop (didn't bet)
Seat 2: dinoVIEIRA (small blind) folded before Flop
Seat 3: Scaaalll (big blind) folded before Flop
Seat 4: Sadikson folded before Flop (didn't bet)
Seat 5: Doktor Yes collected ($0.05)
Seat 6: KissingTheSun folded before Flop (didn't bet)



PokerStars Zoom Hand #229233415043:  Hold'em No Limit ($0.01/$0.02) - 2021/08/21 23:29:08 CET [2021/08/21 17:29:08 ET]
Table 'Halley' 6-max Seat #1 is the button
Seat 1: adrianh2002 ($2 in chips) 
Seat 2: pavlo8855 ($2.14 in chips) 
Seat 3: Vahenta ($2.96 in chips) 
Seat 4: gasmar_29 ($2.39 in chips) 
Seat 5: comptonBL ($2 in chips) 
Seat 6: Scaaalll ($3.21 in chips) 
pavlo8855: posts small blind $0.01
Vahenta: posts big blind $0.02
*** HOLE CARDS ***
Dealt to Scaaalll [3d 4d]
gasmar_29: folds 
comptonBL: raises $0.04 to $0.06
Vahenta is disconnected 
Scaaalll: folds 
adrianh2002: calls $0.06
pavlo8855: folds 
Vahenta: folds 
*** FLOP *** [Qh Kd 8s]
comptonBL: checks 
adrianh2002: checks 
*** TURN *** [Qh Kd 8s] [9h]
comptonBL: checks 
adrianh2002: bets $0.10
comptonBL: folds 
Uncalled bet ($0.10) returned to adrianh2002
adrianh2002 collected $0.14 from pot
adrianh2002: doesn't show hand 
*** SUMMARY ***
Total pot $0.15 | Rake $0.01 
Board [Qh Kd 8s 9h]
Seat 1: adrianh2002 (button) collected ($0.14)
Seat 2: pavlo8855 (small blind) folded before Flop
Seat 3: Vahenta (big blind) folded before Flop
Seat 4: gasmar_29 folded before Flop (didn't bet)
Seat 5: comptonBL folded on the Turn
Seat 6: Scaaalll folded before Flop (didn't bet)



PokerStars Zoom Hand #229233426085:  Hold'em No Limit ($0.01/$0.02) - 2021/08/21 23:29:34 CET [2021/08/21 17:29:34 ET]
Table 'Halley' 6-max Seat #1 is the button
Seat 1: kboskov123 ($1.85 in chips) 
Seat 2: Nihility77 ($2 in chips) 
Seat 3: polymorhp ($2.17 in chips) 
Seat 4: bart8612 ($2.25 in chips) 
Seat 5: Scaaalll ($3.19 in chips) 
Seat 6: elmex886 ($2.08 in chips) 
Nihility77: posts small blind $0.01
polymorhp: posts big blind $0.02
*** HOLE CARDS ***
Dealt to Scaaalll [As Jc]
bart8612: folds 
Scaaalll: raises $0.04 to $0.06
elmex886: folds 
kboskov123: folds 
Nihility77: folds 
polymorhp: folds 
Uncalled bet ($0.04) returned to Scaaalll
Scaaalll collected $0.05 from pot
Scaaalll: doesn't show hand 
*** SUMMARY ***
Total pot $0.05 | Rake $0 
Seat 1: kboskov123 (button) folded before Flop (didn't bet)
Seat 2: Nihility77 (small blind) folded before Flop
Seat 3: polymorhp (big blind) folded before Flop
Seat 4: bart8612 folded before Flop (didn't bet)
Seat 5: Scaaalll collected ($0.05)
Seat 6: elmex886 folded before Flop (didn't bet)



PokerStars Zoom Hand #229233431819:  Hold'em No Limit ($0.01/$0.02) - 2021/08/21 23:29:48 CET [2021/08/21 17:29:48 ET]
Table 'Halley' 6-max Seat #1 is the button
Seat 1: Scaaalll ($3.22 in chips) 
Seat 2: Colby1771 ($2.12 in chips) 
Seat 3: REZAKOV72 ($3.58 in chips) 
Seat 4: FabOliveira9 ($2.10 in chips) 
Seat 5: Ryota 8 Suzui ($2.11 in chips) 
Seat 6: 888lifeIS ($2 in chips) 
Colby1771: posts small blind $0.01
REZAKOV72: posts big blind $0.02
*** HOLE CARDS ***
Dealt to Scaaalll [8d 5h]
Ryota 8 Suzui is disconnected 
FabOliveira9: raises $0.03 to $0.05
Ryota 8 Suzui: folds 
888lifeIS: folds 
Scaaalll: folds 
Colby1771: folds 
REZAKOV72: calls $0.03
*** FLOP *** [As 4s 9c]
REZAKOV72: checks 
FabOliveira9: bets $0.02
REZAKOV72: folds 
Uncalled bet ($0.02) returned to FabOliveira9
FabOliveira9 collected $0.11 from pot
FabOliveira9: doesn't show hand 
*** SUMMARY ***
Total pot $0.11 | Rake $0 
Board [As 4s 9c]
Seat 1: Scaaalll (button) folded before Flop (didn't bet)
Seat 2: Colby1771 (small blind) folded before Flop
Seat 3: REZAKOV72 (big blind) folded on the Flop
Seat 4: FabOliveira9 collected ($0.11)
Seat 5: Ryota 8 Suzui folded before Flop (didn't bet)
Seat 6: 888lifeIS folded before Flop (didn't bet)



PokerStars Zoom Hand #229233435578:  Hold'em No Limit ($0.01/$0.02) - 2021/08/21 23:29:57 CET [2021/08/21 17:29:57 ET]
Table 'Halley' 6-max Seat #1 is the button
Seat 1: Gamer577 ($2.03 in chips) 
Seat 2: Xlavariable ($2.76 in chips) 
Seat 3: Scaaalll ($3.21 in chips) 
Seat 4: ussr246 ($2.86 in chips) 
Seat 5: Sul07 ($0.72 in chips) 
Seat 6: Hallyson_23 ($4.53 in chips) 
Xlavariable: posts small blind $0.01
Scaaalll: posts big blind $0.02
*** HOLE CARDS ***
Dealt to Scaaalll [2s 7h]
ussr246: folds 
Sul07: raises $0.04 to $0.06
Hallyson_23: folds 
Gamer577: folds 
Xlavariable: folds 
Scaaalll: folds 
Uncalled bet ($0.04) returned to Sul07
Sul07 collected $0.05 from pot
Sul07: doesn't show hand 
*** SUMMARY ***
Total pot $0.05 | Rake $0 
Seat 1: Gamer577 (button) folded before Flop (didn't bet)
Seat 2: Xlavariable (small blind) folded before Flop
Seat 3: Scaaalll (big blind) folded before Flop
Seat 4: ussr246 folded before Flop (didn't bet)
Seat 5: Sul07 collected ($0.05)
Seat 6: Hallyson_23 folded before Flop (didn't bet)



PokerStars Zoom Hand #229233441565:  Hold'em No Limit ($0.01/$0.02) - 2021/08/21 23:30:11 CET [2021/08/21 17:30:11 ET]
Table 'Halley' 6-max Seat #1 is the button
Seat 1: WITKOW_AV ($2.17 in chips) 
Seat 2: Iv3rson18 ($2.32 in chips) 
Seat 3: kboskov123 ($2.17 in chips) 
Seat 4: Scaaalll ($3.19 in chips) 
Seat 5: Hallyson_23 ($4.18 in chips) 
Seat 6: AlienMdeo ($1.70 in chips) 
Iv3rson18: posts small blind $0.01
kboskov123: posts big blind $0.02
*** HOLE CARDS ***
Dealt to Scaaalll [2d Td]
Scaaalll: folds 
Hallyson_23: raises $0.03 to $0.05
AlienMdeo: folds 
WITKOW_AV: folds 
Iv3rson18: folds 
kboskov123: folds 
Uncalled bet ($0.03) returned to Hallyson_23
Hallyson_23 collected $0.05 from pot
Hallyson_23: doesn't show hand 
*** SUMMARY ***
Total pot $0.05 | Rake $0 
Seat 1: WITKOW_AV (button) folded before Flop (didn't bet)
Seat 2: Iv3rson18 (small blind) folded before Flop
Seat 3: kboskov123 (big blind) folded before Flop
Seat 4: Scaaalll folded before Flop (didn't bet)
Seat 5: Hallyson_23 collected ($0.05)
Seat 6: AlienMdeo folded before Flop (didn't bet)



PokerStars Zoom Hand #229233444001:  Hold'em No Limit ($0.01/$0.02) - 2021/08/21 23:30:17 CET [2021/08/21 17:30:17 ET]
Table 'Halley' 6-max Seat #1 is the button
Seat 1: gasmar_29 ($2.30 in chips) 
Seat 2: Cineva81 ($2 in chips) 
Seat 3: ciucibaby ($2.12 in chips) 
Seat 4: Scaaalll ($3.19 in chips) 
Seat 5: OLKOG ($2.24 in chips) 
Seat 6: NickAlex18 ($2.43 in chips) 
Cineva81: posts small blind $0.01
ciucibaby: posts big blind $0.02
*** HOLE CARDS ***
Dealt to Scaaalll [Th Qc]
Scaaalll: folds 
OLKOG: folds 
OLKOG is disconnected 
NickAlex18: raises $0.03 to $0.05
gasmar_29: folds 
Cineva81: folds 
ciucibaby: folds 
Uncalled bet ($0.03) returned to NickAlex18
NickAlex18 collected $0.05 from pot
NickAlex18: doesn't show hand 
*** SUMMARY ***
Total pot $0.05 | Rake $0 
Seat 1: gasmar_29 (button) folded before Flop (didn't bet)
Seat 2: Cineva81 (small blind) folded before Flop
Seat 3: ciucibaby (big blind) folded before Flop
Seat 4: Scaaalll folded before Flop (didn't bet)
Seat 5: OLKOG folded before Flop (didn't bet)
Seat 6: NickAlex18 collected ($0.05)



PokerStars Zoom Hand #229233433909:  Hold'em No Limit ($0.01/$0.02) - 2021/08/21 23:29:53 CET [2021/08/21 17:29:53 ET]
Table 'Halley' 6-max Seat #1 is the button
Seat 1: cheddarspreada ($2.48 in chips) 
Seat 2: Scaaalll ($3.22 in chips) 
Seat 3: lucksuckdonk ($6.69 in chips) 
Seat 4: adrianh2002 ($3.76 in chips) 
Seat 5: maliniak75 ($3.08 in chips) 
Seat 6: Gamer577 ($5.84 in chips) 
Scaaalll: posts small blind $0.01
lucksuckdonk: posts big blind $0.02
*** HOLE CARDS ***
Dealt to Scaaalll [9h 4h]
adrianh2002: folds 
maliniak75: folds 
Gamer577: folds 
cheddarspreada: calls $0.02
Scaaalll: folds 
lucksuckdonk: raises $0.08 to $0.10
cheddarspreada: calls $0.08
*** FLOP *** [4d Kd 5h]
lucksuckdonk: checks 
cheddarspreada: bets $0.02
lucksuckdonk: raises $0.13 to $0.15
cheddarspreada: calls $0.13
*** TURN *** [4d Kd 5h] [2c]
lucksuckdonk: bets $0.27
cheddarspreada: calls $0.27
*** RIVER *** [4d Kd 5h 2c] [As]
lucksuckdonk: bets $0.56
cheddarspreada: calls $0.56
*** SHOW DOWN ***
lucksuckdonk: shows [Kc Ad] (two pair, Aces and Kings)
cheddarspreada: mucks hand 
lucksuckdonk collected $2.09 from pot
*** SUMMARY ***
Total pot $2.17 | Rake $0.08 
Board [4d Kd 5h 2c As]
Seat 1: cheddarspreada (button) mucked [Ks 5s]
Seat 2: Scaaalll (small blind) folded before Flop
Seat 3: lucksuckdonk (big blind) showed [Kc Ad] and won ($2.09) with two pair, Aces and Kings
Seat 4: adrianh2002 folded before Flop (didn't bet)
Seat 5: maliniak75 folded before Flop (didn't bet)
Seat 6: Gamer577 folded before Flop (didn't bet)



PokerStars Zoom Hand #229233446194:  Hold'em No Limit ($0.01/$0.02) - 2021/08/21 23:30:22 CET [2021/08/21 17:30:22 ET]
Table 'Halley' 6-max Seat #1 is the button
Seat 1: new face onl ($1.57 in chips) 
Seat 2: BeastBoy18 ($2 in chips) 
Seat 3: PapiMik3 ($7.11 in chips) 
Seat 4: Hallyson_23 ($4.21 in chips) 
Seat 5: porcorosso23 ($4.23 in chips) 
Seat 6: Scaaalll ($3.19 in chips) 
BeastBoy18: posts small blind $0.01
PapiMik3: posts big blind $0.02
*** HOLE CARDS ***
Dealt to Scaaalll [6c 6s]
Hallyson_23: folds 
porcorosso23: folds 
Scaaalll: raises $0.04 to $0.06
new face onl: folds 
BeastBoy18: calls $0.05
PapiMik3: folds 
*** FLOP *** [8c 9d Ac]
BeastBoy18: checks 
Scaaalll: checks 
*** TURN *** [8c 9d Ac] [7d]
BeastBoy18: checks 
Scaaalll: checks 
*** RIVER *** [8c 9d Ac 7d] [5s]
BeastBoy18: checks 
Scaaalll: bets $0.09
BeastBoy18: folds 
Uncalled bet ($0.09) returned to Scaaalll
Scaaalll collected $0.14 from pot
Scaaalll: doesn't show hand 
*** SUMMARY ***
Total pot $0.14 | Rake $0 
Board [8c 9d Ac 7d 5s]
Seat 1: new face onl (button) folded before Flop (didn't bet)
Seat 2: BeastBoy18 (small blind) folded on the River
Seat 3: PapiMik3 (big blind) folded before Flop
Seat 4: Hallyson_23 folded before Flop (didn't bet)
Seat 5: porcorosso23 folded before Flop (didn't bet)
Seat 6: Scaaalll collected ($0.14)



PokerStars Zoom Hand #229233464291:  Hold'em No Limit ($0.01/$0.02) - 2021/08/21 23:31:05 CET [2021/08/21 17:31:05 ET]
Table 'Halley' 6-max Seat #1 is the button
Seat 1: zergmiky ($2.05 in chips) 
Seat 2: Scaaalll ($3.27 in chips) 
Seat 3: ash1448 ($6.22 in chips) 
Seat 4: Cineva81 ($2 in chips) 
Seat 5: Bina_sweety ($2 in chips) 
Seat 6: rekopo203 ($7.19 in chips) 
Scaaalll: posts small blind $0.01
ash1448: posts big blind $0.02
*** HOLE CARDS ***
Dealt to Scaaalll [2c Kd]
Cineva81: folds 
Bina_sweety: folds 
rekopo203: folds 
zergmiky: folds 
Scaaalll: folds 
Uncalled bet ($0.01) returned to ash1448
ash1448 collected $0.02 from pot
ash1448: doesn't show hand 
*** SUMMARY ***
Total pot $0.02 | Rake $0 
Seat 1: zergmiky (button) folded before Flop (didn't bet)
Seat 2: Scaaalll (small blind) folded before Flop
Seat 3: ash1448 (big blind) collected ($0.02)
Seat 4: Cineva81 folded before Flop (didn't bet)
Seat 5: Bina_sweety folded before Flop (didn't bet)
Seat 6: rekopo203 folded before Flop (didn't bet)



PokerStars Zoom Hand #229233471291:  Hold'em No Limit ($0.01/$0.02) - 2021/08/21 23:31:22 CET [2021/08/21 17:31:22 ET]
Table 'Halley' 6-max Seat #1 is the button
Seat 1: Scaaalll ($3.26 in chips) 
Seat 2: byakuda ($2.04 in chips) 
Seat 3: tuolau ($3.26 in chips) 
Seat 4: Xlavariable ($2.02 in chips) 
Seat 5: pavlo8855 ($2.08 in chips) 
Seat 6: KonopDima ($2.36 in chips) 
byakuda: posts small blind $0.01
tuolau: posts big blind $0.02
*** HOLE CARDS ***
Dealt to Scaaalll [6c Qc]
Xlavariable: folds 
pavlo8855: folds 
KonopDima: folds 
Scaaalll: raises $0.03 to $0.05
byakuda: folds 
tuolau: folds 
Uncalled bet ($0.03) returned to Scaaalll
Scaaalll collected $0.05 from pot
Scaaalll: doesn't show hand 
tuolau is disconnected 
*** SUMMARY ***
Total pot $0.05 | Rake $0 
Seat 1: Scaaalll (button) collected ($0.05)
Seat 2: byakuda (small blind) folded before Flop
Seat 3: tuolau (big blind) folded before Flop
Seat 4: Xlavariable folded before Flop (didn't bet)
Seat 5: pavlo8855 folded before Flop (didn't bet)
Seat 6: KonopDima folded before Flop (didn't bet)



PokerStars Zoom Hand #229233482322:  Hold'em No Limit ($0.01/$0.02) - 2021/08/21 23:31:48 CET [2021/08/21 17:31:48 ET]
Table 'Halley' 6-max Seat #1 is the button
Seat 1: hairy navel ($1.93 in chips) 
Seat 2: darkhexxer ($4.10 in chips) 
Seat 3: Xlavariable ($2.93 in chips) 
Seat 4: Scaaalll ($3.29 in chips) 
Seat 5: TTGemi ($2.07 in chips) 
Seat 6: dannyluijten ($2.20 in chips) 
darkhexxer: posts small blind $0.01
Xlavariable: posts big blind $0.02
*** HOLE CARDS ***
Dealt to Scaaalll [As 2h]
darkhexxer is disconnected 
Scaaalll: folds 
TTGemi: folds 
dannyluijten: folds 
hairy navel: folds 
darkhexxer: folds 
Uncalled bet ($0.01) returned to Xlavariable
Xlavariable collected $0.02 from pot
Xlavariable: doesn't show hand 
*** SUMMARY ***
Total pot $0.02 | Rake $0 
Seat 1: hairy navel (button) folded before Flop (didn't bet)
Seat 2: darkhexxer (small blind) folded before Flop
Seat 3: Xlavariable (big blind) collected ($0.02)
Seat 4: Scaaalll folded before Flop (didn't bet)
Seat 5: TTGemi folded before Flop (didn't bet)
Seat 6: dannyluijten folded before Flop (didn't bet)



PokerStars Zoom Hand #229233484381:  Hold'em No Limit ($0.01/$0.02) - 2021/08/21 23:31:53 CET [2021/08/21 17:31:53 ET]
Table 'Halley' 6-max Seat #1 is the button
Seat 1: Cineva81 ($2 in chips) 
Seat 2: MattieBOZ ($1.47 in chips) 
Seat 3: Scaaalll ($3.29 in chips) 
Seat 4: Vanekakqj ($3.25 in chips) 
Seat 5: Xlavariable ($2 in chips) 
Seat 6: josealfredonino ($1.46 in chips) 
MattieBOZ: posts small blind $0.01
Scaaalll: posts big blind $0.02
*** HOLE CARDS ***
Dealt to Scaaalll [Td 5s]
Vanekakqj: folds 
Xlavariable: folds 
MattieBOZ is disconnected 
josealfredonino: raises $0.02 to $0.04
Cineva81: folds 
MattieBOZ: folds 
Scaaalll: folds 
Uncalled bet ($0.02) returned to josealfredonino
josealfredonino collected $0.05 from pot
josealfredonino: doesn't show hand 
*** SUMMARY ***
Total pot $0.05 | Rake $0 
Seat 1: Cineva81 (button) folded before Flop (didn't bet)
Seat 2: MattieBOZ (small blind) folded before Flop
Seat 3: Scaaalll (big blind) folded before Flop
Seat 4: Vanekakqj folded before Flop (didn't bet)
Seat 5: Xlavariable folded before Flop (didn't bet)
Seat 6: josealfredonino collected ($0.05)



PokerStars Zoom Hand #229233490701:  Hold'em No Limit ($0.01/$0.02) - 2021/08/21 23:32:08 CET [2021/08/21 17:32:08 ET]
Table 'Halley' 6-max Seat #1 is the button
Seat 1: Merlin_Arg ($3.47 in chips) 
Seat 2: rabbitmeat73 ($0.92 in chips) 
Seat 3: Hope2706 ($4.75 in chips) 
Seat 4: vovan100157 ($3.38 in chips) 
Seat 5: estelionat171 ($1.36 in chips) 
Seat 6: Scaaalll ($3.27 in chips) 
rabbitmeat73: posts small blind $0.01
Hope2706: posts big blind $0.02
*** HOLE CARDS ***
Dealt to Scaaalll [Th Jh]
vovan100157: folds 
estelionat171: folds 
Scaaalll: raises $0.04 to $0.06
Merlin_Arg: folds 
rabbitmeat73: calls $0.05
Hope2706: folds 
*** FLOP *** [6d 3c Kc]
Hope2706 is disconnected 
rabbitmeat73: checks 
Scaaalll: bets $0.08
rabbitmeat73: folds 
Uncalled bet ($0.08) returned to Scaaalll
Scaaalll collected $0.14 from pot
Scaaalll: doesn't show hand 
*** SUMMARY ***
Total pot $0.14 | Rake $0 
Board [6d 3c Kc]
Seat 1: Merlin_Arg (button) folded before Flop (didn't bet)
Seat 2: rabbitmeat73 (small blind) folded on the Flop
Seat 3: Hope2706 (big blind) folded before Flop
Seat 4: vovan100157 folded before Flop (didn't bet)
Seat 5: estelionat171 folded before Flop (didn't bet)
Seat 6: Scaaalll collected ($0.14)



PokerStars Zoom Hand #229233508925:  Hold'em No Limit ($0.01/$0.02) - 2021/08/21 23:32:52 CET [2021/08/21 17:32:52 ET]
Table 'Halley' 6-max Seat #1 is the button
Seat 1: ash1448 ($6.14 in chips) 
Seat 2: Scaaalll ($3.35 in chips) 
Seat 3: HubertFroh ($2.45 in chips) 
Seat 4: fishh_play ($2.65 in chips) 
Seat 5: Vanekakqj ($4.13 in chips) 
Seat 6: adrianh2002 ($4.60 in chips) 
Scaaalll: posts small blind $0.01
HubertFroh: posts big blind $0.02
*** HOLE CARDS ***
Dealt to Scaaalll [Qd 6h]
fishh_play: folds 
Vanekakqj: folds 
adrianh2002: folds 
ash1448: folds 
Scaaalll: folds 
Uncalled bet ($0.01) returned to HubertFroh
HubertFroh collected $0.02 from pot
HubertFroh: doesn't show hand 
*** SUMMARY ***
Total pot $0.02 | Rake $0 
Seat 1: ash1448 (button) folded before Flop (didn't bet)
Seat 2: Scaaalll (small blind) folded before Flop
Seat 3: HubertFroh (big blind) collected ($0.02)
Seat 4: fishh_play folded before Flop (didn't bet)
Seat 5: Vanekakqj folded before Flop (didn't bet)
Seat 6: adrianh2002 folded before Flop (didn't bet)



PokerStars Zoom Hand #229233507337:  Hold'em No Limit ($0.01/$0.02) - 2021/08/21 23:32:48 CET [2021/08/21 17:32:48 ET]
Table 'Halley' 6-max Seat #1 is the button
Seat 1: Scaaalll ($3.35 in chips) 
Seat 2: Vladimir1954 ($2.22 in chips) 
Seat 3: nikof420 ($2.24 in chips) 
Seat 4: El Chicha.CL ($3.92 in chips) 
Seat 5: BeastBoy18 ($3.11 in chips) 
Seat 6: Cineva81 ($2.03 in chips) 
Vladimir1954: posts small blind $0.01
nikof420: posts big blind $0.02
*** HOLE CARDS ***
Dealt to Scaaalll [9d Qh]
El Chicha.CL: folds 
BeastBoy18: raises $0.04 to $0.06
Cineva81: folds 
Scaaalll: folds 
Vladimir1954: folds 
nikof420: raises $0.08 to $0.14
BeastBoy18: calls $0.08
*** FLOP *** [8h 8d 7s]
nikof420: checks 
BeastBoy18: checks 
*** TURN *** [8h 8d 7s] [Js]
nikof420: checks 
BeastBoy18: checks 
*** RIVER *** [8h 8d 7s Js] [4h]
nikof420: bets $0.14
BeastBoy18: folds 
Uncalled bet ($0.14) returned to nikof420
nikof420 collected $0.28 from pot
nikof420: doesn't show hand 
*** SUMMARY ***
Total pot $0.29 | Rake $0.01 
Board [8h 8d 7s Js 4h]
Seat 1: Scaaalll (button) folded before Flop (didn't bet)
Seat 2: Vladimir1954 (small blind) folded before Flop
Seat 3: nikof420 (big blind) collected ($0.28)
Seat 4: El Chicha.CL folded before Flop (didn't bet)
Seat 5: BeastBoy18 folded on the River
Seat 6: Cineva81 folded before Flop (didn't bet)



PokerStars Zoom Hand #229233513535:  Hold'em No Limit ($0.01/$0.02) - 2021/08/21 23:33:03 CET [2021/08/21 17:33:03 ET]
Table 'Halley' 6-max Seat #1 is the button
Seat 1: SIGREX ($2 in chips) 
Seat 2: FabOliveira9 ($3.27 in chips) 
Seat 3: WITKOW_AV ($2 in chips) 
Seat 4: didiclavi777 ($2.58 in chips) 
Seat 5: Scaaalll ($3.34 in chips) 
Seat 6: Langusta1 ($1.52 in chips) 
FabOliveira9: posts small blind $0.01
WITKOW_AV: posts big blind $0.02
*** HOLE CARDS ***
Dealt to Scaaalll [Jh 5h]
didiclavi777: folds 
Scaaalll has timed out
Scaaalll: folds 
Langusta1: raises $0.04 to $0.06
SIGREX: folds 
FabOliveira9: folds 
WITKOW_AV: calls $0.04
*** FLOP *** [2s 4c Td]
WITKOW_AV: checks 
Langusta1: bets $0.06
WITKOW_AV: raises $0.12 to $0.18
Langusta1: calls $0.12
*** TURN *** [2s 4c Td] [5s]
WITKOW_AV: checks 
Langusta1: bets $0.47
WITKOW_AV: folds 
Uncalled bet ($0.47) returned to Langusta1
Langusta1 collected $0.47 from pot
Langusta1: doesn't show hand 
*** SUMMARY ***
Total pot $0.49 | Rake $0.02 
Board [2s 4c Td 5s]
Seat 1: SIGREX (button) folded before Flop (didn't bet)
Seat 2: FabOliveira9 (small blind) folded before Flop
Seat 3: WITKOW_AV (big blind) folded on the Turn
Seat 4: didiclavi777 folded before Flop (didn't bet)
Seat 5: Scaaalll folded before Flop (didn't bet)
Seat 6: Langusta1 collected ($0.47)



PokerStars Zoom Hand #229233526280:  Hold'em No Limit ($0.01/$0.02) - 2021/08/21 23:33:34 CET [2021/08/21 17:33:34 ET]
Table 'Halley' 6-max Seat #1 is the button
Seat 1: Mdnexoc ($2.03 in chips) 
Seat 2: Taran0001 ($5.02 in chips) 
Seat 3: Scaaalll ($3.34 in chips) 
Seat 4: Mikeloko182 ($4.15 in chips) 
Seat 5: kukulagosleep ($3.97 in chips) 
Seat 6: Mikmaq Caper ($0.63 in chips) 
Taran0001: posts small blind $0.01
Scaaalll: posts big blind $0.02
*** HOLE CARDS ***
Dealt to Scaaalll [3c Ah]
Mikmaq Caper is disconnected 
Mikeloko182: folds 
kukulagosleep: folds 
Mikmaq Caper: folds 
Mdnexoc: folds 
Taran0001: folds 
Uncalled bet ($0.01) returned to Scaaalll
Scaaalll collected $0.02 from pot
Scaaalll: doesn't show hand 
*** SUMMARY ***
Total pot $0.02 | Rake $0 
Seat 1: Mdnexoc (button) folded before Flop (didn't bet)
Seat 2: Taran0001 (small blind) folded before Flop
Seat 3: Scaaalll (big blind) collected ($0.02)
Seat 4: Mikeloko182 folded before Flop (didn't bet)
Seat 5: kukulagosleep folded before Flop (didn't bet)
Seat 6: Mikmaq Caper folded before Flop (didn't bet)



PokerStars Zoom Hand #229233522645:  Hold'em No Limit ($0.01/$0.02) - 2021/08/21 23:33:25 CET [2021/08/21 17:33:25 ET]
Table 'Halley' 6-max Seat #1 is the button
Seat 1: bt710 ($4.32 in chips) 
Seat 2: Koldun 2636 ($4.15 in chips) 
Seat 3: ZermeloFraenkel ($2.16 in chips) 
Seat 4: Scaaalll ($3.34 in chips) 
Seat 5: pavel play pay ($4.11 in chips) 
Seat 6: Dr.stromg ($3.16 in chips) 
Koldun 2636: posts small blind $0.01
ZermeloFraenkel: posts big blind $0.02
*** HOLE CARDS ***
Dealt to Scaaalll [8h 3s]
Scaaalll: folds 
pavel play pay: calls $0.02
Dr.stromg: folds 
bt710: folds 
Koldun 2636: calls $0.01
ZermeloFraenkel: checks 
*** FLOP *** [5d 5c 2s]
Koldun 2636: checks 
ZermeloFraenkel: checks 
pavel play pay: checks 
*** TURN *** [5d 5c 2s] [Kc]
Koldun 2636: checks 
ZermeloFraenkel: checks 
pavel play pay: bets $0.03
Koldun 2636: calls $0.03
ZermeloFraenkel: calls $0.03
*** RIVER *** [5d 5c 2s Kc] [2c]
Koldun 2636: checks 
ZermeloFraenkel: checks 
pavel play pay: bets $0.14
Koldun 2636: folds 
ZermeloFraenkel: folds 
Uncalled bet ($0.14) returned to pavel play pay
pavel play pay collected $0.14 from pot
pavel play pay: doesn't show hand 
*** SUMMARY ***
Total pot $0.15 | Rake $0.01 
Board [5d 5c 2s Kc 2c]
Seat 1: bt710 (button) folded before Flop (didn't bet)
Seat 2: Koldun 2636 (small blind) folded on the River
Seat 3: ZermeloFraenkel (big blind) folded on the River
Seat 4: Scaaalll folded before Flop (didn't bet)
Seat 5: pavel play pay collected ($0.14)
Seat 6: Dr.stromg folded before Flop (didn't bet)



PokerStars Zoom Hand #229233538794:  Hold'em No Limit ($0.01/$0.02) - 2021/08/21 23:34:04 CET [2021/08/21 17:34:04 ET]
Table 'Halley' 6-max Seat #1 is the button
Seat 1: El Chicha.CL ($2 in chips) 
Seat 2: NoEff0rt2w1n ($6.88 in chips) 
Seat 3: YgovAndrey ($1.86 in chips) 
Seat 4: Healthys07 ($3.32 in chips) 
Seat 5: FrancoOlmedo ($2.18 in chips) 
Seat 6: Scaaalll ($3.34 in chips) 
NoEff0rt2w1n: posts small blind $0.01
YgovAndrey: posts big blind $0.02
*** HOLE CARDS ***
Dealt to Scaaalll [8s Ad]
Healthys07: folds 
FrancoOlmedo: raises $0.03 to $0.05
Scaaalll: folds 
El Chicha.CL: raises $0.12 to $0.17
NoEff0rt2w1n: folds 
YgovAndrey: folds 
FrancoOlmedo: folds 
Uncalled bet ($0.12) returned to El Chicha.CL
El Chicha.CL collected $0.13 from pot
El Chicha.CL: doesn't show hand 
*** SUMMARY ***
Total pot $0.13 | Rake $0 
Seat 1: El Chicha.CL (button) collected ($0.13)
Seat 2: NoEff0rt2w1n (small blind) folded before Flop
Seat 3: YgovAndrey (big blind) folded before Flop
Seat 4: Healthys07 folded before Flop (didn't bet)
Seat 5: FrancoOlmedo folded before Flop
Seat 6: Scaaalll folded before Flop (didn't bet)



PokerStars Zoom Hand #229233531319:  Hold'em No Limit ($0.01/$0.02) - 2021/08/21 23:33:46 CET [2021/08/21 17:33:46 ET]
Table 'Halley' 6-max Seat #1 is the button
Seat 1: Scaaalll ($3.35 in chips) 
Seat 2: Langusta1 ($1.75 in chips) 
Seat 3: Sharabora ($0.54 in chips) 
Seat 4: nAfEd585 ($2.88 in chips) 
Seat 5: pipecmolodec ($2.11 in chips) 
Seat 6: Xlavariable ($2.14 in chips) 
Langusta1: posts small blind $0.01
Sharabora: posts big blind $0.02
*** HOLE CARDS ***
Dealt to Scaaalll [Qs 5s]
nAfEd585: calls $0.02
pipecmolodec: raises $0.02 to $0.04
Xlavariable: folds 
Scaaalll: folds 
Langusta1: folds 
Sharabora: folds 
nAfEd585: calls $0.02
*** FLOP *** [Ad 8s 2s]
nAfEd585: bets $0.02
pipecmolodec: raises $0.05 to $0.07
nAfEd585: calls $0.05
*** TURN *** [Ad 8s 2s] [9c]
nAfEd585: checks 
pipecmolodec: bets $0.16
nAfEd585: folds 
Uncalled bet ($0.16) returned to pipecmolodec
pipecmolodec collected $0.24 from pot
pipecmolodec: doesn't show hand 
*** SUMMARY ***
Total pot $0.25 | Rake $0.01 
Board [Ad 8s 2s 9c]
Seat 1: Scaaalll (button) folded before Flop (didn't bet)
Seat 2: Langusta1 (small blind) folded before Flop
Seat 3: Sharabora (big blind) folded before Flop
Seat 4: nAfEd585 folded on the Turn
Seat 5: pipecmolodec collected ($0.24)
Seat 6: Xlavariable folded before Flop (didn't bet)



PokerStars Zoom Hand #229233555054:  Hold'em No Limit ($0.01/$0.02) - 2021/08/21 23:34:28 CET [2021/08/21 17:34:28 ET]
Table 'Halley' 6-max Seat #1 is the button
Seat 1: Langusta1 ($1.67 in chips) 
Seat 2: Gerar NB ($2 in chips) 
Seat 3: Scaaalll ($3.34 in chips) 
Seat 4: maressen ($2.24 in chips) 
Seat 5: orlovac1995 ($4.89 in chips) 
Seat 6: kai_inge_mar ($0.17 in chips) 
Gerar NB: posts small blind $0.01
Scaaalll: posts big blind $0.02
*** HOLE CARDS ***
Dealt to Scaaalll [2h 8s]
maressen: folds 
orlovac1995: folds 
kai_inge_mar: raises $0.15 to $0.17 and is all-in
Langusta1: folds 
Gerar NB: folds 
Scaaalll: folds 
Uncalled bet ($0.15) returned to kai_inge_mar
kai_inge_mar collected $0.05 from pot
kai_inge_mar: doesn't show hand 
*** SUMMARY ***
Total pot $0.05 | Rake $0 
Seat 1: Langusta1 (button) folded before Flop (didn't bet)
Seat 2: Gerar NB (small blind) folded before Flop
Seat 3: Scaaalll (big blind) folded before Flop
Seat 4: maressen folded before Flop (didn't bet)
Seat 5: orlovac1995 folded before Flop (didn't bet)
Seat 6: kai_inge_mar collected ($0.05)



PokerStars Zoom Hand #229233542463:  Hold'em No Limit ($0.01/$0.02) - 2021/08/21 23:34:13 CET [2021/08/21 17:34:13 ET]
Table 'Halley' 6-max Seat #1 is the button
Seat 1: 888lifeIS ($2.45 in chips) 
Seat 2: nikof420 ($2.34 in chips) 
Seat 3: tisadaisy ($2.11 in chips) 
Seat 4: kukulagosleep ($4.31 in chips) 
Seat 5: Scaaalll ($3.34 in chips) 
Seat 6: Mdnexoc ($2 in chips) 
nikof420: posts small blind $0.01
tisadaisy: posts big blind $0.02
*** HOLE CARDS ***
Dealt to Scaaalll [Jd 3s]
kukulagosleep: raises $0.04 to $0.06
Scaaalll: folds 
Mdnexoc: folds 
888lifeIS: folds 
nikof420: calls $0.05
tisadaisy: folds 
*** FLOP *** [Kc 8d 2d]
nikof420: bets $0.07
kukulagosleep: calls $0.07
*** TURN *** [Kc 8d 2d] [8c]
nikof420: bets $0.13
kukulagosleep: calls $0.13
*** RIVER *** [Kc 8d 2d 8c] [3d]
nikof420: checks 
kukulagosleep: checks 
*** SHOW DOWN ***
nikof420: shows [Th As] (a pair of Eights)
kukulagosleep: shows [Qc Qs] (two pair, Queens and Eights)
kukulagosleep collected $0.52 from pot
*** SUMMARY ***
Total pot $0.54 | Rake $0.02 
Board [Kc 8d 2d 8c 3d]
Seat 1: 888lifeIS (button) folded before Flop (didn't bet)
Seat 2: nikof420 (small blind) showed [Th As] and lost with a pair of Eights
Seat 3: tisadaisy (big blind) folded before Flop
Seat 4: kukulagosleep showed [Qc Qs] and won ($0.52) with two pair, Queens and Eights
Seat 5: Scaaalll folded before Flop (didn't bet)
Seat 6: Mdnexoc folded before Flop (didn't bet)



PokerStars Zoom Hand #229233551762:  Hold'em No Limit ($0.01/$0.02) - 2021/08/21 23:34:20 CET [2021/08/21 17:34:20 ET]
Table 'Halley' 6-max Seat #1 is the button
Seat 1: BriceDo1917 ($3.56 in chips) 
Seat 2: 47911728 ($1.89 in chips) 
Seat 3: BeastBoy18 ($2.94 in chips) 
Seat 4: Scaaalll ($3.34 in chips) 
Seat 5: nightwacher ($1.87 in chips) 
Seat 6: samn102 ($2 in chips) 
47911728: posts small blind $0.01
BeastBoy18: posts big blind $0.02
*** HOLE CARDS ***
Dealt to Scaaalll [4h 2h]
Scaaalll: folds 
nightwacher: folds 
samn102: folds 
BriceDo1917: raises $0.02 to $0.04
47911728: folds 
BeastBoy18: raises $0.18 to $0.22
BriceDo1917: folds 
Uncalled bet ($0.18) returned to BeastBoy18
BeastBoy18 collected $0.09 from pot
BeastBoy18: doesn't show hand 
BriceDo1917 is disconnected 
*** SUMMARY ***
Total pot $0.09 | Rake $0 
Seat 1: BriceDo1917 (button) folded before Flop
Seat 2: 47911728 (small blind) folded before Flop
Seat 3: BeastBoy18 (big blind) collected ($0.09)
Seat 4: Scaaalll folded before Flop (didn't bet)
Seat 5: nightwacher folded before Flop (didn't bet)
Seat 6: samn102 folded before Flop (didn't bet)



PokerStars Zoom Hand #229233533799:  Hold'em No Limit ($0.01/$0.02) - 2021/08/21 23:33:52 CET [2021/08/21 17:33:52 ET]
Table 'Halley' 6-max Seat #1 is the button
Seat 1: Xpokerfreak ($1.05 in chips) 
Seat 2: Scaaalll ($3.35 in chips) 
Seat 3: MattieBOZ ($2.71 in chips) 
Seat 4: kingdieter1 ($2.15 in chips) 
Seat 5: Pechorin.G ($2.25 in chips) 
Seat 6: ctaceo ($2 in chips) 
Scaaalll: posts small blind $0.01
MattieBOZ: posts big blind $0.02
*** HOLE CARDS ***
Dealt to Scaaalll [7s Tc]
kingdieter1: folds 
Pechorin.G: folds 
kingdieter1 is disconnected 
ctaceo: raises $0.03 to $0.05
Xpokerfreak: calls $0.05
Scaaalll: folds 
MattieBOZ: calls $0.03
*** FLOP *** [Ac 8h 4s]
MattieBOZ: checks 
ctaceo: checks 
Xpokerfreak: checks 
*** TURN *** [Ac 8h 4s] [Js]
MattieBOZ: checks 
ctaceo: bets $0.11
Xpokerfreak: folds 
MattieBOZ: calls $0.11
*** RIVER *** [Ac 8h 4s Js] [Jh]
MattieBOZ: checks 
ctaceo: checks 
*** SHOW DOWN ***
MattieBOZ: shows [9s 8s] (two pair, Jacks and Eights)
ctaceo: mucks hand 
MattieBOZ collected $0.37 from pot
*** SUMMARY ***
Total pot $0.38 | Rake $0.01 
Board [Ac 8h 4s Js Jh]
Seat 1: Xpokerfreak (button) folded on the Turn
Seat 2: Scaaalll (small blind) folded before Flop
Seat 3: MattieBOZ (big blind) showed [9s 8s] and won ($0.37) with two pair, Jacks and Eights
Seat 4: kingdieter1 folded before Flop (didn't bet)
Seat 5: Pechorin.G folded before Flop (didn't bet)
Seat 6: ctaceo mucked [6s 5s]



PokerStars Zoom Hand #229233559558:  Hold'em No Limit ($0.01/$0.02) - 2021/08/21 23:34:39 CET [2021/08/21 17:34:39 ET]
Table 'Halley' 6-max Seat #1 is the button
Seat 1: djovex ($1.93 in chips) 
Seat 2: so0love ($5.23 in chips) 
Seat 3: rabbitmeat73 ($0.43 in chips) 
Seat 4: PapiMik3 ($7.67 in chips) 
Seat 5: FabOliveira9 ($2.63 in chips) 
Seat 6: Scaaalll ($3.32 in chips) 
so0love: posts small blind $0.01
rabbitmeat73: posts big blind $0.02
*** HOLE CARDS ***
Dealt to Scaaalll [8s 8c]
PapiMik3: folds 
FabOliveira9: folds 
djovex is disconnected 
Scaaalll: raises $0.04 to $0.06
djovex: folds 
so0love: folds 
rabbitmeat73: folds 
Uncalled bet ($0.04) returned to Scaaalll
Scaaalll collected $0.05 from pot
Scaaalll: doesn't show hand 
*** SUMMARY ***
Total pot $0.05 | Rake $0 
Seat 1: djovex (button) folded before Flop (didn't bet)
Seat 2: so0love (small blind) folded before Flop
Seat 3: rabbitmeat73 (big blind) folded before Flop
Seat 4: PapiMik3 folded before Flop (didn't bet)
Seat 5: FabOliveira9 folded before Flop (didn't bet)
Seat 6: Scaaalll collected ($0.05)



PokerStars Zoom Hand #229233567826:  Hold'em No Limit ($0.01/$0.02) - 2021/08/21 23:34:59 CET [2021/08/21 17:34:59 ET]
Table 'Halley' 6-max Seat #1 is the button
Seat 1: kahzura ($2.23 in chips) 
Seat 2: Scaaalll ($3.35 in chips) 
Seat 3: NickAlex18 ($2.95 in chips) 
Seat 4: GVMELLO ($2 in chips) 
Seat 5: WITKOW_AV ($2.07 in chips) 
Seat 6: Bol'tazar111 ($2.21 in chips) 
Scaaalll: posts small blind $0.01
NickAlex18: posts big blind $0.02
*** HOLE CARDS ***
Dealt to Scaaalll [Ks 3s]
GVMELLO: folds 
WITKOW_AV: raises $0.04 to $0.06
Bol'tazar111: folds 
kahzura: calls $0.06
Scaaalll: folds 
NickAlex18: calls $0.04
*** FLOP *** [Th 7h 4h]
NickAlex18: checks 
WITKOW_AV: bets $0.09
kahzura: folds 
NickAlex18: folds 
Uncalled bet ($0.09) returned to WITKOW_AV
WITKOW_AV collected $0.18 from pot
WITKOW_AV: doesn't show hand 
*** SUMMARY ***
Total pot $0.19 | Rake $0.01 
Board [Th 7h 4h]
Seat 1: kahzura (button) folded on the Flop
Seat 2: Scaaalll (small blind) folded before Flop
Seat 3: NickAlex18 (big blind) folded on the Flop
Seat 4: GVMELLO folded before Flop (didn't bet)
Seat 5: WITKOW_AV collected ($0.18)
Seat 6: Bol'tazar111 folded before Flop (didn't bet)



PokerStars Zoom Hand #229233565368:  Hold'em No Limit ($0.01/$0.02) - 2021/08/21 23:34:53 CET [2021/08/21 17:34:53 ET]
Table 'Halley' 6-max Seat #1 is the button
Seat 1: lauti214 ($2.01 in chips) 
Seat 2: isurusa ($3.36 in chips) 
Seat 3: hustlehero ($2 in chips) 
Seat 4: bart8612 ($2.62 in chips) 
Seat 5: Scaaalll ($3.35 in chips) 
Seat 6: Cineva81 ($2 in chips) 
isurusa: posts small blind $0.01
hustlehero: posts big blind $0.02
*** HOLE CARDS ***
Dealt to Scaaalll [4c 7d]
bart8612: folds 
Scaaalll: folds 
Cineva81: folds 
lauti214: calls $0.02
isurusa: folds 
hustlehero: checks 
*** FLOP *** [4s 9h 2s]
hustlehero: checks 
lauti214: bets $0.03
hustlehero: calls $0.03
*** TURN *** [4s 9h 2s] [2d]
hustlehero: checks 
lauti214: checks 
*** RIVER *** [4s 9h 2s 2d] [9c]
hustlehero: bets $0.06
lauti214: calls $0.06
*** SHOW DOWN ***
hustlehero: shows [4d 7c] (two pair, Nines and Fours)
lauti214: shows [8d 8s] (two pair, Nines and Eights)
lauti214 collected $0.22 from pot
*** SUMMARY ***
Total pot $0.23 | Rake $0.01 
Board [4s 9h 2s 2d 9c]
Seat 1: lauti214 (button) showed [8d 8s] and won ($0.22) with two pair, Nines and Eights
Seat 2: isurusa (small blind) folded before Flop
Seat 3: hustlehero (big blind) showed [4d 7c] and lost with two pair, Nines and Fours
Seat 4: bart8612 folded before Flop (didn't bet)
Seat 5: Scaaalll folded before Flop (didn't bet)
Seat 6: Cineva81 folded before Flop (didn't bet)



PokerStars Zoom Hand #229233570732:  Hold'em No Limit ($0.01/$0.02) - 2021/08/21 23:35:06 CET [2021/08/21 17:35:06 ET]
Table 'Halley' 6-max Seat #1 is the button
Seat 1: Scaaalll ($3.34 in chips) 
Seat 2: adrianh2002 ($2.35 in chips) 
Seat 3: Bina_sweety ($2.85 in chips) 
Seat 4: Lekcey05 ($2 in chips) 
Seat 5: clay070 ($1.49 in chips) 
Seat 6: nagibatorali ($1 in chips) 
adrianh2002: posts small blind $0.01
Bina_sweety: posts big blind $0.02
*** HOLE CARDS ***
Dealt to Scaaalll [9h Js]
Lekcey05: raises $0.04 to $0.06
clay070: folds 
nagibatorali: calls $0.06
Scaaalll: folds 
adrianh2002: folds 
Bina_sweety: folds 
*** FLOP *** [Tc Qs Jd]
Lekcey05: bets $0.07
nagibatorali: calls $0.07
*** TURN *** [Tc Qs Jd] [9s]
Lekcey05: checks 
nagibatorali: bets $0.28
Lekcey05: calls $0.28
*** RIVER *** [Tc Qs Jd 9s] [Kh]
Lekcey05: bets $0.62
nagibatorali: calls $0.59 and is all-in
Uncalled bet ($0.03) returned to Lekcey05
*** SHOW DOWN ***
Lekcey05: shows [Ad Qd] (a straight, Ten to Ace)
nagibatorali: shows [7d Ah] (a straight, Ten to Ace)
Lekcey05 collected $0.98 from pot
nagibatorali collected $0.98 from pot
*** SUMMARY ***
Total pot $2.03 | Rake $0.07 
Board [Tc Qs Jd 9s Kh]
Seat 1: Scaaalll (button) folded before Flop (didn't bet)
Seat 2: adrianh2002 (small blind) folded before Flop
Seat 3: Bina_sweety (big blind) folded before Flop
Seat 4: Lekcey05 showed [Ad Qd] and won ($0.98) with a straight, Ten to Ace
Seat 5: clay070 folded before Flop (didn't bet)
Seat 6: nagibatorali showed [7d Ah] and won ($0.98) with a straight, Ten to Ace



PokerStars Zoom Hand #229233574720:  Hold'em No Limit ($0.01/$0.02) - 2021/08/21 23:35:16 CET [2021/08/21 17:35:16 ET]
Table 'Halley' 6-max Seat #1 is the button
Seat 1: Gamer577 ($2.05 in chips) 
Seat 2: Hejpåre ($2.02 in chips) 
Seat 3: KKARMELO ($2.99 in chips) 
Seat 4: TTGemi ($2.58 in chips) 
Seat 5: comptonBL ($2.10 in chips) 
Seat 6: Scaaalll ($3.34 in chips) 
Hejpåre: posts small blind $0.01
KKARMELO: posts big blind $0.02
*** HOLE CARDS ***
Dealt to Scaaalll [4h 5h]
TTGemi: folds 
comptonBL: raises $0.04 to $0.06
Scaaalll: folds 
Gamer577: folds 
Hejpåre: folds 
KKARMELO: calls $0.04
*** FLOP *** [Qd Qh 8h]
KKARMELO: checks 
comptonBL: bets $0.07
KKARMELO: folds 
Uncalled bet ($0.07) returned to comptonBL
comptonBL collected $0.13 from pot
comptonBL: doesn't show hand 
*** SUMMARY ***
Total pot $0.13 | Rake $0 
Board [Qd Qh 8h]
Seat 1: Gamer577 (button) folded before Flop (didn't bet)
Seat 2: Hejpåre (small blind) folded before Flop
Seat 3: KKARMELO (big blind) folded on the Flop
Seat 4: TTGemi folded before Flop (didn't bet)
Seat 5: comptonBL collected ($0.13)
Seat 6: Scaaalll folded before Flop (didn't bet)



PokerStars Zoom Hand #229233578104:  Hold'em No Limit ($0.01/$0.02) - 2021/08/21 23:35:24 CET [2021/08/21 17:35:24 ET]
Table 'Halley' 6-max Seat #1 is the button
Seat 1: olga3021221 ($2.77 in chips) 
Seat 2: PapiMik3 ($3 in chips) 
Seat 3: Scaaalll ($3.34 in chips) 
Seat 4: cheddarspreada ($1.28 in chips) 
Seat 5: JTbukowski ($2.83 in chips) 
Seat 6: kahzura ($2.17 in chips) 
PapiMik3: posts small blind $0.01
Scaaalll: posts big blind $0.02
*** HOLE CARDS ***
Dealt to Scaaalll [9h 4s]
cheddarspreada: calls $0.02
JTbukowski: folds 
kahzura: folds 
olga3021221: folds 
PapiMik3: folds 
Scaaalll: checks 
*** FLOP *** [2d Tc Qd]
Scaaalll: checks 
cheddarspreada: checks 
*** TURN *** [2d Tc Qd] [Ac]
Scaaalll: checks 
cheddarspreada: checks 
*** RIVER *** [2d Tc Qd Ac] [2s]
Scaaalll: checks 
cheddarspreada: checks 
*** SHOW DOWN ***
Scaaalll: shows [9h 4s] (a pair of Deuces)
cheddarspreada: shows [Kc 8c] (a pair of Deuces - Ace+King kicker)
cheddarspreada collected $0.05 from pot
*** SUMMARY ***
Total pot $0.05 | Rake $0 
Board [2d Tc Qd Ac 2s]
Seat 1: olga3021221 (button) folded before Flop (didn't bet)
Seat 2: PapiMik3 (small blind) folded before Flop
Seat 3: Scaaalll (big blind) showed [9h 4s] and lost with a pair of Deuces
Seat 4: cheddarspreada showed [Kc 8c] and won ($0.05) with a pair of Deuces
Seat 5: JTbukowski folded before Flop (didn't bet)
Seat 6: kahzura folded before Flop (didn't bet)



PokerStars Zoom Hand #229233573127:  Hold'em No Limit ($0.01/$0.02) - 2021/08/21 23:35:12 CET [2021/08/21 17:35:12 ET]
Table 'Halley' 6-max Seat #1 is the button
Seat 1: Gerar NB ($2.03 in chips) 
Seat 2: Yangyang1407 ($2.07 in chips) 
Seat 3: ronald1982 ($3.10 in chips) 
Seat 4: Scaaalll ($3.34 in chips) 
Seat 5: Taran0001 ($5.16 in chips) 
Seat 6: elmex886 ($2 in chips) 
Yangyang1407: posts small blind $0.01
ronald1982: posts big blind $0.02
*** HOLE CARDS ***
Dealt to Scaaalll [4s Kh]
Scaaalll: folds 
Taran0001: folds 
elmex886: raises $0.03 to $0.05
Gerar NB: calls $0.05
Yangyang1407: folds 
ronald1982: calls $0.03
*** FLOP *** [Kd 6c 2h]
ronald1982: checks 
elmex886: checks 
Gerar NB: bets $0.08
ronald1982: calls $0.08
elmex886: folds 
*** TURN *** [Kd 6c 2h] [4d]
ronald1982: checks 
Gerar NB: bets $0.16
ronald1982: calls $0.16
*** RIVER *** [Kd 6c 2h 4d] [4h]
ronald1982: checks 
Gerar NB: bets $0.31
ronald1982: folds 
Uncalled bet ($0.31) returned to Gerar NB
Gerar NB collected $0.62 from pot
Gerar NB: doesn't show hand 
*** SUMMARY ***
Total pot $0.64 | Rake $0.02 
Board [Kd 6c 2h 4d 4h]
Seat 1: Gerar NB (button) collected ($0.62)
Seat 2: Yangyang1407 (small blind) folded before Flop
Seat 3: ronald1982 (big blind) folded on the River
Seat 4: Scaaalll folded before Flop (didn't bet)
Seat 5: Taran0001 folded before Flop (didn't bet)
Seat 6: elmex886 folded on the Flop



PokerStars Zoom Hand #229233596619:  Hold'em No Limit ($0.01/$0.02) - 2021/08/21 23:36:09 CET [2021/08/21 17:36:09 ET]
Table 'Halley' 6-max Seat #1 is the button
Seat 1: gaturamard ($2.62 in chips) 
Seat 2: Scaaalll ($3.32 in chips) 
Seat 3: Agneobr ($2 in chips) 
Seat 4: lucksuckdonk ($9.55 in chips) 
Seat 5: Gerar NB ($2.36 in chips) 
Seat 6: BIITRU ($2.04 in chips) 
Scaaalll: posts small blind $0.01
Agneobr: posts big blind $0.02
*** HOLE CARDS ***
Dealt to Scaaalll [5c Ah]
lucksuckdonk: folds 
Gerar NB: folds 
BIITRU: folds 
gaturamard: raises $0.03 to $0.05
Scaaalll: folds 
Agneobr: folds 
Uncalled bet ($0.03) returned to gaturamard
gaturamard collected $0.05 from pot
gaturamard: doesn't show hand 
*** SUMMARY ***
Total pot $0.05 | Rake $0 
Seat 1: gaturamard (button) collected ($0.05)
Seat 2: Scaaalll (small blind) folded before Flop
Seat 3: Agneobr (big blind) folded before Flop
Seat 4: lucksuckdonk folded before Flop (didn't bet)
Seat 5: Gerar NB folded before Flop (didn't bet)
Seat 6: BIITRU folded before Flop (didn't bet)



PokerStars Zoom Hand #229233601843:  Hold'em No Limit ($0.01/$0.02) - 2021/08/21 23:36:22 CET [2021/08/21 17:36:22 ET]
Table 'Halley' 6-max Seat #1 is the button
Seat 1: kukulagosleep ($4.51 in chips) 
Seat 2: hairy navel ($1.95 in chips) 
Seat 3: Scaaalll ($3.31 in chips) 
Seat 4: KKARMELO ($2.81 in chips) 
Seat 5: REZAKOV72 ($2.94 in chips) 
Seat 6: kumka8812 ($1.49 in chips) 
hairy navel: posts small blind $0.01
Scaaalll: posts big blind $0.02
*** HOLE CARDS ***
Dealt to Scaaalll [5h 9h]
KKARMELO: folds 
REZAKOV72: folds 
kumka8812: calls $0.02
kukulagosleep: folds 
hairy navel: folds 
Scaaalll: checks 
*** FLOP *** [Jh 8h 4s]
Scaaalll: checks 
kumka8812: checks 
*** TURN *** [Jh 8h 4s] [Jc]
Scaaalll: checks 
kumka8812: checks 
*** RIVER *** [Jh 8h 4s Jc] [Kd]
Scaaalll: checks 
kumka8812: bets $1.47 and is all-in
Scaaalll: folds 
Uncalled bet ($1.47) returned to kumka8812
kumka8812 collected $0.05 from pot
kumka8812: doesn't show hand 
*** SUMMARY ***
Total pot $0.05 | Rake $0 
Board [Jh 8h 4s Jc Kd]
Seat 1: kukulagosleep (button) folded before Flop (didn't bet)
Seat 2: hairy navel (small blind) folded before Flop
Seat 3: Scaaalll (big blind) folded on the River
Seat 4: KKARMELO folded before Flop (didn't bet)
Seat 5: REZAKOV72 folded before Flop (didn't bet)
Seat 6: kumka8812 collected ($0.05)



PokerStars Zoom Hand #229233592909:  Hold'em No Limit ($0.01/$0.02) - 2021/08/21 23:36:00 CET [2021/08/21 17:36:00 ET]
Table 'Halley' 6-max Seat #1 is the button
Seat 1: LijanaV ($5.49 in chips) 
Seat 2: dannyluijten ($2.37 in chips) 
Seat 3: Gamer577 ($5.99 in chips) 
Seat 4: Feliciano16 ($7.61 in chips) 
Seat 5: Scaaalll ($3.32 in chips) 
Seat 6: isurusa ($1.09 in chips) 
dannyluijten: posts small blind $0.01
Gamer577: posts big blind $0.02
*** HOLE CARDS ***
Dealt to Scaaalll [7h 6d]
Feliciano16: folds 
Scaaalll: folds 
isurusa: folds 
LijanaV: calls $0.02
dannyluijten: raises $0.06 to $0.08
Gamer577: calls $0.06
LijanaV: calls $0.06
*** FLOP *** [Qd 9s 3h]
dannyluijten: checks 
Gamer577: checks 
LijanaV: checks 
*** TURN *** [Qd 9s 3h] [Kd]
dannyluijten: bets $0.16
LijanaV is disconnected 
Gamer577: raises $0.32 to $0.48
LijanaV: folds 
dannyluijten: raises $0.62 to $1.10
Gamer577: raises $4.81 to $5.91 and is all-in
dannyluijten: calls $1.19 and is all-in
Uncalled bet ($3.62) returned to Gamer577
*** FIRST RIVER *** [Qd 9s 3h Kd] [7s]
*** SECOND RIVER *** [Qd 9s 3h Kd] [2h]
*** FIRST SHOW DOWN ***
dannyluijten: shows [9d 9c] (three of a kind, Nines)
Gamer577: shows [Tc Jc] (a straight, Nine to King)
Gamer577 collected $2.33 from pot
*** SECOND SHOW DOWN ***
dannyluijten: shows [9d 9c] (three of a kind, Nines)
Gamer577: shows [Tc Jc] (a straight, Nine to King)
Gamer577 collected $2.32 from pot
*** SUMMARY ***
Total pot $4.82 | Rake $0.17 
Hand was run twice
FIRST Board [Qd 9s 3h Kd 7s]
SECOND Board [Qd 9s 3h Kd 2h]
Seat 1: LijanaV (button) folded on the Turn
Seat 2: dannyluijten (small blind) showed [9d 9c] and lost with three of a kind, Nines, and lost with three of a kind, Nines
Seat 3: Gamer577 (big blind) showed [Tc Jc] and won ($2.33) with a straight, Nine to King, and won ($2.32) with a straight, Nine to King
Seat 4: Feliciano16 folded before Flop (didn't bet)
Seat 5: Scaaalll folded before Flop (didn't bet)
Seat 6: isurusa folded before Flop (didn't bet)



PokerStars Zoom Hand #229233617821:  Hold'em No Limit ($0.01/$0.02) - 2021/08/21 23:37:01 CET [2021/08/21 17:37:01 ET]
Table 'Halley' 6-max Seat #1 is the button
Seat 1: pavlo8855 ($2.22 in chips) 
Seat 2: Jackb9908 ($1 in chips) 
Seat 3: olga3021221 ($2.05 in chips) 
Seat 4: Scaaalll ($3.29 in chips) 
Seat 5: hustlehero ($2.05 in chips) 
Seat 6: A.Khodyakov ($1.94 in chips) 
Jackb9908: posts small blind $0.01
olga3021221: posts big blind $0.02
*** HOLE CARDS ***
Dealt to Scaaalll [7h 5h]
Scaaalll: folds 
hustlehero: folds 
A.Khodyakov: folds 
pavlo8855: folds 
Jackb9908: folds 
Uncalled bet ($0.01) returned to olga3021221
olga3021221 collected $0.02 from pot
olga3021221: doesn't show hand 
*** SUMMARY ***
Total pot $0.02 | Rake $0 
Seat 1: pavlo8855 (button) folded before Flop (didn't bet)
Seat 2: Jackb9908 (small blind) folded before Flop
Seat 3: olga3021221 (big blind) collected ($0.02)
Seat 4: Scaaalll folded before Flop (didn't bet)
Seat 5: hustlehero folded before Flop (didn't bet)
Seat 6: A.Khodyakov folded before Flop (didn't bet)



PokerStars Zoom Hand #229233613808:  Hold'em No Limit ($0.01/$0.02) - 2021/08/21 23:36:51 CET [2021/08/21 17:36:51 ET]
Table 'Halley' 6-max Seat #1 is the button
Seat 1: Scaaalll ($3.29 in chips) 
Seat 2: Nihility77 ($4.56 in chips) 
Seat 3: 47911728 ($0.83 in chips) 
Seat 4: gilberto98 ($4.56 in chips) 
Seat 5: ronald1982 ($2.79 in chips) 
Seat 6: kai_inge_mar ($0.99 in chips) 
Nihility77: posts small blind $0.01
47911728: posts big blind $0.02
*** HOLE CARDS ***
Dealt to Scaaalll [9c Qs]
gilberto98: calls $0.02
ronald1982: folds 
kai_inge_mar: folds 
Scaaalll: folds 
Nihility77: folds 
47911728: checks 
*** FLOP *** [Td 3c Qh]
47911728: checks 
gilberto98: bets $0.05
47911728: folds 
Uncalled bet ($0.05) returned to gilberto98
gilberto98 collected $0.05 from pot
gilberto98: doesn't show hand 
*** SUMMARY ***
Total pot $0.05 | Rake $0 
Board [Td 3c Qh]
Seat 1: Scaaalll (button) folded before Flop (didn't bet)
Seat 2: Nihility77 (small blind) folded before Flop
Seat 3: 47911728 (big blind) folded on the Flop
Seat 4: gilberto98 collected ($0.05)
Seat 5: ronald1982 folded before Flop (didn't bet)
Seat 6: kai_inge_mar folded before Flop (didn't bet)



PokerStars Zoom Hand #229233619423:  Hold'em No Limit ($0.01/$0.02) - 2021/08/21 23:37:05 CET [2021/08/21 17:37:05 ET]
Table 'Halley' 6-max Seat #1 is the button
Seat 1: BIITRU ($2.49 in chips) 
Seat 2: Feyqdoi ($2.05 in chips) 
Seat 3: Gerar NB ($2.08 in chips) 
Seat 4: punkosk8 ($6.80 in chips) 
Seat 5: Scaaalll ($3.29 in chips) 
Seat 6: Jackb9908 ($0.99 in chips) 
Feyqdoi: posts small blind $0.01
Gerar NB: posts big blind $0.02
*** HOLE CARDS ***
Dealt to Scaaalll [7h 3d]
punkosk8: folds 
Scaaalll: folds 
punkosk8 is disconnected 
Jackb9908: raises $0.02 to $0.04
BIITRU: folds 
Feyqdoi: calls $0.03
Gerar NB: folds 
*** FLOP *** [2s 3s 4c]
Feyqdoi: checks 
Jackb9908: checks 
*** TURN *** [2s 3s 4c] [7c]
Feyqdoi: bets $0.06
Jackb9908: calls $0.06
*** RIVER *** [2s 3s 4c 7c] [7s]
Feyqdoi: bets $0.16
Jackb9908: raises $0.16 to $0.32
Feyqdoi: calls $0.16
*** SHOW DOWN ***
Jackb9908: shows [5h 5s] (two pair, Sevens and Fives)
Feyqdoi: shows [8s 9s] (a flush, Nine high)
Feyqdoi collected $0.83 from pot
*** SUMMARY ***
Total pot $0.86 | Rake $0.03 
Board [2s 3s 4c 7c 7s]
Seat 1: BIITRU (button) folded before Flop (didn't bet)
Seat 2: Feyqdoi (small blind) showed [8s 9s] and won ($0.83) with a flush, Nine high
Seat 3: Gerar NB (big blind) folded before Flop
Seat 4: punkosk8 folded before Flop (didn't bet)
Seat 5: Scaaalll folded before Flop (didn't bet)
Seat 6: Jackb9908 showed [5h 5s] and lost with two pair, Sevens and Fives



PokerStars Zoom Hand #229233622308:  Hold'em No Limit ($0.01/$0.02) - 2021/08/21 23:37:12 CET [2021/08/21 17:37:12 ET]
Table 'Halley' 6-max Seat #1 is the button
Seat 1: pipecmolodec ($2.36 in chips) 
Seat 2: lucksuckdonk ($5.43 in chips) 
Seat 3: Hejpåre ($4.28 in chips) 
Seat 4: hustlehero ($2.04 in chips) 
Seat 5: Agneobr ($1.92 in chips) 
Seat 6: Scaaalll ($3.29 in chips) 
lucksuckdonk: posts small blind $0.01
Hejpåre: posts big blind $0.02
*** HOLE CARDS ***
Dealt to Scaaalll [Kh 7d]
hustlehero: folds 
Agneobr: raises $0.03 to $0.05
Scaaalll: folds 
pipecmolodec: folds 
lucksuckdonk: calls $0.04
Hejpåre: calls $0.03
*** FLOP *** [Ts 2s 4h]
lucksuckdonk: checks 
Hejpåre: checks 
Agneobr: checks 
*** TURN *** [Ts 2s 4h] [5c]
lucksuckdonk: bets $0.09
Hejpåre: folds 
Agneobr: folds 
Uncalled bet ($0.09) returned to lucksuckdonk
lucksuckdonk collected $0.14 from pot
lucksuckdonk: doesn't show hand 
*** SUMMARY ***
Total pot $0.15 | Rake $0.01 
Board [Ts 2s 4h 5c]
Seat 1: pipecmolodec (button) folded before Flop (didn't bet)
Seat 2: lucksuckdonk (small blind) collected ($0.14)
Seat 3: Hejpåre (big blind) folded on the Turn
Seat 4: hustlehero folded before Flop (didn't bet)
Seat 5: Agneobr folded on the Turn
Seat 6: Scaaalll folded before Flop (didn't bet)



PokerStars Zoom Hand #229233629186:  Hold'em No Limit ($0.01/$0.02) - 2021/08/21 23:37:29 CET [2021/08/21 17:37:29 ET]
Table 'Halley' 6-max Seat #1 is the button
Seat 1: kahzura ($2.28 in chips) 
Seat 2: gabgordula ($2.01 in chips) 
Seat 3: sulcinob ($1.97 in chips) 
Seat 4: Scaaalll ($3.29 in chips) 
Seat 5: hairy navel ($1.90 in chips) 
Seat 6: qqqqqqqqq966 ($1.58 in chips) 
gabgordula: posts small blind $0.01
sulcinob: posts big blind $0.02
*** HOLE CARDS ***
Dealt to Scaaalll [8h Jc]
Scaaalll: folds 
hairy navel: folds 
qqqqqqqqq966: raises $0.02 to $0.04
kahzura: folds 
gabgordula: raises $0.12 to $0.16
sulcinob: folds 
qqqqqqqqq966: calls $0.12
*** FLOP *** [2h 8c 9c]
gabgordula: bets $0.20
qqqqqqqqq966: folds 
Uncalled bet ($0.20) returned to gabgordula
gabgordula collected $0.33 from pot
gabgordula: doesn't show hand 
qqqqqqqqq966 is disconnected 
*** SUMMARY ***
Total pot $0.34 | Rake $0.01 
Board [2h 8c 9c]
Seat 1: kahzura (button) folded before Flop (didn't bet)
Seat 2: gabgordula (small blind) collected ($0.33)
Seat 3: sulcinob (big blind) folded before Flop
Seat 4: Scaaalll folded before Flop (didn't bet)
Seat 5: hairy navel folded before Flop (didn't bet)
Seat 6: qqqqqqqqq966 folded on the Flop



PokerStars Zoom Hand #229233635769:  Hold'em No Limit ($0.01/$0.02) - 2021/08/21 23:37:45 CET [2021/08/21 17:37:45 ET]
Table 'Halley' 6-max Seat #1 is the button
Seat 1: Scaaalll ($3.28 in chips) 
Seat 2: Fenix888888 ($0.80 in chips) 
Seat 3: PEDACIT0 ($2.10 in chips) 
Seat 4: ussr246 ($2.67 in chips) 
Seat 5: fabor1303 ($2.60 in chips) 
Seat 6: Sha.Le.Ol. ($1.15 in chips) 
Fenix888888: posts small blind $0.01
PEDACIT0: posts big blind $0.02
*** HOLE CARDS ***
Dealt to Scaaalll [4h Qh]
ussr246: raises $0.02 to $0.04
fabor1303: folds 
Sha.Le.Ol.: raises $0.05 to $0.09
Scaaalll: folds 
Fenix888888: folds 
PEDACIT0: folds 
ussr246: calls $0.05
*** FLOP *** [9c Kh 6c]
ussr246: checks 
Sha.Le.Ol.: bets $0.13
ussr246: folds 
Uncalled bet ($0.13) returned to Sha.Le.Ol.
Sha.Le.Ol. collected $0.20 from pot
Sha.Le.Ol.: doesn't show hand 
*** SUMMARY ***
Total pot $0.21 | Rake $0.01 
Board [9c Kh 6c]
Seat 1: Scaaalll (button) folded before Flop (didn't bet)
Seat 2: Fenix888888 (small blind) folded before Flop
Seat 3: PEDACIT0 (big blind) folded before Flop
Seat 4: ussr246 folded on the Flop
Seat 5: fabor1303 folded before Flop (didn't bet)
Seat 6: Sha.Le.Ol. collected ($0.20)



PokerStars Zoom Hand #229233630871:  Hold'em No Limit ($0.01/$0.02) - 2021/08/21 23:37:33 CET [2021/08/21 17:37:33 ET]
Table 'Halley' 6-max Seat #1 is the button
Seat 1: polymorhp ($3.26 in chips) 
Seat 2: Scaaalll ($3.29 in chips) 
Seat 3: Langusta1 ($1.06 in chips) 
Seat 4: Binny Puch ($2 in chips) 
Seat 5: MattieBOZ ($1.16 in chips) 
Seat 6: zergmiky ($3.23 in chips) 
Scaaalll: posts small blind $0.01
Langusta1: posts big blind $0.02
*** HOLE CARDS ***
Dealt to Scaaalll [6h Qd]
MattieBOZ is disconnected 
Binny Puch has timed out
Binny Puch: folds 
MattieBOZ: folds 
zergmiky: raises $0.03 to $0.05
polymorhp: raises $0.13 to $0.18
Scaaalll: folds 
Langusta1: folds 
zergmiky: calls $0.13
*** FLOP *** [9s 7d 9c]
zergmiky: checks 
polymorhp: checks 
*** TURN *** [9s 7d 9c] [7h]
zergmiky: checks 
polymorhp: bets $0.27
zergmiky: folds 
Uncalled bet ($0.27) returned to polymorhp
polymorhp collected $0.38 from pot
polymorhp: doesn't show hand 
*** SUMMARY ***
Total pot $0.39 | Rake $0.01 
Board [9s 7d 9c 7h]
Seat 1: polymorhp (button) collected ($0.38)
Seat 2: Scaaalll (small blind) folded before Flop
Seat 3: Langusta1 (big blind) folded before Flop
Seat 4: Binny Puch folded before Flop (didn't bet)
Seat 5: MattieBOZ folded before Flop (didn't bet)
Seat 6: zergmiky folded on the Turn



PokerStars Zoom Hand #229233638653:  Hold'em No Limit ($0.01/$0.02) - 2021/08/21 23:37:52 CET [2021/08/21 17:37:52 ET]
Table 'Halley' 6-max Seat #1 is the button
Seat 1: tassy237 ($1.19 in chips) 
Seat 2: Bina_sweety ($2.49 in chips) 
Seat 3: Nihility77 ($3 in chips) 
Seat 4: Red Sky 15 ($9.86 in chips) 
Seat 5: ulisessoria ($2 in chips) 
Seat 6: Scaaalll ($3.28 in chips) 
Bina_sweety: posts small blind $0.01
Nihility77: posts big blind $0.02
*** HOLE CARDS ***
Dealt to Scaaalll [9c 9d]
tassy237 is disconnected 
Red Sky 15: folds 
Red Sky 15 is disconnected 
ulisessoria: folds 
Scaaalll: raises $0.04 to $0.06
tassy237: folds 
Bina_sweety: calls $0.05
Nihility77: folds 
*** FLOP *** [2h 5d 8s]
Bina_sweety: bets $0.07
Scaaalll: calls $0.07
*** TURN *** [2h 5d 8s] [As]
Bina_sweety: checks 
Scaaalll: bets $0.14
Bina_sweety: raises $0.28 to $0.42
Scaaalll: folds 
Uncalled bet ($0.28) returned to Bina_sweety
Bina_sweety collected $0.54 from pot
Bina_sweety: doesn't show hand 
*** SUMMARY ***
Total pot $0.56 | Rake $0.02 
Board [2h 5d 8s As]
Seat 1: tassy237 (button) folded before Flop (didn't bet)
Seat 2: Bina_sweety (small blind) collected ($0.54)
Seat 3: Nihility77 (big blind) folded before Flop
Seat 4: Red Sky 15 folded before Flop (didn't bet)
Seat 5: ulisessoria folded before Flop (didn't bet)
Seat 6: Scaaalll folded on the Turn



PokerStars Zoom Hand #229233654903:  Hold'em No Limit ($0.01/$0.02) - 2021/08/21 23:38:32 CET [2021/08/21 17:38:32 ET]
Table 'Halley' 6-max Seat #1 is the button
Seat 1: Koldun 2636 ($3.93 in chips) 
Seat 2: Ne0net ($2.08 in chips) 
Seat 3: Scaaalll ($3.01 in chips) 
Seat 4: johnpa89 ($3.29 in chips) 
Seat 5: vovan100157 ($2.02 in chips) 
Seat 6: Jackb9908 ($0.59 in chips) 
Ne0net: posts small blind $0.01
Scaaalll: posts big blind $0.02
*** HOLE CARDS ***
Dealt to Scaaalll [Tc 8d]
johnpa89: folds 
vovan100157: folds 
Jackb9908: raises $0.57 to $0.59 and is all-in
Koldun 2636: folds 
Ne0net: folds 
Scaaalll: folds 
Uncalled bet ($0.57) returned to Jackb9908
Jackb9908 collected $0.05 from pot
Jackb9908: doesn't show hand 
*** SUMMARY ***
Total pot $0.05 | Rake $0 
Seat 1: Koldun 2636 (button) folded before Flop (didn't bet)
Seat 2: Ne0net (small blind) folded before Flop
Seat 3: Scaaalll (big blind) folded before Flop
Seat 4: johnpa89 folded before Flop (didn't bet)
Seat 5: vovan100157 folded before Flop (didn't bet)
Seat 6: Jackb9908 collected ($0.05)



PokerStars Zoom Hand #229233659758:  Hold'em No Limit ($0.01/$0.02) - 2021/08/21 23:38:44 CET [2021/08/21 17:38:44 ET]
Table 'Halley' 6-max Seat #1 is the button
Seat 1: Scaaalll ($2.99 in chips) 
Seat 2: nodtress ($2 in chips) 
Seat 3: AlienMdeo ($1.97 in chips) 
Seat 4: lucksuckdonk ($5.60 in chips) 
Seat 5: A.Khodyakov ($2.54 in chips) 
Seat 6: dkno77 ($3.51 in chips) 
nodtress: posts small blind $0.01
AlienMdeo: posts big blind $0.02
*** HOLE CARDS ***
Dealt to Scaaalll [Td 9h]
lucksuckdonk: folds 
A.Khodyakov: folds 
dkno77: folds 
Scaaalll: raises $0.02 to $0.04
nodtress: folds 
AlienMdeo: folds 
Uncalled bet ($0.02) returned to Scaaalll
Scaaalll collected $0.05 from pot
Scaaalll: doesn't show hand 
*** SUMMARY ***
Total pot $0.05 | Rake $0 
Seat 1: Scaaalll (button) collected ($0.05)
Seat 2: nodtress (small blind) folded before Flop
Seat 3: AlienMdeo (big blind) folded before Flop
Seat 4: lucksuckdonk folded before Flop (didn't bet)
Seat 5: A.Khodyakov folded before Flop (didn't bet)
Seat 6: dkno77 folded before Flop (didn't bet)



PokerStars Zoom Hand #229233670185:  Hold'em No Limit ($0.01/$0.02) - 2021/08/21 23:39:10 CET [2021/08/21 17:39:10 ET]
Table 'Halley' 6-max Seat #1 is the button
Seat 1: fabor1303 ($10.16 in chips) 
Seat 2: Finderra ($2.96 in chips) 
Seat 3: elmex886 ($2 in chips) 
Seat 4: KonopDima ($2.32 in chips) 
Seat 5: Scaaalll ($3.01 in chips) 
Seat 6: funomal ($1.44 in chips) 
Finderra: posts small blind $0.01
elmex886: posts big blind $0.02
*** HOLE CARDS ***
Dealt to Scaaalll [7c 2s]
funomal is disconnected 
KonopDima: folds 
Scaaalll: folds 
funomal: folds 
fabor1303: folds 
Finderra: folds 
Uncalled bet ($0.01) returned to elmex886
elmex886 collected $0.02 from pot
elmex886: doesn't show hand 
*** SUMMARY ***
Total pot $0.02 | Rake $0 
Seat 1: fabor1303 (button) folded before Flop (didn't bet)
Seat 2: Finderra (small blind) folded before Flop
Seat 3: elmex886 (big blind) collected ($0.02)
Seat 4: KonopDima folded before Flop (didn't bet)
Seat 5: Scaaalll folded before Flop (didn't bet)
Seat 6: funomal folded before Flop (didn't bet)



PokerStars Zoom Hand #229233671772:  Hold'em No Limit ($0.01/$0.02) - 2021/08/21 23:39:14 CET [2021/08/21 17:39:14 ET]
Table 'Halley' 6-max Seat #1 is the button
Seat 1: kahzura ($2.50 in chips) 
Seat 2: FrancoOlmedo ($1.84 in chips) 
Seat 3: ofalkeid ($2 in chips) 
Seat 4: REZAKOV72 ($3.31 in chips) 
Seat 5: Scaaalll ($3.01 in chips) 
Seat 6: fabor1303 ($10.16 in chips) 
FrancoOlmedo: posts small blind $0.01
ofalkeid: posts big blind $0.02
*** HOLE CARDS ***
Dealt to Scaaalll [Qs Th]
REZAKOV72: folds 
Scaaalll: folds 
fabor1303: folds 
kahzura: folds 
FrancoOlmedo: folds 
Uncalled bet ($0.01) returned to ofalkeid
ofalkeid collected $0.02 from pot
ofalkeid: doesn't show hand 
*** SUMMARY ***
Total pot $0.02 | Rake $0 
Seat 1: kahzura (button) folded before Flop (didn't bet)
Seat 2: FrancoOlmedo (small blind) folded before Flop
Seat 3: ofalkeid (big blind) collected ($0.02)
Seat 4: REZAKOV72 folded before Flop (didn't bet)
Seat 5: Scaaalll folded before Flop (didn't bet)
Seat 6: fabor1303 folded before Flop (didn't bet)



PokerStars Zoom Hand #229233668194:  Hold'em No Limit ($0.01/$0.02) - 2021/08/21 23:39:05 CET [2021/08/21 17:39:05 ET]
Table 'Halley' 6-max Seat #1 is the button
Seat 1: lucksuckdonk ($5.57 in chips) 
Seat 2: Scaaalll ($3.02 in chips) 
Seat 3: Lamazflush ($5.20 in chips) 
Seat 4: FrancoOlmedo ($2.07 in chips) 
Seat 5: nightwacher ($1.99 in chips) 
Seat 6: gasmar_29 ($2.68 in chips) 
Scaaalll: posts small blind $0.01
Lamazflush: posts big blind $0.02
*** HOLE CARDS ***
Dealt to Scaaalll [3c As]
FrancoOlmedo: folds 
nightwacher: folds 
gasmar_29: folds 
lucksuckdonk: raises $0.04 to $0.06
Scaaalll: folds 
Lamazflush: calls $0.04
*** FLOP *** [Qc 4c 4d]
Lamazflush: checks 
lucksuckdonk: checks 
*** TURN *** [Qc 4c 4d] [Th]
Lamazflush: checks 
lucksuckdonk: bets $0.07
Lamazflush: calls $0.07
*** RIVER *** [Qc 4c 4d Th] [9s]
Lamazflush: checks 
lucksuckdonk: checks 
*** SHOW DOWN ***
Lamazflush: shows [Kh 6c] (a pair of Fours)
lucksuckdonk: shows [Js 9h] (two pair, Nines and Fours)
lucksuckdonk collected $0.26 from pot
*** SUMMARY ***
Total pot $0.27 | Rake $0.01 
Board [Qc 4c 4d Th 9s]
Seat 1: lucksuckdonk (button) showed [Js 9h] and won ($0.26) with two pair, Nines and Fours
Seat 2: Scaaalll (small blind) folded before Flop
Seat 3: Lamazflush (big blind) showed [Kh 6c] and lost with a pair of Fours
Seat 4: FrancoOlmedo folded before Flop (didn't bet)
Seat 5: nightwacher folded before Flop (didn't bet)
Seat 6: gasmar_29 folded before Flop (didn't bet)



PokerStars Zoom Hand #229233673503:  Hold'em No Limit ($0.01/$0.02) - 2021/08/21 23:39:18 CET [2021/08/21 17:39:18 ET]
Table 'Halley' 6-max Seat #1 is the button
Seat 1: BeastBoy18 ($3.09 in chips) 
Seat 2: Xlavariable ($2.79 in chips) 
Seat 3: Iv3rson18 ($3.07 in chips) 
Seat 4: Scaaalll ($3.01 in chips) 
Seat 5: so0love ($4.19 in chips) 
Seat 6: tuolau ($4.20 in chips) 
Xlavariable: posts small blind $0.01
Iv3rson18: posts big blind $0.02
*** HOLE CARDS ***
Dealt to Scaaalll [2h 2c]
Scaaalll: raises $0.04 to $0.06
so0love: folds 
tuolau: calls $0.06
BeastBoy18: folds 
Xlavariable: folds 
Iv3rson18: folds 
*** FLOP *** [8s Qs Ah]
Scaaalll: checks 
tuolau: checks 
*** TURN *** [8s Qs Ah] [4s]
Scaaalll: checks 
tuolau: bets $0.06
Scaaalll: folds 
Uncalled bet ($0.06) returned to tuolau
tuolau collected $0.14 from pot
tuolau: doesn't show hand 
*** SUMMARY ***
Total pot $0.15 | Rake $0.01 
Board [8s Qs Ah 4s]
Seat 1: BeastBoy18 (button) folded before Flop (didn't bet)
Seat 2: Xlavariable (small blind) folded before Flop
Seat 3: Iv3rson18 (big blind) folded before Flop
Seat 4: Scaaalll folded on the Turn
Seat 5: so0love folded before Flop (didn't bet)
Seat 6: tuolau collected ($0.14)



PokerStars Zoom Hand #229233692535:  Hold'em No Limit ($0.01/$0.02) - 2021/08/21 23:40:05 CET [2021/08/21 17:40:05 ET]
Table 'Halley' 6-max Seat #1 is the button
Seat 1: Hallyson_23 ($4.43 in chips) 
Seat 2: NetoFLX ($2 in chips) 
Seat 3: ctaceo ($2.41 in chips) 
Seat 4: polymorhp ($3.55 in chips) 
Seat 5: tuolau ($4.28 in chips) 
Seat 6: Scaaalll ($2.95 in chips) 
NetoFLX: posts small blind $0.01
ctaceo: posts big blind $0.02
*** HOLE CARDS ***
Dealt to Scaaalll [9s 8h]
polymorhp: folds 
tuolau: folds 
Scaaalll: folds 
Hallyson_23: folds 
tuolau is disconnected 
NetoFLX: folds 
Uncalled bet ($0.01) returned to ctaceo
ctaceo collected $0.02 from pot
ctaceo: doesn't show hand 
*** SUMMARY ***
Total pot $0.02 | Rake $0 
Seat 1: Hallyson_23 (button) folded before Flop (didn't bet)
Seat 2: NetoFLX (small blind) folded before Flop
Seat 3: ctaceo (big blind) collected ($0.02)
Seat 4: polymorhp folded before Flop (didn't bet)
Seat 5: tuolau folded before Flop (didn't bet)
Seat 6: Scaaalll folded before Flop (didn't bet)



PokerStars Zoom Hand #229233694076:  Hold'em No Limit ($0.01/$0.02) - 2021/08/21 23:40:09 CET [2021/08/21 17:40:09 ET]
Table 'Halley' 6-max Seat #1 is the button
Seat 1: ofalkeid ($2.22 in chips) 
Seat 2: YgovAndrey ($2.06 in chips) 
Seat 3: Scaaalll ($2.95 in chips) 
Seat 4: olga3021221 ($2.87 in chips) 
Seat 5: tarogame ($3.31 in chips) 
Seat 6: tisadaisy ($2.06 in chips) 
YgovAndrey: posts small blind $0.01
Scaaalll: posts big blind $0.02
*** HOLE CARDS ***
Dealt to Scaaalll [7c Tc]
olga3021221: folds 
tarogame: raises $0.03 to $0.05
tisadaisy: calls $0.05
ofalkeid: folds 
YgovAndrey: folds 
Scaaalll: calls $0.03
*** FLOP *** [5c Ac 4h]
Scaaalll: checks 
tarogame: bets $0.08
tisadaisy: calls $0.08
Scaaalll: calls $0.08
*** TURN *** [5c Ac 4h] [3s]
Scaaalll: checks 
tarogame: checks 
tisadaisy: bets $0.28
Scaaalll: calls $0.28
tarogame: calls $0.28
*** RIVER *** [5c Ac 4h 3s] [Js]
Scaaalll: checks 
tarogame: checks 
tisadaisy: bets $0.60
Scaaalll: folds 
tarogame: calls $0.60
*** SHOW DOWN ***
tisadaisy: shows [5s 5d] (three of a kind, Fives)
tarogame: mucks hand 
tisadaisy collected $2.35 from pot
*** SUMMARY ***
Total pot $2.44 | Rake $0.09 
Board [5c Ac 4h 3s Js]
Seat 1: ofalkeid (button) folded before Flop (didn't bet)
Seat 2: YgovAndrey (small blind) folded before Flop
Seat 3: Scaaalll (big blind) folded on the River
Seat 4: olga3021221 folded before Flop (didn't bet)
Seat 5: tarogame mucked [9c As]
Seat 6: tisadaisy showed [5s 5d] and won ($2.35) with three of a kind, Fives



PokerStars Zoom Hand #229233718791:  Hold'em No Limit ($0.01/$0.02) - 2021/08/21 23:41:10 CET [2021/08/21 17:41:10 ET]
Table 'Halley' 6-max Seat #1 is the button
Seat 1: Nihility77 ($5.92 in chips) 
Seat 2: Scaaalll ($2.54 in chips) 
Seat 3: hairy navel ($2.25 in chips) 
Seat 4: kidninja888 ($2.72 in chips) 
Seat 5: AlienMdeo ($1.96 in chips) 
Seat 6: egroj1700 ($2.16 in chips) 
Scaaalll: posts small blind $0.01
hairy navel: posts big blind $0.02
*** HOLE CARDS ***
Dealt to Scaaalll [Qd Ah]
kidninja888: folds 
AlienMdeo: folds 
egroj1700: folds 
Nihility77: folds 
Scaaalll: raises $0.04 to $0.06
hairy navel: folds 
Uncalled bet ($0.04) returned to Scaaalll
Scaaalll collected $0.04 from pot
Scaaalll: doesn't show hand 
*** SUMMARY ***
Total pot $0.04 | Rake $0 
Seat 1: Nihility77 (button) folded before Flop (didn't bet)
Seat 2: Scaaalll (small blind) collected ($0.04)
Seat 3: hairy navel (big blind) folded before Flop
Seat 4: kidninja888 folded before Flop (didn't bet)
Seat 5: AlienMdeo folded before Flop (didn't bet)
Seat 6: egroj1700 folded before Flop (didn't bet)



PokerStars Zoom Hand #229233730469:  Hold'em No Limit ($0.01/$0.02) - 2021/08/21 23:41:39 CET [2021/08/21 17:41:39 ET]
Table 'Halley' 6-max Seat #1 is the button
Seat 1: kahzura ($2.50 in chips) 
Seat 2: FrancoOlmedo ($2.35 in chips) 
Seat 3: Tabitaji ($6.97 in chips) 
Seat 4: Scaaalll ($2.56 in chips) 
Seat 5: BriceDo1917 ($4.21 in chips) 
Seat 6: zergmiky ($2.38 in chips) 
FrancoOlmedo: posts small blind $0.01
Tabitaji: posts big blind $0.02
*** HOLE CARDS ***
Dealt to Scaaalll [2s 4d]
Scaaalll: folds 
BriceDo1917: folds 
BriceDo1917 is disconnected 
zergmiky: folds 
kahzura: folds 
FrancoOlmedo: folds 
Uncalled bet ($0.01) returned to Tabitaji
Tabitaji collected $0.02 from pot
Tabitaji: doesn't show hand 
*** SUMMARY ***
Total pot $0.02 | Rake $0 
Seat 1: kahzura (button) folded before Flop (didn't bet)
Seat 2: FrancoOlmedo (small blind) folded before Flop
Seat 3: Tabitaji (big blind) collected ($0.02)
Seat 4: Scaaalll folded before Flop (didn't bet)
Seat 5: BriceDo1917 folded before Flop (didn't bet)
Seat 6: zergmiky folded before Flop (didn't bet)



PokerStars Zoom Hand #229233728439:  Hold'em No Limit ($0.01/$0.02) - 2021/08/21 23:41:34 CET [2021/08/21 17:41:34 ET]
Table 'Halley' 6-max Seat #1 is the button
Seat 1: Scaaalll ($2.56 in chips) 
Seat 2: gabgordula ($2.23 in chips) 
Seat 3: Sul07 ($0.97 in chips) 
Seat 4: lauti214 ($1.88 in chips) 
Seat 5: STE1NBERG ($4.98 in chips) 
Seat 6: Iv3rson18 ($2.08 in chips) 
gabgordula: posts small blind $0.01
Sul07: posts big blind $0.02
*** HOLE CARDS ***
Dealt to Scaaalll [Qs 3d]
lauti214: folds 
STE1NBERG: folds 
Iv3rson18: folds 
Scaaalll: folds 
gabgordula: raises $0.04 to $0.06
Sul07: folds 
Uncalled bet ($0.04) returned to gabgordula
gabgordula collected $0.04 from pot
gabgordula: doesn't show hand 
*** SUMMARY ***
Total pot $0.04 | Rake $0 
Seat 1: Scaaalll (button) folded before Flop (didn't bet)
Seat 2: gabgordula (small blind) collected ($0.04)
Seat 3: Sul07 (big blind) folded before Flop
Seat 4: lauti214 folded before Flop (didn't bet)
Seat 5: STE1NBERG folded before Flop (didn't bet)
Seat 6: Iv3rson18 folded before Flop (didn't bet)



PokerStars Zoom Hand #229233736545:  Hold'em No Limit ($0.01/$0.02) - 2021/08/21 23:41:54 CET [2021/08/21 17:41:54 ET]
Table 'Halley' 6-max Seat #1 is the button
Seat 1: morpheus206 ($1.95 in chips) 
Seat 2: bioern ($2.70 in chips) 
Seat 3: baileyduck ($0.85 in chips) 
Seat 4: ofalkeid ($1.58 in chips) 
Seat 5: Carlos_glaza ($2.70 in chips) 
Seat 6: Scaaalll ($2.54 in chips) 
bioern: posts small blind $0.01
baileyduck: posts big blind $0.02
*** HOLE CARDS ***
Dealt to Scaaalll [5c Qh]
ofalkeid: folds 
Carlos_glaza: folds 
Scaaalll: folds 
morpheus206: raises $0.04 to $0.06
bioern: folds 
baileyduck: folds 
Uncalled bet ($0.04) returned to morpheus206
morpheus206 collected $0.05 from pot
morpheus206: doesn't show hand 
baileyduck is disconnected 
*** SUMMARY ***
Total pot $0.05 | Rake $0 
Seat 1: morpheus206 (button) collected ($0.05)
Seat 2: bioern (small blind) folded before Flop
Seat 3: baileyduck (big blind) folded before Flop
Seat 4: ofalkeid folded before Flop (didn't bet)
Seat 5: Carlos_glaza folded before Flop (didn't bet)
Seat 6: Scaaalll folded before Flop (didn't bet)



PokerStars Zoom Hand #229233741003:  Hold'em No Limit ($0.01/$0.02) - 2021/08/21 23:42:05 CET [2021/08/21 17:42:05 ET]
Table 'Halley' 6-max Seat #1 is the button
Seat 1: Scaaalll ($2.53 in chips) 
Seat 2: 47911728 ($2.53 in chips) 
Seat 3: new face onl ($1.07 in chips) 
Seat 4: adrianh2002 ($4.48 in chips) 
Seat 5: KKARMELO ($3.63 in chips) 
Seat 6: lalon22 ($2 in chips) 
47911728: posts small blind $0.01
new face onl: posts big blind $0.02
*** HOLE CARDS ***
Dealt to Scaaalll [Js 9d]
adrianh2002: raises $0.03 to $0.05
KKARMELO: folds 
lalon22: folds 
Scaaalll: folds 
47911728: folds 
new face onl: folds 
Uncalled bet ($0.03) returned to adrianh2002
adrianh2002 collected $0.05 from pot
adrianh2002: doesn't show hand 
*** SUMMARY ***
Total pot $0.05 | Rake $0 
Seat 1: Scaaalll (button) folded before Flop (didn't bet)
Seat 2: 47911728 (small blind) folded before Flop
Seat 3: new face onl (big blind) folded before Flop
Seat 4: adrianh2002 collected ($0.05)
Seat 5: KKARMELO folded before Flop (didn't bet)
Seat 6: lalon22 folded before Flop (didn't bet)



PokerStars Zoom Hand #229233732073:  Hold'em No Limit ($0.01/$0.02) - 2021/08/21 23:41:43 CET [2021/08/21 17:41:43 ET]
Table 'Halley' 6-max Seat #1 is the button
Seat 1: Ape$apiens ($1.51 in chips) 
Seat 2: isaeg ($2.74 in chips) 
Seat 3: Scaaalll ($2.56 in chips) 
Seat 4: rancing87 ($2.02 in chips) 
Seat 5: didiclavi777 ($2.09 in chips) 
Seat 6: egroj1700 ($2.36 in chips) 
isaeg: posts small blind $0.01
Scaaalll: posts big blind $0.02
*** HOLE CARDS ***
Dealt to Scaaalll [8c Kh]
isaeg is disconnected 
Ape$apiens is disconnected 
rancing87: raises $0.04 to $0.06
didiclavi777: calls $0.06
egroj1700: folds 
Ape$apiens: folds 
isaeg: folds 
Scaaalll: folds 
*** FLOP *** [Jd Qh 8d]
rancing87: bets $0.04
didiclavi777: calls $0.04
*** TURN *** [Jd Qh 8d] [7c]
rancing87: bets $0.10
didiclavi777: folds 
Uncalled bet ($0.10) returned to rancing87
rancing87 collected $0.22 from pot
rancing87: doesn't show hand 
*** SUMMARY ***
Total pot $0.23 | Rake $0.01 
Board [Jd Qh 8d 7c]
Seat 1: Ape$apiens (button) folded before Flop (didn't bet)
Seat 2: isaeg (small blind) folded before Flop
Seat 3: Scaaalll (big blind) folded before Flop
Seat 4: rancing87 collected ($0.22)
Seat 5: didiclavi777 folded on the Turn
Seat 6: egroj1700 folded before Flop (didn't bet)



PokerStars Zoom Hand #229233742643:  Hold'em No Limit ($0.01/$0.02) - 2021/08/21 23:42:09 CET [2021/08/21 17:42:09 ET]
Table 'Halley' 6-max Seat #1 is the button
Seat 1: Espartacus5222 ($2.59 in chips) 
Seat 2: pavlo8855 ($2.18 in chips) 
Seat 3: Mikeloko182 ($3.07 in chips) 
Seat 4: Chapaev136 ($1.64 in chips) 
Seat 5: Scaaalll ($2.53 in chips) 
Seat 6: you_my_bich ($1.05 in chips) 
pavlo8855: posts small blind $0.01
Mikeloko182: posts big blind $0.02
*** HOLE CARDS ***
Dealt to Scaaalll [5c 8s]
Chapaev136: folds 
Scaaalll: folds 
you_my_bich: raises $0.04 to $0.06
Espartacus5222: folds 
pavlo8855: folds 
Mikeloko182: folds 
Uncalled bet ($0.04) returned to you_my_bich
you_my_bich collected $0.05 from pot
you_my_bich: doesn't show hand 
*** SUMMARY ***
Total pot $0.05 | Rake $0 
Seat 1: Espartacus5222 (button) folded before Flop (didn't bet)
Seat 2: pavlo8855 (small blind) folded before Flop
Seat 3: Mikeloko182 (big blind) folded before Flop
Seat 4: Chapaev136 folded before Flop (didn't bet)
Seat 5: Scaaalll folded before Flop (didn't bet)
Seat 6: you_my_bich collected ($0.05)



PokerStars Zoom Hand #229233745892:  Hold'em No Limit ($0.01/$0.02) - 2021/08/21 23:42:17 CET [2021/08/21 17:42:17 ET]
Table 'Halley' 6-max Seat #1 is the button
Seat 1: rancing87 ($2.14 in chips) 
Seat 2: adamkoz777 ($0.98 in chips) 
Seat 3: Feliciano16 ($3.21 in chips) 
Seat 4: YgovAndrey ($1.58 in chips) 
Seat 5: Scaaalll ($2.53 in chips) 
Seat 6: viktoldo ($2.04 in chips) 
adamkoz777: posts small blind $0.01
Feliciano16: posts big blind $0.02
*** HOLE CARDS ***
Dealt to Scaaalll [2h Jc]
YgovAndrey: folds 
Scaaalll: folds 
viktoldo: folds 
rancing87: folds 
viktoldo is disconnected 
adamkoz777: raises $0.04 to $0.06
Feliciano16: folds 
Uncalled bet ($0.04) returned to adamkoz777
adamkoz777 collected $0.04 from pot
adamkoz777: doesn't show hand 
adamkoz777 is disconnected 
*** SUMMARY ***
Total pot $0.04 | Rake $0 
Seat 1: rancing87 (button) folded before Flop (didn't bet)
Seat 2: adamkoz777 (small blind) collected ($0.04)
Seat 3: Feliciano16 (big blind) folded before Flop
Seat 4: YgovAndrey folded before Flop (didn't bet)
Seat 5: Scaaalll folded before Flop (didn't bet)
Seat 6: viktoldo folded before Flop (didn't bet)



PokerStars Zoom Hand #229233747499:  Hold'em No Limit ($0.01/$0.02) - 2021/08/21 23:42:21 CET [2021/08/21 17:42:21 ET]
Table 'Halley' 6-max Seat #1 is the button
Seat 1: Pechorin.G ($2.67 in chips) 
Seat 2: geo8787891 ($5.65 in chips) 
Seat 3: Scaaalll ($2.53 in chips) 
Seat 4: egroj1700 ($2.35 in chips) 
Seat 5: FrancoOlmedo ($2 in chips) 
Seat 6: ronald1982 ($5.44 in chips) 
geo8787891: posts small blind $0.01
Scaaalll: posts big blind $0.02
*** HOLE CARDS ***
Dealt to Scaaalll [9d 4c]
geo8787891 is disconnected 
egroj1700: folds 
FrancoOlmedo: raises $0.02 to $0.04
ronald1982: folds 
Pechorin.G: folds 
geo8787891: folds 
Scaaalll: folds 
Uncalled bet ($0.02) returned to FrancoOlmedo
FrancoOlmedo collected $0.05 from pot
FrancoOlmedo: doesn't show hand 
*** SUMMARY ***
Total pot $0.05 | Rake $0 
Seat 1: Pechorin.G (button) folded before Flop (didn't bet)
Seat 2: geo8787891 (small blind) folded before Flop
Seat 3: Scaaalll (big blind) folded before Flop
Seat 4: egroj1700 folded before Flop (didn't bet)
Seat 5: FrancoOlmedo collected ($0.05)
Seat 6: ronald1982 folded before Flop (didn't bet)



PokerStars Zoom Hand #229233755135:  Hold'em No Limit ($0.01/$0.02) - 2021/08/21 23:42:40 CET [2021/08/21 17:42:40 ET]
Table 'Halley' 6-max Seat #1 is the button
Seat 1: Scaaalll ($2.51 in chips) 
Seat 2: owtwilldo ($2.64 in chips) 
Seat 3: Baldisback ($2.96 in chips) 
Seat 4: AtZ3899 ($1.24 in chips) 
Seat 5: Doktor Yes ($2 in chips) 
Seat 6: olga3021221 ($2.05 in chips) 
owtwilldo: posts small blind $0.01
Baldisback: posts big blind $0.02
*** HOLE CARDS ***
Dealt to Scaaalll [3c 2d]
AtZ3899: folds 
Doktor Yes: folds 
olga3021221: folds 
Scaaalll: folds 
owtwilldo: folds 
Uncalled bet ($0.01) returned to Baldisback
Baldisback collected $0.02 from pot
Baldisback: doesn't show hand 
*** SUMMARY ***
Total pot $0.02 | Rake $0 
Seat 1: Scaaalll (button) folded before Flop (didn't bet)
Seat 2: owtwilldo (small blind) folded before Flop
Seat 3: Baldisback (big blind) collected ($0.02)
Seat 4: AtZ3899 folded before Flop (didn't bet)
Seat 5: Doktor Yes folded before Flop (didn't bet)
Seat 6: olga3021221 folded before Flop (didn't bet)



PokerStars Zoom Hand #229233739347:  Hold'em No Limit ($0.01/$0.02) - 2021/08/21 23:42:01 CET [2021/08/21 17:42:01 ET]
Table 'Halley' 6-max Seat #1 is the button
Seat 1: Chapaev136 ($1.64 in chips) 
Seat 2: Scaaalll ($2.54 in chips) 
Seat 3: NickAlex18 ($2.34 in chips) 
Seat 4: Ape$apiens ($1.51 in chips) 
Seat 5: Cineva81 ($4.77 in chips) 
Seat 6: LeoZ77755 ($2.25 in chips) 
Scaaalll: posts small blind $0.01
NickAlex18: posts big blind $0.02
*** HOLE CARDS ***
Dealt to Scaaalll [Jh 7d]
Ape$apiens: raises $0.02 to $0.04
Cineva81: folds 
LeoZ77755: raises $0.07 to $0.11
Chapaev136: folds 
Scaaalll: folds 
NickAlex18: folds 
Ape$apiens: calls $0.07
*** FLOP *** [2c 4s 7c]
Ape$apiens: checks 
LeoZ77755: bets $0.20
Ape$apiens: folds 
Uncalled bet ($0.20) returned to LeoZ77755
LeoZ77755 collected $0.24 from pot
LeoZ77755: doesn't show hand 
Ape$apiens is disconnected 
*** SUMMARY ***
Total pot $0.25 | Rake $0.01 
Board [2c 4s 7c]
Seat 1: Chapaev136 (button) folded before Flop (didn't bet)
Seat 2: Scaaalll (small blind) folded before Flop
Seat 3: NickAlex18 (big blind) folded before Flop
Seat 4: Ape$apiens folded on the Flop
Seat 5: Cineva81 folded before Flop (didn't bet)
Seat 6: LeoZ77755 collected ($0.24)



PokerStars Zoom Hand #229233744285:  Hold'em No Limit ($0.01/$0.02) - 2021/08/21 23:42:13 CET [2021/08/21 17:42:13 ET]
Table 'Halley' 6-max Seat #1 is the button
Seat 1: jaamonra ($2.29 in chips) 
Seat 2: Hejpåre ($3.67 in chips) 
Seat 3: Iv3rson18 ($2.31 in chips) 
Seat 4: Scaaalll ($2.53 in chips) 
Seat 5: lucky1529 ($0.89 in chips) 
Seat 6: so0love ($2.15 in chips) 
Hejpåre: posts small blind $0.01
Iv3rson18: posts big blind $0.02
*** HOLE CARDS ***
Dealt to Scaaalll [9c Ts]
Scaaalll: folds 
lucky1529: folds 
so0love: folds 
jaamonra: folds 
Hejpåre: calls $0.01
Iv3rson18: checks 
*** FLOP *** [8s Jd 7c]
Hejpåre: checks 
Iv3rson18: checks 
*** TURN *** [8s Jd 7c] [9h]
Hejpåre: checks 
Iv3rson18: checks 
*** RIVER *** [8s Jd 7c 9h] [Jh]
Hejpåre: checks 
Iv3rson18: checks 
*** SHOW DOWN ***
Hejpåre: shows [Kd 2c] (a pair of Jacks)
Iv3rson18: mucks hand 
Hejpåre collected $0.04 from pot
*** SUMMARY ***
Total pot $0.04 | Rake $0 
Board [8s Jd 7c 9h Jh]
Seat 1: jaamonra (button) folded before Flop (didn't bet)
Seat 2: Hejpåre (small blind) showed [Kd 2c] and won ($0.04) with a pair of Jacks
Seat 3: Iv3rson18 (big blind) mucked [6c 3d]
Seat 4: Scaaalll folded before Flop (didn't bet)
Seat 5: lucky1529 folded before Flop (didn't bet)
Seat 6: so0love folded before Flop (didn't bet)



PokerStars Zoom Hand #229233756401:  Hold'em No Limit ($0.01/$0.02) - 2021/08/21 23:42:43 CET [2021/08/21 17:42:43 ET]
Table 'Halley' 6-max Seat #1 is the button
Seat 1: xmaksimus ($2.05 in chips) 
Seat 2: h3cTics ($1.22 in chips) 
Seat 3: BlackhawKK's ($2 in chips) 
Seat 4: Dr.stromg ($3.13 in chips) 
Seat 5: Hejpåre ($4.27 in chips) 
Seat 6: Scaaalll ($2.51 in chips) 
h3cTics: posts small blind $0.01
BlackhawKK's: posts big blind $0.02
*** HOLE CARDS ***
Dealt to Scaaalll [4s 9d]
Dr.stromg: folds 
Hejpåre: folds 
Scaaalll: folds 
xmaksimus: folds 
h3cTics: calls $0.01
BlackhawKK's: raises $0.04 to $0.06
h3cTics: calls $0.04
*** FLOP *** [6d 2c Ks]
h3cTics: checks 
BlackhawKK's: checks 
*** TURN *** [6d 2c Ks] [Qs]
h3cTics: bets $0.06
BlackhawKK's: calls $0.06
*** RIVER *** [6d 2c Ks Qs] [Qd]
h3cTics: bets $0.12
BlackhawKK's: folds 
Uncalled bet ($0.12) returned to h3cTics
h3cTics collected $0.23 from pot
h3cTics: doesn't show hand 
*** SUMMARY ***
Total pot $0.24 | Rake $0.01 
Board [6d 2c Ks Qs Qd]
Seat 1: xmaksimus (button) folded before Flop (didn't bet)
Seat 2: h3cTics (small blind) collected ($0.23)
Seat 3: BlackhawKK's (big blind) folded on the River
Seat 4: Dr.stromg folded before Flop (didn't bet)
Seat 5: Hejpåre folded before Flop (didn't bet)
Seat 6: Scaaalll folded before Flop (didn't bet)



PokerStars Zoom Hand #229233758046:  Hold'em No Limit ($0.01/$0.02) - 2021/08/21 23:42:47 CET [2021/08/21 17:42:47 ET]
Table 'Halley' 6-max Seat #1 is the button
Seat 1: RrriotGrrrl ($2.76 in chips) 
Seat 2: Scaaalll ($2.51 in chips) 
Seat 3: rancing87 ($2.43 in chips) 
Seat 4: olga3021221 ($3.58 in chips) 
Seat 5: Espartacus5222 ($2.07 in chips) 
Seat 6: Luisit0_aqp ($0.67 in chips) 
Scaaalll: posts small blind $0.01
rancing87: posts big blind $0.02
*** HOLE CARDS ***
Dealt to Scaaalll [Ah Jd]
olga3021221: folds 
Espartacus5222: raises $0.04 to $0.06
Luisit0_aqp: folds 
RrriotGrrrl: folds 
Scaaalll: calls $0.05
rancing87: folds 
*** FLOP *** [3s Ad Kc]
Scaaalll: checks 
Espartacus5222: bets $0.06
Scaaalll: calls $0.06
*** TURN *** [3s Ad Kc] [Js]
Scaaalll: checks 
Espartacus5222: checks 
*** RIVER *** [3s Ad Kc Js] [Qc]
Scaaalll: bets $0.10
Espartacus5222: raises $0.12 to $0.22
Scaaalll: folds 
Uncalled bet ($0.12) returned to Espartacus5222
Espartacus5222 collected $0.44 from pot
Espartacus5222: doesn't show hand 
*** SUMMARY ***
Total pot $0.46 | Rake $0.02 
Board [3s Ad Kc Js Qc]
Seat 1: RrriotGrrrl (button) folded before Flop (didn't bet)
Seat 2: Scaaalll (small blind) folded on the River
Seat 3: rancing87 (big blind) folded before Flop
Seat 4: olga3021221 folded before Flop (didn't bet)
Seat 5: Espartacus5222 collected ($0.44)
Seat 6: Luisit0_aqp folded before Flop (didn't bet)



PokerStars Zoom Hand #229233780998:  Hold'em No Limit ($0.01/$0.02) - 2021/08/21 23:43:44 CET [2021/08/21 17:43:44 ET]
Table 'Halley' 6-max Seat #1 is the button
Seat 1: 888lifeIS ($2.34 in chips) 
Seat 2: viktoldo ($2.05 in chips) 
Seat 3: Reipinguimm ($3.54 in chips) 
Seat 4: alphabeta1d ($2.03 in chips) 
Seat 5: Valera Terentev ($0.98 in chips) 
Seat 6: Scaaalll ($2.29 in chips) 
viktoldo: posts small blind $0.01
Reipinguimm: posts big blind $0.02
*** HOLE CARDS ***
Dealt to Scaaalll [Jc Jh]
alphabeta1d: folds 
Valera Terentev: calls $0.02
viktoldo is disconnected 
Scaaalll: raises $0.07 to $0.09
888lifeIS: folds 
viktoldo: folds 
Reipinguimm: folds 
Valera Terentev: calls $0.07
*** FLOP *** [Ad 8s 9c]
Valera Terentev: bets $0.10
Scaaalll: calls $0.10
*** TURN *** [Ad 8s 9c] [2h]
Valera Terentev: bets $0.20
Scaaalll: calls $0.20
*** RIVER *** [Ad 8s 9c 2h] [4h]
Valera Terentev: bets $0.14
Scaaalll: calls $0.14
*** SHOW DOWN ***
Valera Terentev: shows [2s 5d] (a pair of Deuces)
Scaaalll: shows [Jc Jh] (a pair of Jacks)
Scaaalll collected $1.04 from pot
*** SUMMARY ***
Total pot $1.09 | Rake $0.05 
Board [Ad 8s 9c 2h 4h]
Seat 1: 888lifeIS (button) folded before Flop (didn't bet)
Seat 2: viktoldo (small blind) folded before Flop
Seat 3: Reipinguimm (big blind) folded before Flop
Seat 4: alphabeta1d folded before Flop (didn't bet)
Seat 5: Valera Terentev showed [2s 5d] and lost with a pair of Deuces
Seat 6: Scaaalll showed [Jc Jh] and won ($1.04) with a pair of Jacks



PokerStars Zoom Hand #229233801901:  Hold'em No Limit ($0.01/$0.02) - 2021/08/21 23:44:36 CET [2021/08/21 17:44:36 ET]
Table 'Halley' 6-max Seat #1 is the button
Seat 1: kukulagosleep ($6.87 in chips) 
Seat 2: Feliciano16 ($3.37 in chips) 
Seat 3: Scaaalll ($2.80 in chips) 
Seat 4: E Z TAKEDOWN ($2.25 in chips) 
Seat 5: Valera Terentev ($0.45 in chips) 
Seat 6: Nihility77 ($4.85 in chips) 
Feliciano16: posts small blind $0.01
Scaaalll: posts big blind $0.02
*** HOLE CARDS ***
Dealt to Scaaalll [8d 3s]
E Z TAKEDOWN: raises $0.03 to $0.05
Valera Terentev: calls $0.05
Nihility77: calls $0.05
kukulagosleep: folds 
Feliciano16: folds 
Scaaalll: folds 
*** FLOP *** [8c Qc 4d]
E Z TAKEDOWN: checks 
Valera Terentev: bets $0.10
Nihility77: folds 
E Z TAKEDOWN: folds 
Uncalled bet ($0.10) returned to Valera Terentev
Valera Terentev collected $0.17 from pot
Valera Terentev: doesn't show hand 
*** SUMMARY ***
Total pot $0.18 | Rake $0.01 
Board [8c Qc 4d]
Seat 1: kukulagosleep (button) folded before Flop (didn't bet)
Seat 2: Feliciano16 (small blind) folded before Flop
Seat 3: Scaaalll (big blind) folded before Flop
Seat 4: E Z TAKEDOWN folded on the Flop
Seat 5: Valera Terentev collected ($0.17)
Seat 6: Nihility77 folded on the Flop



PokerStars Zoom Hand #229233807930:  Hold'em No Limit ($0.01/$0.02) - 2021/08/21 23:44:51 CET [2021/08/21 17:44:51 ET]
Table 'Halley' 6-max Seat #1 is the button
Seat 1: Scaaalll ($2.78 in chips) 
Seat 2: Lekcey05 ($2.01 in chips) 
Seat 3: lucky1529 ($0.73 in chips) 
Seat 4: Spinatstrudel ($2 in chips) 
Seat 5: estelionat171 ($0.97 in chips) 
Seat 6: 365p2eva ($2.20 in chips) 
Lekcey05: posts small blind $0.01
lucky1529: posts big blind $0.02
*** HOLE CARDS ***
Dealt to Scaaalll [8s Ks]
Spinatstrudel: folds 
estelionat171: folds 
365p2eva: folds 
Scaaalll: raises $0.02 to $0.04
Lekcey05: folds 
lucky1529: calls $0.02
*** FLOP *** [3d Jd As]
lucky1529: checks 
Scaaalll: checks 
*** TURN *** [3d Jd As] [Jh]
lucky1529: checks 
Scaaalll: checks 
*** RIVER *** [3d Jd As Jh] [Kh]
lucky1529: bets $0.02
Scaaalll: calls $0.02
*** SHOW DOWN ***
lucky1529: shows [Kc 9d] (two pair, Kings and Jacks)
Scaaalll: shows [8s Ks] (two pair, Kings and Jacks)
lucky1529 collected $0.07 from pot
Scaaalll collected $0.06 from pot
*** SUMMARY ***
Total pot $0.13 | Rake $0 
Board [3d Jd As Jh Kh]
Seat 1: Scaaalll (button) showed [8s Ks] and won ($0.06) with two pair, Kings and Jacks
Seat 2: Lekcey05 (small blind) folded before Flop
Seat 3: lucky1529 (big blind) showed [Kc 9d] and won ($0.07) with two pair, Kings and Jacks
Seat 4: Spinatstrudel folded before Flop (didn't bet)
Seat 5: estelionat171 folded before Flop (didn't bet)
Seat 6: 365p2eva folded before Flop (didn't bet)



PokerStars Zoom Hand #229233831532:  Hold'em No Limit ($0.01/$0.02) - 2021/08/21 23:45:50 CET [2021/08/21 17:45:50 ET]
Table 'Halley' 6-max Seat #1 is the button
Seat 1: AtZ3899 ($1.77 in chips) 
Seat 2: EdwardF95 ($2.15 in chips) 
Seat 3: OmahaWheels ($3.36 in chips) 
Seat 4: Scaaalll ($2.78 in chips) 
Seat 5: Jmapih ($1.22 in chips) 
Seat 6: EzukoChan ($3.07 in chips) 
EdwardF95: posts small blind $0.01
OmahaWheels: posts big blind $0.02
*** HOLE CARDS ***
Dealt to Scaaalll [Qh 5s]
Scaaalll: folds 
Jmapih: folds 
EzukoChan: folds 
AtZ3899: folds 
EdwardF95: folds 
Uncalled bet ($0.01) returned to OmahaWheels
OmahaWheels collected $0.02 from pot
OmahaWheels: doesn't show hand 
*** SUMMARY ***
Total pot $0.02 | Rake $0 
Seat 1: AtZ3899 (button) folded before Flop (didn't bet)
Seat 2: EdwardF95 (small blind) folded before Flop
Seat 3: OmahaWheels (big blind) collected ($0.02)
Seat 4: Scaaalll folded before Flop (didn't bet)
Seat 5: Jmapih folded before Flop (didn't bet)
Seat 6: EzukoChan folded before Flop (didn't bet)



PokerStars Zoom Hand #229233827927:  Hold'em No Limit ($0.01/$0.02) - 2021/08/21 23:45:41 CET [2021/08/21 17:45:41 ET]
Table 'Halley' 6-max Seat #1 is the button
Seat 1: owtwilldo ($2.19 in chips) 
Seat 2: zergmiky ($3.24 in chips) 
Seat 3: danteesq ($2 in chips) 
Seat 4: 1nTeresT ($2 in chips) 
Seat 5: Scaaalll ($2.78 in chips) 
Seat 6: 365p2eva ($2.26 in chips) 
zergmiky: posts small blind $0.01
danteesq: posts big blind $0.02
*** HOLE CARDS ***
Dealt to Scaaalll [9s 7c]
1nTeresT: folds 
Scaaalll: folds 
365p2eva: folds 
owtwilldo: raises $0.02 to $0.04
zergmiky: folds 
danteesq: calls $0.02
*** FLOP *** [4h 8h Js]
danteesq: checks 
owtwilldo: bets $0.06
danteesq: folds 
Uncalled bet ($0.06) returned to owtwilldo
owtwilldo collected $0.09 from pot
owtwilldo: doesn't show hand 
*** SUMMARY ***
Total pot $0.09 | Rake $0 
Board [4h 8h Js]
Seat 1: owtwilldo (button) collected ($0.09)
Seat 2: zergmiky (small blind) folded before Flop
Seat 3: danteesq (big blind) folded on the Flop
Seat 4: 1nTeresT folded before Flop (didn't bet)
Seat 5: Scaaalll folded before Flop (didn't bet)
Seat 6: 365p2eva folded before Flop (didn't bet)



PokerStars Zoom Hand #229233833124:  Hold'em No Limit ($0.01/$0.02) - 2021/08/21 23:45:54 CET [2021/08/21 17:45:54 ET]
Table 'Halley' 6-max Seat #1 is the button
Seat 1: squidy4 ($1.35 in chips) 
Seat 2: Scaaalll ($2.78 in chips) 
Seat 3: Xpokerfreak ($1.83 in chips) 
Seat 4: gilberto98 ($2.36 in chips) 
Seat 5: nbarreiro021 ($2.08 in chips) 
Seat 6: rekopo203 ($8.46 in chips) 
Scaaalll: posts small blind $0.01
Xpokerfreak: posts big blind $0.02
*** HOLE CARDS ***
Dealt to Scaaalll [2c 7c]
gilberto98: calls $0.02
nbarreiro021: raises $0.06 to $0.08
rekopo203: folds 
squidy4: folds 
Scaaalll: folds 
Xpokerfreak: folds 
gilberto98: folds 
Uncalled bet ($0.06) returned to nbarreiro021
nbarreiro021 collected $0.07 from pot
nbarreiro021: doesn't show hand 
*** SUMMARY ***
Total pot $0.07 | Rake $0 
Seat 1: squidy4 (button) folded before Flop (didn't bet)
Seat 2: Scaaalll (small blind) folded before Flop
Seat 3: Xpokerfreak (big blind) folded before Flop
Seat 4: gilberto98 folded before Flop
Seat 5: nbarreiro021 collected ($0.07)
Seat 6: rekopo203 folded before Flop (didn't bet)



PokerStars Zoom Hand #229233839939:  Hold'em No Limit ($0.01/$0.02) - 2021/08/21 23:46:11 CET [2021/08/21 17:46:11 ET]
Table 'Halley' 6-max Seat #1 is the button
Seat 1: Sadikson ($1.98 in chips) 
Seat 2: Dr.stromg ($2.79 in chips) 
Seat 3: Scaaalll ($2.77 in chips) 
Seat 4: MattieBOZ ($2.14 in chips) 
Seat 5: cheddarspreada ($1.38 in chips) 
Seat 6: Gamer577 ($4.97 in chips) 
Dr.stromg: posts small blind $0.01
Scaaalll: posts big blind $0.02
*** HOLE CARDS ***
Dealt to Scaaalll [Ac 8s]
Sadikson is disconnected 
MattieBOZ: folds 
MattieBOZ is disconnected 
cheddarspreada: folds 
Gamer577: folds 
Sadikson: folds 
Dr.stromg: folds 
Uncalled bet ($0.01) returned to Scaaalll
cheddarspreada is disconnected 
Scaaalll collected $0.02 from pot
Scaaalll: doesn't show hand 
*** SUMMARY ***
Total pot $0.02 | Rake $0 
Seat 1: Sadikson (button) folded before Flop (didn't bet)
Seat 2: Dr.stromg (small blind) folded before Flop
Seat 3: Scaaalll (big blind) collected ($0.02)
Seat 4: MattieBOZ folded before Flop (didn't bet)
Seat 5: cheddarspreada folded before Flop (didn't bet)
Seat 6: Gamer577 folded before Flop (didn't bet)



PokerStars Zoom Hand #229233847889:  Hold'em No Limit ($0.01/$0.02) - 2021/08/21 23:46:31 CET [2021/08/21 17:46:31 ET]
Table 'Halley' 6-max Seat #1 is the button
Seat 1: Alexasha78 ($2.19 in chips) 
Seat 2: Scaaalll ($2.78 in chips) 
Seat 3: Merlin_Arg ($2.75 in chips) 
Seat 4: 888lifeIS ($2.11 in chips) 
Seat 5: dannyluijten ($2.24 in chips) 
Seat 6: Reipinguimm ($3.44 in chips) 
Scaaalll: posts small blind $0.01
Merlin_Arg: posts big blind $0.02
*** HOLE CARDS ***
Dealt to Scaaalll [Ts Jc]
Alexasha78 is disconnected 
888lifeIS: folds 
dannyluijten: folds 
Reipinguimm: folds 
Alexasha78: folds 
Scaaalll: folds 
Uncalled bet ($0.01) returned to Merlin_Arg
Merlin_Arg collected $0.02 from pot
Merlin_Arg: doesn't show hand 
*** SUMMARY ***
Total pot $0.02 | Rake $0 
Seat 1: Alexasha78 (button) folded before Flop (didn't bet)
Seat 2: Scaaalll (small blind) folded before Flop
Seat 3: Merlin_Arg (big blind) collected ($0.02)
Seat 4: 888lifeIS folded before Flop (didn't bet)
Seat 5: dannyluijten folded before Flop (didn't bet)
Seat 6: Reipinguimm folded before Flop (didn't bet)



PokerStars Zoom Hand #229233843989:  Hold'em No Limit ($0.01/$0.02) - 2021/08/21 23:46:21 CET [2021/08/21 17:46:21 ET]
Table 'Halley' 6-max Seat #1 is the button
Seat 1: ronald1982 ($1.14 in chips) 
Seat 2: HitEmUpWatz9420 ($3.34 in chips) 
Seat 3: zergmiky ($4.19 in chips) 
Seat 4: Scaaalll ($2.78 in chips) 
Seat 5: gilberto98 ($4.34 in chips) 
Seat 6: WITKOW_AV ($4.08 in chips) 
HitEmUpWatz9420: posts small blind $0.01
zergmiky: posts big blind $0.02
*** HOLE CARDS ***
Dealt to Scaaalll [4c Kd]
Scaaalll: folds 
gilberto98: folds 
WITKOW_AV: folds 
ronald1982: folds 
HitEmUpWatz9420: calls $0.01
zergmiky: checks 
*** FLOP *** [8h Ks 5d]
HitEmUpWatz9420: checks 
zergmiky: bets $0.02
HitEmUpWatz9420: folds 
Uncalled bet ($0.02) returned to zergmiky
zergmiky collected $0.04 from pot
zergmiky: doesn't show hand 
HitEmUpWatz9420 is disconnected 
*** SUMMARY ***
Total pot $0.04 | Rake $0 
Board [8h Ks 5d]
Seat 1: ronald1982 (button) folded before Flop (didn't bet)
Seat 2: HitEmUpWatz9420 (small blind) folded on the Flop
Seat 3: zergmiky (big blind) collected ($0.04)
Seat 4: Scaaalll folded before Flop (didn't bet)
Seat 5: gilberto98 folded before Flop (didn't bet)
Seat 6: WITKOW_AV folded before Flop (didn't bet)



PokerStars Zoom Hand #229233845549:  Hold'em No Limit ($0.01/$0.02) - 2021/08/21 23:46:25 CET [2021/08/21 17:46:25 ET]
Table 'Halley' 6-max Seat #1 is the button
Seat 1: HubertFroh ($2.95 in chips) 
Seat 2: KissingTheSun ($2.47 in chips) 
Seat 3: KonopDima ($2 in chips) 
Seat 4: spirosz1000 ($2.14 in chips) 
Seat 5: volf55321 ($1.16 in chips) 
Seat 6: Scaaalll ($2.78 in chips) 
KissingTheSun: posts small blind $0.01
KonopDima: posts big blind $0.02
*** HOLE CARDS ***
Dealt to Scaaalll [3c 9s]
spirosz1000: folds 
volf55321: calls $0.02
Scaaalll: folds 
HubertFroh: folds 
KissingTheSun: folds 
KonopDima: checks 
*** FLOP *** [Kh 7s 4c]
KonopDima: checks 
volf55321: bets $0.02
KonopDima: folds 
Uncalled bet ($0.02) returned to volf55321
volf55321 collected $0.05 from pot
volf55321: doesn't show hand 
*** SUMMARY ***
Total pot $0.05 | Rake $0 
Board [Kh 7s 4c]
Seat 1: HubertFroh (button) folded before Flop (didn't bet)
Seat 2: KissingTheSun (small blind) folded before Flop
Seat 3: KonopDima (big blind) folded on the Flop
Seat 4: spirosz1000 folded before Flop (didn't bet)
Seat 5: volf55321 collected ($0.05)
Seat 6: Scaaalll folded before Flop (didn't bet)



PokerStars Zoom Hand #229233852928:  Hold'em No Limit ($0.01/$0.02) - 2021/08/21 23:46:44 CET [2021/08/21 17:46:44 ET]
Table 'Halley' 6-max Seat #1 is the button
Seat 1: Scaaalll ($2.77 in chips) 
Seat 2: EdwardF95 ($2.45 in chips) 
Seat 3: Gamer577 ($2.55 in chips) 
Seat 4: Treadero ($1.12 in chips) 
Seat 5: KissingTheSun ($2.46 in chips) 
Seat 6: 365p2eva ($2.31 in chips) 
EdwardF95: posts small blind $0.01
Gamer577: posts big blind $0.02
*** HOLE CARDS ***
Dealt to Scaaalll [Ac Qs]
Treadero: folds 
KissingTheSun: folds 
365p2eva: folds 
Scaaalll: raises $0.02 to $0.04
EdwardF95: folds 
Gamer577: folds 
Uncalled bet ($0.02) returned to Scaaalll
Scaaalll collected $0.05 from pot
Scaaalll: doesn't show hand 
*** SUMMARY ***
Total pot $0.05 | Rake $0 
Seat 1: Scaaalll (button) collected ($0.05)
Seat 2: EdwardF95 (small blind) folded before Flop
Seat 3: Gamer577 (big blind) folded before Flop
Seat 4: Treadero folded before Flop (didn't bet)
Seat 5: KissingTheSun folded before Flop (didn't bet)
Seat 6: 365p2eva folded before Flop (didn't bet)



PokerStars Zoom Hand #229233863694:  Hold'em No Limit ($0.01/$0.02) - 2021/08/21 23:47:11 CET [2021/08/21 17:47:11 ET]
Table 'Halley' 6-max Seat #1 is the button
Seat 1: NickAlex18 ($2.02 in chips) 
Seat 2: leeroy818 ($2.36 in chips) 
Seat 3: Sn@ke6 ($3.54 in chips) 
Seat 4: Scaaalll ($2.80 in chips) 
Seat 5: rancing87 ($2.34 in chips) 
Seat 6: VaanKroenen ($2.61 in chips) 
leeroy818: posts small blind $0.01
Sn@ke6: posts big blind $0.02
*** HOLE CARDS ***
Dealt to Scaaalll [Ah 8h]
Scaaalll: folds 
rancing87: folds 
VaanKroenen: folds 
NickAlex18: raises $0.03 to $0.05
leeroy818: folds 
Sn@ke6: folds 
Uncalled bet ($0.03) returned to NickAlex18
NickAlex18 collected $0.05 from pot
NickAlex18: doesn't show hand 
Sn@ke6 is disconnected 
*** SUMMARY ***
Total pot $0.05 | Rake $0 
Seat 1: NickAlex18 (button) collected ($0.05)
Seat 2: leeroy818 (small blind) folded before Flop
Seat 3: Sn@ke6 (big blind) folded before Flop
Seat 4: Scaaalll folded before Flop (didn't bet)
Seat 5: rancing87 folded before Flop (didn't bet)
Seat 6: VaanKroenen folded before Flop (didn't bet)



PokerStars Zoom Hand #229233861733:  Hold'em No Limit ($0.01/$0.02) - 2021/08/21 23:47:06 CET [2021/08/21 17:47:06 ET]
Table 'Halley' 6-max Seat #1 is the button
Seat 1: clay070 ($1.34 in chips) 
Seat 2: alphabeta1d ($2.01 in chips) 
Seat 3: STE1NBERG ($5.90 in chips) 
Seat 4: AtZ3899 ($1.87 in chips) 
Seat 5: Scaaalll ($2.80 in chips) 
Seat 6: volt_by ($0.86 in chips) 
alphabeta1d: posts small blind $0.01
STE1NBERG: posts big blind $0.02
*** HOLE CARDS ***
Dealt to Scaaalll [7c 5c]
AtZ3899: folds 
Scaaalll: folds 
volt_by: raises $0.04 to $0.06
clay070: calls $0.06
alphabeta1d: folds 
STE1NBERG: folds 
*** FLOP *** [3s 6s Qc]
volt_by: bets $0.07
clay070: folds 
Uncalled bet ($0.07) returned to volt_by
volt_by collected $0.14 from pot
volt_by: doesn't show hand 
*** SUMMARY ***
Total pot $0.15 | Rake $0.01 
Board [3s 6s Qc]
Seat 1: clay070 (button) folded on the Flop
Seat 2: alphabeta1d (small blind) folded before Flop
Seat 3: STE1NBERG (big blind) folded before Flop
Seat 4: AtZ3899 folded before Flop (didn't bet)
Seat 5: Scaaalll folded before Flop (didn't bet)
Seat 6: volt_by collected ($0.14)



PokerStars Zoom Hand #229233868007:  Hold'em No Limit ($0.01/$0.02) - 2021/08/21 23:47:22 CET [2021/08/21 17:47:22 ET]
Table 'Halley' 6-max Seat #1 is the button
Seat 1: San4oWV ($1 in chips) 
Seat 2: KissingTheSun ($3.58 in chips) 
Seat 3: cutter2468 ($2.92 in chips) 
Seat 4: Scaaalll ($2.80 in chips) 
Seat 5: hustlehero ($2.01 in chips) 
Seat 6: zergmiky ($4.20 in chips) 
KissingTheSun: posts small blind $0.01
cutter2468: posts big blind $0.02
*** HOLE CARDS ***
Dealt to Scaaalll [3h 4s]
Scaaalll: folds 
hustlehero: folds 
zergmiky: folds 
San4oWV: folds 
KissingTheSun: raises $0.04 to $0.06
cutter2468: folds 
Uncalled bet ($0.04) returned to KissingTheSun
KissingTheSun collected $0.04 from pot
KissingTheSun: doesn't show hand 
*** SUMMARY ***
Total pot $0.04 | Rake $0 
Seat 1: San4oWV (button) folded before Flop (didn't bet)
Seat 2: KissingTheSun (small blind) collected ($0.04)
Seat 3: cutter2468 (big blind) folded before Flop
Seat 4: Scaaalll folded before Flop (didn't bet)
Seat 5: hustlehero folded before Flop (didn't bet)
Seat 6: zergmiky folded before Flop (didn't bet)



PokerStars Zoom Hand #229233869569:  Hold'em No Limit ($0.01/$0.02) - 2021/08/21 23:47:26 CET [2021/08/21 17:47:26 ET]
Table 'Halley' 6-max Seat #1 is the button
Seat 1: rafa0509416 ($2.13 in chips) 
Seat 2: rodrigoasor ($3.19 in chips) 
Seat 3: Scaaalll ($2.80 in chips) 
Seat 4: Ck@tih@ ($1.99 in chips) 
Seat 5: Ne0net ($2 in chips) 
Seat 6: spirosz1000 ($1.99 in chips) 
rodrigoasor: posts small blind $0.01
Scaaalll: posts big blind $0.02
*** HOLE CARDS ***
Dealt to Scaaalll [9d Qh]
Ck@tih@: folds 
Ne0net: folds 
spirosz1000: raises $0.02 to $0.04
rafa0509416: folds 
rodrigoasor: folds 
Scaaalll: folds 
Uncalled bet ($0.02) returned to spirosz1000
spirosz1000 collected $0.05 from pot
spirosz1000: doesn't show hand 
*** SUMMARY ***
Total pot $0.05 | Rake $0 
Seat 1: rafa0509416 (button) folded before Flop (didn't bet)
Seat 2: rodrigoasor (small blind) folded before Flop
Seat 3: Scaaalll (big blind) folded before Flop
Seat 4: Ck@tih@ folded before Flop (didn't bet)
Seat 5: Ne0net folded before Flop (didn't bet)
Seat 6: spirosz1000 collected ($0.05)



PokerStars Zoom Hand #229233866016:  Hold'em No Limit ($0.01/$0.02) - 2021/08/21 23:47:17 CET [2021/08/21 17:47:17 ET]
Table 'Halley' 6-max Seat #1 is the button
Seat 1: Hiury5 ($2.03 in chips) 
Seat 2: Ilya_Skobelev ($1.74 in chips) 
Seat 3: StaffsUni ($2 in chips) 
Seat 4: Hallyson_23 ($6.54 in chips) 
Seat 5: pavel play pay ($6.19 in chips) 
Seat 6: Scaaalll ($2.80 in chips) 
Ilya_Skobelev: posts small blind $0.01
StaffsUni: posts big blind $0.02
*** HOLE CARDS ***
Dealt to Scaaalll [4h 5d]
Hallyson_23: folds 
pavel play pay: calls $0.02
Scaaalll: folds 
Hiury5: folds 
Ilya_Skobelev: calls $0.01
StaffsUni: checks 
*** FLOP *** [Kh Ks 3c]
Ilya_Skobelev: bets $0.06
StaffsUni: folds 
pavel play pay: calls $0.06
*** TURN *** [Kh Ks 3c] [Ad]
Ilya_Skobelev: bets $1.66 and is all-in
pavel play pay: calls $1.66
*** RIVER *** [Kh Ks 3c Ad] [Js]
*** SHOW DOWN ***
Ilya_Skobelev: shows [Ac Kd] (a full house, Kings full of Aces)
pavel play pay: shows [3h 3s] (a full house, Threes full of Kings)
Ilya_Skobelev collected $3.38 from pot
pavel play pay cashed out the hand for $0.07
*** SUMMARY ***
Total pot $3.50 | Rake $0.12 
Board [Kh Ks 3c Ad Js]
Seat 1: Hiury5 (button) folded before Flop (didn't bet)
Seat 2: Ilya_Skobelev (small blind) showed [Ac Kd] and won ($3.38) with a full house, Kings full of Aces
Seat 3: StaffsUni (big blind) folded on the Flop
Seat 4: Hallyson_23 folded before Flop (didn't bet)
Seat 5: pavel play pay showed [3h 3s] and lost with a full house, Threes full of Kings (cashed out).
Seat 6: Scaaalll folded before Flop (didn't bet)



PokerStars Zoom Hand #229233877904:  Hold'em No Limit ($0.01/$0.02) - 2021/08/21 23:47:47 CET [2021/08/21 17:47:47 ET]
Table 'Halley' 6-max Seat #1 is the button
Seat 1: gasmar_29 ($2.52 in chips) 
Seat 2: Scaaalll ($2.78 in chips) 
Seat 3: Merlin_Arg ($2.73 in chips) 
Seat 4: 888lifeIS ($2.22 in chips) 
Seat 5: BogoJIa3_77 ($2.04 in chips) 
Seat 6: KissingTheSun ($3.60 in chips) 
Scaaalll: posts small blind $0.01
Merlin_Arg: posts big blind $0.02
*** HOLE CARDS ***
Dealt to Scaaalll [Qd 3h]
888lifeIS: folds 
BogoJIa3_77: folds 
KissingTheSun: folds 
gasmar_29: folds 
Scaaalll: folds 
Uncalled bet ($0.01) returned to Merlin_Arg
Merlin_Arg collected $0.02 from pot
Merlin_Arg: doesn't show hand 
*** SUMMARY ***
Total pot $0.02 | Rake $0 
Seat 1: gasmar_29 (button) folded before Flop (didn't bet)
Seat 2: Scaaalll (small blind) folded before Flop
Seat 3: Merlin_Arg (big blind) collected ($0.02)
Seat 4: 888lifeIS folded before Flop (didn't bet)
Seat 5: BogoJIa3_77 folded before Flop (didn't bet)
Seat 6: KissingTheSun folded before Flop (didn't bet)



PokerStars Zoom Hand #229233884193:  Hold'em No Limit ($0.01/$0.02) - 2021/08/21 23:48:03 CET [2021/08/21 17:48:03 ET]
Table 'Halley' 6-max Seat #1 is the button
Seat 1: MinorityRule ($2.40 in chips) 
Seat 2: YgovAndrey ($2.56 in chips) 
Seat 3: SKV_1985 ($2.60 in chips) 
Seat 4: prosto lili ($0.87 in chips) 
Seat 5: GGopenBet ($1.08 in chips) 
Seat 6: Scaaalll ($2.77 in chips) 
YgovAndrey: posts small blind $0.01
SKV_1985: posts big blind $0.02
*** HOLE CARDS ***
Dealt to Scaaalll [Ac Qh]
prosto lili: folds 
GGopenBet: folds 
GGopenBet is disconnected 
Scaaalll: raises $0.04 to $0.06
MinorityRule: folds 
YgovAndrey: folds 
MinorityRule is disconnected 
SKV_1985: folds 
Uncalled bet ($0.04) returned to Scaaalll
Scaaalll collected $0.05 from pot
Scaaalll: doesn't show hand 
*** SUMMARY ***
Total pot $0.05 | Rake $0 
Seat 1: MinorityRule (button) folded before Flop (didn't bet)
Seat 2: YgovAndrey (small blind) folded before Flop
Seat 3: SKV_1985 (big blind) folded before Flop
Seat 4: prosto lili folded before Flop (didn't bet)
Seat 5: GGopenBet folded before Flop (didn't bet)
Seat 6: Scaaalll collected ($0.05)



PokerStars Zoom Hand #229233875516:  Hold'em No Limit ($0.01/$0.02) - 2021/08/21 23:47:41 CET [2021/08/21 17:47:41 ET]
Table 'Halley' 6-max Seat #1 is the button
Seat 1: MATIdf365 ($3.13 in chips) 
Seat 2: ctaceo ($2.08 in chips) 
Seat 3: cheddarspreada ($1.42 in chips) 
Seat 4: REZAKOV72 ($2.94 in chips) 
Seat 5: Scaaalll ($2.78 in chips) 
Seat 6: lucksuckdonk ($5.10 in chips) 
ctaceo: posts small blind $0.01
cheddarspreada: posts big blind $0.02
*** HOLE CARDS ***
Dealt to Scaaalll [8s Qc]
REZAKOV72: folds 
Scaaalll: folds 
lucksuckdonk: folds 
MATIdf365: raises $0.03 to $0.05
ctaceo: folds 
cheddarspreada: calls $0.03
*** FLOP *** [5c Ts Js]
cheddarspreada: checks 
MATIdf365: bets $0.03
cheddarspreada: calls $0.03
*** TURN *** [5c Ts Js] [Jh]
cheddarspreada: checks 
MATIdf365: checks 
*** RIVER *** [5c Ts Js Jh] [3d]
cheddarspreada: checks 
MATIdf365: checks 
*** SHOW DOWN ***
cheddarspreada: shows [Ad 8h] (a pair of Jacks)
MATIdf365: shows [Tc 9h] (two pair, Jacks and Tens)
MATIdf365 collected $0.16 from pot
*** SUMMARY ***
Total pot $0.17 | Rake $0.01 
Board [5c Ts Js Jh 3d]
Seat 1: MATIdf365 (button) showed [Tc 9h] and won ($0.16) with two pair, Jacks and Tens
Seat 2: ctaceo (small blind) folded before Flop
Seat 3: cheddarspreada (big blind) showed [Ad 8h] and lost with a pair of Jacks
Seat 4: REZAKOV72 folded before Flop (didn't bet)
Seat 5: Scaaalll folded before Flop (didn't bet)
Seat 6: lucksuckdonk folded before Flop (didn't bet)



PokerStars Zoom Hand #229233882243:  Hold'em No Limit ($0.01/$0.02) - 2021/08/21 23:47:58 CET [2021/08/21 17:47:58 ET]
Table 'Halley' 6-max Seat #1 is the button
Seat 1: Scaaalll ($2.77 in chips) 
Seat 2: Mikeloko182 ($5.37 in chips) 
Seat 3: fatedsuperior ($0.87 in chips) 
Seat 4: dkno77 ($2.04 in chips) 
Seat 5: 1nTeresT ($2.06 in chips) 
Seat 6: SatoruGoj142 ($2.26 in chips) 
Mikeloko182: posts small blind $0.01
fatedsuperior: posts big blind $0.02
*** HOLE CARDS ***
Dealt to Scaaalll [7d 2h]
dkno77: folds 
1nTeresT: folds 
SatoruGoj142: folds 
Scaaalll: folds 
Mikeloko182: raises $0.04 to $0.06
fatedsuperior: raises $0.04 to $0.10
Mikeloko182: calls $0.04
*** FLOP *** [7s Qc 5h]
Mikeloko182: checks 
fatedsuperior: bets $0.19
Mikeloko182: folds 
Uncalled bet ($0.19) returned to fatedsuperior
fatedsuperior collected $0.19 from pot
fatedsuperior: doesn't show hand 
*** SUMMARY ***
Total pot $0.20 | Rake $0.01 
Board [7s Qc 5h]
Seat 1: Scaaalll (button) folded before Flop (didn't bet)
Seat 2: Mikeloko182 (small blind) folded on the Flop
Seat 3: fatedsuperior (big blind) collected ($0.19)
Seat 4: dkno77 folded before Flop (didn't bet)
Seat 5: 1nTeresT folded before Flop (didn't bet)
Seat 6: SatoruGoj142 folded before Flop (didn't bet)



PokerStars Zoom Hand #229233891982:  Hold'em No Limit ($0.01/$0.02) - 2021/08/21 23:48:23 CET [2021/08/21 17:48:23 ET]
Table 'Halley' 6-max Seat #1 is the button
Seat 1: jaamonra ($2.38 in chips) 
Seat 2: Dr.stromg ($4.41 in chips) 
Seat 3: $w4y ($2.16 in chips) 
Seat 4: SKV_1985 ($2.17 in chips) 
Seat 5: Scaaalll ($2.80 in chips) 
Seat 6: WITKOW_AV ($2.15 in chips) 
Dr.stromg: posts small blind $0.01
$w4y: posts big blind $0.02
*** HOLE CARDS ***
Dealt to Scaaalll [4h 3d]
SKV_1985: folds 
Scaaalll: folds 
WITKOW_AV: folds 
jaamonra: folds 
Dr.stromg: raises $0.03 to $0.05
$w4y: calls $0.03
*** FLOP *** [4c 5s Ks]
Dr.stromg: bets $0.03
$w4y: raises $0.11 to $0.14
Dr.stromg: folds 
Uncalled bet ($0.11) returned to $w4y
$w4y collected $0.15 from pot
$w4y: doesn't show hand 
*** SUMMARY ***
Total pot $0.16 | Rake $0.01 
Board [4c 5s Ks]
Seat 1: jaamonra (button) folded before Flop (didn't bet)
Seat 2: Dr.stromg (small blind) folded on the Flop
Seat 3: $w4y (big blind) collected ($0.15)
Seat 4: SKV_1985 folded before Flop (didn't bet)
Seat 5: Scaaalll folded before Flop (didn't bet)
Seat 6: WITKOW_AV folded before Flop (didn't bet)



PokerStars Zoom Hand #229233895555:  Hold'em No Limit ($0.01/$0.02) - 2021/08/21 23:48:32 CET [2021/08/21 17:48:32 ET]
Table 'Halley' 6-max Seat #1 is the button
Seat 1: AtZ3899 ($1.90 in chips) 
Seat 2: yorkoss ($3.50 in chips) 
Seat 3: Scaaalll ($2.80 in chips) 
Seat 4: medyza111 ($3.28 in chips) 
Seat 5: punkosk8 ($6.87 in chips) 
Seat 6: WITKOW_AV ($8.14 in chips) 
yorkoss: posts small blind $0.01
Scaaalll: posts big blind $0.02
*** HOLE CARDS ***
Dealt to Scaaalll [9d Td]
medyza111: folds 
punkosk8: raises $0.04 to $0.06
WITKOW_AV: folds 
AtZ3899: folds 
yorkoss: folds 
Scaaalll: calls $0.04
*** FLOP *** [9c Ts 9h]
Scaaalll: checks 
punkosk8: bets $0.06
Scaaalll: calls $0.06
*** TURN *** [9c Ts 9h] [5s]
Scaaalll: checks 
punkosk8: bets $0.18
Scaaalll: calls $0.18
*** RIVER *** [9c Ts 9h 5s] [5d]
Scaaalll: checks 
punkosk8: bets $0.59
Scaaalll: raises $1.91 to $2.50 and is all-in
punkosk8: calls $1.91
*** SHOW DOWN ***
Scaaalll: shows [9d Td] (a full house, Nines full of Tens)
punkosk8: shows [9s 8s] (a full house, Nines full of Fives)
Scaaalll collected $5.36 from pot
*** SUMMARY ***
Total pot $5.61 | Rake $0.25 
Board [9c Ts 9h 5s 5d]
Seat 1: AtZ3899 (button) folded before Flop (didn't bet)
Seat 2: yorkoss (small blind) folded before Flop
Seat 3: Scaaalll (big blind) showed [9d Td] and won ($5.36) with a full house, Nines full of Tens
Seat 4: medyza111 folded before Flop (didn't bet)
Seat 5: punkosk8 showed [9s 8s] and lost with a full house, Nines full of Fives
Seat 6: WITKOW_AV folded before Flop (didn't bet)



PokerStars Zoom Hand #229233929308:  Hold'em No Limit ($0.01/$0.02) - 2021/08/21 23:49:59 CET [2021/08/21 17:49:59 ET]
Table 'Halley' 6-max Seat #1 is the button
Seat 1: nbarreiro021 ($2.56 in chips) 
Seat 2: Scaaalll ($5.36 in chips) 
Seat 3: cutter2468 ($2.89 in chips) 
Seat 4: so0love ($4.17 in chips) 
Seat 5: lucky1529 ($0.48 in chips) 
Seat 6: CowboyNicky ($1.72 in chips) 
Scaaalll: posts small blind $0.01
cutter2468: posts big blind $0.02
*** HOLE CARDS ***
Dealt to Scaaalll [8h Ad]
CowboyNicky is disconnected 
so0love: folds 
lucky1529: folds 
CowboyNicky: folds 
nbarreiro021: raises $0.04 to $0.06
Scaaalll: folds 
cutter2468: folds 
Uncalled bet ($0.04) returned to nbarreiro021
nbarreiro021 collected $0.05 from pot
nbarreiro021: doesn't show hand 
*** SUMMARY ***
Total pot $0.05 | Rake $0 
Seat 1: nbarreiro021 (button) collected ($0.05)
Seat 2: Scaaalll (small blind) folded before Flop
Seat 3: cutter2468 (big blind) folded before Flop
Seat 4: so0love folded before Flop (didn't bet)
Seat 5: lucky1529 folded before Flop (didn't bet)
Seat 6: CowboyNicky folded before Flop (didn't bet)



PokerStars Zoom Hand #229233943380:  Hold'em No Limit ($0.01/$0.02) - 2021/08/21 23:50:35 CET [2021/08/21 17:50:35 ET]
Table 'Halley' 6-max Seat #1 is the button
Seat 1: Scaaalll ($5.33 in chips) 
Seat 2: ciucibaby ($2.40 in chips) 
Seat 3: jaamonra ($2.06 in chips) 
Seat 4: AXXILLES ($5.10 in chips) 
Seat 5: Marcos130790 ($2.10 in chips) 
Seat 6: diegohgmelo ($1.12 in chips) 
ciucibaby: posts small blind $0.01
jaamonra: posts big blind $0.02
*** HOLE CARDS ***
Dealt to Scaaalll [7h 8c]
AXXILLES: folds 
diegohgmelo is disconnected 
Marcos130790: folds 
diegohgmelo: folds 
Scaaalll: folds 
ciucibaby: folds 
Uncalled bet ($0.01) returned to jaamonra
jaamonra collected $0.02 from pot
jaamonra: doesn't show hand 
*** SUMMARY ***
Total pot $0.02 | Rake $0 
Seat 1: Scaaalll (button) folded before Flop (didn't bet)
Seat 2: ciucibaby (small blind) folded before Flop
Seat 3: jaamonra (big blind) collected ($0.02)
Seat 4: AXXILLES folded before Flop (didn't bet)
Seat 5: Marcos130790 folded before Flop (didn't bet)
Seat 6: diegohgmelo folded before Flop (didn't bet)



PokerStars Zoom Hand #229233936366:  Hold'em No Limit ($0.01/$0.02) - 2021/08/21 23:50:17 CET [2021/08/21 17:50:17 ET]
Table 'Halley' 6-max Seat #1 is the button
Seat 1: StartGoy ($2.39 in chips) 
Seat 2: isurusa ($2.86 in chips) 
Seat 3: Scaaalll ($5.35 in chips) 
Seat 4: Demidov V.S. ($2.72 in chips) 
Seat 5: Finderra ($2.61 in chips) 
Seat 6: fabor1303 ($10.43 in chips) 
isurusa: posts small blind $0.01
Scaaalll: posts big blind $0.02
*** HOLE CARDS ***
Dealt to Scaaalll [5d 2c]
Demidov V.S.: folds 
Demidov V.S. is disconnected 
Finderra: folds 
fabor1303: folds 
StartGoy: raises $0.05 to $0.07
isurusa: raises $0.16 to $0.23
Scaaalll: folds 
StartGoy: calls $0.16
*** FLOP *** [6h 7d Th]
isurusa: bets $0.23
StartGoy: calls $0.23
*** TURN *** [6h 7d Th] [9s]
isurusa: bets $0.46
StartGoy: raises $1.47 to $1.93 and is all-in
isurusa: calls $1.47
*** RIVER *** [6h 7d Th 9s] [Kh]
*** SHOW DOWN ***
isurusa: shows [Jh Ac] (high card Ace)
StartGoy: shows [5c 4c] (high card King)
isurusa collected $4.63 from pot
*** SUMMARY ***
Total pot $4.80 | Rake $0.17 
Board [6h 7d Th 9s Kh]
Seat 1: StartGoy (button) showed [5c 4c] and lost with high card King
Seat 2: isurusa (small blind) showed [Jh Ac] and won ($4.63) with high card Ace
Seat 3: Scaaalll (big blind) folded before Flop
Seat 4: Demidov V.S. folded before Flop (didn't bet)
Seat 5: Finderra folded before Flop (didn't bet)
Seat 6: fabor1303 folded before Flop (didn't bet)



PokerStars Zoom Hand #229233934840:  Hold'em No Limit ($0.01/$0.02) - 2021/08/21 23:50:13 CET [2021/08/21 17:50:13 ET]
Table 'Halley' 6-max Seat #1 is the button
Seat 1: max-101219 ($1.79 in chips) 
Seat 2: viktor2935 ($0.50 in chips) 
Seat 3: KonopDima ($2.07 in chips) 
Seat 4: Scaaalll ($5.35 in chips) 
Seat 5: Busya777 ($5.17 in chips) 
Seat 6: willmorel ($2.29 in chips) 
viktor2935: posts small blind $0.01
KonopDima: posts big blind $0.02
*** HOLE CARDS ***
Dealt to Scaaalll [As 5d]
Scaaalll: folds 
Busya777: folds 
Busya777 is disconnected 
willmorel: folds 
max-101219 has timed out
max-101219: folds 
max-101219 is disconnected 
viktor2935: calls $0.01
KonopDima: checks 
*** FLOP *** [6c Th 6d]
viktor2935: checks 
KonopDima: checks 
*** TURN *** [6c Th 6d] [5h]
viktor2935: checks 
KonopDima: checks 
*** RIVER *** [6c Th 6d 5h] [Qc]
viktor2935: checks 
KonopDima: checks 
*** SHOW DOWN ***
viktor2935: shows [Kh 3d] (a pair of Sixes)
KonopDima: shows [Ts 7s] (two pair, Tens and Sixes)
KonopDima collected $0.04 from pot
*** SUMMARY ***
Total pot $0.04 | Rake $0 
Board [6c Th 6d 5h Qc]
Seat 1: max-101219 (button) folded before Flop (didn't bet)
Seat 2: viktor2935 (small blind) showed [Kh 3d] and lost with a pair of Sixes
Seat 3: KonopDima (big blind) showed [Ts 7s] and won ($0.04) with two pair, Tens and Sixes
Seat 4: Scaaalll folded before Flop (didn't bet)
Seat 5: Busya777 folded before Flop (didn't bet)
Seat 6: willmorel folded before Flop (didn't bet)



PokerStars Zoom Hand #229233945240:  Hold'em No Limit ($0.01/$0.02) - 2021/08/21 23:50:40 CET [2021/08/21 17:50:40 ET]
Table 'Halley' 6-max Seat #1 is the button
Seat 1: Ximinguei ($1.43 in chips) 
Seat 2: E Z TAKEDOWN ($2.03 in chips) 
Seat 3: nbarreiro021 ($2.34 in chips) 
Seat 4: fabor1303 ($5.61 in chips) 
Seat 5: Scaaalll ($5.33 in chips) 
Seat 6: Espartacus5222 ($2.41 in chips) 
E Z TAKEDOWN: posts small blind $0.01
nbarreiro021: posts big blind $0.02
*** HOLE CARDS ***
Dealt to Scaaalll [Ah Jd]
fabor1303: raises $0.03 to $0.05
Ximinguei is disconnected 
Scaaalll: calls $0.05
Espartacus5222: folds 
Ximinguei: folds 
E Z TAKEDOWN: calls $0.04
nbarreiro021: calls $0.03
*** FLOP *** [Jh 9d 5s]
E Z TAKEDOWN: checks 
nbarreiro021: checks 
fabor1303: checks 
Scaaalll: bets $0.12
E Z TAKEDOWN: folds 
nbarreiro021: folds 
fabor1303: calls $0.12
*** TURN *** [Jh 9d 5s] [7d]
fabor1303: checks 
Scaaalll: bets $0.24
fabor1303: calls $0.24
*** RIVER *** [Jh 9d 5s 7d] [6d]
fabor1303: checks 
Scaaalll: checks 
*** SHOW DOWN ***
fabor1303: shows [Ts Js] (a pair of Jacks)
Scaaalll: shows [Ah Jd] (a pair of Jacks - Ace kicker)
Scaaalll collected $0.88 from pot
*** SUMMARY ***
Total pot $0.92 | Rake $0.04 
Board [Jh 9d 5s 7d 6d]
Seat 1: Ximinguei (button) folded before Flop (didn't bet)
Seat 2: E Z TAKEDOWN (small blind) folded on the Flop
Seat 3: nbarreiro021 (big blind) folded on the Flop
Seat 4: fabor1303 showed [Ts Js] and lost with a pair of Jacks
Seat 5: Scaaalll showed [Ah Jd] and won ($0.88) with a pair of Jacks
Seat 6: Espartacus5222 folded before Flop (didn't bet)



PokerStars Zoom Hand #229233981967:  Hold'em No Limit ($0.01/$0.02) - 2021/08/21 23:52:04 CET [2021/08/21 17:52:04 ET]
Table 'Halley' 6-max Seat #1 is the button
Seat 1: jorgemolga ($1.01 in chips) 
Seat 2: sulcinob ($2.70 in chips) 
Seat 3: AtZ3899 ($2.01 in chips) 
Seat 4: viktor2935 ($0.36 in chips) 
Seat 5: CYBOPOB66 ($2.38 in chips) 
Seat 6: Scaaalll ($5.80 in chips) 
sulcinob: posts small blind $0.01
AtZ3899: posts big blind $0.02
*** HOLE CARDS ***
Dealt to Scaaalll [6s 7s]
viktor2935: folds 
CYBOPOB66: folds 
Scaaalll: raises $0.04 to $0.06
jorgemolga: calls $0.06
sulcinob: folds 
AtZ3899: calls $0.04
*** FLOP *** [2d Ad 2c]
AtZ3899: checks 
Scaaalll: checks 
jorgemolga: bets $0.09
AtZ3899: folds 
Scaaalll: folds 
Uncalled bet ($0.09) returned to jorgemolga
jorgemolga collected $0.18 from pot
jorgemolga: doesn't show hand 
*** SUMMARY ***
Total pot $0.19 | Rake $0.01 
Board [2d Ad 2c]
Seat 1: jorgemolga (button) collected ($0.18)
Seat 2: sulcinob (small blind) folded before Flop
Seat 3: AtZ3899 (big blind) folded on the Flop
Seat 4: viktor2935 folded before Flop (didn't bet)
Seat 5: CYBOPOB66 folded before Flop (didn't bet)
Seat 6: Scaaalll folded on the Flop



PokerStars Zoom Hand #229234001996:  Hold'em No Limit ($0.01/$0.02) - 2021/08/21 23:52:56 CET [2021/08/21 17:52:56 ET]
Table 'Halley' 6-max Seat #1 is the button
Seat 1: CowboyNicky ($1.73 in chips) 
Seat 2: Scaaalll ($5.74 in chips) 
Seat 3: Misteltje ($1.20 in chips) 
Seat 4: rpycmbEM ($5.74 in chips) 
Seat 5: kcyxa ($1.93 in chips) 
Seat 6: fishh_play ($8.37 in chips) 
Scaaalll: posts small blind $0.01
Misteltje: posts big blind $0.02
*** HOLE CARDS ***
Dealt to Scaaalll [8h 8s]
kcyxa is disconnected 
rpycmbEM: folds 
kcyxa: folds 
CowboyNicky is disconnected 
fishh_play: folds 
CowboyNicky: folds 
Scaaalll: raises $0.04 to $0.06
Misteltje: calls $0.04
*** FLOP *** [4h 9c 3d]
Scaaalll: bets $0.08
Misteltje: calls $0.08
*** TURN *** [4h 9c 3d] [9s]
Scaaalll: bets $0.16
Misteltje: calls $0.16
*** RIVER *** [4h 9c 3d 9s] [As]
Scaaalll: checks 
Misteltje: bets $0.02
Scaaalll: calls $0.02
*** SHOW DOWN ***
Misteltje: shows [4s Kc] (two pair, Nines and Fours)
Scaaalll: shows [8h 8s] (two pair, Nines and Eights)
Scaaalll collected $0.62 from pot
*** SUMMARY ***
Total pot $0.64 | Rake $0.02 
Board [4h 9c 3d 9s As]
Seat 1: CowboyNicky (button) folded before Flop (didn't bet)
Seat 2: Scaaalll (small blind) showed [8h 8s] and won ($0.62) with two pair, Nines and Eights
Seat 3: Misteltje (big blind) showed [4s Kc] and lost with two pair, Nines and Fours
Seat 4: rpycmbEM folded before Flop (didn't bet)
Seat 5: kcyxa folded before Flop (didn't bet)
Seat 6: fishh_play folded before Flop (didn't bet)



PokerStars Zoom Hand #229234026542:  Hold'em No Limit ($0.01/$0.02) - 2021/08/21 23:54:00 CET [2021/08/21 17:54:00 ET]
Table 'Halley' 6-max Seat #1 is the button
Seat 1: Scaaalll ($6.04 in chips) 
Seat 2: hotbud77 ($2.36 in chips) 
Seat 3: Chapaev136 ($1.30 in chips) 
Seat 4: Nam Tsedom Tsom ($2.30 in chips) 
Seat 5: ussr246 ($2.65 in chips) 
Seat 6: levachok ($4.64 in chips) 
hotbud77: posts small blind $0.01
Chapaev136: posts big blind $0.02
*** HOLE CARDS ***
Dealt to Scaaalll [2s Ah]
Nam Tsedom Tsom: raises $0.04 to $0.06
ussr246: folds 
levachok: folds 
Scaaalll: folds 
hotbud77: folds 
Chapaev136: folds 
Uncalled bet ($0.04) returned to Nam Tsedom Tsom
Nam Tsedom Tsom collected $0.05 from pot
Nam Tsedom Tsom: doesn't show hand 
*** SUMMARY ***
Total pot $0.05 | Rake $0 
Seat 1: Scaaalll (button) folded before Flop (didn't bet)
Seat 2: hotbud77 (small blind) folded before Flop
Seat 3: Chapaev136 (big blind) folded before Flop
Seat 4: Nam Tsedom Tsom collected ($0.05)
Seat 5: ussr246 folded before Flop (didn't bet)
Seat 6: levachok folded before Flop (didn't bet)



PokerStars Zoom Hand #229234031066:  Hold'em No Limit ($0.01/$0.02) - 2021/08/21 23:54:12 CET [2021/08/21 17:54:12 ET]
Table 'Halley' 6-max Seat #1 is the button
Seat 1: ernmic ($2.47 in chips) 
Seat 2: Baldisback ($3.77 in chips) 
Seat 3: Sergio Rigel ($2.03 in chips) 
Seat 4: A.Khodyakov ($2.19 in chips) 
Seat 5: samn102 ($2.79 in chips) 
Seat 6: Scaaalll ($6.04 in chips) 
Baldisback: posts small blind $0.01
Sergio Rigel: posts big blind $0.02
*** HOLE CARDS ***
Dealt to Scaaalll [6c 2h]
A.Khodyakov: folds 
samn102: folds 
Scaaalll: folds 
ernmic: folds 
Baldisback: folds 
Uncalled bet ($0.01) returned to Sergio Rigel
Sergio Rigel collected $0.02 from pot
Sergio Rigel: doesn't show hand 
*** SUMMARY ***
Total pot $0.02 | Rake $0 
Seat 1: ernmic (button) folded before Flop (didn't bet)
Seat 2: Baldisback (small blind) folded before Flop
Seat 3: Sergio Rigel (big blind) collected ($0.02)
Seat 4: A.Khodyakov folded before Flop (didn't bet)
Seat 5: samn102 folded before Flop (didn't bet)
Seat 6: Scaaalll folded before Flop (didn't bet)



PokerStars Zoom Hand #229234034951:  Hold'em No Limit ($0.01/$0.02) - 2021/08/21 23:54:22 CET [2021/08/21 17:54:22 ET]
Table 'Halley' 6-max Seat #1 is the button
Seat 1: AtZ3899 ($1.71 in chips) 
Seat 2: ctaceo ($2.25 in chips) 
Seat 3: 888lifeIS ($2.08 in chips) 
Seat 4: bookerjee ($1.20 in chips) 
Seat 5: Scaaalll ($6.04 in chips) 
Seat 6: lucky1529 ($0.84 in chips) 
ctaceo: posts small blind $0.01
888lifeIS: posts big blind $0.02
*** HOLE CARDS ***
Dealt to Scaaalll [Jh Th]
bookerjee: folds 
bookerjee is disconnected 
Scaaalll: raises $0.04 to $0.06
lucky1529: calls $0.06
AtZ3899: calls $0.06
ctaceo: folds 
888lifeIS: folds 
*** FLOP *** [8s 3d 7s]
Scaaalll: bets $0.12
lucky1529: folds 
AtZ3899: folds 
Uncalled bet ($0.12) returned to Scaaalll
Scaaalll collected $0.20 from pot
Scaaalll: doesn't show hand 
*** SUMMARY ***
Total pot $0.21 | Rake $0.01 
Board [8s 3d 7s]
Seat 1: AtZ3899 (button) folded on the Flop
Seat 2: ctaceo (small blind) folded before Flop
Seat 3: 888lifeIS (big blind) folded before Flop
Seat 4: bookerjee folded before Flop (didn't bet)
Seat 5: Scaaalll collected ($0.20)
Seat 6: lucky1529 folded on the Flop



PokerStars Zoom Hand #229234033008:  Hold'em No Limit ($0.01/$0.02) - 2021/08/21 23:54:17 CET [2021/08/21 17:54:17 ET]
Table 'Halley' 6-max Seat #1 is the button
Seat 1: nikos803 ($2.26 in chips) 
Seat 2: GambleNinjaEX ($5.50 in chips) 
Seat 3: Araj Moon ($2 in chips) 
Seat 4: Scaaalll ($6.04 in chips) 
Seat 5: STE1NBERG ($3.02 in chips) 
Seat 6: El Chicha.CL ($2.41 in chips) 
GambleNinjaEX: posts small blind $0.01
Araj Moon: posts big blind $0.02
*** HOLE CARDS ***
Dealt to Scaaalll [Qh 7d]
Scaaalll: folds 
STE1NBERG: raises $0.03 to $0.05
El Chicha.CL: folds 
nikos803: folds 
GambleNinjaEX: calls $0.04
Araj Moon: folds 
*** FLOP *** [Js 5s 4s]
GambleNinjaEX: checks 
STE1NBERG: bets $0.06
GambleNinjaEX: calls $0.06
*** TURN *** [Js 5s 4s] [Jd]
GambleNinjaEX: checks 
STE1NBERG: bets $0.12
GambleNinjaEX: calls $0.12
*** RIVER *** [Js 5s 4s Jd] [7h]
GambleNinjaEX: checks 
STE1NBERG: checks 
*** SHOW DOWN ***
GambleNinjaEX: shows [Jc Tc] (three of a kind, Jacks)
STE1NBERG: mucks hand 
GambleNinjaEX collected $0.46 from pot
*** SUMMARY ***
Total pot $0.48 | Rake $0.02 
Board [Js 5s 4s Jd 7h]
Seat 1: nikos803 (button) folded before Flop (didn't bet)
Seat 2: GambleNinjaEX (small blind) showed [Jc Tc] and won ($0.46) with three of a kind, Jacks
Seat 3: Araj Moon (big blind) folded before Flop
Seat 4: Scaaalll folded before Flop (didn't bet)
Seat 5: STE1NBERG mucked [3d 3s]
Seat 6: El Chicha.CL folded before Flop (didn't bet)



PokerStars Zoom Hand #229234044877:  Hold'em No Limit ($0.01/$0.02) - 2021/08/21 23:54:48 CET [2021/08/21 17:54:48 ET]
Table 'Halley' 6-max Seat #1 is the button
Seat 1: KissingTheSun ($3.69 in chips) 
Seat 2: fabor1303 ($5.12 in chips) 
Seat 3: Scaaalll ($6.18 in chips) 
Seat 4: sulcinob ($2.85 in chips) 
Seat 5: kukulagosleep ($7.11 in chips) 
Seat 6: rancing87 ($2.41 in chips) 
fabor1303: posts small blind $0.01
Scaaalll: posts big blind $0.02
*** HOLE CARDS ***
Dealt to Scaaalll [8c 8d]
sulcinob: folds 
kukulagosleep: folds 
rancing87: folds 
KissingTheSun: folds 
fabor1303: raises $0.04 to $0.06
Scaaalll: calls $0.04
*** FLOP *** [4c Qc Qh]
fabor1303: checks 
Scaaalll: bets $0.06
fabor1303: folds 
Uncalled bet ($0.06) returned to Scaaalll
Scaaalll collected $0.12 from pot
Scaaalll: doesn't show hand 
*** SUMMARY ***
Total pot $0.12 | Rake $0 
Board [4c Qc Qh]
Seat 1: KissingTheSun (button) folded before Flop (didn't bet)
Seat 2: fabor1303 (small blind) folded on the Flop
Seat 3: Scaaalll (big blind) collected ($0.12)
Seat 4: sulcinob folded before Flop (didn't bet)
Seat 5: kukulagosleep folded before Flop (didn't bet)
Seat 6: rancing87 folded before Flop (didn't bet)



PokerStars Zoom Hand #229234055131:  Hold'em No Limit ($0.01/$0.02) - 2021/08/21 23:55:18 CET [2021/08/21 17:55:18 ET]
Table 'Halley' 6-max Seat #1 is the button
Seat 1: KissingTheSun ($3.67 in chips) 
Seat 2: kifa612 ($2.15 in chips) 
Seat 3: Nihility77 ($4.29 in chips) 
Seat 4: IIDARKROBOTII ($1.84 in chips) 
Seat 5: Scaaalll ($6.24 in chips) 
Seat 6: Holmie111 ($4.41 in chips) 
kifa612: posts small blind $0.01
Nihility77: posts big blind $0.02
*** HOLE CARDS ***
Dealt to Scaaalll [7d 4s]
Holmie111 is disconnected 
IIDARKROBOTII: raises $0.04 to $0.06
Scaaalll: folds 
Holmie111: folds 
KissingTheSun: folds 
kifa612: folds 
Nihility77: folds 
Uncalled bet ($0.04) returned to IIDARKROBOTII
IIDARKROBOTII collected $0.05 from pot
IIDARKROBOTII: doesn't show hand 
*** SUMMARY ***
Total pot $0.05 | Rake $0 
Seat 1: KissingTheSun (button) folded before Flop (didn't bet)
Seat 2: kifa612 (small blind) folded before Flop
Seat 3: Nihility77 (big blind) folded before Flop
Seat 4: IIDARKROBOTII collected ($0.05)
Seat 5: Scaaalll folded before Flop (didn't bet)
Seat 6: Holmie111 folded before Flop (didn't bet)



PokerStars Zoom Hand #229234058348:  Hold'em No Limit ($0.01/$0.02) - 2021/08/21 23:55:29 CET [2021/08/21 17:55:29 ET]
Table 'Halley' 6-max Seat #1 is the button
Seat 1: Gamer577 ($3.94 in chips) 
Seat 2: 3@RAZZA.BLR ($2.80 in chips) 
Seat 3: Nihility77 ($2.14 in chips) 
Seat 4: baddbeat4fun ($3.51 in chips) 
Seat 5: hallowed_0 ($3.48 in chips) 
Seat 6: Scaaalll ($6.24 in chips) 
3@RAZZA.BLR: posts small blind $0.01
Nihility77: posts big blind $0.02
*** HOLE CARDS ***
Dealt to Scaaalll [Ad 6c]
baddbeat4fun: folds 
hallowed_0: folds 
Scaaalll: folds 
Gamer577: folds 
3@RAZZA.BLR: folds 
Uncalled bet ($0.01) returned to Nihility77
Nihility77 collected $0.02 from pot
Nihility77: doesn't show hand 
*** SUMMARY ***
Total pot $0.02 | Rake $0 
Seat 1: Gamer577 (button) folded before Flop (didn't bet)
Seat 2: 3@RAZZA.BLR (small blind) folded before Flop
Seat 3: Nihility77 (big blind) collected ($0.02)
Seat 4: baddbeat4fun folded before Flop (didn't bet)
Seat 5: hallowed_0 folded before Flop (didn't bet)
Seat 6: Scaaalll folded before Flop (didn't bet)



PokerStars Zoom Hand #229234064865:  Hold'em No Limit ($0.01/$0.02) - 2021/08/21 23:55:51 CET [2021/08/21 17:55:51 ET]
Table 'Halley' 6-max Seat #1 is the button
Seat 1: Reipinguimm ($2.01 in chips) 
Seat 2: Scaaalll ($6.24 in chips) 
Seat 3: zergmiky ($2.03 in chips) 
Seat 4: nbarreiro021 ($2.64 in chips) 
Seat 5: KissingTheSun ($2.24 in chips) 
Seat 6: El Chicha.CL ($2.43 in chips) 
Scaaalll: posts small blind $0.01
zergmiky: posts big blind $0.02
*** HOLE CARDS ***
Dealt to Scaaalll [Td 4c]
nbarreiro021: folds 
KissingTheSun: folds 
El Chicha.CL: folds 
Reipinguimm: raises $0.02 to $0.04
Scaaalll: folds 
zergmiky: folds 
Uncalled bet ($0.02) returned to Reipinguimm
Reipinguimm collected $0.05 from pot
Reipinguimm: doesn't show hand 
*** SUMMARY ***
Total pot $0.05 | Rake $0 
Seat 1: Reipinguimm (button) collected ($0.05)
Seat 2: Scaaalll (small blind) folded before Flop
Seat 3: zergmiky (big blind) folded before Flop
Seat 4: nbarreiro021 folded before Flop (didn't bet)
Seat 5: KissingTheSun folded before Flop (didn't bet)
Seat 6: El Chicha.CL folded before Flop (didn't bet)



PokerStars Zoom Hand #229234060991:  Hold'em No Limit ($0.01/$0.02) - 2021/08/21 23:55:38 CET [2021/08/21 17:55:38 ET]
Table 'Halley' 6-max Seat #1 is the button
Seat 1: Scaaalll ($6.24 in chips) 
Seat 2: lucksuckdonk ($9.15 in chips) 
Seat 3: pavlo8855 ($2 in chips) 
Seat 4: EdwardF95 ($2.66 in chips) 
Seat 5: AlienMdeo ($0.82 in chips) 
Seat 6: Iv3rson18 ($3.13 in chips) 
lucksuckdonk: posts small blind $0.01
pavlo8855: posts big blind $0.02
*** HOLE CARDS ***
Dealt to Scaaalll [5d 8s]
EdwardF95: folds 
AlienMdeo: folds 
Iv3rson18: raises $0.03 to $0.05
Scaaalll: folds 
lucksuckdonk: calls $0.04
pavlo8855: folds 
*** FLOP *** [Th 7s 9s]
lucksuckdonk: checks 
Iv3rson18: bets $0.06
lucksuckdonk: calls $0.06
*** TURN *** [Th 7s 9s] [Jd]
lucksuckdonk: checks 
Iv3rson18: bets $0.12
lucksuckdonk: folds 
Uncalled bet ($0.12) returned to Iv3rson18
Iv3rson18 collected $0.23 from pot
Iv3rson18: doesn't show hand 
*** SUMMARY ***
Total pot $0.24 | Rake $0.01 
Board [Th 7s 9s Jd]
Seat 1: Scaaalll (button) folded before Flop (didn't bet)
Seat 2: lucksuckdonk (small blind) folded on the Turn
Seat 3: pavlo8855 (big blind) folded before Flop
Seat 4: EdwardF95 folded before Flop (didn't bet)
Seat 5: AlienMdeo folded before Flop (didn't bet)
Seat 6: Iv3rson18 collected ($0.23)



PokerStars Zoom Hand #229234069779:  Hold'em No Limit ($0.01/$0.02) - 2021/08/21 23:56:08 CET [2021/08/21 17:56:08 ET]
Table 'Halley' 6-max Seat #1 is the button
Seat 1: MattieBOZ ($2.32 in chips) 
Seat 2: LDGarces ($1.06 in chips) 
Seat 3: nagiloR ($2.05 in chips) 
Seat 4: Scaaalll ($6.23 in chips) 
Seat 5: Craitastrophe ($2.77 in chips) 
Seat 6: Busya777 ($5 in chips) 
LDGarces: posts small blind $0.01
nagiloR: posts big blind $0.02
*** HOLE CARDS ***
Dealt to Scaaalll [4h Ks]
Busya777 is disconnected 
Scaaalll: folds 
Craitastrophe: folds 
Busya777: folds 
MattieBOZ: folds 
MattieBOZ is disconnected 
LDGarces: raises $0.04 to $0.06
nagiloR: calls $0.04
*** FLOP *** [5c Qh 2d]
LDGarces: bets $0.06
nagiloR: raises $0.12 to $0.18
LDGarces: raises $0.82 to $1 and is all-in
nagiloR: calls $0.82
*** TURN *** [5c Qh 2d] [6s]
*** RIVER *** [5c Qh 2d 6s] [Ah]
*** SHOW DOWN ***
LDGarces: shows [Kh As] (a pair of Aces)
nagiloR: shows [2h 5s] (two pair, Fives and Deuces)
nagiloR collected $2.05 from pot
LDGarces cashed out the hand for $0.14
*** SUMMARY ***
Total pot $2.12 | Rake $0.07 
Board [5c Qh 2d 6s Ah]
Seat 1: MattieBOZ (button) folded before Flop (didn't bet)
Seat 2: LDGarces (small blind) showed [Kh As] and lost with a pair of Aces (cashed out).
Seat 3: nagiloR (big blind) showed [2h 5s] and won ($2.05) with two pair, Fives and Deuces
Seat 4: Scaaalll folded before Flop (didn't bet)
Seat 5: Craitastrophe folded before Flop (didn't bet)
Seat 6: Busya777 folded before Flop (didn't bet)



PokerStars Zoom Hand #229234071245:  Hold'em No Limit ($0.01/$0.02) - 2021/08/21 23:56:13 CET [2021/08/21 17:56:13 ET]
Table 'Halley' 6-max Seat #1 is the button
Seat 1: arex194 ($0.91 in chips) 
Seat 2: Doktor Yes ($3.04 in chips) 
Seat 3: Scaaalll ($6.23 in chips) 
Seat 4: Red Sky 15 ($7.58 in chips) 
Seat 5: boa juice ($1.94 in chips) 
Seat 6: davidalejag ($2.40 in chips) 
Doktor Yes: posts small blind $0.01
Scaaalll: posts big blind $0.02
*** HOLE CARDS ***
Dealt to Scaaalll [Qh Ah]
arex194 is disconnected 
boa juice is disconnected 
Red Sky 15: raises $0.04 to $0.06
boa juice: folds 
davidalejag: folds 
arex194: folds 
Doktor Yes: folds 
Scaaalll: calls $0.04
*** FLOP *** [Jd 8s 6s]
Scaaalll: checks 
Red Sky 15: bets $0.06
Scaaalll: folds 
Uncalled bet ($0.06) returned to Red Sky 15
Red Sky 15 collected $0.13 from pot
Red Sky 15: doesn't show hand 
*** SUMMARY ***
Total pot $0.13 | Rake $0 
Board [Jd 8s 6s]
Seat 1: arex194 (button) folded before Flop (didn't bet)
Seat 2: Doktor Yes (small blind) folded before Flop
Seat 3: Scaaalll (big blind) folded on the Flop
Seat 4: Red Sky 15 collected ($0.13)
Seat 5: boa juice folded before Flop (didn't bet)
Seat 6: davidalejag folded before Flop (didn't bet)



PokerStars Zoom Hand #229234082753:  Hold'em No Limit ($0.01/$0.02) - 2021/08/21 23:56:52 CET [2021/08/21 17:56:52 ET]
Table 'Halley' 6-max Seat #1 is the button
Seat 1: Scaaalll ($6.17 in chips) 
Seat 2: ctaceo ($2.27 in chips) 
Seat 3: gilberto98 ($4.24 in chips) 
Seat 4: ulisessoria ($2.48 in chips) 
Seat 5: jaamonra ($2.17 in chips) 
Seat 6: Dr.stromg ($2.43 in chips) 
ctaceo: posts small blind $0.01
gilberto98: posts big blind $0.02
*** HOLE CARDS ***
Dealt to Scaaalll [5c 3h]
ulisessoria: folds 
jaamonra: folds 
Dr.stromg: folds 
Scaaalll: folds 
ctaceo: folds 
Uncalled bet ($0.01) returned to gilberto98
gilberto98 collected $0.02 from pot
gilberto98: doesn't show hand 
*** SUMMARY ***
Total pot $0.02 | Rake $0 
Seat 1: Scaaalll (button) folded before Flop (didn't bet)
Seat 2: ctaceo (small blind) folded before Flop
Seat 3: gilberto98 (big blind) collected ($0.02)
Seat 4: ulisessoria folded before Flop (didn't bet)
Seat 5: jaamonra folded before Flop (didn't bet)
Seat 6: Dr.stromg folded before Flop (didn't bet)



PokerStars Zoom Hand #229234085104:  Hold'em No Limit ($0.01/$0.02) - 2021/08/21 23:57:00 CET [2021/08/21 17:57:00 ET]
Table 'Halley' 6-max Seat #1 is the button
Seat 1: Dr.stromg ($2.43 in chips) 
Seat 2: baddbeat4fun ($4.28 in chips) 
Seat 3: egroj1700 ($2 in chips) 
Seat 4: CowboyNicky ($2.76 in chips) 
Seat 5: Scaaalll ($6.17 in chips) 
Seat 6: zergmiky ($2.20 in chips) 
baddbeat4fun: posts small blind $0.01
egroj1700: posts big blind $0.02
*** HOLE CARDS ***
Dealt to Scaaalll [2h 6c]
CowboyNicky: folds 
CowboyNicky is disconnected 
Scaaalll: folds 
zergmiky: folds 
Dr.stromg: folds 
baddbeat4fun: folds 
Uncalled bet ($0.01) returned to egroj1700
egroj1700 collected $0.02 from pot
egroj1700: doesn't show hand 
*** SUMMARY ***
Total pot $0.02 | Rake $0 
Seat 1: Dr.stromg (button) folded before Flop (didn't bet)
Seat 2: baddbeat4fun (small blind) folded before Flop
Seat 3: egroj1700 (big blind) collected ($0.02)
Seat 4: CowboyNicky folded before Flop (didn't bet)
Seat 5: Scaaalll folded before Flop (didn't bet)
Seat 6: zergmiky folded before Flop (didn't bet)



PokerStars Zoom Hand #229234088735:  Hold'em No Limit ($0.01/$0.02) - 2021/08/21 23:57:12 CET [2021/08/21 17:57:12 ET]
Table 'Halley' 6-max Seat #1 is the button
Seat 1: rodrigoasor ($5.74 in chips) 
Seat 2: Scaaalll ($6.17 in chips) 
Seat 3: alphabeta1d ($2.39 in chips) 
Seat 4: gaturamard ($4.80 in chips) 
Seat 5: WolvegastL ($1.07 in chips) 
Seat 6: Superior1712 ($2 in chips) 
Scaaalll: posts small blind $0.01
alphabeta1d: posts big blind $0.02
*** HOLE CARDS ***
Dealt to Scaaalll [Kh 7s]
gaturamard: folds 
WolvegastL: folds 
Superior1712: folds 
rodrigoasor: folds 
Scaaalll: folds 
Uncalled bet ($0.01) returned to alphabeta1d
alphabeta1d collected $0.02 from pot
alphabeta1d: doesn't show hand 
*** SUMMARY ***
Total pot $0.02 | Rake $0 
Seat 1: rodrigoasor (button) folded before Flop (didn't bet)
Seat 2: Scaaalll (small blind) folded before Flop
Seat 3: alphabeta1d (big blind) collected ($0.02)
Seat 4: gaturamard folded before Flop (didn't bet)
Seat 5: WolvegastL folded before Flop (didn't bet)
Seat 6: Superior1712 folded before Flop (didn't bet)



PokerStars Zoom Hand #229234089860:  Hold'em No Limit ($0.01/$0.02) - 2021/08/21 23:57:16 CET [2021/08/21 17:57:16 ET]
Table 'Halley' 6-max Seat #1 is the button
Seat 1: estelionat171 ($0.80 in chips) 
Seat 2: ulisessoria ($2.16 in chips) 
Seat 3: Razmenchic ($4.83 in chips) 
Seat 4: Stasilo21 ($2.12 in chips) 
Seat 5: pipecmolodec ($2.02 in chips) 
Seat 6: Scaaalll ($6.16 in chips) 
ulisessoria: posts small blind $0.01
Razmenchic: posts big blind $0.02
*** HOLE CARDS ***
Dealt to Scaaalll [2c 8c]
Stasilo21: folds 
pipecmolodec: folds 
Scaaalll: folds 
estelionat171: folds 
ulisessoria: raises $0.04 to $0.06
Razmenchic: folds 
Uncalled bet ($0.04) returned to ulisessoria
ulisessoria collected $0.04 from pot
ulisessoria: doesn't show hand 
*** SUMMARY ***
Total pot $0.04 | Rake $0 
Seat 1: estelionat171 (button) folded before Flop (didn't bet)
Seat 2: ulisessoria (small blind) collected ($0.04)
Seat 3: Razmenchic (big blind) folded before Flop
Seat 4: Stasilo21 folded before Flop (didn't bet)
Seat 5: pipecmolodec folded before Flop (didn't bet)
Seat 6: Scaaalll folded before Flop (didn't bet)



PokerStars Zoom Hand #229234091999:  Hold'em No Limit ($0.01/$0.02) - 2021/08/21 23:57:23 CET [2021/08/21 17:57:23 ET]
Table 'Halley' 6-max Seat #1 is the button
Seat 1: SW579 ($1.61 in chips) 
Seat 2: prosto lili ($0.33 in chips) 
Seat 3: Treadero ($4.42 in chips) 
Seat 4: Scaaalll ($6.16 in chips) 
Seat 5: tarogame ($3.75 in chips) 
Seat 6: Dost_M_1 ($2.20 in chips) 
prosto lili: posts small blind $0.01
Treadero: posts big blind $0.02
*** HOLE CARDS ***
Dealt to Scaaalll [Jc Qh]
Scaaalll has timed out
Scaaalll: folds 
tarogame: raises $0.03 to $0.05
Dost_M_1: folds 
SW579: calls $0.05
prosto lili: folds 
Treadero: raises $0.11 to $0.16
SW579 is disconnected 
tarogame: folds 
SW579: folds 
Uncalled bet ($0.11) returned to Treadero
Treadero collected $0.16 from pot
Treadero: doesn't show hand 
*** SUMMARY ***
Total pot $0.16 | Rake $0 
Seat 1: SW579 (button) folded before Flop
Seat 2: prosto lili (small blind) folded before Flop
Seat 3: Treadero (big blind) collected ($0.16)
Seat 4: Scaaalll folded before Flop (didn't bet)
Seat 5: tarogame folded before Flop
Seat 6: Dost_M_1 folded before Flop (didn't bet)



PokerStars Zoom Hand #229234108928:  Hold'em No Limit ($0.01/$0.02) - 2021/08/21 23:58:20 CET [2021/08/21 17:58:20 ET]
Table 'Halley' 6-max Seat #1 is the button
Seat 1: RaulacateFolds ($2 in chips) 
Seat 2: estelionat171 ($0.35 in chips) 
Seat 3: Scaaalll ($6.16 in chips) 
Seat 4: Nikalians ($2.79 in chips) 
Seat 5: gaturamard ($3.36 in chips) 
Seat 6: hallowed_0 ($2.03 in chips) 
estelionat171: posts small blind $0.01
Scaaalll: posts big blind $0.02
*** HOLE CARDS ***
Dealt to Scaaalll [3d 2s]
Nikalians: folds 
gaturamard: folds 
hallowed_0: raises $0.02 to $0.04
RaulacateFolds: folds 
estelionat171: folds 
Scaaalll: folds 
Uncalled bet ($0.02) returned to hallowed_0
hallowed_0 collected $0.05 from pot
hallowed_0: doesn't show hand 
*** SUMMARY ***
Total pot $0.05 | Rake $0 
Seat 1: RaulacateFolds (button) folded before Flop (didn't bet)
Seat 2: estelionat171 (small blind) folded before Flop
Seat 3: Scaaalll (big blind) folded before Flop
Seat 4: Nikalians folded before Flop (didn't bet)
Seat 5: gaturamard folded before Flop (didn't bet)
Seat 6: hallowed_0 collected ($0.05)



PokerStars Zoom Hand #229234114661:  Hold'em No Limit ($0.01/$0.02) - 2021/08/21 23:58:39 CET [2021/08/21 17:58:39 ET]
Table 'Halley' 6-max Seat #1 is the button
Seat 1: Scaaalll ($6.14 in chips) 
Seat 2: Reipinguimm ($2.09 in chips) 
Seat 3: DocAcid ($1 in chips) 
Seat 4: tarogame ($2.91 in chips) 
Seat 5: Fedor_Gar ($4.61 in chips) 
Seat 6: AtZ3899 ($1.99 in chips) 
Reipinguimm: posts small blind $0.01
DocAcid: posts big blind $0.02
*** HOLE CARDS ***
Dealt to Scaaalll [2s Qc]
tarogame: folds 
Fedor_Gar: folds 
AtZ3899: folds 
Scaaalll: folds 
Reipinguimm: folds 
Uncalled bet ($0.01) returned to DocAcid
DocAcid collected $0.02 from pot
DocAcid: doesn't show hand 
*** SUMMARY ***
Total pot $0.02 | Rake $0 
Seat 1: Scaaalll (button) folded before Flop (didn't bet)
Seat 2: Reipinguimm (small blind) folded before Flop
Seat 3: DocAcid (big blind) collected ($0.02)
Seat 4: tarogame folded before Flop (didn't bet)
Seat 5: Fedor_Gar folded before Flop (didn't bet)
Seat 6: AtZ3899 folded before Flop (didn't bet)



PokerStars Zoom Hand #229234115851:  Hold'em No Limit ($0.01/$0.02) - 2021/08/21 23:58:43 CET [2021/08/21 17:58:43 ET]
Table 'Halley' 6-max Seat #1 is the button
Seat 1: STE1NBERG ($5.39 in chips) 
Seat 2: Scaaalll ($6.14 in chips) 
Seat 3: Demidov V.S. ($2.73 in chips) 
Seat 4: rpycmbEM ($4.22 in chips) 
Seat 5: downwithbdp ($1.19 in chips) 
Seat 6: Pizotifen ($2.37 in chips) 
Scaaalll: posts small blind $0.01
Demidov V.S.: posts big blind $0.02
*** HOLE CARDS ***
Dealt to Scaaalll [7h 8c]
rpycmbEM: folds 
downwithbdp: folds 
Pizotifen: folds 
STE1NBERG: raises $0.03 to $0.05
Scaaalll: folds 
Demidov V.S.: folds 
Uncalled bet ($0.03) returned to STE1NBERG
STE1NBERG collected $0.05 from pot
STE1NBERG: doesn't show hand 
Demidov V.S. is disconnected 
*** SUMMARY ***
Total pot $0.05 | Rake $0 
Seat 1: STE1NBERG (button) collected ($0.05)
Seat 2: Scaaalll (small blind) folded before Flop
Seat 3: Demidov V.S. (big blind) folded before Flop
Seat 4: rpycmbEM folded before Flop (didn't bet)
Seat 5: downwithbdp folded before Flop (didn't bet)
Seat 6: Pizotifen folded before Flop (didn't bet)



PokerStars Zoom Hand #229234117041:  Hold'em No Limit ($0.01/$0.02) - 2021/08/21 23:58:47 CET [2021/08/21 17:58:47 ET]
Table 'Halley' 6-max Seat #1 is the button
Seat 1: Gamer577 ($4.71 in chips) 
Seat 2: bt710 ($5.22 in chips) 
Seat 3: DaniilF43 ($1.03 in chips) 
Seat 4: Pizotifen ($2.37 in chips) 
Seat 5: Scaaalll ($6.13 in chips) 
Seat 6: rodrigoasor ($2.72 in chips) 
bt710: posts small blind $0.01
DaniilF43: posts big blind $0.02
*** HOLE CARDS ***
Dealt to Scaaalll [9h 5d]
Pizotifen: raises $0.04 to $0.06
Scaaalll: folds 
rodrigoasor: folds 
Gamer577: folds 
bt710: folds 
DaniilF43: raises $0.13 to $0.19
Pizotifen: folds 
Uncalled bet ($0.13) returned to DaniilF43
DaniilF43 collected $0.13 from pot
DaniilF43: doesn't show hand 
*** SUMMARY ***
Total pot $0.13 | Rake $0 
Seat 1: Gamer577 (button) folded before Flop (didn't bet)
Seat 2: bt710 (small blind) folded before Flop
Seat 3: DaniilF43 (big blind) collected ($0.13)
Seat 4: Pizotifen folded before Flop
Seat 5: Scaaalll folded before Flop (didn't bet)
Seat 6: rodrigoasor folded before Flop (didn't bet)



PokerStars Zoom Hand #229234113482:  Hold'em No Limit ($0.01/$0.02) - 2021/08/21 23:58:35 CET [2021/08/21 17:58:35 ET]
Table 'Halley' 6-max Seat #1 is the button
Seat 1: sg.32rus ($1.14 in chips) 
Seat 2: KonopDima ($2.09 in chips) 
Seat 3: Gamer577 ($3.60 in chips) 
Seat 4: Doktor Yes ($2.39 in chips) 
Seat 5: kevzz0223 ($1.91 in chips) 
Seat 6: Scaaalll ($6.14 in chips) 
KonopDima: posts small blind $0.01
Gamer577: posts big blind $0.02
*** HOLE CARDS ***
Dealt to Scaaalll [9d 5h]
Doktor Yes: raises $0.04 to $0.06
kevzz0223: folds 
Scaaalll: folds 
sg.32rus: calls $0.06
KonopDima: folds 
Gamer577: folds 
*** FLOP *** [Kd 6d 9s]
Doktor Yes: bets $0.07
sg.32rus: folds 
Uncalled bet ($0.07) returned to Doktor Yes
Doktor Yes collected $0.14 from pot
Doktor Yes: doesn't show hand 
*** SUMMARY ***
Total pot $0.15 | Rake $0.01 
Board [Kd 6d 9s]
Seat 1: sg.32rus (button) folded on the Flop
Seat 2: KonopDima (small blind) folded before Flop
Seat 3: Gamer577 (big blind) folded before Flop
Seat 4: Doktor Yes collected ($0.14)
Seat 5: kevzz0223 folded before Flop (didn't bet)
Seat 6: Scaaalll folded before Flop (didn't bet)



PokerStars Zoom Hand #229234122199:  Hold'em No Limit ($0.01/$0.02) - 2021/08/21 23:58:56 CET [2021/08/21 17:58:56 ET]
Table 'Halley' 6-max Seat #1 is the button
Seat 1: AtZ3899 ($1.96 in chips) 
Seat 2: Nihility77 ($6.53 in chips) 
Seat 3: pipecmolodec ($2.03 in chips) 
Seat 4: Scaaalll ($6.13 in chips) 
Seat 5: 888lifeIS ($2.17 in chips) 
Seat 6: hallowed_0 ($2.05 in chips) 
Nihility77: posts small blind $0.01
pipecmolodec: posts big blind $0.02
*** HOLE CARDS ***
Dealt to Scaaalll [6d 7d]
Scaaalll: raises $0.04 to $0.06
888lifeIS: folds 
hallowed_0: folds 
AtZ3899: calls $0.06
Nihility77: folds 
pipecmolodec: folds 
*** FLOP *** [8c Ac 8h]
Scaaalll: bets $0.08
AtZ3899: folds 
Uncalled bet ($0.08) returned to Scaaalll
Scaaalll collected $0.14 from pot
Scaaalll: doesn't show hand 
*** SUMMARY ***
Total pot $0.15 | Rake $0.01 
Board [8c Ac 8h]
Seat 1: AtZ3899 (button) folded on the Flop
Seat 2: Nihility77 (small blind) folded before Flop
Seat 3: pipecmolodec (big blind) folded before Flop
Seat 4: Scaaalll collected ($0.14)
Seat 5: 888lifeIS folded before Flop (didn't bet)
Seat 6: hallowed_0 folded before Flop (didn't bet)



PokerStars Zoom Hand #229234128458:  Hold'em No Limit ($0.01/$0.02) - 2021/08/21 23:59:17 CET [2021/08/21 17:59:17 ET]
Table 'Halley' 6-max Seat #1 is the button
Seat 1: newfie2102 ($1.06 in chips) 
Seat 2: gabgordula ($2.13 in chips) 
Seat 3: Scaaalll ($6.21 in chips) 
Seat 4: MattieBOZ ($2.05 in chips) 
Seat 5: kboskov123 ($1.68 in chips) 
Seat 6: byakuda ($2.02 in chips) 
gabgordula: posts small blind $0.01
Scaaalll: posts big blind $0.02
*** HOLE CARDS ***
Dealt to Scaaalll [3c 8s]
MattieBOZ: folds 
kboskov123: folds 
MattieBOZ is disconnected 
byakuda: raises $0.04 to $0.06
newfie2102: folds 
gabgordula: folds 
Scaaalll: folds 
Uncalled bet ($0.04) returned to byakuda
byakuda collected $0.05 from pot
byakuda: doesn't show hand 
*** SUMMARY ***
Total pot $0.05 | Rake $0 
Seat 1: newfie2102 (button) folded before Flop (didn't bet)
Seat 2: gabgordula (small blind) folded before Flop
Seat 3: Scaaalll (big blind) folded before Flop
Seat 4: MattieBOZ folded before Flop (didn't bet)
Seat 5: kboskov123 folded before Flop (didn't bet)
Seat 6: byakuda collected ($0.05)



PokerStars Zoom Hand #229234134383:  Hold'em No Limit ($0.01/$0.02) - 2021/08/21 23:59:37 CET [2021/08/21 17:59:37 ET]
Table 'Halley' 6-max Seat #1 is the button
Seat 1: Xlavariable ($2 in chips) 
Seat 2: estelionat171 ($0.82 in chips) 
Seat 3: Red Sky 15 ($8.07 in chips) 
Seat 4: Scaaalll ($6.19 in chips) 
Seat 5: ancqPRO ($2.04 in chips) 
Seat 6: Dr.stromg ($5.20 in chips) 
estelionat171: posts small blind $0.01
Red Sky 15: posts big blind $0.02
*** HOLE CARDS ***
Dealt to Scaaalll [3c Qh]
Scaaalll: folds 
ancqPRO: folds 
Dr.stromg: folds 
Xlavariable: folds 
estelionat171: folds 
Uncalled bet ($0.01) returned to Red Sky 15
Red Sky 15 collected $0.02 from pot
Red Sky 15: doesn't show hand 
*** SUMMARY ***
Total pot $0.02 | Rake $0 
Seat 1: Xlavariable (button) folded before Flop (didn't bet)
Seat 2: estelionat171 (small blind) folded before Flop
Seat 3: Red Sky 15 (big blind) collected ($0.02)
Seat 4: Scaaalll folded before Flop (didn't bet)
Seat 5: ancqPRO folded before Flop (didn't bet)
Seat 6: Dr.stromg folded before Flop (didn't bet)



PokerStars Zoom Hand #229234136827:  Hold'em No Limit ($0.01/$0.02) - 2021/08/21 23:59:45 CET [2021/08/21 17:59:45 ET]
Table 'Halley' 6-max Seat #1 is the button
Seat 1: NoEff0rt2w1n ($5.89 in chips) 
Seat 2: Scaaalll ($6.19 in chips) 
Seat 3: danteesq ($2.23 in chips) 
Seat 4: thekidisnuts ($4.32 in chips) 
Seat 5: isurusa ($5.94 in chips) 
Seat 6: Pere Ubu ($1.64 in chips) 
Scaaalll: posts small blind $0.01
danteesq: posts big blind $0.02
*** HOLE CARDS ***
Dealt to Scaaalll [4c 6d]
Pere Ubu is disconnected 
thekidisnuts: folds 
isurusa: folds 
Pere Ubu: folds 
NoEff0rt2w1n: folds 
Scaaalll: folds 
Uncalled bet ($0.01) returned to danteesq
danteesq collected $0.02 from pot
danteesq: doesn't show hand 
*** SUMMARY ***
Total pot $0.02 | Rake $0 
Seat 1: NoEff0rt2w1n (button) folded before Flop (didn't bet)
Seat 2: Scaaalll (small blind) folded before Flop
Seat 3: danteesq (big blind) collected ($0.02)
Seat 4: thekidisnuts folded before Flop (didn't bet)
Seat 5: isurusa folded before Flop (didn't bet)
Seat 6: Pere Ubu folded before Flop (didn't bet)



PokerStars Zoom Hand #229234133244:  Hold'em No Limit ($0.01/$0.02) - 2021/08/21 23:59:33 CET [2021/08/21 17:59:33 ET]
Table 'Halley' 6-max Seat #1 is the button
Seat 1: lucky1529 ($0.98 in chips) 
Seat 2: spirosz1000 ($2.23 in chips) 
Seat 3: MattieBOZ ($1.65 in chips) 
Seat 4: Scaaalll ($6.19 in chips) 
Seat 5: hallowed_0 ($3.45 in chips) 
Seat 6: ctaceo ($2.23 in chips) 
spirosz1000: posts small blind $0.01
MattieBOZ: posts big blind $0.02
*** HOLE CARDS ***
Dealt to Scaaalll [7h 5d]
Scaaalll: folds 
hallowed_0: folds 
ctaceo: folds 
lucky1529: folds 
spirosz1000: raises $0.04 to $0.06
MattieBOZ: folds 
Uncalled bet ($0.04) returned to spirosz1000
spirosz1000 collected $0.04 from pot
spirosz1000: doesn't show hand 
MattieBOZ is disconnected 
*** SUMMARY ***
Total pot $0.04 | Rake $0 
Seat 1: lucky1529 (button) folded before Flop (didn't bet)
Seat 2: spirosz1000 (small blind) collected ($0.04)
Seat 3: MattieBOZ (big blind) folded before Flop
Seat 4: Scaaalll folded before Flop (didn't bet)
Seat 5: hallowed_0 folded before Flop (didn't bet)
Seat 6: ctaceo folded before Flop (didn't bet)



PokerStars Zoom Hand #229234140100:  Hold'em No Limit ($0.01/$0.02) - 2021/08/21 23:59:55 CET [2021/08/21 17:59:55 ET]
Table 'Halley' 6-max Seat #1 is the button
Seat 1: Scaaalll ($6.18 in chips) 
Seat 2: Jmapih ($2.34 in chips) 
Seat 3: adrianh2002 ($2.29 in chips) 
Seat 4: ash1448 ($11.69 in chips) 
Seat 5: nbarreiro021 ($2.10 in chips) 
Seat 6: KonopDima ($2 in chips) 
Jmapih: posts small blind $0.01
adrianh2002: posts big blind $0.02
*** HOLE CARDS ***
Dealt to Scaaalll [Ac Kh]
ash1448: folds 
nbarreiro021: folds 
KonopDima: folds 
Scaaalll: raises $0.03 to $0.05
Jmapih: folds 
adrianh2002: folds 
Uncalled bet ($0.03) returned to Scaaalll
Scaaalll collected $0.05 from pot
Scaaalll: doesn't show hand 
*** SUMMARY ***
Total pot $0.05 | Rake $0 
Seat 1: Scaaalll (button) collected ($0.05)
Seat 2: Jmapih (small blind) folded before Flop
Seat 3: adrianh2002 (big blind) folded before Flop
Seat 4: ash1448 folded before Flop (didn't bet)
Seat 5: nbarreiro021 folded before Flop (didn't bet)
Seat 6: KonopDima folded before Flop (didn't bet)



PokerStars Zoom Hand #229234146347:  Hold'em No Limit ($0.01/$0.02) - 2021/08/22 0:00:15 CET [2021/08/21 18:00:15 ET]
Table 'Halley' 6-max Seat #1 is the button
Seat 1: Scaaalll ($6.21 in chips) 
Seat 2: SHALOMandKAT ($0.40 in chips) 
Seat 3: RageReaperf ($2.02 in chips) 
Seat 4: egroj1700 ($2 in chips) 
Seat 5: adrianh2002 ($2.27 in chips) 
Seat 6: SKV_1985 ($3.62 in chips) 
SHALOMandKAT: posts small blind $0.01
RageReaperf: posts big blind $0.02
*** HOLE CARDS ***
Dealt to Scaaalll [Th 9d]
egroj1700: folds 
adrianh2002: folds 
SKV_1985: folds 
Scaaalll: raises $0.02 to $0.04
SHALOMandKAT: raises $0.36 to $0.40 and is all-in
RageReaperf: folds 
Scaaalll: folds 
Uncalled bet ($0.36) returned to SHALOMandKAT
SHALOMandKAT collected $0.10 from pot
SHALOMandKAT: doesn't show hand 
*** SUMMARY ***
Total pot $0.10 | Rake $0 
Seat 1: Scaaalll (button) folded before Flop
Seat 2: SHALOMandKAT (small blind) collected ($0.10)
Seat 3: RageReaperf (big blind) folded before Flop
Seat 4: egroj1700 folded before Flop (didn't bet)
Seat 5: adrianh2002 folded before Flop (didn't bet)
Seat 6: SKV_1985 folded before Flop (didn't bet)



PokerStars Zoom Hand #229234152392:  Hold'em No Limit ($0.01/$0.02) - 2021/08/22 0:00:34 CET [2021/08/21 18:00:34 ET]
Table 'Halley' 6-max Seat #1 is the button
Seat 1: Gamer577 ($3.73 in chips) 
Seat 2: robbie_cox ($2.49 in chips) 
Seat 3: Scaaalll ($6.17 in chips) 
Seat 4: young25stars ($2.37 in chips) 
Seat 5: MajestickVladi ($1.42 in chips) 
Seat 6: Sergio Rigel ($2.31 in chips) 
robbie_cox: posts small blind $0.01
Scaaalll: posts big blind $0.02
*** HOLE CARDS ***
Dealt to Scaaalll [7d Th]
young25stars: calls $0.02
MajestickVladi: folds 
Sergio Rigel: folds 
Gamer577: folds 
robbie_cox: folds 
robbie_cox is disconnected 
Scaaalll: checks 
*** FLOP *** [8s Qs Tc]
Scaaalll: checks 
young25stars: bets $0.05
Scaaalll: folds 
Uncalled bet ($0.05) returned to young25stars
young25stars collected $0.05 from pot
young25stars: doesn't show hand 
*** SUMMARY ***
Total pot $0.05 | Rake $0 
Board [8s Qs Tc]
Seat 1: Gamer577 (button) folded before Flop (didn't bet)
Seat 2: robbie_cox (small blind) folded before Flop
Seat 3: Scaaalll (big blind) folded on the Flop
Seat 4: young25stars collected ($0.05)
Seat 5: MajestickVladi folded before Flop (didn't bet)
Seat 6: Sergio Rigel folded before Flop (didn't bet)



PokerStars Zoom Hand #229234169313:  Hold'em No Limit ($0.01/$0.02) - 2021/08/22 0:01:23 CET [2021/08/21 18:01:23 ET]
Table 'Halley' 6-max Seat #1 is the button
Seat 1: Bina_sweety ($2.89 in chips) 
Seat 2: Jmapih ($2.14 in chips) 
Seat 3: zergmiky ($2 in chips) 
Seat 4: MajestickVladi ($1.53 in chips) 
Seat 5: Scaaalll ($6.15 in chips) 
Seat 6: vovan100157 ($3.09 in chips) 
Jmapih: posts small blind $0.01
zergmiky: posts big blind $0.02
*** HOLE CARDS ***
Dealt to Scaaalll [Td Qs]
MajestickVladi: folds 
Scaaalll: folds 
vovan100157: folds 
Bina_sweety: folds 
Jmapih: folds 
Uncalled bet ($0.01) returned to zergmiky
zergmiky collected $0.02 from pot
zergmiky: doesn't show hand 
*** SUMMARY ***
Total pot $0.02 | Rake $0 
Seat 1: Bina_sweety (button) folded before Flop (didn't bet)
Seat 2: Jmapih (small blind) folded before Flop
Seat 3: zergmiky (big blind) collected ($0.02)
Seat 4: MajestickVladi folded before Flop (didn't bet)
Seat 5: Scaaalll folded before Flop (didn't bet)
Seat 6: vovan100157 folded before Flop (didn't bet)



PokerStars Zoom Hand #229234162596:  Hold'em No Limit ($0.01/$0.02) - 2021/08/22 0:01:04 CET [2021/08/21 18:01:04 ET]
Table 'Halley' 6-max Seat #1 is the button
Seat 1: fabianhn504 ($0.38 in chips) 
Seat 2: Stasilo21 ($2.02 in chips) 
Seat 3: fujita_kyo ($2.27 in chips) 
Seat 4: 1984gonzo33 ($1.98 in chips) 
Seat 5: jeroninho ($1.65 in chips) 
Seat 6: Scaaalll ($6.15 in chips) 
Stasilo21: posts small blind $0.01
fujita_kyo: posts big blind $0.02
*** HOLE CARDS ***
Dealt to Scaaalll [8s 2s]
1984gonzo33: folds 
jeroninho: folds 
1984gonzo33 is disconnected 
Scaaalll: folds 
fabianhn504: raises $0.04 to $0.06
Stasilo21: raises $0.12 to $0.18
fujita_kyo: folds 
fabianhn504: raises $0.12 to $0.30
Stasilo21: calls $0.12
*** FLOP *** [5s 7s 6d]
Stasilo21: checks 
fabianhn504: bets $0.08 and is all-in
Stasilo21: calls $0.08
*** TURN *** [5s 7s 6d] [9s]
*** RIVER *** [5s 7s 6d 9s] [5c]
*** SHOW DOWN ***
Stasilo21: shows [Jh Jc] (two pair, Jacks and Fives)
fabianhn504: shows [Ac 6c] (two pair, Sixes and Fives)
Stasilo21 collected $0.75 from pot
*** SUMMARY ***
Total pot $0.78 | Rake $0.03 
Board [5s 7s 6d 9s 5c]
Seat 1: fabianhn504 (button) showed [Ac 6c] and lost with two pair, Sixes and Fives
Seat 2: Stasilo21 (small blind) showed [Jh Jc] and won ($0.75) with two pair, Jacks and Fives
Seat 3: fujita_kyo (big blind) folded before Flop
Seat 4: 1984gonzo33 folded before Flop (didn't bet)
Seat 5: jeroninho folded before Flop (didn't bet)
Seat 6: Scaaalll folded before Flop (didn't bet)



PokerStars Zoom Hand #229234165896:  Hold'em No Limit ($0.01/$0.02) - 2021/08/22 0:01:13 CET [2021/08/21 18:01:13 ET]
Table 'Halley' 6-max Seat #1 is the button
Seat 1: 888lifeIS ($2.02 in chips) 
Seat 2: nagibatorali ($0.78 in chips) 
Seat 3: carlomagno ($2.23 in chips) 
Seat 4: PapiMik3 ($2.03 in chips) 
Seat 5: Scaaalll ($6.15 in chips) 
Seat 6: ladypoker77 ($1.88 in chips) 
nagibatorali: posts small blind $0.01
carlomagno: posts big blind $0.02
*** HOLE CARDS ***
Dealt to Scaaalll [4d Jc]
nagibatorali is disconnected 
PapiMik3: raises $0.04 to $0.06
Scaaalll: folds 
ladypoker77: raises $0.10 to $0.16
888lifeIS: folds 
nagibatorali: folds 
carlomagno: folds 
PapiMik3: calls $0.10
*** FLOP *** [9s 3d 2d]
PapiMik3: checks 
ladypoker77: bets $0.18
PapiMik3: calls $0.18
*** TURN *** [9s 3d 2d] [Qd]
PapiMik3: checks 
ladypoker77: bets $0.35
PapiMik3: folds 
Uncalled bet ($0.35) returned to ladypoker77
ladypoker77 collected $0.69 from pot
ladypoker77: doesn't show hand 
*** SUMMARY ***
Total pot $0.71 | Rake $0.02 
Board [9s 3d 2d Qd]
Seat 1: 888lifeIS (button) folded before Flop (didn't bet)
Seat 2: nagibatorali (small blind) folded before Flop
Seat 3: carlomagno (big blind) folded before Flop
Seat 4: PapiMik3 folded on the Turn
Seat 5: Scaaalll folded before Flop (didn't bet)
Seat 6: ladypoker77 collected ($0.69)



PokerStars Zoom Hand #229234171453:  Hold'em No Limit ($0.01/$0.02) - 2021/08/22 0:01:29 CET [2021/08/21 18:01:29 ET]
Table 'Halley' 6-max Seat #1 is the button
Seat 1: 888lifeIS ($2.13 in chips) 
Seat 2: Scaaalll ($6.15 in chips) 
Seat 3: Pechorin.G ($3.62 in chips) 
Seat 4: disanddowny ($1.73 in chips) 
Seat 5: hallowed_0 ($2.16 in chips) 
Seat 6: SchinkenToni ($0.41 in chips) 
Scaaalll: posts small blind $0.01
Pechorin.G: posts big blind $0.02
*** HOLE CARDS ***
Dealt to Scaaalll [9h 8h]
disanddowny: folds 
hallowed_0: folds 
SchinkenToni: raises $0.02 to $0.04
888lifeIS: folds 
Scaaalll: calls $0.03
Pechorin.G: calls $0.02
*** FLOP *** [Ks 2h 6d]
Scaaalll: checks 
Pechorin.G: checks 
SchinkenToni: bets $0.37 and is all-in
Scaaalll: folds 
Pechorin.G: folds 
Uncalled bet ($0.37) returned to SchinkenToni
SchinkenToni collected $0.12 from pot
SchinkenToni: doesn't show hand 
*** SUMMARY ***
Total pot $0.12 | Rake $0 
Board [Ks 2h 6d]
Seat 1: 888lifeIS (button) folded before Flop (didn't bet)
Seat 2: Scaaalll (small blind) folded on the Flop
Seat 3: Pechorin.G (big blind) folded on the Flop
Seat 4: disanddowny folded before Flop (didn't bet)
Seat 5: hallowed_0 folded before Flop (didn't bet)
Seat 6: SchinkenToni collected ($0.12)



PokerStars Zoom Hand #229234192688:  Hold'em No Limit ($0.01/$0.02) - 2021/08/22 0:02:08 CET [2021/08/21 18:02:08 ET]
Table 'Halley' 6-max Seat #1 is the button
Seat 1: PaddyPoland ($2.88 in chips) 
Seat 2: Marcus579 ($2.02 in chips) 
Seat 3: Ser1ozha ($3.08 in chips) 
Seat 4: baddbeat4fun ($2 in chips) 
Seat 5: hustlehero ($3.79 in chips) 
Seat 6: Scaaalll ($6.11 in chips) 
Marcus579: posts small blind $0.01
Ser1ozha: posts big blind $0.02
*** HOLE CARDS ***
Dealt to Scaaalll [5s Th]
baddbeat4fun: folds 
hustlehero: folds 
Scaaalll: folds 
PaddyPoland: raises $0.03 to $0.05
Marcus579: calls $0.04
Ser1ozha: folds 
*** FLOP *** [4c Tc 2c]
Marcus579: checks 
PaddyPoland: bets $0.07
Marcus579: folds 
Uncalled bet ($0.07) returned to PaddyPoland
PaddyPoland collected $0.12 from pot
PaddyPoland: doesn't show hand 
*** SUMMARY ***
Total pot $0.12 | Rake $0 
Board [4c Tc 2c]
Seat 1: PaddyPoland (button) collected ($0.12)
Seat 2: Marcus579 (small blind) folded on the Flop
Seat 3: Ser1ozha (big blind) folded before Flop
Seat 4: baddbeat4fun folded before Flop (didn't bet)
Seat 5: hustlehero folded before Flop (didn't bet)
Seat 6: Scaaalll folded before Flop (didn't bet)



