PokerStars Zoom Hand #229231005683:  Hold'em No Limit ($0.01/$0.02) - 2021/08/21 21:57:31 CET [2021/08/21 15:57:31 ET]
Table 'Halley' 6-max Seat #1 is the button
Seat 1: Forest404 ($4.21 in chips) 
Seat 2: usenovm ($2.03 in chips) 
Seat 3: Scaaalll ($2 in chips) 
Seat 4: LuckyCheewey ($1.99 in chips) 
Seat 5: shingo594 ($2.33 in chips) 
Seat 6: BARDICHExSIN ($1.67 in chips) 
usenovm: posts small blind $0.01
Scaaalll: posts big blind $0.02
*** HOLE CARDS ***
Dealt to Scaaalll [7c 7s]
LuckyCheewey: folds 
shingo594: folds 
shingo594 is disconnected 
BARDICHExSIN: raises $0.04 to $0.06
Forest404: folds 
usenovm: folds 
Scaaalll: calls $0.04
*** FLOP *** [Jd 2s 3d]
Scaaalll: checks 
BARDICHExSIN: bets $0.08
Scaaalll: calls $0.08
*** TURN *** [Jd 2s 3d] [9d]
Scaaalll: checks 
BARDICHExSIN: bets $0.10
Scaaalll: folds 
Uncalled bet ($0.10) returned to BARDICHExSIN
BARDICHExSIN collected $0.28 from pot
BARDICHExSIN: doesn't show hand 
*** SUMMARY ***
Total pot $0.29 | Rake $0.01 
Board [Jd 2s 3d 9d]
Seat 1: Forest404 (button) folded before Flop (didn't bet)
Seat 2: usenovm (small blind) folded before Flop
Seat 3: Scaaalll (big blind) folded on the Turn
Seat 4: LuckyCheewey folded before Flop (didn't bet)
Seat 5: shingo594 folded before Flop (didn't bet)
Seat 6: BARDICHExSIN collected ($0.28)



PokerStars Zoom Hand #229231015770:  Hold'em No Limit ($0.01/$0.02) - 2021/08/21 21:58:03 CET [2021/08/21 15:58:03 ET]
Table 'Halley' 6-max Seat #1 is the button
Seat 1: Scaaalll ($2 in chips) 
Seat 2: felipeciji ($2.24 in chips) 
Seat 3: Blaackie ($2 in chips) 
Seat 4: maaitee ($2 in chips) 
Seat 5: Gerar NB ($2.06 in chips) 
Seat 6: BigTestIcicle ($1.14 in chips) 
felipeciji: posts small blind $0.01
Blaackie: posts big blind $0.02
*** HOLE CARDS ***
Dealt to Scaaalll [Qh 8s]
maaitee: folds 
Gerar NB: folds 
BigTestIcicle: raises $0.04 to $0.06
Scaaalll: folds 
felipeciji: folds 
Blaackie: raises $0.16 to $0.22
BigTestIcicle: folds 
Uncalled bet ($0.16) returned to Blaackie
Blaackie collected $0.13 from pot
Blaackie: doesn't show hand 
*** SUMMARY ***
Total pot $0.13 | Rake $0 
Seat 1: Scaaalll (button) folded before Flop (didn't bet)
Seat 2: felipeciji (small blind) folded before Flop
Seat 3: Blaackie (big blind) collected ($0.13)
Seat 4: maaitee folded before Flop (didn't bet)
Seat 5: Gerar NB folded before Flop (didn't bet)
Seat 6: BigTestIcicle folded before Flop



PokerStars Zoom Hand #229231019242:  Hold'em No Limit ($0.01/$0.02) - 2021/08/21 21:58:14 CET [2021/08/21 15:58:14 ET]
Table 'Halley' 6-max Seat #1 is the button
Seat 1: SaRCh_Ale ($1.47 in chips) 
Seat 2: Scaaalll ($2 in chips) 
Seat 3: hubertott ($2.13 in chips) 
Seat 4: pphit ($2.11 in chips) 
Seat 5: romul795 ($0.52 in chips) 
Seat 6: sg.32rus ($1.36 in chips) 
Scaaalll: posts small blind $0.01
hubertott: posts big blind $0.02
*** HOLE CARDS ***
Dealt to Scaaalll [9h 7h]
pphit: folds 
romul795: folds 
sg.32rus: folds 
SaRCh_Ale: folds 
romul795 is disconnected 
Scaaalll: raises $0.04 to $0.06
hubertott: folds 
Uncalled bet ($0.04) returned to Scaaalll
Scaaalll collected $0.04 from pot
Scaaalll: doesn't show hand 
*** SUMMARY ***
Total pot $0.04 | Rake $0 
Seat 1: SaRCh_Ale (button) folded before Flop (didn't bet)
Seat 2: Scaaalll (small blind) collected ($0.04)
Seat 3: hubertott (big blind) folded before Flop
Seat 4: pphit folded before Flop (didn't bet)
Seat 5: romul795 folded before Flop (didn't bet)
Seat 6: sg.32rus folded before Flop (didn't bet)



PokerStars Zoom Hand #229231027135:  Hold'em No Limit ($0.01/$0.02) - 2021/08/21 21:58:39 CET [2021/08/21 15:58:39 ET]
Table 'Halley' 6-max Seat #1 is the button
Seat 1: IWMTW ($0.54 in chips) 
Seat 2: Oprichnick90 ($4.03 in chips) 
Seat 3: Chupacabra G ($1.94 in chips) 
Seat 4: HDYD18 ($2.21 in chips) 
Seat 5: sg.32rus ($0.83 in chips) 
Seat 6: Scaaalll ($2.02 in chips) 
Oprichnick90: posts small blind $0.01
Chupacabra G: posts big blind $0.02
*** HOLE CARDS ***
Dealt to Scaaalll [Ad 3h]
HDYD18: folds 
sg.32rus: raises $0.02 to $0.04
Scaaalll: folds 
IWMTW: folds 
Oprichnick90: raises $0.14 to $0.18
Chupacabra G: folds 
sg.32rus: folds 
Uncalled bet ($0.14) returned to Oprichnick90
Oprichnick90 collected $0.10 from pot
Oprichnick90: doesn't show hand 
*** SUMMARY ***
Total pot $0.10 | Rake $0 
Seat 1: IWMTW (button) folded before Flop (didn't bet)
Seat 2: Oprichnick90 (small blind) collected ($0.10)
Seat 3: Chupacabra G (big blind) folded before Flop
Seat 4: HDYD18 folded before Flop (didn't bet)
Seat 5: sg.32rus folded before Flop
Seat 6: Scaaalll folded before Flop (didn't bet)



PokerStars Zoom Hand #229231029970:  Hold'em No Limit ($0.01/$0.02) - 2021/08/21 21:58:48 CET [2021/08/21 15:58:48 ET]
Table 'Halley' 6-max Seat #1 is the button
Seat 1: Pechorin.G ($2.17 in chips) 
Seat 2: Kreodont1987 ($5.27 in chips) 
Seat 3: ppluiaule ($2.34 in chips) 
Seat 4: dkno77 ($2.44 in chips) 
Seat 5: OGTripleOG247 ($1.80 in chips) 
Seat 6: Scaaalll ($2.02 in chips) 
Kreodont1987: posts small blind $0.01
ppluiaule: posts big blind $0.02
*** HOLE CARDS ***
Dealt to Scaaalll [7d Js]
dkno77: folds 
OGTripleOG247: folds 
Scaaalll: folds 
Pechorin.G: folds 
Kreodont1987: folds 
Uncalled bet ($0.01) returned to ppluiaule
ppluiaule collected $0.02 from pot
ppluiaule: doesn't show hand 
*** SUMMARY ***
Total pot $0.02 | Rake $0 
Seat 1: Pechorin.G (button) folded before Flop (didn't bet)
Seat 2: Kreodont1987 (small blind) folded before Flop
Seat 3: ppluiaule (big blind) collected ($0.02)
Seat 4: dkno77 folded before Flop (didn't bet)
Seat 5: OGTripleOG247 folded before Flop (didn't bet)
Seat 6: Scaaalll folded before Flop (didn't bet)



PokerStars Zoom Hand #229231033730:  Hold'em No Limit ($0.01/$0.02) - 2021/08/21 21:59:00 CET [2021/08/21 15:59:00 ET]
Table 'Halley' 6-max Seat #1 is the button
Seat 1: maressen ($4.64 in chips) 
Seat 2: DaBaDaBaDooo ($2.13 in chips) 
Seat 3: Scaaalll ($2.01 in chips) 
Seat 4: Larson_mfk ($0.83 in chips) 
Seat 5: malandro733 ($2 in chips) 
Seat 6: alecha11 ($2.77 in chips) 
DaBaDaBaDooo: posts small blind $0.01
Scaaalll: posts big blind $0.02
*** HOLE CARDS ***
Dealt to Scaaalll [4c 9c]
Larson_mfk: folds 
malandro733: folds 
Larson_mfk is disconnected 
alecha11: folds 
maressen: raises $0.03 to $0.05
DaBaDaBaDooo: folds 
Scaaalll: folds 
Uncalled bet ($0.03) returned to maressen
maressen collected $0.05 from pot
maressen: doesn't show hand 
*** SUMMARY ***
Total pot $0.05 | Rake $0 
Seat 1: maressen (button) collected ($0.05)
Seat 2: DaBaDaBaDooo (small blind) folded before Flop
Seat 3: Scaaalll (big blind) folded before Flop
Seat 4: Larson_mfk folded before Flop (didn't bet)
Seat 5: malandro733 folded before Flop (didn't bet)
Seat 6: alecha11 folded before Flop (didn't bet)



PokerStars Zoom Hand #229231031848:  Hold'em No Limit ($0.01/$0.02) - 2021/08/21 21:58:54 CET [2021/08/21 15:58:54 ET]
Table 'Halley' 6-max Seat #1 is the button
Seat 1: artbiart ($0.61 in chips) 
Seat 2: Scaaalll ($2.02 in chips) 
Seat 3: S.P.S...99 ($2 in chips) 
Seat 4: zbixxx ($4.85 in chips) 
Seat 5: ARTMVSLV ($2.17 in chips) 
Seat 6: rodrigoaduar ($0.94 in chips) 
Scaaalll: posts small blind $0.01
S.P.S...99: posts big blind $0.02
*** HOLE CARDS ***
Dealt to Scaaalll [Kd 4d]
zbixxx: folds 
ARTMVSLV: folds 
rodrigoaduar: calls $0.02
artbiart: folds 
Scaaalll: folds 
S.P.S...99: checks 
*** FLOP *** [4c 6c 3c]
S.P.S...99: checks 
rodrigoaduar: bets $0.05
S.P.S...99: calls $0.05
*** TURN *** [4c 6c 3c] [Ad]
S.P.S...99: checks 
rodrigoaduar: checks 
*** RIVER *** [4c 6c 3c Ad] [2s]
S.P.S...99: bets $0.14
rodrigoaduar: calls $0.14
*** SHOW DOWN ***
S.P.S...99: shows [8c Tc] (a flush, Ten high)
rodrigoaduar: mucks hand 
S.P.S...99 collected $0.41 from pot
*** SUMMARY ***
Total pot $0.43 | Rake $0.02 
Board [4c 6c 3c Ad 2s]
Seat 1: artbiart (button) folded before Flop (didn't bet)
Seat 2: Scaaalll (small blind) folded before Flop
Seat 3: S.P.S...99 (big blind) showed [8c Tc] and won ($0.41) with a flush, Ten high
Seat 4: zbixxx folded before Flop (didn't bet)
Seat 5: ARTMVSLV folded before Flop (didn't bet)
Seat 6: rodrigoaduar mucked [Ah 3s]



PokerStars Zoom Hand #229231043371:  Hold'em No Limit ($0.01/$0.02) - 2021/08/21 21:59:30 CET [2021/08/21 15:59:30 ET]
Table 'Halley' 6-max Seat #1 is the button
Seat 1: Alfmasterrr ($2.11 in chips) 
Seat 2: Chapaev136 ($1.69 in chips) 
Seat 3: FicheroQuit ($2.72 in chips) 
Seat 4: Tabitaji ($2 in chips) 
Seat 5: Scaaalll ($2 in chips) 
Seat 6: zielony ($2.34 in chips) 
Chapaev136: posts small blind $0.01
FicheroQuit: posts big blind $0.02
*** HOLE CARDS ***
Dealt to Scaaalll [Js 2d]
Tabitaji: folds 
Scaaalll: folds 
zielony: folds 
Alfmasterrr: folds 
Chapaev136: folds 
Uncalled bet ($0.01) returned to FicheroQuit
FicheroQuit collected $0.02 from pot
FicheroQuit: doesn't show hand 
*** SUMMARY ***
Total pot $0.02 | Rake $0 
Seat 1: Alfmasterrr (button) folded before Flop (didn't bet)
Seat 2: Chapaev136 (small blind) folded before Flop
Seat 3: FicheroQuit (big blind) collected ($0.02)
Seat 4: Tabitaji folded before Flop (didn't bet)
Seat 5: Scaaalll folded before Flop (didn't bet)
Seat 6: zielony folded before Flop (didn't bet)



PokerStars Zoom Hand #229231037792:  Hold'em No Limit ($0.01/$0.02) - 2021/08/21 21:59:13 CET [2021/08/21 15:59:13 ET]
Table 'Halley' 6-max Seat #1 is the button
Seat 1: Scaaalll ($2 in chips) 
Seat 2: arrow17 ($2.37 in chips) 
Seat 3: slipknot956 ($3.65 in chips) 
Seat 4: alecha11 ($2.77 in chips) 
Seat 5: Loto70 ($2 in chips) 
Seat 6: meikoz ($3.68 in chips) 
arrow17: posts small blind $0.01
slipknot956: posts big blind $0.02
*** HOLE CARDS ***
Dealt to Scaaalll [7s 8d]
alecha11: folds 
Loto70: folds 
meikoz: folds 
Scaaalll: folds 
arrow17: raises $0.04 to $0.06
slipknot956: raises $0.12 to $0.18
arrow17: folds 
Uncalled bet ($0.12) returned to slipknot956
slipknot956 collected $0.12 from pot
slipknot956: doesn't show hand 
*** SUMMARY ***
Total pot $0.12 | Rake $0 
Seat 1: Scaaalll (button) folded before Flop (didn't bet)
Seat 2: arrow17 (small blind) folded before Flop
Seat 3: slipknot956 (big blind) collected ($0.12)
Seat 4: alecha11 folded before Flop (didn't bet)
Seat 5: Loto70 folded before Flop (didn't bet)
Seat 6: meikoz folded before Flop (didn't bet)



PokerStars Zoom Hand #229231045186:  Hold'em No Limit ($0.01/$0.02) - 2021/08/21 21:59:36 CET [2021/08/21 15:59:36 ET]
Table 'Halley' 6-max Seat #1 is the button
Seat 1: HubertFroh ($2 in chips) 
Seat 2: Koldun 2636 ($2.74 in chips) 
Seat 3: JustGums ($1 in chips) 
Seat 4: Blaackie ($2.06 in chips) 
Seat 5: Scaaalll ($2 in chips) 
Seat 6: Chupacabra G ($1.83 in chips) 
Koldun 2636: posts small blind $0.01
JustGums: posts big blind $0.02
*** HOLE CARDS ***
Dealt to Scaaalll [5c 2c]
Blaackie: folds 
Scaaalll: folds 
Chupacabra G: folds 
HubertFroh: folds 
Koldun 2636: folds 
Uncalled bet ($0.01) returned to JustGums
JustGums collected $0.02 from pot
JustGums: doesn't show hand 
*** SUMMARY ***
Total pot $0.02 | Rake $0 
Seat 1: HubertFroh (button) folded before Flop (didn't bet)
Seat 2: Koldun 2636 (small blind) folded before Flop
Seat 3: JustGums (big blind) collected ($0.02)
Seat 4: Blaackie folded before Flop (didn't bet)
Seat 5: Scaaalll folded before Flop (didn't bet)
Seat 6: Chupacabra G folded before Flop (didn't bet)



PokerStars Zoom Hand #229231051179:  Hold'em No Limit ($0.01/$0.02) - 2021/08/21 21:59:56 CET [2021/08/21 15:59:56 ET]
Table 'Halley' 6-max Seat #1 is the button
Seat 1: meps88 ($3.97 in chips) 
Seat 2: HDYD18 ($2.13 in chips) 
Seat 3: texashenry2 ($1.18 in chips) 
Seat 4: Scaaalll ($2 in chips) 
Seat 5: causavera ($4.18 in chips) 
Seat 6: zeus11983 ($2.16 in chips) 
HDYD18: posts small blind $0.01
texashenry2: posts big blind $0.02
*** HOLE CARDS ***
Dealt to Scaaalll [2d 4h]
Scaaalll: folds 
causavera: folds 
zeus11983: raises $0.03 to $0.05
meps88: folds 
HDYD18: folds 
texashenry2: folds 
Uncalled bet ($0.03) returned to zeus11983
zeus11983 collected $0.05 from pot
zeus11983: doesn't show hand 
*** SUMMARY ***
Total pot $0.05 | Rake $0 
Seat 1: meps88 (button) folded before Flop (didn't bet)
Seat 2: HDYD18 (small blind) folded before Flop
Seat 3: texashenry2 (big blind) folded before Flop
Seat 4: Scaaalll folded before Flop (didn't bet)
Seat 5: causavera folded before Flop (didn't bet)
Seat 6: zeus11983 collected ($0.05)



PokerStars Zoom Hand #229231048950:  Hold'em No Limit ($0.01/$0.02) - 2021/08/21 21:59:49 CET [2021/08/21 15:59:49 ET]
Table 'Halley' 6-max Seat #1 is the button
Seat 1: RonilsonCosta ($2.44 in chips) 
Seat 2: Scaaalll ($2 in chips) 
Seat 3: kboskov123 ($2.25 in chips) 
Seat 4: andihorni1 ($1.78 in chips) 
Seat 5: Allexii ($2.07 in chips) 
Seat 6: Pechorin.G ($2.14 in chips) 
Scaaalll: posts small blind $0.01
kboskov123: posts big blind $0.02
*** HOLE CARDS ***
Dealt to Scaaalll [Tc 6h]
andihorni1: folds 
Allexii: folds 
Allexii is disconnected 
Pechorin.G: raises $0.03 to $0.05
RonilsonCosta: folds 
Scaaalll: folds 
kboskov123: calls $0.03
*** FLOP *** [4s 3h 9h]
kboskov123: checks 
Pechorin.G: checks 
*** TURN *** [4s 3h 9h] [6c]
kboskov123: bets $0.10
Pechorin.G: folds 
Uncalled bet ($0.10) returned to kboskov123
kboskov123 collected $0.11 from pot
kboskov123: doesn't show hand 
*** SUMMARY ***
Total pot $0.11 | Rake $0 
Board [4s 3h 9h 6c]
Seat 1: RonilsonCosta (button) folded before Flop (didn't bet)
Seat 2: Scaaalll (small blind) folded before Flop
Seat 3: kboskov123 (big blind) collected ($0.11)
Seat 4: andihorni1 folded before Flop (didn't bet)
Seat 5: Allexii folded before Flop (didn't bet)
Seat 6: Pechorin.G folded on the Turn



PokerStars Zoom Hand #229231052721:  Hold'em No Limit ($0.01/$0.02) - 2021/08/21 22:00:01 CET [2021/08/21 16:00:01 ET]
Table 'Halley' 6-max Seat #1 is the button
Seat 1: Scaaalll ($2 in chips) 
Seat 2: ugi-dugi ($2.01 in chips) 
Seat 3: causavera ($4.18 in chips) 
Seat 4: HDYD18 ($2.12 in chips) 
Seat 5: Ne0net ($2.03 in chips) 
Seat 6: humo97 ($2.06 in chips) 
ugi-dugi: posts small blind $0.01
causavera: posts big blind $0.02
*** HOLE CARDS ***
Dealt to Scaaalll [Qc 7c]
HDYD18: folds 
Ne0net: folds 
humo97: folds 
Scaaalll: raises $0.02 to $0.04
ugi-dugi: calls $0.03
causavera: folds 
*** FLOP *** [3c 5h Kh]
ugi-dugi: checks 
Scaaalll: bets $0.06
ugi-dugi: folds 
Uncalled bet ($0.06) returned to Scaaalll
Scaaalll collected $0.10 from pot
Scaaalll: doesn't show hand 
*** SUMMARY ***
Total pot $0.10 | Rake $0 
Board [3c 5h Kh]
Seat 1: Scaaalll (button) collected ($0.10)
Seat 2: ugi-dugi (small blind) folded on the Flop
Seat 3: causavera (big blind) folded before Flop
Seat 4: HDYD18 folded before Flop (didn't bet)
Seat 5: Ne0net folded before Flop (didn't bet)
Seat 6: humo97 folded before Flop (didn't bet)



PokerStars Zoom Hand #229231059612:  Hold'em No Limit ($0.01/$0.02) - 2021/08/21 22:00:21 CET [2021/08/21 16:00:21 ET]
Table 'Halley' 6-max Seat #1 is the button
Seat 1: EevAA190 ($2.05 in chips) 
Seat 2: @Kwiebus2 ($2.28 in chips) 
Seat 3: Scaaalll ($2.06 in chips) 
Seat 4: Bufre ($2.05 in chips) 
Seat 5: HellNative ($3.17 in chips) 
Seat 6: maurivispa10 ($1.62 in chips) 
@Kwiebus2: posts small blind $0.01
Scaaalll: posts big blind $0.02
*** HOLE CARDS ***
Dealt to Scaaalll [4s 6s]
Bufre: folds 
HellNative: folds 
maurivispa10: raises $0.04 to $0.06
EevAA190: folds 
@Kwiebus2: folds 
Scaaalll: folds 
Uncalled bet ($0.04) returned to maurivispa10
maurivispa10 collected $0.05 from pot
maurivispa10: doesn't show hand 
*** SUMMARY ***
Total pot $0.05 | Rake $0 
Seat 1: EevAA190 (button) folded before Flop (didn't bet)
Seat 2: @Kwiebus2 (small blind) folded before Flop
Seat 3: Scaaalll (big blind) folded before Flop
Seat 4: Bufre folded before Flop (didn't bet)
Seat 5: HellNative folded before Flop (didn't bet)
Seat 6: maurivispa10 collected ($0.05)



PokerStars Zoom Hand #229231067002:  Hold'em No Limit ($0.01/$0.02) - 2021/08/21 22:00:42 CET [2021/08/21 16:00:42 ET]
Table 'Halley' 6-max Seat #1 is the button
Seat 1: nodtress ($2.47 in chips) 
Seat 2: ARTMVSLV ($6.37 in chips) 
Seat 3: Sergant20081 ($2.12 in chips) 
Seat 4: ash1448 ($10.23 in chips) 
Seat 5: Kreodont1987 ($4.30 in chips) 
Seat 6: Scaaalll ($2.04 in chips) 
ARTMVSLV: posts small blind $0.01
Sergant20081: posts big blind $0.02
*** HOLE CARDS ***
Dealt to Scaaalll [4c 2d]
ash1448: folds 
Kreodont1987: folds 
Scaaalll: folds 
nodtress: folds 
ARTMVSLV: raises $0.03 to $0.05
Sergant20081: folds 
Uncalled bet ($0.03) returned to ARTMVSLV
ARTMVSLV collected $0.04 from pot
ARTMVSLV: doesn't show hand 
*** SUMMARY ***
Total pot $0.04 | Rake $0 
Seat 1: nodtress (button) folded before Flop (didn't bet)
Seat 2: ARTMVSLV (small blind) collected ($0.04)
Seat 3: Sergant20081 (big blind) folded before Flop
Seat 4: ash1448 folded before Flop (didn't bet)
Seat 5: Kreodont1987 folded before Flop (didn't bet)
Seat 6: Scaaalll folded before Flop (didn't bet)



PokerStars Zoom Hand #229231068502:  Hold'em No Limit ($0.01/$0.02) - 2021/08/21 22:00:46 CET [2021/08/21 16:00:46 ET]
Table 'Halley' 6-max Seat #1 is the button
Seat 1: zeus11983 ($2 in chips) 
Seat 2: 77omsk ($10.13 in chips) 
Seat 3: ash1448 ($10.23 in chips) 
Seat 4: Scaaalll ($2.04 in chips) 
Seat 5: irina940 ($3.65 in chips) 
Seat 6: Emilmoller1 ($1.89 in chips) 
77omsk: posts small blind $0.01
ash1448: posts big blind $0.02
*** HOLE CARDS ***
Dealt to Scaaalll [8c Ac]
Scaaalll: folds 
irina940: folds 
Emilmoller1: folds 
zeus11983: folds 
77omsk: folds 
Uncalled bet ($0.01) returned to ash1448
ash1448 collected $0.02 from pot
ash1448: doesn't show hand 
*** SUMMARY ***
Total pot $0.02 | Rake $0 
Seat 1: zeus11983 (button) folded before Flop (didn't bet)
Seat 2: 77omsk (small blind) folded before Flop
Seat 3: ash1448 (big blind) collected ($0.02)
Seat 4: Scaaalll folded before Flop (didn't bet)
Seat 5: irina940 folded before Flop (didn't bet)
Seat 6: Emilmoller1 folded before Flop (didn't bet)



PokerStars Zoom Hand #229231070380:  Hold'em No Limit ($0.01/$0.02) - 2021/08/21 22:00:51 CET [2021/08/21 16:00:51 ET]
Table 'Halley' 6-max Seat #1 is the button
Seat 1: meps88 ($4.02 in chips) 
Seat 2: Aho1337 ($2.49 in chips) 
Seat 3: hubertott ($2.51 in chips) 
Seat 4: Mikeloko182 ($2.54 in chips) 
Seat 5: Scaaalll ($2.04 in chips) 
Seat 6: dinoVIEIRA ($3.23 in chips) 
Aho1337: posts small blind $0.01
hubertott: posts big blind $0.02
*** HOLE CARDS ***
Dealt to Scaaalll [5h Tc]
Mikeloko182: folds 
Scaaalll: folds 
dinoVIEIRA: folds 
meps88: folds 
Aho1337: folds 
Uncalled bet ($0.01) returned to hubertott
hubertott collected $0.02 from pot
hubertott: doesn't show hand 
*** SUMMARY ***
Total pot $0.02 | Rake $0 
Seat 1: meps88 (button) folded before Flop (didn't bet)
Seat 2: Aho1337 (small blind) folded before Flop
Seat 3: hubertott (big blind) collected ($0.02)
Seat 4: Mikeloko182 folded before Flop (didn't bet)
Seat 5: Scaaalll folded before Flop (didn't bet)
Seat 6: dinoVIEIRA folded before Flop (didn't bet)



PokerStars Zoom Hand #229231064860:  Hold'em No Limit ($0.01/$0.02) - 2021/08/21 22:00:36 CET [2021/08/21 16:00:36 ET]
Table 'Halley' 6-max Seat #1 is the button
Seat 1: blillad ($1.96 in chips) 
Seat 2: RoughRafff ($2.19 in chips) 
Seat 3: feedwizard ($3.89 in chips) 
Seat 4: GiordanoBrn ($2 in chips) 
Seat 5: Scaaalll ($2.04 in chips) 
Seat 6: Agno$tic ($2.65 in chips) 
RoughRafff: posts small blind $0.01
feedwizard: posts big blind $0.02
*** HOLE CARDS ***
Dealt to Scaaalll [8c Qh]
GiordanoBrn: folds 
GiordanoBrn is disconnected 
Scaaalll: folds 
Agno$tic: folds 
blillad: folds 
RoughRafff: raises $0.04 to $0.06
feedwizard: calls $0.04
*** FLOP *** [4c As Ks]
RoughRafff: bets $0.10
feedwizard: folds 
Uncalled bet ($0.10) returned to RoughRafff
RoughRafff collected $0.12 from pot
RoughRafff: doesn't show hand 
*** SUMMARY ***
Total pot $0.12 | Rake $0 
Board [4c As Ks]
Seat 1: blillad (button) folded before Flop (didn't bet)
Seat 2: RoughRafff (small blind) collected ($0.12)
Seat 3: feedwizard (big blind) folded on the Flop
Seat 4: GiordanoBrn folded before Flop (didn't bet)
Seat 5: Scaaalll folded before Flop (didn't bet)
Seat 6: Agno$tic folded before Flop (didn't bet)



PokerStars Zoom Hand #229231072727:  Hold'em No Limit ($0.01/$0.02) - 2021/08/21 22:00:57 CET [2021/08/21 16:00:57 ET]
Table 'Halley' 6-max Seat #1 is the button
Seat 1: uniicecube ($2.07 in chips) 
Seat 2: Quad Jacks21 ($4.56 in chips) 
Seat 3: kboskov123 ($1.79 in chips) 
Seat 4: Scaaalll ($2.04 in chips) 
Seat 5: AtZ3899 ($2.15 in chips) 
Seat 6: SaRCh_Ale ($2.30 in chips) 
Quad Jacks21: posts small blind $0.01
kboskov123: posts big blind $0.02
*** HOLE CARDS ***
Dealt to Scaaalll [7d 5c]
Scaaalll: folds 
AtZ3899: raises $0.02 to $0.04
SaRCh_Ale: folds 
uniicecube: raises $0.08 to $0.12
Quad Jacks21: folds 
kboskov123: folds 
AtZ3899: calls $0.08
*** FLOP *** [Jh 2h Qs]
AtZ3899: checks 
uniicecube: checks 
*** TURN *** [Jh 2h Qs] [Ac]
AtZ3899: bets $0.02
uniicecube: calls $0.02
*** RIVER *** [Jh 2h Qs Ac] [Qc]
AtZ3899: bets $0.15
uniicecube: calls $0.15
*** SHOW DOWN ***
AtZ3899: shows [As 5s] (two pair, Aces and Queens)
uniicecube: shows [Ad Kd] (two pair, Aces and Queens - King kicker)
uniicecube collected $0.59 from pot
*** SUMMARY ***
Total pot $0.61 | Rake $0.02 
Board [Jh 2h Qs Ac Qc]
Seat 1: uniicecube (button) showed [Ad Kd] and won ($0.59) with two pair, Aces and Queens
Seat 2: Quad Jacks21 (small blind) folded before Flop
Seat 3: kboskov123 (big blind) folded before Flop
Seat 4: Scaaalll folded before Flop (didn't bet)
Seat 5: AtZ3899 showed [As 5s] and lost with two pair, Aces and Queens
Seat 6: SaRCh_Ale folded before Flop (didn't bet)



PokerStars Zoom Hand #229231074178:  Hold'em No Limit ($0.01/$0.02) - 2021/08/21 22:01:01 CET [2021/08/21 16:01:01 ET]
Table 'Halley' 6-max Seat #1 is the button
Seat 1: fishh_play ($5.94 in chips) 
Seat 2: PrinceFelix1 ($3.44 in chips) 
Seat 3: Scaaalll ($2.04 in chips) 
Seat 4: AndreaBsAs ($2.97 in chips) 
Seat 5: gasmar_29 ($6.11 in chips) 
Seat 6: Shcherbak252 ($1.67 in chips) 
PrinceFelix1: posts small blind $0.01
Scaaalll: posts big blind $0.02
*** HOLE CARDS ***
Dealt to Scaaalll [6s 2d]
AndreaBsAs: folds 
gasmar_29: folds 
Shcherbak252: folds 
fishh_play: folds 
PrinceFelix1: calls $0.01
Scaaalll: checks 
*** FLOP *** [Td Jd Ts]
PrinceFelix1: checks 
Scaaalll: checks 
*** TURN *** [Td Jd Ts] [4d]
PrinceFelix1: checks 
Scaaalll: checks 
*** RIVER *** [Td Jd Ts 4d] [2s]
PrinceFelix1: checks 
Scaaalll: checks 
*** SHOW DOWN ***
PrinceFelix1: shows [Kd 3s] (a pair of Tens)
Scaaalll: shows [6s 2d] (two pair, Tens and Deuces)
Scaaalll collected $0.04 from pot
*** SUMMARY ***
Total pot $0.04 | Rake $0 
Board [Td Jd Ts 4d 2s]
Seat 1: fishh_play (button) folded before Flop (didn't bet)
Seat 2: PrinceFelix1 (small blind) showed [Kd 3s] and lost with a pair of Tens
Seat 3: Scaaalll (big blind) showed [6s 2d] and won ($0.04) with two pair, Tens and Deuces
Seat 4: AndreaBsAs folded before Flop (didn't bet)
Seat 5: gasmar_29 folded before Flop (didn't bet)
Seat 6: Shcherbak252 folded before Flop (didn't bet)



PokerStars Zoom Hand #229231099902:  Hold'em No Limit ($0.01/$0.02) - 2021/08/21 22:01:56 CET [2021/08/21 16:01:56 ET]
Table 'Halley' 6-max Seat #1 is the button
Seat 1: ramalhorod ($2.24 in chips) 
Seat 2: Scaaalll ($2.06 in chips) 
Seat 3: Victor151886 ($3.60 in chips) 
Seat 4: davidalejag ($2.19 in chips) 
Seat 5: dcd113 ($2.45 in chips) 
Seat 6: Gamer577 ($3.91 in chips) 
Scaaalll: posts small blind $0.01
Victor151886: posts big blind $0.02
*** HOLE CARDS ***
Dealt to Scaaalll [4d Jc]
davidalejag: folds 
dcd113: folds 
Gamer577: folds 
ramalhorod: folds 
Scaaalll: folds 
Uncalled bet ($0.01) returned to Victor151886
ramalhorod is disconnected 
Victor151886 collected $0.02 from pot
Victor151886: doesn't show hand 
*** SUMMARY ***
Total pot $0.02 | Rake $0 
Seat 1: ramalhorod (button) folded before Flop (didn't bet)
Seat 2: Scaaalll (small blind) folded before Flop
Seat 3: Victor151886 (big blind) collected ($0.02)
Seat 4: davidalejag folded before Flop (didn't bet)
Seat 5: dcd113 folded before Flop (didn't bet)
Seat 6: Gamer577 folded before Flop (didn't bet)



PokerStars Zoom Hand #229231101618:  Hold'em No Limit ($0.01/$0.02) - 2021/08/21 22:02:00 CET [2021/08/21 16:02:00 ET]
Table 'Halley' 6-max Seat #1 is the button
Seat 1: Scaaalll ($2.05 in chips) 
Seat 2: ARTMVSLV ($2.20 in chips) 
Seat 3: HDYD18 ($4.42 in chips) 
Seat 4: BigTestIcicle ($1.23 in chips) 
Seat 5: py100ta ($15.20 in chips) 
Seat 6: LegendaryLRS ($6.60 in chips) 
ARTMVSLV: posts small blind $0.01
HDYD18: posts big blind $0.02
*** HOLE CARDS ***
Dealt to Scaaalll [8c 3c]
BigTestIcicle: folds 
py100ta: folds 
LegendaryLRS: folds 
Scaaalll: folds 
ARTMVSLV: raises $0.03 to $0.05
HDYD18: folds 
Uncalled bet ($0.03) returned to ARTMVSLV
ARTMVSLV collected $0.04 from pot
ARTMVSLV: doesn't show hand 
*** SUMMARY ***
Total pot $0.04 | Rake $0 
Seat 1: Scaaalll (button) folded before Flop (didn't bet)
Seat 2: ARTMVSLV (small blind) collected ($0.04)
Seat 3: HDYD18 (big blind) folded before Flop
Seat 4: BigTestIcicle folded before Flop (didn't bet)
Seat 5: py100ta folded before Flop (didn't bet)
Seat 6: LegendaryLRS folded before Flop (didn't bet)



PokerStars Zoom Hand #229231107323:  Hold'em No Limit ($0.01/$0.02) - 2021/08/21 22:02:12 CET [2021/08/21 16:02:12 ET]
Table 'Halley' 6-max Seat #1 is the button
Seat 1: usenovm ($2.51 in chips) 
Seat 2: LuckyCheewey ($6.99 in chips) 
Seat 3: Agno$tic ($2.16 in chips) 
Seat 4: dcd113 ($2.44 in chips) 
Seat 5: PapiMik3 ($2.28 in chips) 
Seat 6: Scaaalll ($2.05 in chips) 
LuckyCheewey: posts small blind $0.01
Agno$tic: posts big blind $0.02
*** HOLE CARDS ***
Dealt to Scaaalll [7c 6d]
dcd113: folds 
PapiMik3: folds 
Scaaalll: folds 
usenovm: folds 
LuckyCheewey: folds 
Uncalled bet ($0.01) returned to Agno$tic
Agno$tic collected $0.02 from pot
Agno$tic: doesn't show hand 
*** SUMMARY ***
Total pot $0.02 | Rake $0 
Seat 1: usenovm (button) folded before Flop (didn't bet)
Seat 2: LuckyCheewey (small blind) folded before Flop
Seat 3: Agno$tic (big blind) collected ($0.02)
Seat 4: dcd113 folded before Flop (didn't bet)
Seat 5: PapiMik3 folded before Flop (didn't bet)
Seat 6: Scaaalll folded before Flop (didn't bet)



PokerStars Zoom Hand #229231104765:  Hold'em No Limit ($0.01/$0.02) - 2021/08/21 22:02:06 CET [2021/08/21 16:02:06 ET]
Table 'Halley' 6-max Seat #1 is the button
Seat 1: RoughRafff ($4.55 in chips) 
Seat 2: kahzura ($2 in chips) 
Seat 3: Clavis Noa ($2.37 in chips) 
Seat 4: Scaaalll ($2.05 in chips) 
Seat 5: Na4a1nika ($3.58 in chips) 
Seat 6: Atiszon ($3.89 in chips) 
kahzura: posts small blind $0.01
Clavis Noa: posts big blind $0.02
*** HOLE CARDS ***
Dealt to Scaaalll [3d 2s]
Scaaalll: folds 
Na4a1nika: folds 
Atiszon: folds 
RoughRafff: folds 
kahzura: raises $0.03 to $0.05
Clavis Noa: calls $0.03
*** FLOP *** [Ts Qh 3s]
kahzura: checks 
Clavis Noa: bets $0.05
kahzura: calls $0.05
*** TURN *** [Ts Qh 3s] [Js]
kahzura: checks 
Clavis Noa: bets $0.04
kahzura: calls $0.04
*** RIVER *** [Ts Qh 3s Js] [7d]
kahzura: checks 
Clavis Noa: checks 
*** SHOW DOWN ***
kahzura: shows [Ah Jd] (a pair of Jacks)
Clavis Noa: shows [9c Qd] (a pair of Queens)
Clavis Noa collected $0.27 from pot
*** SUMMARY ***
Total pot $0.28 | Rake $0.01 
Board [Ts Qh 3s Js 7d]
Seat 1: RoughRafff (button) folded before Flop (didn't bet)
Seat 2: kahzura (small blind) showed [Ah Jd] and lost with a pair of Jacks
Seat 3: Clavis Noa (big blind) showed [9c Qd] and won ($0.27) with a pair of Queens
Seat 4: Scaaalll folded before Flop (didn't bet)
Seat 5: Na4a1nika folded before Flop (didn't bet)
Seat 6: Atiszon folded before Flop (didn't bet)



PokerStars Zoom Hand #229231110705:  Hold'em No Limit ($0.01/$0.02) - 2021/08/21 22:02:20 CET [2021/08/21 16:02:20 ET]
Table 'Halley' 6-max Seat #1 is the button
Seat 1: yannikdaehne ($7.97 in chips) 
Seat 2: Scaaalll ($2.05 in chips) 
Seat 3: Befinski_K2 ($1.98 in chips) 
Seat 4: RonilsonCosta ($2 in chips) 
Seat 5: SIGREX ($2 in chips) 
Seat 6: dkno77 ($2.48 in chips) 
Scaaalll: posts small blind $0.01
Befinski_K2: posts big blind $0.02
*** HOLE CARDS ***
Dealt to Scaaalll [5h 4d]
RonilsonCosta: folds 
SIGREX: folds 
dkno77: folds 
yannikdaehne: folds 
Scaaalll: folds 
Uncalled bet ($0.01) returned to Befinski_K2
Befinski_K2 collected $0.02 from pot
Befinski_K2: doesn't show hand 
*** SUMMARY ***
Total pot $0.02 | Rake $0 
Seat 1: yannikdaehne (button) folded before Flop (didn't bet)
Seat 2: Scaaalll (small blind) folded before Flop
Seat 3: Befinski_K2 (big blind) collected ($0.02)
Seat 4: RonilsonCosta folded before Flop (didn't bet)
Seat 5: SIGREX folded before Flop (didn't bet)
Seat 6: dkno77 folded before Flop (didn't bet)



PokerStars Zoom Hand #229231112295:  Hold'em No Limit ($0.01/$0.02) - 2021/08/21 22:02:24 CET [2021/08/21 16:02:24 ET]
Table 'Halley' 6-max Seat #1 is the button
Seat 1: BIITRU ($4.76 in chips) 
Seat 2: Chapaev136 ($2.99 in chips) 
Seat 3: Scaaalll ($2.04 in chips) 
Seat 4: Begon505 ($1.21 in chips) 
Seat 5: Kuzmich_2502 ($3.45 in chips) 
Seat 6: olegb197006 ($2.31 in chips) 
Chapaev136: posts small blind $0.01
Scaaalll: posts big blind $0.02
*** HOLE CARDS ***
Dealt to Scaaalll [7h 8s]
Begon505: folds 
Kuzmich_2502: folds 
olegb197006: folds 
olegb197006 is disconnected 
BIITRU: raises $0.03 to $0.05
Chapaev136: folds 
Scaaalll: folds 
Uncalled bet ($0.03) returned to BIITRU
BIITRU collected $0.05 from pot
BIITRU: doesn't show hand 
*** SUMMARY ***
Total pot $0.05 | Rake $0 
Seat 1: BIITRU (button) collected ($0.05)
Seat 2: Chapaev136 (small blind) folded before Flop
Seat 3: Scaaalll (big blind) folded before Flop
Seat 4: Begon505 folded before Flop (didn't bet)
Seat 5: Kuzmich_2502 folded before Flop (didn't bet)
Seat 6: olegb197006 folded before Flop (didn't bet)



PokerStars Zoom Hand #229231108784:  Hold'em No Limit ($0.01/$0.02) - 2021/08/21 22:02:15 CET [2021/08/21 16:02:15 ET]
Table 'Halley' 6-max Seat #1 is the button
Seat 1: uniicecube ($2.09 in chips) 
Seat 2: ChowMangao ($6.04 in chips) 
Seat 3: tosticious ($2 in chips) 
Seat 4: Scaaalll ($2.05 in chips) 
Seat 5: kingchaos79 ($2.21 in chips) 
Seat 6: WithMyWalker ($2.50 in chips) 
ChowMangao: posts small blind $0.01
tosticious: posts big blind $0.02
*** HOLE CARDS ***
Dealt to Scaaalll [5d 7c]
Scaaalll: folds 
kingchaos79: folds 
WithMyWalker: folds 
uniicecube: raises $0.04 to $0.06
ChowMangao: raises $0.14 to $0.20
tosticious: folds 
uniicecube: folds 
Uncalled bet ($0.14) returned to ChowMangao
ChowMangao collected $0.14 from pot
ChowMangao: doesn't show hand 
*** SUMMARY ***
Total pot $0.14 | Rake $0 
Seat 1: uniicecube (button) folded before Flop
Seat 2: ChowMangao (small blind) collected ($0.14)
Seat 3: tosticious (big blind) folded before Flop
Seat 4: Scaaalll folded before Flop (didn't bet)
Seat 5: kingchaos79 folded before Flop (didn't bet)
Seat 6: WithMyWalker folded before Flop (didn't bet)



PokerStars Zoom Hand #229231120617:  Hold'em No Limit ($0.01/$0.02) - 2021/08/21 22:02:43 CET [2021/08/21 16:02:43 ET]
Table 'Halley' 6-max Seat #1 is the button
Seat 1: Scaaalll ($2.02 in chips) 
Seat 2: elmex886 ($2.03 in chips) 
Seat 3: LuckyCheewey ($6.98 in chips) 
Seat 4: Finkey99 ($6.89 in chips) 
Seat 5: ugi-dugi ($2.31 in chips) 
Seat 6: Draat505 ($3.50 in chips) 
elmex886: posts small blind $0.01
LuckyCheewey: posts big blind $0.02
*** HOLE CARDS ***
Dealt to Scaaalll [2h 2c]
Finkey99: folds 
ugi-dugi: raises $0.04 to $0.06
Draat505: calls $0.06
Scaaalll: calls $0.06
elmex886: folds 
LuckyCheewey: folds 
*** FLOP *** [Ac 5s 9c]
ugi-dugi: checks 
Draat505: checks 
Scaaalll: checks 
*** TURN *** [Ac 5s 9c] [7d]
ugi-dugi: checks 
Draat505: bets $0.07
Scaaalll: folds 
ugi-dugi: folds 
Uncalled bet ($0.07) returned to Draat505
Draat505 collected $0.20 from pot
Draat505: doesn't show hand 
*** SUMMARY ***
Total pot $0.21 | Rake $0.01 
Board [Ac 5s 9c 7d]
Seat 1: Scaaalll (button) folded on the Turn
Seat 2: elmex886 (small blind) folded before Flop
Seat 3: LuckyCheewey (big blind) folded before Flop
Seat 4: Finkey99 folded before Flop (didn't bet)
Seat 5: ugi-dugi folded on the Turn
Seat 6: Draat505 collected ($0.20)



PokerStars Zoom Hand #229231136569:  Hold'em No Limit ($0.01/$0.02) - 2021/08/21 22:03:20 CET [2021/08/21 16:03:20 ET]
Table 'Halley' 6-max Seat #1 is the button
Seat 1: fishh_play ($4.27 in chips) 
Seat 2: maaitee ($2.56 in chips) 
Seat 3: jerl22 ($1.47 in chips) 
Seat 4: Blaackie ($2.84 in chips) 
Seat 5: AlexGTPS ($3.35 in chips) 
Seat 6: Scaaalll ($2 in chips) 
maaitee: posts small blind $0.01
jerl22: posts big blind $0.02
*** HOLE CARDS ***
Dealt to Scaaalll [Jh 5d]
Blaackie: folds 
AlexGTPS: raises $0.03 to $0.05
Scaaalll: folds 
fishh_play: folds 
maaitee: folds 
jerl22: folds 
Uncalled bet ($0.03) returned to AlexGTPS
AlexGTPS collected $0.05 from pot
AlexGTPS: doesn't show hand 
jerl22 is disconnected 
*** SUMMARY ***
Total pot $0.05 | Rake $0 
Seat 1: fishh_play (button) folded before Flop (didn't bet)
Seat 2: maaitee (small blind) folded before Flop
Seat 3: jerl22 (big blind) folded before Flop
Seat 4: Blaackie folded before Flop (didn't bet)
Seat 5: AlexGTPS collected ($0.05)
Seat 6: Scaaalll folded before Flop (didn't bet)



PokerStars Zoom Hand #229231138618:  Hold'em No Limit ($0.01/$0.02) - 2021/08/21 22:03:24 CET [2021/08/21 16:03:24 ET]
Table 'Halley' 6-max Seat #1 is the button
Seat 1: felipeciji ($2 in chips) 
Seat 2: Vanekakqj ($3.21 in chips) 
Seat 3: Kb013497 ($3.41 in chips) 
Seat 4: bananAAbandit ($4.48 in chips) 
Seat 5: Scaaalll ($2 in chips) 
Seat 6: jftd123 ($3.40 in chips) 
Vanekakqj: posts small blind $0.01
Kb013497: posts big blind $0.02
*** HOLE CARDS ***
Dealt to Scaaalll [8d 7c]
bananAAbandit: folds 
Scaaalll: folds 
jftd123: folds 
felipeciji: folds 
Vanekakqj: raises $0.04 to $0.06
Kb013497: folds 
Uncalled bet ($0.04) returned to Vanekakqj
Vanekakqj collected $0.04 from pot
Vanekakqj: doesn't show hand 
*** SUMMARY ***
Total pot $0.04 | Rake $0 
Seat 1: felipeciji (button) folded before Flop (didn't bet)
Seat 2: Vanekakqj (small blind) collected ($0.04)
Seat 3: Kb013497 (big blind) folded before Flop
Seat 4: bananAAbandit folded before Flop (didn't bet)
Seat 5: Scaaalll folded before Flop (didn't bet)
Seat 6: jftd123 folded before Flop (didn't bet)



PokerStars Zoom Hand #229231140511:  Hold'em No Limit ($0.01/$0.02) - 2021/08/21 22:03:28 CET [2021/08/21 16:03:28 ET]
Table 'Halley' 6-max Seat #1 is the button
Seat 1: estelionat171 ($0.97 in chips) 
Seat 2: Mokkavit ($1.86 in chips) 
Seat 3: Lusnamar ($2.58 in chips) 
Seat 4: lucksuckdonk ($3.27 in chips) 
Seat 5: Baksit79 ($0.26 in chips) 
Seat 6: Scaaalll ($2 in chips) 
Mokkavit: posts small blind $0.01
Lusnamar: posts big blind $0.02
*** HOLE CARDS ***
Dealt to Scaaalll [Kc Qs]
lucksuckdonk: folds 
Baksit79: folds 
Baksit79 is disconnected 
Scaaalll: raises $0.04 to $0.06
estelionat171: folds 
Mokkavit: folds 
Lusnamar: calls $0.04
*** FLOP *** [5d Kh Ad]
Lusnamar: checks 
Scaaalll: bets $0.08
Lusnamar: folds 
Uncalled bet ($0.08) returned to Scaaalll
Scaaalll collected $0.13 from pot
Scaaalll: doesn't show hand 
*** SUMMARY ***
Total pot $0.13 | Rake $0 
Board [5d Kh Ad]
Seat 1: estelionat171 (button) folded before Flop (didn't bet)
Seat 2: Mokkavit (small blind) folded before Flop
Seat 3: Lusnamar (big blind) folded on the Flop
Seat 4: lucksuckdonk folded before Flop (didn't bet)
Seat 5: Baksit79 folded before Flop (didn't bet)
Seat 6: Scaaalll collected ($0.13)



PokerStars Zoom Hand #229231154619:  Hold'em No Limit ($0.01/$0.02) - 2021/08/21 22:04:00 CET [2021/08/21 16:04:00 ET]
Table 'Halley' 6-max Seat #1 is the button
Seat 1: AlStFish ($1 in chips) 
Seat 2: miagi12345 ($3.18 in chips) 
Seat 3: Scaaalll ($2.07 in chips) 
Seat 4: zbixxx ($4.93 in chips) 
Seat 5: ppluiaule ($2.02 in chips) 
Seat 6: zergmiky ($2.01 in chips) 
miagi12345: posts small blind $0.01
Scaaalll: posts big blind $0.02
*** HOLE CARDS ***
Dealt to Scaaalll [Kh Th]
zbixxx: folds 
ppluiaule: folds 
zergmiky: folds 
AlStFish: raises $0.04 to $0.06
miagi12345: calls $0.05
Scaaalll: calls $0.04
*** FLOP *** [4h 6h 9d]
miagi12345: checks 
Scaaalll: checks 
AlStFish: bets $0.09
miagi12345: calls $0.09
Scaaalll: raises $0.25 to $0.34
AlStFish: folds 
miagi12345: calls $0.25
*** TURN *** [4h 6h 9d] [6d]
miagi12345: checks 
Scaaalll: checks 
*** RIVER *** [4h 6h 9d 6d] [2h]
miagi12345: checks 
Scaaalll: bets $0.56
miagi12345: calls $0.56
*** SHOW DOWN ***
Scaaalll: shows [Kh Th] (a flush, King high)
miagi12345: mucks hand 
Scaaalll collected $1.98 from pot
*** SUMMARY ***
Total pot $2.07 | Rake $0.09 
Board [4h 6h 9d 6d 2h]
Seat 1: AlStFish (button) folded on the Flop
Seat 2: miagi12345 (small blind) mucked [9c 8d]
Seat 3: Scaaalll (big blind) showed [Kh Th] and won ($1.98) with a flush, King high
Seat 4: zbixxx folded before Flop (didn't bet)
Seat 5: ppluiaule folded before Flop (didn't bet)
Seat 6: zergmiky folded before Flop (didn't bet)



PokerStars Zoom Hand #229231192750:  Hold'em No Limit ($0.01/$0.02) - 2021/08/21 22:05:26 CET [2021/08/21 16:05:26 ET]
Table 'Halley' 6-max Seat #1 is the button
Seat 1: PapiMik3 ($6.60 in chips) 
Seat 2: Scaaalll ($3.09 in chips) 
Seat 3: Iwanb4 ($1.44 in chips) 
Seat 4: Loto70 ($2 in chips) 
Seat 5: estelionat171 ($0.86 in chips) 
Seat 6: Kuzmich_2502 ($3.14 in chips) 
Scaaalll: posts small blind $0.01
Iwanb4: posts big blind $0.02
*** HOLE CARDS ***
Dealt to Scaaalll [Ac 7c]
Loto70: folds 
estelionat171: folds 
Kuzmich_2502: folds 
PapiMik3: folds 
Scaaalll: raises $0.04 to $0.06
Iwanb4: raises $0.12 to $0.18
Scaaalll: folds 
Uncalled bet ($0.12) returned to Iwanb4
Iwanb4 collected $0.12 from pot
Iwanb4: doesn't show hand 
*** SUMMARY ***
Total pot $0.12 | Rake $0 
Seat 1: PapiMik3 (button) folded before Flop (didn't bet)
Seat 2: Scaaalll (small blind) folded before Flop
Seat 3: Iwanb4 (big blind) collected ($0.12)
Seat 4: Loto70 folded before Flop (didn't bet)
Seat 5: estelionat171 folded before Flop (didn't bet)
Seat 6: Kuzmich_2502 folded before Flop (didn't bet)



PokerStars Zoom Hand #229231201607:  Hold'em No Limit ($0.01/$0.02) - 2021/08/21 22:05:46 CET [2021/08/21 16:05:46 ET]
Table 'Halley' 6-max Seat #1 is the button
Seat 1: Scaaalll ($3.03 in chips) 
Seat 2: sg.32rus ($1.43 in chips) 
Seat 3: twobii668 ($1.11 in chips) 
Seat 4: zbixxx ($2.12 in chips) 
Seat 5: Chupacabra G ($1.79 in chips) 
Seat 6: so0love ($7 in chips) 
sg.32rus: posts small blind $0.01
twobii668: posts big blind $0.02
*** HOLE CARDS ***
Dealt to Scaaalll [8d Kd]
zbixxx: folds 
Chupacabra G: folds 
so0love: folds 
Scaaalll: raises $0.02 to $0.04
sg.32rus: folds 
twobii668: calls $0.02
*** FLOP *** [Kc Ts 4c]
twobii668: checks 
Scaaalll: bets $0.06
twobii668: folds 
Uncalled bet ($0.06) returned to Scaaalll
Scaaalll collected $0.09 from pot
Scaaalll: doesn't show hand 
twobii668 is disconnected 
*** SUMMARY ***
Total pot $0.09 | Rake $0 
Board [Kc Ts 4c]
Seat 1: Scaaalll (button) collected ($0.09)
Seat 2: sg.32rus (small blind) folded before Flop
Seat 3: twobii668 (big blind) folded on the Flop
Seat 4: zbixxx folded before Flop (didn't bet)
Seat 5: Chupacabra G folded before Flop (didn't bet)
Seat 6: so0love folded before Flop (didn't bet)



PokerStars Zoom Hand #229231218120:  Hold'em No Limit ($0.01/$0.02) - 2021/08/21 22:06:23 CET [2021/08/21 16:06:23 ET]
Table 'Halley' 6-max Seat #1 is the button
Seat 1: LuckyCheewey ($2.51 in chips) 
Seat 2: OFSHOR ($2 in chips) 
Seat 3: Sergant20081 ($3.60 in chips) 
Seat 4: AtZ3899 ($1.48 in chips) 
Seat 5: Scaaalll ($3.08 in chips) 
Seat 6: Amigo113 ($2.93 in chips) 
OFSHOR: posts small blind $0.01
Sergant20081: posts big blind $0.02
*** HOLE CARDS ***
Dealt to Scaaalll [4h Ah]
AtZ3899: folds 
Scaaalll: folds 
Amigo113: folds 
LuckyCheewey: raises $0.05 to $0.07
OFSHOR: folds 
Sergant20081: folds 
Uncalled bet ($0.05) returned to LuckyCheewey
LuckyCheewey collected $0.05 from pot
LuckyCheewey: doesn't show hand 
*** SUMMARY ***
Total pot $0.05 | Rake $0 
Seat 1: LuckyCheewey (button) collected ($0.05)
Seat 2: OFSHOR (small blind) folded before Flop
Seat 3: Sergant20081 (big blind) folded before Flop
Seat 4: AtZ3899 folded before Flop (didn't bet)
Seat 5: Scaaalll folded before Flop (didn't bet)
Seat 6: Amigo113 folded before Flop (didn't bet)



PokerStars Zoom Hand #229231228357:  Hold'em No Limit ($0.01/$0.02) - 2021/08/21 22:06:46 CET [2021/08/21 16:06:46 ET]
Table 'Halley' 6-max Seat #1 is the button
Seat 1: ChuckGaylordIII ($2.04 in chips) 
Seat 2: Loto70 ($2.13 in chips) 
Seat 3: Scaaalll ($3.07 in chips) 
Seat 4: F_oksi(BLR) ($1.84 in chips) 
Seat 5: shingo594 ($3.71 in chips) 
Seat 6: Gerar NB ($2.09 in chips) 
Loto70: posts small blind $0.01
Scaaalll: posts big blind $0.02
*** HOLE CARDS ***
Dealt to Scaaalll [5s 4s]
ChuckGaylordIII is disconnected 
shingo594 is disconnected 
F_oksi(BLR): raises $0.03 to $0.05
shingo594: folds 
Gerar NB: folds 
ChuckGaylordIII: folds 
Loto70: folds 
Scaaalll: folds 
Uncalled bet ($0.03) returned to F_oksi(BLR)
F_oksi(BLR) collected $0.05 from pot
F_oksi(BLR): doesn't show hand 
*** SUMMARY ***
Total pot $0.05 | Rake $0 
Seat 1: ChuckGaylordIII (button) folded before Flop (didn't bet)
Seat 2: Loto70 (small blind) folded before Flop
Seat 3: Scaaalll (big blind) folded before Flop
Seat 4: F_oksi(BLR) collected ($0.05)
Seat 5: shingo594 folded before Flop (didn't bet)
Seat 6: Gerar NB folded before Flop (didn't bet)



PokerStars Zoom Hand #229231227020:  Hold'em No Limit ($0.01/$0.02) - 2021/08/21 22:06:43 CET [2021/08/21 16:06:43 ET]
Table 'Halley' 6-max Seat #1 is the button
Seat 1: EmperorKurr ($2.54 in chips) 
Seat 2: Scaaalll ($3.08 in chips) 
Seat 3: ugi-dugi ($2 in chips) 
Seat 4: LegendaryLRS ($5.48 in chips) 
Seat 5: Kojak34 ($6.02 in chips) 
Seat 6: alexxandr ($1.75 in chips) 
Scaaalll: posts small blind $0.01
ugi-dugi: posts big blind $0.02
*** HOLE CARDS ***
Dealt to Scaaalll [2h 8d]
LegendaryLRS: folds 
Kojak34: folds 
alexxandr: folds 
EmperorKurr: raises $0.03 to $0.05
Scaaalll: folds 
ugi-dugi: raises $0.15 to $0.20
EmperorKurr: folds 
Uncalled bet ($0.15) returned to ugi-dugi
ugi-dugi collected $0.11 from pot
ugi-dugi: doesn't show hand 
*** SUMMARY ***
Total pot $0.11 | Rake $0 
Seat 1: EmperorKurr (button) folded before Flop
Seat 2: Scaaalll (small blind) folded before Flop
Seat 3: ugi-dugi (big blind) collected ($0.11)
Seat 4: LegendaryLRS folded before Flop (didn't bet)
Seat 5: Kojak34 folded before Flop (didn't bet)
Seat 6: alexxandr folded before Flop (didn't bet)



PokerStars Zoom Hand #229231235366:  Hold'em No Limit ($0.01/$0.02) - 2021/08/21 22:07:02 CET [2021/08/21 16:07:02 ET]
Table 'Halley' 6-max Seat #1 is the button
Seat 1: Scaaalll ($3.05 in chips) 
Seat 2: KIBA7660 ($1.02 in chips) 
Seat 3: AtZ3899 ($1.16 in chips) 
Seat 4: so0love ($7.23 in chips) 
Seat 5: Luben_76 ($2.15 in chips) 
Seat 6: Koldun 2636 ($2.28 in chips) 
KIBA7660: posts small blind $0.01
AtZ3899: posts big blind $0.02
*** HOLE CARDS ***
Dealt to Scaaalll [Jc 6c]
so0love: folds 
Luben_76: folds 
Koldun 2636: folds 
KIBA7660 is disconnected 
Scaaalll: raises $0.02 to $0.04
KIBA7660: folds 
AtZ3899: folds 
Uncalled bet ($0.02) returned to Scaaalll
Scaaalll collected $0.05 from pot
Scaaalll: doesn't show hand 
*** SUMMARY ***
Total pot $0.05 | Rake $0 
Seat 1: Scaaalll (button) collected ($0.05)
Seat 2: KIBA7660 (small blind) folded before Flop
Seat 3: AtZ3899 (big blind) folded before Flop
Seat 4: so0love folded before Flop (didn't bet)
Seat 5: Luben_76 folded before Flop (didn't bet)
Seat 6: Koldun 2636 folded before Flop (didn't bet)



PokerStars Zoom Hand #229231223417:  Hold'em No Limit ($0.01/$0.02) - 2021/08/21 22:06:35 CET [2021/08/21 16:06:35 ET]
Table 'Halley' 6-max Seat #1 is the button
Seat 1: zeus11983 ($2.02 in chips) 
Seat 2: arrow17 ($2.46 in chips) 
Seat 3: PapiMik3 ($6.57 in chips) 
Seat 4: Scaaalll ($3.08 in chips) 
Seat 5: Capitaine Pat ($2.45 in chips) 
Seat 6: RATAKEY41673 ($3.50 in chips) 
arrow17: posts small blind $0.01
PapiMik3: posts big blind $0.02
*** HOLE CARDS ***
Dealt to Scaaalll [8d 3h]
Scaaalll: folds 
Capitaine Pat: calls $0.02
RATAKEY41673: folds 
zeus11983: folds 
arrow17: folds 
PapiMik3: checks 
*** FLOP *** [Js 9s Td]
PapiMik3: checks 
Capitaine Pat: checks 
*** TURN *** [Js 9s Td] [2d]
PapiMik3: checks 
Capitaine Pat: checks 
*** RIVER *** [Js 9s Td 2d] [6h]
PapiMik3: checks 
Capitaine Pat: checks 
*** SHOW DOWN ***
PapiMik3: shows [5s Qc] (high card Queen)
Capitaine Pat: shows [3c 3s] (a pair of Threes)
Capitaine Pat collected $0.05 from pot
*** SUMMARY ***
Total pot $0.05 | Rake $0 
Board [Js 9s Td 2d 6h]
Seat 1: zeus11983 (button) folded before Flop (didn't bet)
Seat 2: arrow17 (small blind) folded before Flop
Seat 3: PapiMik3 (big blind) showed [5s Qc] and lost with high card Queen
Seat 4: Scaaalll folded before Flop (didn't bet)
Seat 5: Capitaine Pat showed [3c 3s] and won ($0.05) with a pair of Threes
Seat 6: RATAKEY41673 folded before Flop (didn't bet)



PokerStars Zoom Hand #229231225233:  Hold'em No Limit ($0.01/$0.02) - 2021/08/21 22:06:39 CET [2021/08/21 16:06:39 ET]
Table 'Halley' 6-max Seat #1 is the button
Seat 1: ZNFR77 ($1.11 in chips) 
Seat 2: EevAA190 ($2.53 in chips) 
Seat 3: 13Mohican ($2 in chips) 
Seat 4: Scaaalll ($3.08 in chips) 
Seat 5: Laonikos ($5.92 in chips) 
Seat 6: LegendaryLRS ($5.48 in chips) 
EevAA190: posts small blind $0.01
13Mohican: posts big blind $0.02
*** HOLE CARDS ***
Dealt to Scaaalll [Qh 4s]
Scaaalll: folds 
Laonikos: raises $0.03 to $0.05
LegendaryLRS: folds 
ZNFR77: calls $0.05
EevAA190: folds 
13Mohican: folds 
*** FLOP *** [Ac Kc 3h]
Laonikos: bets $0.06
ZNFR77 has timed out
ZNFR77: folds 
Uncalled bet ($0.06) returned to Laonikos
Laonikos collected $0.13 from pot
Laonikos: doesn't show hand 
*** SUMMARY ***
Total pot $0.13 | Rake $0 
Board [Ac Kc 3h]
Seat 1: ZNFR77 (button) folded on the Flop
Seat 2: EevAA190 (small blind) folded before Flop
Seat 3: 13Mohican (big blind) folded before Flop
Seat 4: Scaaalll folded before Flop (didn't bet)
Seat 5: Laonikos collected ($0.13)
Seat 6: LegendaryLRS folded before Flop (didn't bet)



PokerStars Zoom Hand #229231242037:  Hold'em No Limit ($0.01/$0.02) - 2021/08/21 22:07:17 CET [2021/08/21 16:07:17 ET]
Table 'Halley' 6-max Seat #1 is the button
Seat 1: Shcherbak252 ($1.88 in chips) 
Seat 2: BARDICHExSIN ($1.78 in chips) 
Seat 3: smileakafray ($4.36 in chips) 
Seat 4: gugamoraes ($2.17 in chips) 
Seat 5: Chapaev136 ($3.13 in chips) 
Seat 6: Scaaalll ($3.08 in chips) 
BARDICHExSIN: posts small blind $0.01
smileakafray: posts big blind $0.02
*** HOLE CARDS ***
Dealt to Scaaalll [Ah Kh]
BARDICHExSIN is disconnected 
gugamoraes: raises $0.04 to $0.06
Chapaev136: folds 
Scaaalll: raises $0.12 to $0.18
Shcherbak252: folds 
BARDICHExSIN: folds 
smileakafray: folds 
gugamoraes: calls $0.12
*** FLOP *** [Ts 9c 8d]
gugamoraes: checks 
Scaaalll: checks 
*** TURN *** [Ts 9c 8d] [5c]
gugamoraes: bets $0.30
Scaaalll: folds 
Uncalled bet ($0.30) returned to gugamoraes
gugamoraes collected $0.38 from pot
gugamoraes: doesn't show hand 
*** SUMMARY ***
Total pot $0.39 | Rake $0.01 
Board [Ts 9c 8d 5c]
Seat 1: Shcherbak252 (button) folded before Flop (didn't bet)
Seat 2: BARDICHExSIN (small blind) folded before Flop
Seat 3: smileakafray (big blind) folded before Flop
Seat 4: gugamoraes collected ($0.38)
Seat 5: Chapaev136 folded before Flop (didn't bet)
Seat 6: Scaaalll folded on the Turn



PokerStars Zoom Hand #229231259670:  Hold'em No Limit ($0.01/$0.02) - 2021/08/21 22:07:56 CET [2021/08/21 16:07:56 ET]
Table 'Halley' 6-max Seat #1 is the button
Seat 1: HellNative ($3.78 in chips) 
Seat 2: Alex Koshva1 ($3.36 in chips) 
Seat 3: Scaaalll ($2.90 in chips) 
Seat 4: ash1448 ($10.33 in chips) 
Seat 5: Ichverdammt ($1.03 in chips) 
Seat 6: CordiPS ($3.15 in chips) 
Alex Koshva1: posts small blind $0.01
Scaaalll: posts big blind $0.02
*** HOLE CARDS ***
Dealt to Scaaalll [2s 8c]
ash1448: folds 
Ichverdammt: folds 
CordiPS: folds 
HellNative: folds 
Alex Koshva1: raises $0.02 to $0.04
Scaaalll: folds 
Uncalled bet ($0.02) returned to Alex Koshva1
Alex Koshva1 collected $0.04 from pot
Alex Koshva1: doesn't show hand 
*** SUMMARY ***
Total pot $0.04 | Rake $0 
Seat 1: HellNative (button) folded before Flop (didn't bet)
Seat 2: Alex Koshva1 (small blind) collected ($0.04)
Seat 3: Scaaalll (big blind) folded before Flop
Seat 4: ash1448 folded before Flop (didn't bet)
Seat 5: Ichverdammt folded before Flop (didn't bet)
Seat 6: CordiPS folded before Flop (didn't bet)



PokerStars Zoom Hand #229231265477:  Hold'em No Limit ($0.01/$0.02) - 2021/08/21 22:08:10 CET [2021/08/21 16:08:10 ET]
Table 'Halley' 6-max Seat #1 is the button
Seat 1: NecromiconP ($2.87 in chips) 
Seat 2: Blaackie ($2.83 in chips) 
Seat 3: Fanatspartak ($3.78 in chips) 
Seat 4: py100ta ($16.10 in chips) 
Seat 5: usenovm ($4.11 in chips) 
Seat 6: Scaaalll ($2.88 in chips) 
Blaackie: posts small blind $0.01
Fanatspartak: posts big blind $0.02
*** HOLE CARDS ***
Dealt to Scaaalll [2c 5h]
py100ta: folds 
usenovm: folds 
Scaaalll: folds 
NecromiconP: raises $0.04 to $0.06
Blaackie: folds 
Fanatspartak: folds 
Uncalled bet ($0.04) returned to NecromiconP
NecromiconP collected $0.05 from pot
NecromiconP: doesn't show hand 
*** SUMMARY ***
Total pot $0.05 | Rake $0 
Seat 1: NecromiconP (button) collected ($0.05)
Seat 2: Blaackie (small blind) folded before Flop
Seat 3: Fanatspartak (big blind) folded before Flop
Seat 4: py100ta folded before Flop (didn't bet)
Seat 5: usenovm folded before Flop (didn't bet)
Seat 6: Scaaalll folded before Flop (didn't bet)



PokerStars Zoom Hand #229231258053:  Hold'em No Limit ($0.01/$0.02) - 2021/08/21 22:07:53 CET [2021/08/21 16:07:53 ET]
Table 'Halley' 6-max Seat #1 is the button
Seat 1: zerohorabr ($0.94 in chips) 
Seat 2: iamPecheneg ($1.16 in chips) 
Seat 3: benny6692 ($4.93 in chips) 
Seat 4: Loto70 ($2.01 in chips) 
Seat 5: Scaaalll ($2.90 in chips) 
Seat 6: Luben_76 ($2.52 in chips) 
iamPecheneg: posts small blind $0.01
benny6692: posts big blind $0.02
*** HOLE CARDS ***
Dealt to Scaaalll [Qh 3c]
Loto70: folds 
Scaaalll: folds 
Luben_76: folds 
zerohorabr: calls $0.02
iamPecheneg: calls $0.01
benny6692: checks 
*** FLOP *** [Qd 9h 2d]
iamPecheneg: checks 
benny6692: checks 
zerohorabr: checks 
*** TURN *** [Qd 9h 2d] [3d]
iamPecheneg: bets $0.03
benny6692: calls $0.03
zerohorabr: folds 
*** RIVER *** [Qd 9h 2d 3d] [5c]
iamPecheneg: bets $0.06
benny6692: calls $0.06
*** SHOW DOWN ***
iamPecheneg: shows [2h 3h] (two pair, Threes and Deuces)
benny6692: mucks hand 
iamPecheneg collected $0.23 from pot
*** SUMMARY ***
Total pot $0.24 | Rake $0.01 
Board [Qd 9h 2d 3d 5c]
Seat 1: zerohorabr (button) folded on the Turn
Seat 2: iamPecheneg (small blind) showed [2h 3h] and won ($0.23) with two pair, Threes and Deuces
Seat 3: benny6692 (big blind) mucked [As 7d]
Seat 4: Loto70 folded before Flop (didn't bet)
Seat 5: Scaaalll folded before Flop (didn't bet)
Seat 6: Luben_76 folded before Flop (didn't bet)



PokerStars Zoom Hand #229231268092:  Hold'em No Limit ($0.01/$0.02) - 2021/08/21 22:08:15 CET [2021/08/21 16:08:15 ET]
Table 'Halley' 6-max Seat #1 is the button
Seat 1: pphit ($2.21 in chips) 
Seat 2: Scaaalll ($2.88 in chips) 
Seat 3: MsSuffolk ($3.25 in chips) 
Seat 4: EevAA190 ($2 in chips) 
Seat 5: HellNative ($2.84 in chips) 
Seat 6: Allexii ($2.21 in chips) 
Scaaalll: posts small blind $0.01
MsSuffolk: posts big blind $0.02
*** HOLE CARDS ***
Dealt to Scaaalll [Qd 2h]
EevAA190: folds 
HellNative: folds 
Allexii: folds 
Allexii is disconnected 
pphit: folds 
Scaaalll: folds 
Uncalled bet ($0.01) returned to MsSuffolk
MsSuffolk collected $0.02 from pot
MsSuffolk: doesn't show hand 
*** SUMMARY ***
Total pot $0.02 | Rake $0 
Seat 1: pphit (button) folded before Flop (didn't bet)
Seat 2: Scaaalll (small blind) folded before Flop
Seat 3: MsSuffolk (big blind) collected ($0.02)
Seat 4: EevAA190 folded before Flop (didn't bet)
Seat 5: HellNative folded before Flop (didn't bet)
Seat 6: Allexii folded before Flop (didn't bet)



PokerStars Zoom Hand #229231274352:  Hold'em No Limit ($0.01/$0.02) - 2021/08/21 22:08:30 CET [2021/08/21 16:08:30 ET]
Table 'Halley' 6-max Seat #1 is the button
Seat 1: dkno77 ($2.45 in chips) 
Seat 2: olcham7 ($3.30 in chips) 
Seat 3: OFSHOR ($2.13 in chips) 
Seat 4: Scaaalll ($2.87 in chips) 
Seat 5: AlexGTPS ($3.33 in chips) 
Seat 6: so0love ($2.20 in chips) 
olcham7: posts small blind $0.01
OFSHOR: posts big blind $0.02
*** HOLE CARDS ***
Dealt to Scaaalll [2c Qh]
Scaaalll: folds 
AlexGTPS: folds 
so0love: folds 
dkno77: folds 
olcham7: folds 
Uncalled bet ($0.01) returned to OFSHOR
OFSHOR collected $0.02 from pot
OFSHOR: doesn't show hand 
*** SUMMARY ***
Total pot $0.02 | Rake $0 
Seat 1: dkno77 (button) folded before Flop (didn't bet)
Seat 2: olcham7 (small blind) folded before Flop
Seat 3: OFSHOR (big blind) collected ($0.02)
Seat 4: Scaaalll folded before Flop (didn't bet)
Seat 5: AlexGTPS folded before Flop (didn't bet)
Seat 6: so0love folded before Flop (didn't bet)



PokerStars Zoom Hand #229231276100:  Hold'em No Limit ($0.01/$0.02) - 2021/08/21 22:08:34 CET [2021/08/21 16:08:34 ET]
Table 'Halley' 6-max Seat #1 is the button
Seat 1: Scaaalll ($2.87 in chips) 
Seat 2: estelionat171 ($0.81 in chips) 
Seat 3: DaBaDaBaDooo ($2.51 in chips) 
Seat 4: malandro733 ($2.18 in chips) 
Seat 5: Ne0net ($2.58 in chips) 
Seat 6: zielony ($2.60 in chips) 
estelionat171: posts small blind $0.01
DaBaDaBaDooo: posts big blind $0.02
*** HOLE CARDS ***
Dealt to Scaaalll [6c As]
malandro733: folds 
Ne0net: folds 
zielony: folds 
Scaaalll: folds 
estelionat171: folds 
Uncalled bet ($0.01) returned to DaBaDaBaDooo
DaBaDaBaDooo collected $0.02 from pot
DaBaDaBaDooo: doesn't show hand 
*** SUMMARY ***
Total pot $0.02 | Rake $0 
Seat 1: Scaaalll (button) folded before Flop (didn't bet)
Seat 2: estelionat171 (small blind) folded before Flop
Seat 3: DaBaDaBaDooo (big blind) collected ($0.02)
Seat 4: malandro733 folded before Flop (didn't bet)
Seat 5: Ne0net folded before Flop (didn't bet)
Seat 6: zielony folded before Flop (didn't bet)



PokerStars Zoom Hand #229231280538:  Hold'em No Limit ($0.01/$0.02) - 2021/08/21 22:08:44 CET [2021/08/21 16:08:44 ET]
Table 'Halley' 6-max Seat #1 is the button
Seat 1: Manager2414 ($1.65 in chips) 
Seat 2: olliejaydee ($3.26 in chips) 
Seat 3: Scaaalll ($2.87 in chips) 
Seat 4: 77omsk ($3.11 in chips) 
Seat 5: lucksuckdonk ($3.24 in chips) 
Seat 6: Henry Chinasky ($1.36 in chips) 
olliejaydee: posts small blind $0.01
Scaaalll: posts big blind $0.02
*** HOLE CARDS ***
Dealt to Scaaalll [7d 6c]
77omsk: folds 
lucksuckdonk: folds 
Henry Chinasky: folds 
Manager2414: folds 
olliejaydee: raises $0.03 to $0.05
Scaaalll: folds 
Uncalled bet ($0.03) returned to olliejaydee
olliejaydee collected $0.04 from pot
olliejaydee: doesn't show hand 
*** SUMMARY ***
Total pot $0.04 | Rake $0 
Seat 1: Manager2414 (button) folded before Flop (didn't bet)
Seat 2: olliejaydee (small blind) collected ($0.04)
Seat 3: Scaaalll (big blind) folded before Flop
Seat 4: 77omsk folded before Flop (didn't bet)
Seat 5: lucksuckdonk folded before Flop (didn't bet)
Seat 6: Henry Chinasky folded before Flop (didn't bet)



PokerStars Zoom Hand #229231292708:  Hold'em No Limit ($0.01/$0.02) - 2021/08/21 22:09:12 CET [2021/08/21 16:09:12 ET]
Table 'Halley' 6-max Seat #1 is the button
Seat 1: Scaaalll ($2.84 in chips) 
Seat 2: bananAAbandit ($2.75 in chips) 
Seat 3: HellNative ($3.22 in chips) 
Seat 4: estelionat171 ($0.64 in chips) 
Seat 5: fishh_play ($3.62 in chips) 
Seat 6: Mad_Clock ($2.04 in chips) 
bananAAbandit: posts small blind $0.01
HellNative: posts big blind $0.02
*** HOLE CARDS ***
Dealt to Scaaalll [8h 3c]
estelionat171: folds 
fishh_play: folds 
Mad_Clock: folds 
Scaaalll: folds 
bananAAbandit: folds 
Uncalled bet ($0.01) returned to HellNative
HellNative collected $0.02 from pot
HellNative: doesn't show hand 
*** SUMMARY ***
Total pot $0.02 | Rake $0 
Seat 1: Scaaalll (button) folded before Flop (didn't bet)
Seat 2: bananAAbandit (small blind) folded before Flop
Seat 3: HellNative (big blind) collected ($0.02)
Seat 4: estelionat171 folded before Flop (didn't bet)
Seat 5: fishh_play folded before Flop (didn't bet)
Seat 6: Mad_Clock folded before Flop (didn't bet)



PokerStars Zoom Hand #229231290044:  Hold'em No Limit ($0.01/$0.02) - 2021/08/21 22:09:06 CET [2021/08/21 16:09:06 ET]
Table 'Halley' 6-max Seat #1 is the button
Seat 1: dkno77 ($2.42 in chips) 
Seat 2: Scaaalll ($2.85 in chips) 
Seat 3: Lacitoo ($2.21 in chips) 
Seat 4: Manager2414 ($1.62 in chips) 
Seat 5: rodrigocvx ($2.10 in chips) 
Seat 6: KoAlRy ($2 in chips) 
Scaaalll: posts small blind $0.01
Lacitoo: posts big blind $0.02
*** HOLE CARDS ***
Dealt to Scaaalll [2h 4d]
Manager2414: folds 
rodrigocvx: folds 
KoAlRy: raises $0.03 to $0.05
dkno77: folds 
Scaaalll: folds 
Lacitoo: raises $0.15 to $0.20
KoAlRy: folds 
Uncalled bet ($0.15) returned to Lacitoo
Lacitoo collected $0.11 from pot
Lacitoo: doesn't show hand 
*** SUMMARY ***
Total pot $0.11 | Rake $0 
Seat 1: dkno77 (button) folded before Flop (didn't bet)
Seat 2: Scaaalll (small blind) folded before Flop
Seat 3: Lacitoo (big blind) collected ($0.11)
Seat 4: Manager2414 folded before Flop (didn't bet)
Seat 5: rodrigocvx folded before Flop (didn't bet)
Seat 6: KoAlRy folded before Flop



PokerStars Zoom Hand #229231278327:  Hold'em No Limit ($0.01/$0.02) - 2021/08/21 22:08:39 CET [2021/08/21 16:08:39 ET]
Table 'Halley' 6-max Seat #1 is the button
Seat 1: felipeciji ($2.15 in chips) 
Seat 2: Kreodont1987 ($5.56 in chips) 
Seat 3: fishh_play ($3.77 in chips) 
Seat 4: Coldact ($1.35 in chips) 
Seat 5: Nihility77 ($2 in chips) 
Seat 6: Scaaalll ($2.87 in chips) 
Kreodont1987: posts small blind $0.01
fishh_play: posts big blind $0.02
*** HOLE CARDS ***
Dealt to Scaaalll [2s 9h]
Coldact: raises $0.02 to $0.04
Nihility77: raises $0.11 to $0.15
Scaaalll: folds 
felipeciji: folds 
Kreodont1987: folds 
fishh_play: calls $0.13
Coldact: calls $0.11
*** FLOP *** [Ad 6c 2d]
fishh_play: checks 
Coldact: checks 
Nihility77: bets $0.20
fishh_play: folds 
Coldact: calls $0.20
*** TURN *** [Ad 6c 2d] [Kc]
Coldact: checks 
Nihility77: checks 
*** RIVER *** [Ad 6c 2d Kc] [Jd]
Coldact: bets $0.12
Nihility77: calls $0.12
*** SHOW DOWN ***
Coldact: shows [Ah 3h] (a pair of Aces)
Nihility77: mucks hand 
Coldact collected $1.06 from pot
*** SUMMARY ***
Total pot $1.10 | Rake $0.04 
Board [Ad 6c 2d Kc Jd]
Seat 1: felipeciji (button) folded before Flop (didn't bet)
Seat 2: Kreodont1987 (small blind) folded before Flop
Seat 3: fishh_play (big blind) folded on the Flop
Seat 4: Coldact showed [Ah 3h] and won ($1.06) with a pair of Aces
Seat 5: Nihility77 mucked [Qc Qh]
Seat 6: Scaaalll folded before Flop (didn't bet)



PokerStars Zoom Hand #229231294416:  Hold'em No Limit ($0.01/$0.02) - 2021/08/21 22:09:16 CET [2021/08/21 16:09:16 ET]
Table 'Halley' 6-max Seat #1 is the button
Seat 1: Gerar NB ($2 in chips) 
Seat 2: BriceDo1917 ($1.64 in chips) 
Seat 3: LyahovIvan ($0.25 in chips) 
Seat 4: Coldact ($1.28 in chips) 
Seat 5: Scaaalll ($2.84 in chips) 
Seat 6: ash1448 ($3.16 in chips) 
BriceDo1917: posts small blind $0.01
LyahovIvan: posts big blind $0.02
*** HOLE CARDS ***
Dealt to Scaaalll [3d 4d]
Coldact: folds 
Scaaalll: folds 
ash1448: raises $0.02 to $0.04
Gerar NB: folds 
BriceDo1917: folds 
BriceDo1917 is disconnected 
LyahovIvan: folds 
Uncalled bet ($0.02) returned to ash1448
ash1448 collected $0.05 from pot
ash1448: doesn't show hand 
*** SUMMARY ***
Total pot $0.05 | Rake $0 
Seat 1: Gerar NB (button) folded before Flop (didn't bet)
Seat 2: BriceDo1917 (small blind) folded before Flop
Seat 3: LyahovIvan (big blind) folded before Flop
Seat 4: Coldact folded before Flop (didn't bet)
Seat 5: Scaaalll folded before Flop (didn't bet)
Seat 6: ash1448 collected ($0.05)



PokerStars Zoom Hand #229231297924:  Hold'em No Limit ($0.01/$0.02) - 2021/08/21 22:09:24 CET [2021/08/21 16:09:24 ET]
Table 'Halley' 6-max Seat #1 is the button
Seat 1: djewlz ($1.97 in chips) 
Seat 2: GiordanoBrn ($2.20 in chips) 
Seat 3: WithMyWalker ($2.58 in chips) 
Seat 4: Scaaalll ($2.84 in chips) 
Seat 5: usenovm ($4.02 in chips) 
Seat 6: olcham7 ($2 in chips) 
GiordanoBrn: posts small blind $0.01
WithMyWalker: posts big blind $0.02
*** HOLE CARDS ***
Dealt to Scaaalll [Kd Jc]
GiordanoBrn is disconnected 
Scaaalll: raises $0.04 to $0.06
usenovm: folds 
olcham7: calls $0.06
djewlz: folds 
GiordanoBrn: folds 
WithMyWalker: folds 
*** FLOP *** [3s 6c 7h]
Scaaalll: bets $0.08
olcham7: calls $0.08
*** TURN *** [3s 6c 7h] [Qc]
Scaaalll: checks 
olcham7: bets $0.15
Scaaalll: folds 
Uncalled bet ($0.15) returned to olcham7
olcham7 collected $0.30 from pot
olcham7: doesn't show hand 
*** SUMMARY ***
Total pot $0.31 | Rake $0.01 
Board [3s 6c 7h Qc]
Seat 1: djewlz (button) folded before Flop (didn't bet)
Seat 2: GiordanoBrn (small blind) folded before Flop
Seat 3: WithMyWalker (big blind) folded before Flop
Seat 4: Scaaalll folded on the Turn
Seat 5: usenovm folded before Flop (didn't bet)
Seat 6: olcham7 collected ($0.30)



PokerStars Zoom Hand #229231312989:  Hold'em No Limit ($0.01/$0.02) - 2021/08/21 22:09:58 CET [2021/08/21 16:09:58 ET]
Table 'Halley' 6-max Seat #1 is the button
Seat 1: viktor2935 ($0.60 in chips) 
Seat 2: OFSHOR ($2 in chips) 
Seat 3: Scaaalll ($2.70 in chips) 
Seat 4: Saint_ANBU ($3.75 in chips) 
Seat 5: zergmiky ($2.44 in chips) 
Seat 6: AtZ3899 ($1.39 in chips) 
OFSHOR: posts small blind $0.01
Scaaalll: posts big blind $0.02
*** HOLE CARDS ***
Dealt to Scaaalll [5h 7c]
Saint_ANBU: folds 
zergmiky: folds 
AtZ3899: folds 
viktor2935: folds 
OFSHOR: folds 
Uncalled bet ($0.01) returned to Scaaalll
Scaaalll collected $0.02 from pot
Scaaalll: doesn't show hand 
*** SUMMARY ***
Total pot $0.02 | Rake $0 
Seat 1: viktor2935 (button) folded before Flop (didn't bet)
Seat 2: OFSHOR (small blind) folded before Flop
Seat 3: Scaaalll (big blind) collected ($0.02)
Seat 4: Saint_ANBU folded before Flop (didn't bet)
Seat 5: zergmiky folded before Flop (didn't bet)
Seat 6: AtZ3899 folded before Flop (didn't bet)



PokerStars Zoom Hand #229231320092:  Hold'em No Limit ($0.01/$0.02) - 2021/08/21 22:10:14 CET [2021/08/21 16:10:14 ET]
Table 'Halley' 6-max Seat #1 is the button
Seat 1: 365p2eva ($4.88 in chips) 
Seat 2: Scaaalll ($2.71 in chips) 
Seat 3: rpycmbEM ($4.77 in chips) 
Seat 4: Kb013497 ($3.04 in chips) 
Seat 5: Ebbelwoiexp ($2.01 in chips) 
Seat 6: RoughRafff ($2.49 in chips) 
Scaaalll: posts small blind $0.01
rpycmbEM: posts big blind $0.02
*** HOLE CARDS ***
Dealt to Scaaalll [Ts Jc]
Kb013497: calls $0.02
Ebbelwoiexp: raises $0.09 to $0.11
RoughRafff: folds 
365p2eva: folds 
Scaaalll: folds 
rpycmbEM: folds 
Kb013497: folds 
Uncalled bet ($0.09) returned to Ebbelwoiexp
Ebbelwoiexp collected $0.07 from pot
Ebbelwoiexp: doesn't show hand 
*** SUMMARY ***
Total pot $0.07 | Rake $0 
Seat 1: 365p2eva (button) folded before Flop (didn't bet)
Seat 2: Scaaalll (small blind) folded before Flop
Seat 3: rpycmbEM (big blind) folded before Flop
Seat 4: Kb013497 folded before Flop
Seat 5: Ebbelwoiexp collected ($0.07)
Seat 6: RoughRafff folded before Flop (didn't bet)



PokerStars Zoom Hand #229231327639:  Hold'em No Limit ($0.01/$0.02) - 2021/08/21 22:10:31 CET [2021/08/21 16:10:31 ET]
Table 'Halley' 6-max Seat #1 is the button
Seat 1: 365p2eva ($2.22 in chips) 
Seat 2: amwkl4 ($2.04 in chips) 
Seat 3: Mad_Clock ($3.66 in chips) 
Seat 4: Tj741 ($1.97 in chips) 
Seat 5: Scaaalll ($2.70 in chips) 
Seat 6: usenovm ($1.02 in chips) 
amwkl4: posts small blind $0.01
Mad_Clock: posts big blind $0.02
*** HOLE CARDS ***
Dealt to Scaaalll [9c Qc]
Tj741: folds 
amwkl4 is disconnected 
Scaaalll: raises $0.04 to $0.06
usenovm: folds 
365p2eva: folds 
amwkl4: folds 
Mad_Clock: folds 
Uncalled bet ($0.04) returned to Scaaalll
Scaaalll collected $0.05 from pot
Scaaalll: doesn't show hand 
*** SUMMARY ***
Total pot $0.05 | Rake $0 
Seat 1: 365p2eva (button) folded before Flop (didn't bet)
Seat 2: amwkl4 (small blind) folded before Flop
Seat 3: Mad_Clock (big blind) folded before Flop
Seat 4: Tj741 folded before Flop (didn't bet)
Seat 5: Scaaalll collected ($0.05)
Seat 6: usenovm folded before Flop (didn't bet)



PokerStars Zoom Hand #229231318339:  Hold'em No Limit ($0.01/$0.02) - 2021/08/21 22:10:10 CET [2021/08/21 16:10:10 ET]
Table 'Halley' 6-max Seat #1 is the button
Seat 1: SKV_1985 ($2.30 in chips) 
Seat 2: OFSHOR ($3.87 in chips) 
Seat 3: Luben_76 ($1.83 in chips) 
Seat 4: Saint_ANBU ($3.75 in chips) 
Seat 5: Lacitoo ($2.20 in chips) 
Seat 6: Scaaalll ($2.71 in chips) 
OFSHOR: posts small blind $0.01
Luben_76: posts big blind $0.02
*** HOLE CARDS ***
Dealt to Scaaalll [2s 4d]
Lacitoo is disconnected 
Saint_ANBU: raises $0.04 to $0.06
Lacitoo: folds 
Scaaalll: folds 
SKV_1985: folds 
OFSHOR: folds 
Luben_76: calls $0.04
*** FLOP *** [7d 6c Qh]
Luben_76: checks 
Saint_ANBU: checks 
*** TURN *** [7d 6c Qh] [5d]
Luben_76: bets $0.07
Saint_ANBU: folds 
Uncalled bet ($0.07) returned to Luben_76
Luben_76 collected $0.13 from pot
Luben_76: doesn't show hand 
*** SUMMARY ***
Total pot $0.13 | Rake $0 
Board [7d 6c Qh 5d]
Seat 1: SKV_1985 (button) folded before Flop (didn't bet)
Seat 2: OFSHOR (small blind) folded before Flop
Seat 3: Luben_76 (big blind) collected ($0.13)
Seat 4: Saint_ANBU folded on the Turn
Seat 5: Lacitoo folded before Flop (didn't bet)
Seat 6: Scaaalll folded before Flop (didn't bet)



PokerStars Zoom Hand #229231332039:  Hold'em No Limit ($0.01/$0.02) - 2021/08/21 22:10:41 CET [2021/08/21 16:10:41 ET]
Table 'Halley' 6-max Seat #1 is the button
Seat 1: Scaaalll ($2.73 in chips) 
Seat 2: RaulacateFolds ($2.50 in chips) 
Seat 3: Flankeris ($11.35 in chips) 
Seat 4: maaitee ($2.61 in chips) 
Seat 5: vovo4kapooh ($2.06 in chips) 
Seat 6: LyahovIvan ($0.25 in chips) 
RaulacateFolds: posts small blind $0.01
Flankeris: posts big blind $0.02
*** HOLE CARDS ***
Dealt to Scaaalll [Js Kc]
maaitee: folds 
vovo4kapooh: folds 
LyahovIvan: folds 
Scaaalll: raises $0.02 to $0.04
RaulacateFolds: folds 
Flankeris: folds 
Uncalled bet ($0.02) returned to Scaaalll
Scaaalll collected $0.05 from pot
Scaaalll: doesn't show hand 
*** SUMMARY ***
Total pot $0.05 | Rake $0 
Seat 1: Scaaalll (button) collected ($0.05)
Seat 2: RaulacateFolds (small blind) folded before Flop
Seat 3: Flankeris (big blind) folded before Flop
Seat 4: maaitee folded before Flop (didn't bet)
Seat 5: vovo4kapooh folded before Flop (didn't bet)
Seat 6: LyahovIvan folded before Flop (didn't bet)



PokerStars Zoom Hand #229231325474:  Hold'em No Limit ($0.01/$0.02) - 2021/08/21 22:10:26 CET [2021/08/21 16:10:26 ET]
Table 'Halley' 6-max Seat #1 is the button
Seat 1: LyahovIvan ($0.26 in chips) 
Seat 2: 21041956 ($1.41 in chips) 
Seat 3: olcham7 ($3.25 in chips) 
Seat 4: T-saitama ($2.03 in chips) 
Seat 5: Scaaalll ($2.70 in chips) 
Seat 6: puratiino ($2.29 in chips) 
21041956: posts small blind $0.01
olcham7: posts big blind $0.02
*** HOLE CARDS ***
Dealt to Scaaalll [2d Jd]
T-saitama: folds 
Scaaalll: folds 
puratiino: raises $0.04 to $0.06
LyahovIvan: folds 
21041956: calls $0.05
olcham7: folds 
*** FLOP *** [Ts 3s 5s]
21041956: checks 
puratiino: checks 
*** TURN *** [Ts 3s 5s] [Jc]
21041956: checks 
puratiino: checks 
*** RIVER *** [Ts 3s 5s Jc] [5c]
21041956: checks 
puratiino: checks 
*** SHOW DOWN ***
21041956: shows [9h 9c] (two pair, Nines and Fives)
puratiino: mucks hand 
21041956 collected $0.14 from pot
*** SUMMARY ***
Total pot $0.14 | Rake $0 
Board [Ts 3s 5s Jc 5c]
Seat 1: LyahovIvan (button) folded before Flop (didn't bet)
Seat 2: 21041956 (small blind) showed [9h 9c] and won ($0.14) with two pair, Nines and Fives
Seat 3: olcham7 (big blind) folded before Flop
Seat 4: T-saitama folded before Flop (didn't bet)
Seat 5: Scaaalll folded before Flop (didn't bet)
Seat 6: puratiino mucked [Ac 8c]



PokerStars Zoom Hand #229231339132:  Hold'em No Limit ($0.01/$0.02) - 2021/08/21 22:10:57 CET [2021/08/21 16:10:57 ET]
Table 'Halley' 6-max Seat #1 is the button
Seat 1: queen830 ($8.74 in chips) 
Seat 2: jamal514 ($2 in chips) 
Seat 3: ugi-dugi ($2.14 in chips) 
Seat 4: Luben_76 ($2.09 in chips) 
Seat 5: bananAAbandit ($2.74 in chips) 
Seat 6: Scaaalll ($2.76 in chips) 
jamal514: posts small blind $0.01
ugi-dugi: posts big blind $0.02
*** HOLE CARDS ***
Dealt to Scaaalll [Kh 3s]
Luben_76: raises $0.03 to $0.05
bananAAbandit: folds 
Scaaalll: folds 
queen830: folds 
jamal514: folds 
ugi-dugi: folds 
Uncalled bet ($0.03) returned to Luben_76
Luben_76 collected $0.05 from pot
Luben_76: doesn't show hand 
*** SUMMARY ***
Total pot $0.05 | Rake $0 
Seat 1: queen830 (button) folded before Flop (didn't bet)
Seat 2: jamal514 (small blind) folded before Flop
Seat 3: ugi-dugi (big blind) folded before Flop
Seat 4: Luben_76 collected ($0.05)
Seat 5: bananAAbandit folded before Flop (didn't bet)
Seat 6: Scaaalll folded before Flop (didn't bet)



PokerStars Zoom Hand #229231340892:  Hold'em No Limit ($0.01/$0.02) - 2021/08/21 22:11:01 CET [2021/08/21 16:11:01 ET]
Table 'Halley' 6-max Seat #1 is the button
Seat 1: vovo4kapooh ($2 in chips) 
Seat 2: xxVanquishxx ($1.88 in chips) 
Seat 3: pavlo8855 ($2.05 in chips) 
Seat 4: davidalejag ($2.92 in chips) 
Seat 5: Scaaalll ($2.76 in chips) 
Seat 6: uniicecube ($2.66 in chips) 
xxVanquishxx: posts small blind $0.01
pavlo8855: posts big blind $0.02
*** HOLE CARDS ***
Dealt to Scaaalll [4h Ts]
davidalejag: folds 
Scaaalll: folds 
uniicecube: folds 
vovo4kapooh: folds 
xxVanquishxx: raises $0.04 to $0.06
pavlo8855: folds 
Uncalled bet ($0.04) returned to xxVanquishxx
xxVanquishxx collected $0.04 from pot
xxVanquishxx: doesn't show hand 
*** SUMMARY ***
Total pot $0.04 | Rake $0 
Seat 1: vovo4kapooh (button) folded before Flop (didn't bet)
Seat 2: xxVanquishxx (small blind) collected ($0.04)
Seat 3: pavlo8855 (big blind) folded before Flop
Seat 4: davidalejag folded before Flop (didn't bet)
Seat 5: Scaaalll folded before Flop (didn't bet)
Seat 6: uniicecube folded before Flop (didn't bet)



PokerStars Zoom Hand #229231343531:  Hold'em No Limit ($0.01/$0.02) - 2021/08/21 22:11:07 CET [2021/08/21 16:11:07 ET]
Table 'Halley' 6-max Seat #1 is the button
Seat 1: maksim1-2012 ($0.97 in chips) 
Seat 2: caiolima99 ($6.08 in chips) 
Seat 3: Scaaalll ($2.76 in chips) 
Seat 4: kahzura ($2.15 in chips) 
Seat 5: Nihility77 ($5.14 in chips) 
Seat 6: meikoz ($2.48 in chips) 
caiolima99: posts small blind $0.01
Scaaalll: posts big blind $0.02
*** HOLE CARDS ***
Dealt to Scaaalll [Qc 2h]
kahzura: folds 
Nihility77: folds 
meikoz: folds 
maksim1-2012: folds 
caiolima99: raises $0.04 to $0.06
Scaaalll: folds 
Uncalled bet ($0.04) returned to caiolima99
caiolima99 collected $0.04 from pot
caiolima99: doesn't show hand 
*** SUMMARY ***
Total pot $0.04 | Rake $0 
Seat 1: maksim1-2012 (button) folded before Flop (didn't bet)
Seat 2: caiolima99 (small blind) collected ($0.04)
Seat 3: Scaaalll (big blind) folded before Flop
Seat 4: kahzura folded before Flop (didn't bet)
Seat 5: Nihility77 folded before Flop (didn't bet)
Seat 6: meikoz folded before Flop (didn't bet)



PokerStars Zoom Hand #229231354144:  Hold'em No Limit ($0.01/$0.02) - 2021/08/21 22:11:31 CET [2021/08/21 16:11:31 ET]
Table 'Halley' 6-max Seat #1 is the button
Seat 1: caiolima99 ($6.10 in chips) 
Seat 2: Scaaalll ($2.74 in chips) 
Seat 3: AbusiveLion ($2 in chips) 
Seat 4: furgalik ($1.29 in chips) 
Seat 5: SKV_1985 ($2.37 in chips) 
Seat 6: Xlavariable ($2.04 in chips) 
Scaaalll: posts small blind $0.01
AbusiveLion: posts big blind $0.02
*** HOLE CARDS ***
Dealt to Scaaalll [Ts 4c]
furgalik: folds 
SKV_1985: folds 
Xlavariable: folds 
caiolima99: raises $0.04 to $0.06
Scaaalll: folds 
AbusiveLion: folds 
Uncalled bet ($0.04) returned to caiolima99
caiolima99 collected $0.05 from pot
caiolima99: doesn't show hand 
AbusiveLion is disconnected 
*** SUMMARY ***
Total pot $0.05 | Rake $0 
Seat 1: caiolima99 (button) collected ($0.05)
Seat 2: Scaaalll (small blind) folded before Flop
Seat 3: AbusiveLion (big blind) folded before Flop
Seat 4: furgalik folded before Flop (didn't bet)
Seat 5: SKV_1985 folded before Flop (didn't bet)
Seat 6: Xlavariable folded before Flop (didn't bet)



PokerStars Zoom Hand #229231358944:  Hold'em No Limit ($0.01/$0.02) - 2021/08/21 22:11:42 CET [2021/08/21 16:11:42 ET]
Table 'Halley' 6-max Seat #1 is the button
Seat 1: Scaaalll ($2.73 in chips) 
Seat 2: Emilmoller1 ($1.54 in chips) 
Seat 3: Vitalyi1970 ($1.70 in chips) 
Seat 4: Haraldo550 ($5.03 in chips) 
Seat 5: OFSHOR ($4.38 in chips) 
Seat 6: gy67 ($2.82 in chips) 
Emilmoller1: posts small blind $0.01
Vitalyi1970: posts big blind $0.02
*** HOLE CARDS ***
Dealt to Scaaalll [5h 5s]
Haraldo550: folds 
OFSHOR: folds 
Haraldo550 is disconnected 
gy67: folds 
Scaaalll: raises $0.02 to $0.04
Emilmoller1: folds 
Vitalyi1970: calls $0.02
*** FLOP *** [4s 9d Ts]
Vitalyi1970: checks 
Scaaalll: bets $0.06
Vitalyi1970: raises $0.06 to $0.12
Scaaalll: folds 
Uncalled bet ($0.06) returned to Vitalyi1970
Vitalyi1970 collected $0.20 from pot
Vitalyi1970: doesn't show hand 
*** SUMMARY ***
Total pot $0.21 | Rake $0.01 
Board [4s 9d Ts]
Seat 1: Scaaalll (button) folded on the Flop
Seat 2: Emilmoller1 (small blind) folded before Flop
Seat 3: Vitalyi1970 (big blind) collected ($0.20)
Seat 4: Haraldo550 folded before Flop (didn't bet)
Seat 5: OFSHOR folded before Flop (didn't bet)
Seat 6: gy67 folded before Flop (didn't bet)



PokerStars Zoom Hand #229231374967:  Hold'em No Limit ($0.01/$0.02) - 2021/08/21 22:12:18 CET [2021/08/21 16:12:18 ET]
Table 'Halley' 6-max Seat #1 is the button
Seat 1: PapiMik3 ($2.91 in chips) 
Seat 2: Aho1337 ($2.35 in chips) 
Seat 3: fishh_play ($5.72 in chips) 
Seat 4: Scaaalll ($2.63 in chips) 
Seat 5: rodrigoasor ($0.98 in chips) 
Seat 6: 888lifeIS ($2.56 in chips) 
Aho1337: posts small blind $0.01
fishh_play: posts big blind $0.02
*** HOLE CARDS ***
Dealt to Scaaalll [Kd Tc]
Scaaalll: folds 
rodrigoasor: folds 
888lifeIS: folds 
PapiMik3: folds 
Aho1337: folds 
Uncalled bet ($0.01) returned to fishh_play
fishh_play collected $0.02 from pot
fishh_play: doesn't show hand 
*** SUMMARY ***
Total pot $0.02 | Rake $0 
Seat 1: PapiMik3 (button) folded before Flop (didn't bet)
Seat 2: Aho1337 (small blind) folded before Flop
Seat 3: fishh_play (big blind) collected ($0.02)
Seat 4: Scaaalll folded before Flop (didn't bet)
Seat 5: rodrigoasor folded before Flop (didn't bet)
Seat 6: 888lifeIS folded before Flop (didn't bet)



PokerStars Zoom Hand #229231377167:  Hold'em No Limit ($0.01/$0.02) - 2021/08/21 22:12:23 CET [2021/08/21 16:12:23 ET]
Table 'Halley' 6-max Seat #1 is the button
Seat 1: estelionat171 ($0.68 in chips) 
Seat 2: pphit ($2.46 in chips) 
Seat 3: Draat505 ($4.85 in chips) 
Seat 4: Scaaalll ($2.63 in chips) 
Seat 5: SKV_1985 ($2.10 in chips) 
Seat 6: MATIdf365 ($2.05 in chips) 
pphit: posts small blind $0.01
Draat505: posts big blind $0.02
*** HOLE CARDS ***
Dealt to Scaaalll [Th 4d]
Scaaalll: folds 
SKV_1985: folds 
MATIdf365: folds 
estelionat171: folds 
pphit: raises $0.04 to $0.06
Draat505: calls $0.04
*** FLOP *** [Jd 8d 4h]
pphit: checks 
Draat505: bets $0.09
pphit: calls $0.09
*** TURN *** [Jd 8d 4h] [2s]
pphit: checks 
Draat505: bets $0.22
pphit: folds 
Uncalled bet ($0.22) returned to Draat505
Draat505 collected $0.29 from pot
Draat505: doesn't show hand 
*** SUMMARY ***
Total pot $0.30 | Rake $0.01 
Board [Jd 8d 4h 2s]
Seat 1: estelionat171 (button) folded before Flop (didn't bet)
Seat 2: pphit (small blind) folded on the Turn
Seat 3: Draat505 (big blind) collected ($0.29)
Seat 4: Scaaalll folded before Flop (didn't bet)
Seat 5: SKV_1985 folded before Flop (didn't bet)
Seat 6: MATIdf365 folded before Flop (didn't bet)



PokerStars Zoom Hand #229231380247:  Hold'em No Limit ($0.01/$0.02) - 2021/08/21 22:12:30 CET [2021/08/21 16:12:30 ET]
Table 'Halley' 6-max Seat #1 is the button
Seat 1: rekopo203 ($2.22 in chips) 
Seat 2: PapiMik3 ($2.24 in chips) 
Seat 3: Scaaalll ($2.63 in chips) 
Seat 4: pokershevela ($2.16 in chips) 
Seat 5: HellNative ($3.83 in chips) 
Seat 6: Aho1337 ($2.32 in chips) 
PapiMik3: posts small blind $0.01
Scaaalll: posts big blind $0.02
*** HOLE CARDS ***
Dealt to Scaaalll [7c 7h]
pokershevela: raises $0.04 to $0.06
HellNative: folds 
Aho1337: folds 
rekopo203: folds 
PapiMik3: folds 
Scaaalll: calls $0.04
*** FLOP *** [2d 6d 2c]
Scaaalll: checks 
pokershevela: bets $0.06
Scaaalll: calls $0.06
*** TURN *** [2d 6d 2c] [9c]
Scaaalll: checks 
pokershevela: bets $0.10
Scaaalll: calls $0.10
*** RIVER *** [2d 6d 2c 9c] [Ah]
Scaaalll: checks 
pokershevela: bets $0.20
Scaaalll: folds 
Uncalled bet ($0.20) returned to pokershevela
pokershevela collected $0.43 from pot
pokershevela: doesn't show hand 
*** SUMMARY ***
Total pot $0.45 | Rake $0.02 
Board [2d 6d 2c 9c Ah]
Seat 1: rekopo203 (button) folded before Flop (didn't bet)
Seat 2: PapiMik3 (small blind) folded before Flop
Seat 3: Scaaalll (big blind) folded on the River
Seat 4: pokershevela collected ($0.43)
Seat 5: HellNative folded before Flop (didn't bet)
Seat 6: Aho1337 folded before Flop (didn't bet)



PokerStars Zoom Hand #229231402340:  Hold'em No Limit ($0.01/$0.02) - 2021/08/21 22:13:20 CET [2021/08/21 16:13:20 ET]
Table 'Halley' 6-max Seat #1 is the button
Seat 1: Scaaalll ($2.41 in chips) 
Seat 2: Xlavariable ($2.01 in chips) 
Seat 3: Nihility77 ($2 in chips) 
Seat 4: Koldun 2636 ($4.54 in chips) 
Seat 5: HirotoBeats ($1.83 in chips) 
Seat 6: sewq55 ($0.90 in chips) 
Xlavariable: posts small blind $0.01
Nihility77: posts big blind $0.02
*** HOLE CARDS ***
Dealt to Scaaalll [6h 7h]
Koldun 2636: folds 
HirotoBeats: folds 
sewq55: folds 
Scaaalll: raises $0.02 to $0.04
Xlavariable: folds 
Nihility77: calls $0.02
*** FLOP *** [Kh Th 8d]
Nihility77: checks 
Scaaalll: bets $0.06
Nihility77: calls $0.06
*** TURN *** [Kh Th 8d] [3c]
Nihility77: checks 
Scaaalll: bets $0.14
Nihility77: calls $0.14
*** RIVER *** [Kh Th 8d 3c] [Kd]
Nihility77: checks 
Scaaalll: checks 
*** SHOW DOWN ***
Nihility77: shows [Td Jc] (two pair, Kings and Tens)
Scaaalll: mucks hand 
Nihility77 collected $0.47 from pot
*** SUMMARY ***
Total pot $0.49 | Rake $0.02 
Board [Kh Th 8d 3c Kd]
Seat 1: Scaaalll (button) mucked [6h 7h]
Seat 2: Xlavariable (small blind) folded before Flop
Seat 3: Nihility77 (big blind) showed [Td Jc] and won ($0.47) with two pair, Kings and Tens
Seat 4: Koldun 2636 folded before Flop (didn't bet)
Seat 5: HirotoBeats folded before Flop (didn't bet)
Seat 6: sewq55 folded before Flop (didn't bet)



PokerStars Zoom Hand #229231425131:  Hold'em No Limit ($0.01/$0.02) - 2021/08/21 22:14:12 CET [2021/08/21 16:14:12 ET]
Table 'Halley' 6-max Seat #1 is the button
Seat 1: boa juice ($1.06 in chips) 
Seat 2: rpycmbEM ($4.37 in chips) 
Seat 3: estelionat171 ($1.80 in chips) 
Seat 4: Loto70 ($2.03 in chips) 
Seat 5: ChuckGaylordIII ($2.03 in chips) 
Seat 6: Scaaalll ($2.16 in chips) 
rpycmbEM: posts small blind $0.01
estelionat171: posts big blind $0.02
*** HOLE CARDS ***
Dealt to Scaaalll [9s 6s]
boa juice is disconnected 
Loto70: folds 
ChuckGaylordIII: folds 
ChuckGaylordIII is disconnected 
Scaaalll: folds 
boa juice: folds 
rpycmbEM: folds 
Uncalled bet ($0.01) returned to estelionat171
estelionat171 collected $0.02 from pot
estelionat171: doesn't show hand 
*** SUMMARY ***
Total pot $0.02 | Rake $0 
Seat 1: boa juice (button) folded before Flop (didn't bet)
Seat 2: rpycmbEM (small blind) folded before Flop
Seat 3: estelionat171 (big blind) collected ($0.02)
Seat 4: Loto70 folded before Flop (didn't bet)
Seat 5: ChuckGaylordIII folded before Flop (didn't bet)
Seat 6: Scaaalll folded before Flop (didn't bet)



PokerStars Zoom Hand #229231419386:  Hold'em No Limit ($0.01/$0.02) - 2021/08/21 22:13:59 CET [2021/08/21 16:13:59 ET]
Table 'Halley' 6-max Seat #1 is the button
Seat 1: arturtsutsaev ($1.02 in chips) 
Seat 2: Scaaalll ($2.17 in chips) 
Seat 3: valenciane95 ($1.67 in chips) 
Seat 4: Murileus ($2.03 in chips) 
Seat 5: pipecmolodec ($2.23 in chips) 
Seat 6: nippurkaunas ($1.42 in chips) 
Scaaalll: posts small blind $0.01
valenciane95: posts big blind $0.02
*** HOLE CARDS ***
Dealt to Scaaalll [7d 9h]
Murileus: folds 
pipecmolodec: folds 
arturtsutsaev is disconnected 
nippurkaunas: calls $0.02
arturtsutsaev: folds 
Scaaalll: folds 
valenciane95: raises $0.05 to $0.07
nippurkaunas: calls $0.05
*** FLOP *** [Td 2c Ac]
valenciane95: bets $0.07
nippurkaunas: calls $0.07
*** TURN *** [Td 2c Ac] [8s]
valenciane95: bets $0.14
nippurkaunas: calls $0.14
*** RIVER *** [Td 2c Ac 8s] [Ks]
valenciane95: checks 
nippurkaunas: bets $0.55
valenciane95: calls $0.55
*** SHOW DOWN ***
nippurkaunas: shows [2d Ad] (two pair, Aces and Deuces)
valenciane95: mucks hand 
nippurkaunas collected $1.61 from pot
*** SUMMARY ***
Total pot $1.67 | Rake $0.06 
Board [Td 2c Ac 8s Ks]
Seat 1: arturtsutsaev (button) folded before Flop (didn't bet)
Seat 2: Scaaalll (small blind) folded before Flop
Seat 3: valenciane95 (big blind) mucked [Jd Kc]
Seat 4: Murileus folded before Flop (didn't bet)
Seat 5: pipecmolodec folded before Flop (didn't bet)
Seat 6: nippurkaunas showed [2d Ad] and won ($1.61) with two pair, Aces and Deuces



PokerStars Zoom Hand #229231447516:  Hold'em No Limit ($0.01/$0.02) - 2021/08/21 22:14:34 CET [2021/08/21 16:14:34 ET]
Table 'Halley' 6-max Seat #1 is the button
Seat 1: Scaaalll ($2.16 in chips) 
Seat 2: Jujiluju ($1.84 in chips) 
Seat 3: Rafaxn ($2 in chips) 
Seat 4: 888lifeIS ($2.04 in chips) 
Seat 5: rpycmbEM ($4.34 in chips) 
Seat 6: polymorhp ($3.40 in chips) 
Jujiluju: posts small blind $0.01
Rafaxn: posts big blind $0.02
*** HOLE CARDS ***
Dealt to Scaaalll [3c 6s]
888lifeIS: folds 
rpycmbEM: folds 
polymorhp: folds 
Scaaalll: folds 
Jujiluju: folds 
Uncalled bet ($0.01) returned to Rafaxn
Rafaxn collected $0.02 from pot
Rafaxn: doesn't show hand 
*** SUMMARY ***
Total pot $0.02 | Rake $0 
Seat 1: Scaaalll (button) folded before Flop (didn't bet)
Seat 2: Jujiluju (small blind) folded before Flop
Seat 3: Rafaxn (big blind) collected ($0.02)
Seat 4: 888lifeIS folded before Flop (didn't bet)
Seat 5: rpycmbEM folded before Flop (didn't bet)
Seat 6: polymorhp folded before Flop (didn't bet)



PokerStars Zoom Hand #229231421189:  Hold'em No Limit ($0.01/$0.02) - 2021/08/21 22:14:03 CET [2021/08/21 16:14:03 ET]
Table 'Halley' 6-max Seat #1 is the button
Seat 1: F_oksi(BLR) ($2.50 in chips) 
Seat 2: fishh_play ($4.12 in chips) 
Seat 3: DaBaDaBaDooo ($3.96 in chips) 
Seat 4: zielony ($2.30 in chips) 
Seat 5: mheronmagno ($2.75 in chips) 
Seat 6: Scaaalll ($2.16 in chips) 
fishh_play: posts small blind $0.01
DaBaDaBaDooo: posts big blind $0.02
*** HOLE CARDS ***
Dealt to Scaaalll [8s 5c]
zielony: folds 
mheronmagno: calls $0.02
Scaaalll: folds 
F_oksi(BLR): folds 
fishh_play: folds 
DaBaDaBaDooo: raises $0.06 to $0.08
mheronmagno: calls $0.06
*** FLOP *** [3s 5d Jc]
DaBaDaBaDooo: checks 
mheronmagno: checks 
*** TURN *** [3s 5d Jc] [6d]
DaBaDaBaDooo: checks 
mheronmagno: checks 
*** RIVER *** [3s 5d Jc 6d] [3d]
DaBaDaBaDooo: checks 
mheronmagno: checks 
*** SHOW DOWN ***
DaBaDaBaDooo: shows [Ac 4c] (a pair of Threes)
mheronmagno: shows [2c As] (a pair of Threes)
DaBaDaBaDooo collected $0.08 from pot
mheronmagno collected $0.08 from pot
*** SUMMARY ***
Total pot $0.17 | Rake $0.01 
Board [3s 5d Jc 6d 3d]
Seat 1: F_oksi(BLR) (button) folded before Flop (didn't bet)
Seat 2: fishh_play (small blind) folded before Flop
Seat 3: DaBaDaBaDooo (big blind) showed [Ac 4c] and won ($0.08) with a pair of Threes
Seat 4: zielony folded before Flop (didn't bet)
Seat 5: mheronmagno showed [2c As] and won ($0.08) with a pair of Threes
Seat 6: Scaaalll folded before Flop (didn't bet)



PokerStars Zoom Hand #229231449261:  Hold'em No Limit ($0.01/$0.02) - 2021/08/21 22:14:38 CET [2021/08/21 16:14:38 ET]
Table 'Halley' 6-max Seat #1 is the button
Seat 1: ash1448 ($10.50 in chips) 
Seat 2: Pechorin.G ($2.03 in chips) 
Seat 3: Blaackie ($2.72 in chips) 
Seat 4: Healthys07 ($2.77 in chips) 
Seat 5: Scaaalll ($2.16 in chips) 
Seat 6: Vanekakqj ($2.31 in chips) 
Pechorin.G: posts small blind $0.01
Blaackie: posts big blind $0.02
*** HOLE CARDS ***
Dealt to Scaaalll [4s Js]
Healthys07: folds 
Scaaalll: folds 
Vanekakqj: folds 
ash1448: folds 
Pechorin.G: folds 
Uncalled bet ($0.01) returned to Blaackie
Blaackie collected $0.02 from pot
Blaackie: doesn't show hand 
*** SUMMARY ***
Total pot $0.02 | Rake $0 
Seat 1: ash1448 (button) folded before Flop (didn't bet)
Seat 2: Pechorin.G (small blind) folded before Flop
Seat 3: Blaackie (big blind) collected ($0.02)
Seat 4: Healthys07 folded before Flop (didn't bet)
Seat 5: Scaaalll folded before Flop (didn't bet)
Seat 6: Vanekakqj folded before Flop (didn't bet)



PokerStars Zoom Hand #229231444415:  Hold'em No Limit ($0.01/$0.02) - 2021/08/21 22:14:27 CET [2021/08/21 16:14:27 ET]
Table 'Halley' 6-max Seat #1 is the button
Seat 1: Vanekakqj ($2.33 in chips) 
Seat 2: 888lifeIS ($2.47 in chips) 
Seat 3: smileakafray ($2.64 in chips) 
Seat 4: Scaaalll ($2.16 in chips) 
Seat 5: Esskeetit420/69 ($2.08 in chips) 
Seat 6: ChuckGaylordIII ($2.03 in chips) 
888lifeIS: posts small blind $0.01
smileakafray: posts big blind $0.02
*** HOLE CARDS ***
Dealt to Scaaalll [2h 9h]
ChuckGaylordIII is disconnected 
Scaaalll: folds 
Esskeetit420/69: raises $0.02 to $0.04
ChuckGaylordIII: folds 
Vanekakqj: folds 
888lifeIS: folds 
smileakafray: calls $0.02
*** FLOP *** [3c 2d 5h]
smileakafray: bets $0.05
Esskeetit420/69: calls $0.05
*** TURN *** [3c 2d 5h] [6s]
smileakafray: bets $0.10
Esskeetit420/69: calls $0.10
*** RIVER *** [3c 2d 5h 6s] [9c]
smileakafray: checks 
Esskeetit420/69: bets $0.38
smileakafray: folds 
Uncalled bet ($0.38) returned to Esskeetit420/69
Esskeetit420/69 collected $0.38 from pot
Esskeetit420/69: doesn't show hand 
*** SUMMARY ***
Total pot $0.39 | Rake $0.01 
Board [3c 2d 5h 6s 9c]
Seat 1: Vanekakqj (button) folded before Flop (didn't bet)
Seat 2: 888lifeIS (small blind) folded before Flop
Seat 3: smileakafray (big blind) folded on the River
Seat 4: Scaaalll folded before Flop (didn't bet)
Seat 5: Esskeetit420/69 collected ($0.38)
Seat 6: ChuckGaylordIII folded before Flop (didn't bet)



PokerStars Zoom Hand #229231451480:  Hold'em No Limit ($0.01/$0.02) - 2021/08/21 22:14:43 CET [2021/08/21 16:14:43 ET]
Table 'Halley' 6-max Seat #1 is the button
Seat 1: slipknot956 ($2.04 in chips) 
Seat 2: Iwanb4 ($1.80 in chips) 
Seat 3: Scaaalll ($2.16 in chips) 
Seat 4: MSD2006 ($2.33 in chips) 
Seat 5: olcham7 ($2 in chips) 
Seat 6: leoniduch93 ($1.52 in chips) 
Iwanb4: posts small blind $0.01
Scaaalll: posts big blind $0.02
*** HOLE CARDS ***
Dealt to Scaaalll [8d Qc]
MSD2006: folds 
olcham7: folds 
leoniduch93: folds 
slipknot956 has timed out
slipknot956: folds 
Iwanb4: raises $0.04 to $0.06
Scaaalll: folds 
Uncalled bet ($0.04) returned to Iwanb4
Iwanb4 collected $0.04 from pot
Iwanb4: doesn't show hand 
*** SUMMARY ***
Total pot $0.04 | Rake $0 
Seat 1: slipknot956 (button) folded before Flop (didn't bet)
Seat 2: Iwanb4 (small blind) collected ($0.04)
Seat 3: Scaaalll (big blind) folded before Flop
Seat 4: MSD2006 folded before Flop (didn't bet)
Seat 5: olcham7 folded before Flop (didn't bet)
Seat 6: leoniduch93 folded before Flop (didn't bet)



PokerStars Zoom Hand #229231464489:  Hold'em No Limit ($0.01/$0.02) - 2021/08/21 22:15:12 CET [2021/08/21 16:15:12 ET]
Table 'Halley' 6-max Seat #1 is the button
Seat 1: jamal514 ($2 in chips) 
Seat 2: Kkamm ($2.65 in chips) 
Seat 3: Blaackie ($3.81 in chips) 
Seat 4: Scaaalll ($2.14 in chips) 
Seat 5: so0love ($6.87 in chips) 
Seat 6: RonilsonCosta ($2.03 in chips) 
Kkamm: posts small blind $0.01
Blaackie: posts big blind $0.02
*** HOLE CARDS ***
Dealt to Scaaalll [3h 8s]
Scaaalll: folds 
so0love: raises $0.02 to $0.04
RonilsonCosta: folds 
jamal514: folds 
Kkamm: folds 
Blaackie: folds 
Uncalled bet ($0.02) returned to so0love
so0love collected $0.05 from pot
so0love: doesn't show hand 
*** SUMMARY ***
Total pot $0.05 | Rake $0 
Seat 1: jamal514 (button) folded before Flop (didn't bet)
Seat 2: Kkamm (small blind) folded before Flop
Seat 3: Blaackie (big blind) folded before Flop
Seat 4: Scaaalll folded before Flop (didn't bet)
Seat 5: so0love collected ($0.05)
Seat 6: RonilsonCosta folded before Flop (didn't bet)



PokerStars Zoom Hand #229231466770:  Hold'em No Limit ($0.01/$0.02) - 2021/08/21 22:15:17 CET [2021/08/21 16:15:17 ET]
Table 'Halley' 6-max Seat #1 is the button
Seat 1: 888lifeIS ($2.51 in chips) 
Seat 2: Scaaalll ($2.14 in chips) 
Seat 3: boa juice ($1.08 in chips) 
Seat 4: DaporteWins ($2 in chips) 
Seat 5: usenovm ($2.76 in chips) 
Seat 6: Demidov V.S. ($1.79 in chips) 
Scaaalll: posts small blind $0.01
boa juice: posts big blind $0.02
*** HOLE CARDS ***
Dealt to Scaaalll [Qc Ad]
Demidov V.S. is disconnected 
DaporteWins: folds 
usenovm: folds 
Demidov V.S.: folds 
888lifeIS: folds 
Scaaalll: raises $0.04 to $0.06
boa juice: calls $0.04
*** FLOP *** [9d 3s Ac]
Scaaalll: bets $0.08
boa juice: calls $0.08
*** TURN *** [9d 3s Ac] [4s]
Scaaalll: bets $0.18
boa juice: raises $0.22 to $0.40
Scaaalll: calls $0.22
*** RIVER *** [9d 3s Ac 4s] [9s]
Scaaalll: checks 
boa juice: bets $0.54 and is all-in
Scaaalll: calls $0.54
*** SHOW DOWN ***
boa juice: shows [Kd Ah] (two pair, Aces and Nines)
Scaaalll: shows [Qc Ad] (two pair, Aces and Nines - lower kicker)
boa juice collected $2.08 from pot
*** SUMMARY ***
Total pot $2.16 | Rake $0.08 
Board [9d 3s Ac 4s 9s]
Seat 1: 888lifeIS (button) folded before Flop (didn't bet)
Seat 2: Scaaalll (small blind) showed [Qc Ad] and lost with two pair, Aces and Nines
Seat 3: boa juice (big blind) showed [Kd Ah] and won ($2.08) with two pair, Aces and Nines
Seat 4: DaporteWins folded before Flop (didn't bet)
Seat 5: usenovm folded before Flop (didn't bet)
Seat 6: Demidov V.S. folded before Flop (didn't bet)



PokerStars Zoom Hand #229231491360:  Hold'em No Limit ($0.01/$0.02) - 2021/08/21 22:16:11 CET [2021/08/21 16:16:11 ET]
Table 'Halley' 6-max Seat #1 is the button
Seat 1: Scaaalll ($2 in chips) 
Seat 2: pipecmolodec ($2.29 in chips) 
Seat 3: Coldact ($1.52 in chips) 
Seat 4: Dr.stromg ($2 in chips) 
Seat 5: BlackhawKK's ($3.36 in chips) 
Seat 6: Feliciano16 ($4.38 in chips) 
pipecmolodec: posts small blind $0.01
Coldact: posts big blind $0.02
*** HOLE CARDS ***
Dealt to Scaaalll [Jd Jc]
Dr.stromg: folds 
BlackhawKK's: raises $0.04 to $0.06
Feliciano16: raises $0.14 to $0.20
Scaaalll: calls $0.20
pipecmolodec: folds 
Coldact: folds 
BlackhawKK's: folds 
*** FLOP *** [7h 6d 2h]
Feliciano16: checks 
Scaaalll: checks 
*** TURN *** [7h 6d 2h] [2d]
Feliciano16: bets $0.26
Scaaalll: calls $0.26
*** RIVER *** [7h 6d 2h 2d] [Ts]
Feliciano16: checks 
Scaaalll: bets $0.62
Feliciano16: calls $0.62
*** SHOW DOWN ***
Scaaalll: shows [Jd Jc] (two pair, Jacks and Deuces)
Feliciano16: mucks hand 
Scaaalll collected $2.15 from pot
*** SUMMARY ***
Total pot $2.25 | Rake $0.10 
Board [7h 6d 2h 2d Ts]
Seat 1: Scaaalll (button) showed [Jd Jc] and won ($2.15) with two pair, Jacks and Deuces
Seat 2: pipecmolodec (small blind) folded before Flop
Seat 3: Coldact (big blind) folded before Flop
Seat 4: Dr.stromg folded before Flop (didn't bet)
Seat 5: BlackhawKK's folded before Flop
Seat 6: Feliciano16 mucked [9h 9d]



PokerStars Zoom Hand #229231513436:  Hold'em No Limit ($0.01/$0.02) - 2021/08/21 22:16:59 CET [2021/08/21 16:16:59 ET]
Table 'Halley' 6-max Seat #1 is the button
Seat 1: pphit ($2.92 in chips) 
Seat 2: djewlz ($2.22 in chips) 
Seat 3: Hug0Flavi0 ($1.25 in chips) 
Seat 4: NecromiconP ($2.66 in chips) 
Seat 5: Scaaalll ($3.07 in chips) 
Seat 6: lexus00174 ($1.58 in chips) 
djewlz: posts small blind $0.01
Hug0Flavi0: posts big blind $0.02
*** HOLE CARDS ***
Dealt to Scaaalll [4h Jc]
NecromiconP: folds 
Scaaalll: folds 
lexus00174: folds 
pphit: raises $0.04 to $0.06
djewlz: folds 
Hug0Flavi0: calls $0.04
*** FLOP *** [Ks 9c 9h]
Hug0Flavi0: checks 
pphit: bets $0.05
Hug0Flavi0: folds 
Uncalled bet ($0.05) returned to pphit
pphit collected $0.13 from pot
pphit: doesn't show hand 
*** SUMMARY ***
Total pot $0.13 | Rake $0 
Board [Ks 9c 9h]
Seat 1: pphit (button) collected ($0.13)
Seat 2: djewlz (small blind) folded before Flop
Seat 3: Hug0Flavi0 (big blind) folded on the Flop
Seat 4: NecromiconP folded before Flop (didn't bet)
Seat 5: Scaaalll folded before Flop (didn't bet)
Seat 6: lexus00174 folded before Flop (didn't bet)



PokerStars Zoom Hand #229231516190:  Hold'em No Limit ($0.01/$0.02) - 2021/08/21 22:17:05 CET [2021/08/21 16:17:05 ET]
Table 'Halley' 6-max Seat #1 is the button
Seat 1: Chapaev136 ($3.50 in chips) 
Seat 2: pphit ($2.16 in chips) 
Seat 3: KonopDima ($2.18 in chips) 
Seat 4: Scaaalll ($3.07 in chips) 
Seat 5: Ne0net ($2.24 in chips) 
Seat 6: zbixxx ($6.52 in chips) 
pphit: posts small blind $0.01
KonopDima: posts big blind $0.02
*** HOLE CARDS ***
Dealt to Scaaalll [Ks Qh]
Scaaalll: raises $0.04 to $0.06
Ne0net: folds 
zbixxx: folds 
Chapaev136: calls $0.06
pphit: folds 
KonopDima: folds 
*** FLOP *** [8c Ad 3h]
Scaaalll: bets $0.07
Chapaev136: raises $0.07 to $0.14
Scaaalll: folds 
Uncalled bet ($0.07) returned to Chapaev136
Chapaev136 collected $0.28 from pot
Chapaev136: doesn't show hand 
*** SUMMARY ***
Total pot $0.29 | Rake $0.01 
Board [8c Ad 3h]
Seat 1: Chapaev136 (button) collected ($0.28)
Seat 2: pphit (small blind) folded before Flop
Seat 3: KonopDima (big blind) folded before Flop
Seat 4: Scaaalll folded on the Flop
Seat 5: Ne0net folded before Flop (didn't bet)
Seat 6: zbixxx folded before Flop (didn't bet)



PokerStars Zoom Hand #229231528201:  Hold'em No Limit ($0.01/$0.02) - 2021/08/21 22:17:31 CET [2021/08/21 16:17:31 ET]
Table 'Halley' 6-max Seat #1 is the button
Seat 1: estelionat171 ($0.94 in chips) 
Seat 2: dkno77 ($5.39 in chips) 
Seat 3: Scaaalll ($2.94 in chips) 
Seat 4: Tabitaji ($2.53 in chips) 
Seat 5: Lusnamar ($0.06 in chips) 
Seat 6: BenOKopen ($2.22 in chips) 
dkno77: posts small blind $0.01
Scaaalll: posts big blind $0.02
*** HOLE CARDS ***
Dealt to Scaaalll [7c 9h]
Tabitaji: raises $0.04 to $0.06
Lusnamar: calls $0.06 and is all-in
BenOKopen: folds 
estelionat171: folds 
dkno77: folds 
Scaaalll: folds 
*** FLOP *** [Th Ks 2s]
*** TURN *** [Th Ks 2s] [3d]
*** RIVER *** [Th Ks 2s 3d] [9c]
*** SHOW DOWN ***
Tabitaji: shows [Td Tc] (three of a kind, Tens)
Lusnamar: shows [Ad Ts] (a pair of Tens)
Tabitaji collected $0.14 from pot
*** SUMMARY ***
Total pot $0.15 | Rake $0.01 
Board [Th Ks 2s 3d 9c]
Seat 1: estelionat171 (button) folded before Flop (didn't bet)
Seat 2: dkno77 (small blind) folded before Flop
Seat 3: Scaaalll (big blind) folded before Flop
Seat 4: Tabitaji showed [Td Tc] and won ($0.14) with three of a kind, Tens
Seat 5: Lusnamar showed [Ad Ts] and lost with a pair of Tens
Seat 6: BenOKopen folded before Flop (didn't bet)



PokerStars Zoom Hand #229231534200:  Hold'em No Limit ($0.01/$0.02) - 2021/08/21 22:17:44 CET [2021/08/21 16:17:44 ET]
Table 'Halley' 6-max Seat #1 is the button
Seat 1: Lacitoo ($2.16 in chips) 
Seat 2: sima4ev ($1.55 in chips) 
Seat 3: Zero_sdk ($1.63 in chips) 
Seat 4: keldh ($2.58 in chips) 
Seat 5: rekopo203 ($2.15 in chips) 
Seat 6: Scaaalll ($2.92 in chips) 
sima4ev: posts small blind $0.01
Zero_sdk: posts big blind $0.02
*** HOLE CARDS ***
Dealt to Scaaalll [Jh Qd]
keldh: folds 
rekopo203: folds 
Lacitoo is disconnected 
Scaaalll: raises $0.04 to $0.06
Lacitoo: folds 
Zero_sdk is disconnected 
sima4ev: raises $1.49 to $1.55 and is all-in
Zero_sdk: folds 
Scaaalll: folds 
Uncalled bet ($1.49) returned to sima4ev
sima4ev collected $0.14 from pot
sima4ev: doesn't show hand 
*** SUMMARY ***
Total pot $0.14 | Rake $0 
Seat 1: Lacitoo (button) folded before Flop (didn't bet)
Seat 2: sima4ev (small blind) collected ($0.14)
Seat 3: Zero_sdk (big blind) folded before Flop
Seat 4: keldh folded before Flop (didn't bet)
Seat 5: rekopo203 folded before Flop (didn't bet)
Seat 6: Scaaalll folded before Flop



PokerStars Zoom Hand #229231542937:  Hold'em No Limit ($0.01/$0.02) - 2021/08/21 22:18:03 CET [2021/08/21 16:18:03 ET]
Table 'Halley' 6-max Seat #1 is the button
Seat 1: lucksuckdonk ($3.66 in chips) 
Seat 2: Scaaalll ($2.86 in chips) 
Seat 3: Blaackie ($3.94 in chips) 
Seat 4: amario89 ($5.50 in chips) 
Seat 5: OFSHOR ($2.16 in chips) 
Seat 6: Hallyson_23 ($4.85 in chips) 
Scaaalll: posts small blind $0.01
Blaackie: posts big blind $0.02
*** HOLE CARDS ***
Dealt to Scaaalll [7s Td]
amario89: folds 
OFSHOR: folds 
Hallyson_23: folds 
lucksuckdonk: raises $0.04 to $0.06
Scaaalll: folds 
Blaackie: folds 
Uncalled bet ($0.04) returned to lucksuckdonk
lucksuckdonk collected $0.05 from pot
lucksuckdonk: doesn't show hand 
*** SUMMARY ***
Total pot $0.05 | Rake $0 
Seat 1: lucksuckdonk (button) collected ($0.05)
Seat 2: Scaaalll (small blind) folded before Flop
Seat 3: Blaackie (big blind) folded before Flop
Seat 4: amario89 folded before Flop (didn't bet)
Seat 5: OFSHOR folded before Flop (didn't bet)
Seat 6: Hallyson_23 folded before Flop (didn't bet)



PokerStars Zoom Hand #229231546568:  Hold'em No Limit ($0.01/$0.02) - 2021/08/21 22:18:11 CET [2021/08/21 16:18:11 ET]
Table 'Halley' 6-max Seat #1 is the button
Seat 1: Flankeris ($2.71 in chips) 
Seat 2: Treadero ($3.12 in chips) 
Seat 3: NoEff0rt2w1n ($2.24 in chips) 
Seat 4: IceTdannyB ($3.40 in chips) 
Seat 5: Scaaalll ($2.85 in chips) 
Seat 6: Sergant20081 ($2.08 in chips) 
Treadero: posts small blind $0.01
NoEff0rt2w1n: posts big blind $0.02
*** HOLE CARDS ***
Dealt to Scaaalll [9c 6h]
IceTdannyB: folds 
Scaaalll: folds 
IceTdannyB is disconnected 
Sergant20081: folds 
Flankeris: raises $0.04 to $0.06
Treadero: folds 
NoEff0rt2w1n: calls $0.04
*** FLOP *** [6c 3c 8s]
NoEff0rt2w1n: checks 
Flankeris: bets $0.09
NoEff0rt2w1n: raises $0.31 to $0.40
Flankeris: folds 
Uncalled bet ($0.31) returned to NoEff0rt2w1n
NoEff0rt2w1n collected $0.30 from pot
NoEff0rt2w1n: doesn't show hand 
*** SUMMARY ***
Total pot $0.31 | Rake $0.01 
Board [6c 3c 8s]
Seat 1: Flankeris (button) folded on the Flop
Seat 2: Treadero (small blind) folded before Flop
Seat 3: NoEff0rt2w1n (big blind) collected ($0.30)
Seat 4: IceTdannyB folded before Flop (didn't bet)
Seat 5: Scaaalll folded before Flop (didn't bet)
Seat 6: Sergant20081 folded before Flop (didn't bet)



PokerStars Zoom Hand #229231548338:  Hold'em No Limit ($0.01/$0.02) - 2021/08/21 22:18:15 CET [2021/08/21 16:18:15 ET]
Table 'Halley' 6-max Seat #1 is the button
Seat 1: lakilive ($0.88 in chips) 
Seat 2: DaporteWins ($2.07 in chips) 
Seat 3: Scaaalll ($2.85 in chips) 
Seat 4: malandro733 ($7.81 in chips) 
Seat 5: IceTdannyB ($3.40 in chips) 
Seat 6: ash1448 ($3.30 in chips) 
DaporteWins: posts small blind $0.01
Scaaalll: posts big blind $0.02
*** HOLE CARDS ***
Dealt to Scaaalll [4c 6d]
IceTdannyB is disconnected 
malandro733: raises $0.04 to $0.06
IceTdannyB: folds 
ash1448: folds 
lakilive: raises $0.82 to $0.88 and is all-in
DaporteWins: folds 
Scaaalll: folds 
malandro733: calls $0.82
*** FLOP *** [2h 8c 4d]
*** TURN *** [2h 8c 4d] [Qs]
*** RIVER *** [2h 8c 4d Qs] [4h]
*** SHOW DOWN ***
malandro733: shows [Jc Kc] (a pair of Fours)
lakilive: shows [5c 5h] (two pair, Fives and Fours)
lakilive cashed out the hand for $0.86 | Cash Out Fee $0.01
*** SUMMARY ***
Total pot $1.79 | Rake $0.06 
Board [2h 8c 4d Qs 4h]
Seat 1: lakilive (button) showed [5c 5h] and won ($1.73) with two pair, Fives and Fours (pot not awarded as player cashed out)
Seat 2: DaporteWins (small blind) folded before Flop
Seat 3: Scaaalll (big blind) folded before Flop
Seat 4: malandro733 showed [Jc Kc] and lost with a pair of Fours
Seat 5: IceTdannyB folded before Flop (didn't bet)
Seat 6: ash1448 folded before Flop (didn't bet)



PokerStars Zoom Hand #229231558998:  Hold'em No Limit ($0.01/$0.02) - 2021/08/21 22:18:38 CET [2021/08/21 16:18:38 ET]
Table 'Halley' 6-max Seat #1 is the button
Seat 1: Scaaalll ($2.82 in chips) 
Seat 2: zergmiky ($2.56 in chips) 
Seat 3: kamikaze2017 ($2.24 in chips) 
Seat 4: keb1981 ($2.73 in chips) 
Seat 5: WithMyWalker ($3.69 in chips) 
Seat 6: nodtress ($2.02 in chips) 
zergmiky: posts small blind $0.01
kamikaze2017: posts big blind $0.02
*** HOLE CARDS ***
Dealt to Scaaalll [Qh Ts]
keb1981: folds 
WithMyWalker: folds 
nodtress: folds 
Scaaalll: raises $0.02 to $0.04
zergmiky: raises $0.12 to $0.16
kamikaze2017: folds 
kamikaze2017 is disconnected 
Scaaalll: folds 
Uncalled bet ($0.12) returned to zergmiky
zergmiky collected $0.10 from pot
zergmiky: doesn't show hand 
*** SUMMARY ***
Total pot $0.10 | Rake $0 
Seat 1: Scaaalll (button) folded before Flop
Seat 2: zergmiky (small blind) collected ($0.10)
Seat 3: kamikaze2017 (big blind) folded before Flop
Seat 4: keb1981 folded before Flop (didn't bet)
Seat 5: WithMyWalker folded before Flop (didn't bet)
Seat 6: nodtress folded before Flop (didn't bet)



PokerStars Zoom Hand #229231544711:  Hold'em No Limit ($0.01/$0.02) - 2021/08/21 22:18:07 CET [2021/08/21 16:18:07 ET]
Table 'Halley' 6-max Seat #1 is the button
Seat 1: Chupacabra G ($1.78 in chips) 
Seat 2: zeraxer ($2.03 in chips) 
Seat 3: vovo4kapooh ($2.04 in chips) 
Seat 4: tolstii906 ($4.45 in chips) 
Seat 5: Agno$tic ($2.54 in chips) 
Seat 6: Scaaalll ($2.85 in chips) 
zeraxer: posts small blind $0.01
vovo4kapooh: posts big blind $0.02
*** HOLE CARDS ***
Dealt to Scaaalll [Jh 7c]
tolstii906: raises $0.02 to $0.04
Agno$tic: folds 
Scaaalll: folds 
Chupacabra G: folds 
zeraxer: raises $0.12 to $0.16
vovo4kapooh: folds 
tolstii906: calls $0.12
*** FLOP *** [9h 2c Qs]
zeraxer: bets $0.16
tolstii906: calls $0.16
*** TURN *** [9h 2c Qs] [Jc]
zeraxer: bets $0.34
tolstii906: calls $0.34
*** RIVER *** [9h 2c Qs Jc] [7h]
zeraxer: bets $1.37 and is all-in
tolstii906: folds 
Uncalled bet ($1.37) returned to zeraxer
zeraxer collected $1.29 from pot
zeraxer: doesn't show hand 
*** SUMMARY ***
Total pot $1.34 | Rake $0.05 
Board [9h 2c Qs Jc 7h]
Seat 1: Chupacabra G (button) folded before Flop (didn't bet)
Seat 2: zeraxer (small blind) collected ($1.29)
Seat 3: vovo4kapooh (big blind) folded before Flop
Seat 4: tolstii906 folded on the River
Seat 5: Agno$tic folded before Flop (didn't bet)
Seat 6: Scaaalll folded before Flop (didn't bet)



PokerStars Zoom Hand #229231554791:  Hold'em No Limit ($0.01/$0.02) - 2021/08/21 22:18:29 CET [2021/08/21 16:18:29 ET]
Table 'Halley' 6-max Seat #1 is the button
Seat 1: polymorhp ($3.49 in chips) 
Seat 2: EDJF1999 ($0.38 in chips) 
Seat 3: AndreaBsAs ($2.46 in chips) 
Seat 4: Scaaalll ($2.83 in chips) 
Seat 5: Blaackie ($3.92 in chips) 
Seat 6: texashenry2 ($2 in chips) 
EDJF1999: posts small blind $0.01
AndreaBsAs: posts big blind $0.02
*** HOLE CARDS ***
Dealt to Scaaalll [9c 4d]
Scaaalll: folds 
Blaackie: folds 
texashenry2: folds 
polymorhp: folds 
EDJF1999: calls $0.01
AndreaBsAs: raises $0.06 to $0.08
EDJF1999: raises $0.06 to $0.14
AndreaBsAs: calls $0.06
*** FLOP *** [3s As Jh]
EDJF1999: checks 
AndreaBsAs: bets $0.14
EDJF1999: raises $0.10 to $0.24 and is all-in
AndreaBsAs: calls $0.10
*** TURN *** [3s As Jh] [9s]
*** RIVER *** [3s As Jh 9s] [7s]
*** SHOW DOWN ***
EDJF1999: shows [Ac Ad] (three of a kind, Aces)
AndreaBsAs: shows [4s 4c] (a flush, Ace high)
AndreaBsAs collected $0.73 from pot
*** SUMMARY ***
Total pot $0.76 | Rake $0.03 
Board [3s As Jh 9s 7s]
Seat 1: polymorhp (button) folded before Flop (didn't bet)
Seat 2: EDJF1999 (small blind) showed [Ac Ad] and lost with three of a kind, Aces
Seat 3: AndreaBsAs (big blind) showed [4s 4c] and won ($0.73) with a flush, Ace high
Seat 4: Scaaalll folded before Flop (didn't bet)
Seat 5: Blaackie folded before Flop (didn't bet)
Seat 6: texashenry2 folded before Flop (didn't bet)



PokerStars Zoom Hand #229231557122:  Hold'em No Limit ($0.01/$0.02) - 2021/08/21 22:18:34 CET [2021/08/21 16:18:34 ET]
Table 'Halley' 6-max Seat #1 is the button
Seat 1: Herr.Hikke ($2.03 in chips) 
Seat 2: Scaaalll ($2.83 in chips) 
Seat 3: ricske68 ($4.88 in chips) 
Seat 4: Red Sky 15 ($9.77 in chips) 
Seat 5: Koldun 2636 ($3.03 in chips) 
Seat 6: maksim1-2012 ($0.96 in chips) 
Scaaalll: posts small blind $0.01
ricske68: posts big blind $0.02
*** HOLE CARDS ***
Dealt to Scaaalll [8c Kh]
Red Sky 15: raises $0.04 to $0.06
Koldun 2636: folds 
maksim1-2012: folds 
Herr.Hikke: raises $0.12 to $0.18
Scaaalll: folds 
ricske68: folds 
Red Sky 15: calls $0.12
*** FLOP *** [6d Qd 2d]
Red Sky 15: checks 
Herr.Hikke: checks 
*** TURN *** [6d Qd 2d] [2h]
Red Sky 15: bets $0.19
Herr.Hikke: calls $0.19
*** RIVER *** [6d Qd 2d 2h] [9s]
Red Sky 15: checks 
Herr.Hikke: bets $0.28
Red Sky 15: calls $0.28
*** SHOW DOWN ***
Herr.Hikke: shows [Ad Jd] (a flush, Ace high)
Red Sky 15: mucks hand 
Herr.Hikke collected $1.27 from pot
*** SUMMARY ***
Total pot $1.33 | Rake $0.06 
Board [6d Qd 2d 2h 9s]
Seat 1: Herr.Hikke (button) showed [Ad Jd] and won ($1.27) with a flush, Ace high
Seat 2: Scaaalll (small blind) folded before Flop
Seat 3: ricske68 (big blind) folded before Flop
Seat 4: Red Sky 15 mucked [Ah 6h]
Seat 5: Koldun 2636 folded before Flop (didn't bet)
Seat 6: maksim1-2012 folded before Flop (didn't bet)



PokerStars Zoom Hand #229231572895:  Hold'em No Limit ($0.01/$0.02) - 2021/08/21 22:19:08 CET [2021/08/21 16:19:08 ET]
Table 'Halley' 6-max Seat #1 is the button
Seat 1: RaulacateFolds ($2.51 in chips) 
Seat 2: RonilsonCosta ($2.19 in chips) 
Seat 3: BigTestIcicle ($4.98 in chips) 
Seat 4: Scaaalll ($2.78 in chips) 
Seat 5: juraa14 ($1.61 in chips) 
Seat 6: mheronmagno ($2.20 in chips) 
RonilsonCosta: posts small blind $0.01
BigTestIcicle: posts big blind $0.02
*** HOLE CARDS ***
Dealt to Scaaalll [As 5d]
Scaaalll has timed out
Scaaalll: folds 
juraa14: folds 
mheronmagno: folds 
RaulacateFolds: folds 
RonilsonCosta: raises $0.04 to $0.06
BigTestIcicle: folds 
Uncalled bet ($0.04) returned to RonilsonCosta
RonilsonCosta collected $0.04 from pot
RonilsonCosta: doesn't show hand 
*** SUMMARY ***
Total pot $0.04 | Rake $0 
Seat 1: RaulacateFolds (button) folded before Flop (didn't bet)
Seat 2: RonilsonCosta (small blind) collected ($0.04)
Seat 3: BigTestIcicle (big blind) folded before Flop
Seat 4: Scaaalll folded before Flop (didn't bet)
Seat 5: juraa14 folded before Flop (didn't bet)
Seat 6: mheronmagno folded before Flop (didn't bet)



PokerStars Zoom Hand #229231568663:  Hold'em No Limit ($0.01/$0.02) - 2021/08/21 22:18:59 CET [2021/08/21 16:18:59 ET]
Table 'Halley' 6-max Seat #1 is the button
Seat 1: Loto70 ($2.59 in chips) 
Seat 2: Flankeris ($11.43 in chips) 
Seat 3: shoker23 ($2 in chips) 
Seat 4: kaxerer ($1.57 in chips) 
Seat 5: Scaaalll ($2.78 in chips) 
Seat 6: ded serch ($2.01 in chips) 
Flankeris: posts small blind $0.01
shoker23: posts big blind $0.02
*** HOLE CARDS ***
Dealt to Scaaalll [3h Kc]
kaxerer: folds 
Scaaalll: folds 
ded serch: folds 
Loto70: folds 
Flankeris: raises $0.04 to $0.06
shoker23: calls $0.04
*** FLOP *** [Qs 4s Ad]
Flankeris: bets $0.08
shoker23: calls $0.08
*** TURN *** [Qs 4s Ad] [3d]
Flankeris: bets $0.18
shoker23: calls $0.18
*** RIVER *** [Qs 4s Ad 3d] [Qh]
Flankeris: checks 
shoker23: bets $0.31
Flankeris: folds 
Uncalled bet ($0.31) returned to shoker23
shoker23 collected $0.62 from pot
shoker23: doesn't show hand 
*** SUMMARY ***
Total pot $0.64 | Rake $0.02 
Board [Qs 4s Ad 3d Qh]
Seat 1: Loto70 (button) folded before Flop (didn't bet)
Seat 2: Flankeris (small blind) folded on the River
Seat 3: shoker23 (big blind) collected ($0.62)
Seat 4: kaxerer folded before Flop (didn't bet)
Seat 5: Scaaalll folded before Flop (didn't bet)
Seat 6: ded serch folded before Flop (didn't bet)



PokerStars Zoom Hand #229231580301:  Hold'em No Limit ($0.01/$0.02) - 2021/08/21 22:19:24 CET [2021/08/21 16:19:24 ET]
Table 'Halley' 6-max Seat #1 is the button
Seat 1: Mad_Clock ($2.99 in chips) 
Seat 2: kahzura ($2.19 in chips) 
Seat 3: Scaaalll ($2.78 in chips) 
Seat 4: LuckyCheewey ($6.76 in chips) 
Seat 5: Hallyson_23 ($4.78 in chips) 
Seat 6: tolstii906 ($3.76 in chips) 
kahzura: posts small blind $0.01
Scaaalll: posts big blind $0.02
*** HOLE CARDS ***
Dealt to Scaaalll [3d Jh]
LuckyCheewey: folds 
Hallyson_23: folds 
tolstii906: folds 
Mad_Clock: raises $0.05 to $0.07
kahzura: calls $0.06
Scaaalll: folds 
*** FLOP *** [Ac 8d 3c]
kahzura: checks 
Mad_Clock: bets $0.10
kahzura: folds 
Uncalled bet ($0.10) returned to Mad_Clock
Mad_Clock collected $0.15 from pot
Mad_Clock: doesn't show hand 
*** SUMMARY ***
Total pot $0.16 | Rake $0.01 
Board [Ac 8d 3c]
Seat 1: Mad_Clock (button) collected ($0.15)
Seat 2: kahzura (small blind) folded on the Flop
Seat 3: Scaaalll (big blind) folded before Flop
Seat 4: LuckyCheewey folded before Flop (didn't bet)
Seat 5: Hallyson_23 folded before Flop (didn't bet)
Seat 6: tolstii906 folded before Flop (didn't bet)



PokerStars Zoom Hand #229231593030:  Hold'em No Limit ($0.01/$0.02) - 2021/08/21 22:19:52 CET [2021/08/21 16:19:52 ET]
Table 'Halley' 6-max Seat #1 is the button
Seat 1: KonopDima ($2.03 in chips) 
Seat 2: Scaaalll ($2.76 in chips) 
Seat 3: kahzura ($2.26 in chips) 
Seat 4: fishh_play ($5.55 in chips) 
Seat 5: nemat_g ($2.54 in chips) 
Seat 6: LuckyCheewey ($9.07 in chips) 
Scaaalll: posts small blind $0.01
kahzura: posts big blind $0.02
*** HOLE CARDS ***
Dealt to Scaaalll [Qc 7h]
fishh_play: folds 
nemat_g: raises $0.04 to $0.06
LuckyCheewey: folds 
KonopDima: folds 
Scaaalll: folds 
kahzura: folds 
Uncalled bet ($0.04) returned to nemat_g
nemat_g collected $0.05 from pot
nemat_g: doesn't show hand 
*** SUMMARY ***
Total pot $0.05 | Rake $0 
Seat 1: KonopDima (button) folded before Flop (didn't bet)
Seat 2: Scaaalll (small blind) folded before Flop
Seat 3: kahzura (big blind) folded before Flop
Seat 4: fishh_play folded before Flop (didn't bet)
Seat 5: nemat_g collected ($0.05)
Seat 6: LuckyCheewey folded before Flop (didn't bet)



PokerStars Zoom Hand #229231590343:  Hold'em No Limit ($0.01/$0.02) - 2021/08/21 22:19:46 CET [2021/08/21 16:19:46 ET]
Table 'Halley' 6-max Seat #1 is the button
Seat 1: hubertott ($4.45 in chips) 
Seat 2: Healthys07 ($2.80 in chips) 
Seat 3: lucksuckdonk ($3.51 in chips) 
Seat 4: EmperorKurr ($2.53 in chips) 
Seat 5: Lamro50 ($6.61 in chips) 
Seat 6: Scaaalll ($2.76 in chips) 
Healthys07: posts small blind $0.01
lucksuckdonk: posts big blind $0.02
*** HOLE CARDS ***
Dealt to Scaaalll [6h Qh]
EmperorKurr: folds 
Lamro50: raises $0.04 to $0.06
Scaaalll: folds 
hubertott: folds 
Healthys07: folds 
lucksuckdonk: folds 
Uncalled bet ($0.04) returned to Lamro50
Lamro50 collected $0.05 from pot
Lamro50: doesn't show hand 
*** SUMMARY ***
Total pot $0.05 | Rake $0 
Seat 1: hubertott (button) folded before Flop (didn't bet)
Seat 2: Healthys07 (small blind) folded before Flop
Seat 3: lucksuckdonk (big blind) folded before Flop
Seat 4: EmperorKurr folded before Flop (didn't bet)
Seat 5: Lamro50 collected ($0.05)
Seat 6: Scaaalll folded before Flop (didn't bet)



PokerStars Zoom Hand #229231596705:  Hold'em No Limit ($0.01/$0.02) - 2021/08/21 22:20:00 CET [2021/08/21 16:20:00 ET]
Table 'Halley' 6-max Seat #1 is the button
Seat 1: Scaaalll ($2.75 in chips) 
Seat 2: Bufre ($2.21 in chips) 
Seat 3: Ahoy_04 ($0.96 in chips) 
Seat 4: byakuda ($4.80 in chips) 
Seat 5: rekopo203 ($2.09 in chips) 
Seat 6: Phoenixxxxxxxx ($2.01 in chips) 
Bufre: posts small blind $0.01
Ahoy_04: posts big blind $0.02
*** HOLE CARDS ***
Dealt to Scaaalll [6d 3h]
byakuda: folds 
rekopo203: folds 
Phoenixxxxxxxx: folds 
Scaaalll: folds 
Bufre: raises $0.03 to $0.05
Ahoy_04: calls $0.03
*** FLOP *** [Ts 8h 3d]
Bufre: checks 
Ahoy_04: checks 
*** TURN *** [Ts 8h 3d] [Jc]
Bufre: bets $0.05
Ahoy_04: folds 
Uncalled bet ($0.05) returned to Bufre
Bufre collected $0.10 from pot
Bufre: doesn't show hand 
*** SUMMARY ***
Total pot $0.10 | Rake $0 
Board [Ts 8h 3d Jc]
Seat 1: Scaaalll (button) folded before Flop (didn't bet)
Seat 2: Bufre (small blind) collected ($0.10)
Seat 3: Ahoy_04 (big blind) folded on the Turn
Seat 4: byakuda folded before Flop (didn't bet)
Seat 5: rekopo203 folded before Flop (didn't bet)
Seat 6: Phoenixxxxxxxx folded before Flop (didn't bet)



PokerStars Zoom Hand #229231605450:  Hold'em No Limit ($0.01/$0.02) - 2021/08/21 22:20:19 CET [2021/08/21 16:20:19 ET]
Table 'Halley' 6-max Seat #1 is the button
Seat 1: SIGREX ($2.63 in chips) 
Seat 2: FicheroQuit ($4.19 in chips) 
Seat 3: Scaaalll ($2.75 in chips) 
Seat 4: vovo4kapooh ($2.30 in chips) 
Seat 5: JTbukowski ($1.77 in chips) 
Seat 6: olga3021221 ($5.03 in chips) 
FicheroQuit: posts small blind $0.01
Scaaalll: posts big blind $0.02
*** HOLE CARDS ***
Dealt to Scaaalll [9d 8s]
vovo4kapooh: folds 
JTbukowski: calls $0.02
olga3021221: folds 
SIGREX: folds 
FicheroQuit: folds 
Scaaalll: checks 
*** FLOP *** [8d 8c Kh]
Scaaalll: bets $0.03
JTbukowski: folds 
Uncalled bet ($0.03) returned to Scaaalll
Scaaalll collected $0.05 from pot
Scaaalll: doesn't show hand 
*** SUMMARY ***
Total pot $0.05 | Rake $0 
Board [8d 8c Kh]
Seat 1: SIGREX (button) folded before Flop (didn't bet)
Seat 2: FicheroQuit (small blind) folded before Flop
Seat 3: Scaaalll (big blind) collected ($0.05)
Seat 4: vovo4kapooh folded before Flop (didn't bet)
Seat 5: JTbukowski folded on the Flop
Seat 6: olga3021221 folded before Flop (didn't bet)



PokerStars Zoom Hand #229231603647:  Hold'em No Limit ($0.01/$0.02) - 2021/08/21 22:20:15 CET [2021/08/21 16:20:15 ET]
Table 'Halley' 6-max Seat #1 is the button
Seat 1: Wegezin ($2.17 in chips) 
Seat 2: Daino G ($2.01 in chips) 
Seat 3: irina940 ($3.99 in chips) 
Seat 4: Scaaalll ($2.75 in chips) 
Seat 5: KoAlRy ($2.20 in chips) 
Seat 6: rodrigovini ($2.02 in chips) 
Daino G: posts small blind $0.01
irina940: posts big blind $0.02
*** HOLE CARDS ***
Dealt to Scaaalll [5s Js]
Scaaalll: folds 
KoAlRy: folds 
rodrigovini: folds 
Wegezin has timed out
Wegezin: folds 
Daino G: raises $0.03 to $0.05
irina940: calls $0.03
*** FLOP *** [Jd 6h Jc]
Daino G: checks 
irina940: bets $0.10
Daino G: folds 
Uncalled bet ($0.10) returned to irina940
irina940 collected $0.10 from pot
irina940: doesn't show hand 
*** SUMMARY ***
Total pot $0.10 | Rake $0 
Board [Jd 6h Jc]
Seat 1: Wegezin (button) folded before Flop (didn't bet)
Seat 2: Daino G (small blind) folded on the Flop
Seat 3: irina940 (big blind) collected ($0.10)
Seat 4: Scaaalll folded before Flop (didn't bet)
Seat 5: KoAlRy folded before Flop (didn't bet)
Seat 6: rodrigovini folded before Flop (didn't bet)



PokerStars Zoom Hand #229231616466:  Hold'em No Limit ($0.01/$0.02) - 2021/08/21 22:20:43 CET [2021/08/21 16:20:43 ET]
Table 'Halley' 6-max Seat #1 is the button
Seat 1: ciucibaby ($4.46 in chips) 
Seat 2: Clavis Noa ($3.06 in chips) 
Seat 3: EevAA190 ($2.45 in chips) 
Seat 4: Tony-Broke ($2 in chips) 
Seat 5: Scaaalll ($2.78 in chips) 
Seat 6: zielony ($2.38 in chips) 
Clavis Noa: posts small blind $0.01
EevAA190: posts big blind $0.02
*** HOLE CARDS ***
Dealt to Scaaalll [Js As]
Tony-Broke: folds 
Scaaalll: raises $0.04 to $0.06
zielony: folds 
ciucibaby: folds 
Clavis Noa: folds 
EevAA190: folds 
Uncalled bet ($0.04) returned to Scaaalll
Scaaalll collected $0.05 from pot
Scaaalll: doesn't show hand 
*** SUMMARY ***
Total pot $0.05 | Rake $0 
Seat 1: ciucibaby (button) folded before Flop (didn't bet)
Seat 2: Clavis Noa (small blind) folded before Flop
Seat 3: EevAA190 (big blind) folded before Flop
Seat 4: Tony-Broke folded before Flop (didn't bet)
Seat 5: Scaaalll collected ($0.05)
Seat 6: zielony folded before Flop (didn't bet)



PokerStars Zoom Hand #229231621686:  Hold'em No Limit ($0.01/$0.02) - 2021/08/21 22:20:54 CET [2021/08/21 16:20:54 ET]
Table 'Halley' 6-max Seat #1 is the button
Seat 1: MirkoV224 ($1.51 in chips) 
Seat 2: Kergie ($14.57 in chips) 
Seat 3: Rafaxn ($2.06 in chips) 
Seat 4: EmperorKurr ($2.74 in chips) 
Seat 5: Bufre ($3.33 in chips) 
Seat 6: Scaaalll ($2.81 in chips) 
Kergie: posts small blind $0.01
Rafaxn: posts big blind $0.02
*** HOLE CARDS ***
Dealt to Scaaalll [9d 9c]
EmperorKurr: folds 
Bufre: folds 
Scaaalll: raises $0.04 to $0.06
MirkoV224: folds 
Kergie: folds 
Rafaxn: calls $0.04
*** FLOP *** [4h Th Kc]
Rafaxn: checks 
Scaaalll: bets $0.08
Rafaxn: folds 
Uncalled bet ($0.08) returned to Scaaalll
Scaaalll collected $0.13 from pot
Scaaalll: doesn't show hand 
*** SUMMARY ***
Total pot $0.13 | Rake $0 
Board [4h Th Kc]
Seat 1: MirkoV224 (button) folded before Flop (didn't bet)
Seat 2: Kergie (small blind) folded before Flop
Seat 3: Rafaxn (big blind) folded on the Flop
Seat 4: EmperorKurr folded before Flop (didn't bet)
Seat 5: Bufre folded before Flop (didn't bet)
Seat 6: Scaaalll collected ($0.13)



PokerStars Zoom Hand #229231631983:  Hold'em No Limit ($0.01/$0.02) - 2021/08/21 22:21:17 CET [2021/08/21 16:21:17 ET]
Table 'Halley' 6-max Seat #1 is the button
Seat 1: Scaaalll ($2.88 in chips) 
Seat 2: xxVanquishxx ($1.95 in chips) 
Seat 3: kboskov123 ($1.64 in chips) 
Seat 4: shingo594 ($3.65 in chips) 
Seat 5: NoEff0rt2w1n ($2.37 in chips) 
Seat 6: Sergant20081 ($3.91 in chips) 
xxVanquishxx: posts small blind $0.01
kboskov123: posts big blind $0.02
*** HOLE CARDS ***
Dealt to Scaaalll [5c Ks]
shingo594: folds 
NoEff0rt2w1n: folds 
shingo594 is disconnected 
Sergant20081: folds 
Scaaalll: folds 
xxVanquishxx: folds 
Uncalled bet ($0.01) returned to kboskov123
kboskov123 collected $0.02 from pot
kboskov123: doesn't show hand 
*** SUMMARY ***
Total pot $0.02 | Rake $0 
Seat 1: Scaaalll (button) folded before Flop (didn't bet)
Seat 2: xxVanquishxx (small blind) folded before Flop
Seat 3: kboskov123 (big blind) collected ($0.02)
Seat 4: shingo594 folded before Flop (didn't bet)
Seat 5: NoEff0rt2w1n folded before Flop (didn't bet)
Seat 6: Sergant20081 folded before Flop (didn't bet)



PokerStars Zoom Hand #229231637947:  Hold'em No Limit ($0.01/$0.02) - 2021/08/21 22:21:30 CET [2021/08/21 16:21:30 ET]
Table 'Halley' 6-max Seat #1 is the button
Seat 1: robokop358 ($1.05 in chips) 
Seat 2: 888lifeIS ($2 in chips) 
Seat 3: HirotoBeats ($1.94 in chips) 
Seat 4: Scaaalll ($2.87 in chips) 
Seat 5: uniicecube ($2.70 in chips) 
Seat 6: FicheroQuit ($4.13 in chips) 
888lifeIS: posts small blind $0.01
HirotoBeats: posts big blind $0.02
*** HOLE CARDS ***
Dealt to Scaaalll [9d Jc]
Scaaalll: folds 
uniicecube: folds 
FicheroQuit: folds 
robokop358: calls $0.02
888lifeIS: folds 
HirotoBeats: checks 
*** FLOP *** [8h Kd 4c]
HirotoBeats: checks 
robokop358: bets $0.04
HirotoBeats: calls $0.04
*** TURN *** [8h Kd 4c] [5d]
HirotoBeats: checks 
robokop358: bets $0.10
HirotoBeats: folds 
Uncalled bet ($0.10) returned to robokop358
robokop358 collected $0.13 from pot
robokop358: doesn't show hand 
*** SUMMARY ***
Total pot $0.13 | Rake $0 
Board [8h Kd 4c 5d]
Seat 1: robokop358 (button) collected ($0.13)
Seat 2: 888lifeIS (small blind) folded before Flop
Seat 3: HirotoBeats (big blind) folded on the Turn
Seat 4: Scaaalll folded before Flop (didn't bet)
Seat 5: uniicecube folded before Flop (didn't bet)
Seat 6: FicheroQuit folded before Flop (didn't bet)



PokerStars Zoom Hand #229231633838:  Hold'em No Limit ($0.01/$0.02) - 2021/08/21 22:21:21 CET [2021/08/21 16:21:21 ET]
Table 'Halley' 6-max Seat #1 is the button
Seat 1: Kkamm ($2.11 in chips) 
Seat 2: Scaaalll ($2.88 in chips) 
Seat 3: pokershevela ($2.19 in chips) 
Seat 4: HellNative ($2.34 in chips) 
Seat 5: boa juice ($2.45 in chips) 
Seat 6: Tn 939 ($2.08 in chips) 
Scaaalll: posts small blind $0.01
pokershevela: posts big blind $0.02
*** HOLE CARDS ***
Dealt to Scaaalll [Kc 3d]
HellNative: folds 
boa juice: folds 
boa juice is disconnected 
Tn 939: raises $0.04 to $0.06
Kkamm: folds 
Scaaalll: folds 
pokershevela: folds 
Uncalled bet ($0.04) returned to Tn 939
Tn 939 collected $0.05 from pot
Tn 939: doesn't show hand 
pokershevela is disconnected 
*** SUMMARY ***
Total pot $0.05 | Rake $0 
Seat 1: Kkamm (button) folded before Flop (didn't bet)
Seat 2: Scaaalll (small blind) folded before Flop
Seat 3: pokershevela (big blind) folded before Flop
Seat 4: HellNative folded before Flop (didn't bet)
Seat 5: boa juice folded before Flop (didn't bet)
Seat 6: Tn 939 collected ($0.05)



PokerStars Zoom Hand #229231639775:  Hold'em No Limit ($0.01/$0.02) - 2021/08/21 22:21:34 CET [2021/08/21 16:21:34 ET]
Table 'Halley' 6-max Seat #1 is the button
Seat 1: igara tigara ($7.10 in chips) 
Seat 2: bossquaid ($2.50 in chips) 
Seat 3: RonilsonCosta ($2.03 in chips) 
Seat 4: ARTMVSLV ($4.11 in chips) 
Seat 5: Luben_76 ($2.50 in chips) 
Seat 6: Scaaalll ($2.87 in chips) 
bossquaid: posts small blind $0.01
RonilsonCosta: posts big blind $0.02
*** HOLE CARDS ***
Dealt to Scaaalll [Ah 7h]
ARTMVSLV: raises $0.02 to $0.04
Luben_76: folds 
Scaaalll: calls $0.04
igara tigara: folds 
bossquaid: folds 
RonilsonCosta: folds 
*** FLOP *** [Jd 5h 3c]
ARTMVSLV: bets $0.03
Scaaalll: folds 
Uncalled bet ($0.03) returned to ARTMVSLV
ARTMVSLV collected $0.11 from pot
ARTMVSLV: doesn't show hand 
*** SUMMARY ***
Total pot $0.11 | Rake $0 
Board [Jd 5h 3c]
Seat 1: igara tigara (button) folded before Flop (didn't bet)
Seat 2: bossquaid (small blind) folded before Flop
Seat 3: RonilsonCosta (big blind) folded before Flop
Seat 4: ARTMVSLV collected ($0.11)
Seat 5: Luben_76 folded before Flop (didn't bet)
Seat 6: Scaaalll folded on the Flop



PokerStars Zoom Hand #229231650136:  Hold'em No Limit ($0.01/$0.02) - 2021/08/21 22:21:57 CET [2021/08/21 16:21:57 ET]
Table 'Halley' 6-max Seat #1 is the button
Seat 1: felipeciji ($2 in chips) 
Seat 2: polymorhp ($3.54 in chips) 
Seat 3: BlackhawKK's ($3.68 in chips) 
Seat 4: Feliciano16 ($3.76 in chips) 
Seat 5: Scaaalll ($2.83 in chips) 
Seat 6: Agno$tic ($2.29 in chips) 
polymorhp: posts small blind $0.01
BlackhawKK's: posts big blind $0.02
*** HOLE CARDS ***
Dealt to Scaaalll [2c 6d]
Feliciano16: raises $0.04 to $0.06
Scaaalll: folds 
Agno$tic has timed out
Agno$tic: folds 
felipeciji: folds 
polymorhp: raises $0.18 to $0.24
BlackhawKK's: folds 
Feliciano16: calls $0.18
*** FLOP *** [7h 9d 3d]
polymorhp: bets $0.38
Feliciano16: raises $3.14 to $3.52 and is all-in
polymorhp: calls $2.92 and is all-in
Uncalled bet ($0.22) returned to Feliciano16
*** FIRST TURN *** [7h 9d 3d] [8c]
*** FIRST RIVER *** [7h 9d 3d 8c] [8s]
*** SECOND TURN *** [7h 9d 3d] [Ah]
*** SECOND RIVER *** [7h 9d 3d Ah] [Ks]
*** FIRST SHOW DOWN ***
polymorhp: shows [Qs Qh] (two pair, Queens and Eights)
Feliciano16: shows [3h 3s] (a full house, Threes full of Eights)
Feliciano16 collected $3.43 from pot
*** SECOND SHOW DOWN ***
polymorhp: shows [Qs Qh] (a pair of Queens)
Feliciano16: shows [3h 3s] (three of a kind, Threes)
Feliciano16 collected $3.42 from pot
*** SUMMARY ***
Total pot $7.10 | Rake $0.25 
Hand was run twice
FIRST Board [7h 9d 3d 8c 8s]
SECOND Board [7h 9d 3d Ah Ks]
Seat 1: felipeciji (button) folded before Flop (didn't bet)
Seat 2: polymorhp (small blind) showed [Qs Qh] and lost with two pair, Queens and Eights, and lost with a pair of Queens
Seat 3: BlackhawKK's (big blind) folded before Flop
Seat 4: Feliciano16 showed [3h 3s] and won ($3.43) with a full house, Threes full of Eights, and won ($3.42) with three of a kind, Threes
Seat 5: Scaaalll folded before Flop (didn't bet)
Seat 6: Agno$tic folded before Flop (didn't bet)



PokerStars Zoom Hand #229231660707:  Hold'em No Limit ($0.01/$0.02) - 2021/08/21 22:22:20 CET [2021/08/21 16:22:20 ET]
Table 'Halley' 6-max Seat #1 is the button
Seat 1: byakuda ($4.67 in chips) 
Seat 2: BlackhawKK's ($3.66 in chips) 
Seat 3: Scaaalll ($2.83 in chips) 
Seat 4: guntren.ps ($2.09 in chips) 
Seat 5: RoughRafff ($3.23 in chips) 
Seat 6: Jujiluju ($1.97 in chips) 
BlackhawKK's: posts small blind $0.01
Scaaalll: posts big blind $0.02
*** HOLE CARDS ***
Dealt to Scaaalll [7s Qc]
guntren.ps: folds 
RoughRafff: folds 
Jujiluju: calls $0.02
byakuda: calls $0.02
BlackhawKK's: folds 
Scaaalll: checks 
*** FLOP *** [9c Ks 5c]
Scaaalll: checks 
Jujiluju: checks 
byakuda: checks 
*** TURN *** [9c Ks 5c] [3s]
Scaaalll: checks 
Jujiluju: checks 
byakuda: bets $0.05
Scaaalll: folds 
Jujiluju: folds 
Uncalled bet ($0.05) returned to byakuda
byakuda collected $0.07 from pot
byakuda: doesn't show hand 
*** SUMMARY ***
Total pot $0.07 | Rake $0 
Board [9c Ks 5c 3s]
Seat 1: byakuda (button) collected ($0.07)
Seat 2: BlackhawKK's (small blind) folded before Flop
Seat 3: Scaaalll (big blind) folded on the Turn
Seat 4: guntren.ps folded before Flop (didn't bet)
Seat 5: RoughRafff folded before Flop (didn't bet)
Seat 6: Jujiluju folded on the Turn



PokerStars Zoom Hand #229231680448:  Hold'em No Limit ($0.01/$0.02) - 2021/08/21 22:23:03 CET [2021/08/21 16:23:03 ET]
Table 'Halley' 6-max Seat #1 is the button
Seat 1: malandro733 ($6.76 in chips) 
Seat 2: Scaaalll ($2.81 in chips) 
Seat 3: BenOKopen ($2.06 in chips) 
Seat 4: felipeciji ($2.15 in chips) 
Seat 5: mati-face ($1.03 in chips) 
Seat 6: Daino G ($2.09 in chips) 
Scaaalll: posts small blind $0.01
BenOKopen: posts big blind $0.02
*** HOLE CARDS ***
Dealt to Scaaalll [3h Qc]
felipeciji: folds 
mati-face: folds 
Daino G: folds 
malandro733: folds 
Scaaalll: folds 
Uncalled bet ($0.01) returned to BenOKopen
BenOKopen collected $0.02 from pot
BenOKopen: doesn't show hand 
*** SUMMARY ***
Total pot $0.02 | Rake $0 
Seat 1: malandro733 (button) folded before Flop (didn't bet)
Seat 2: Scaaalll (small blind) folded before Flop
Seat 3: BenOKopen (big blind) collected ($0.02)
Seat 4: felipeciji folded before Flop (didn't bet)
Seat 5: mati-face folded before Flop (didn't bet)
Seat 6: Daino G folded before Flop (didn't bet)



PokerStars Zoom Hand #229231685868:  Hold'em No Limit ($0.01/$0.02) - 2021/08/21 22:23:15 CET [2021/08/21 16:23:15 ET]
Table 'Halley' 6-max Seat #1 is the button
Seat 1: polymorhp ($2.01 in chips) 
Seat 2: Davingo25 ($1.95 in chips) 
Seat 3: NoEff0rt2w1n ($2.36 in chips) 
Seat 4: Scaaalll ($2.80 in chips) 
Seat 5: 888lifeIS ($2.18 in chips) 
Seat 6: sg.32rus ($1.71 in chips) 
Davingo25: posts small blind $0.01
NoEff0rt2w1n: posts big blind $0.02
*** HOLE CARDS ***
Dealt to Scaaalll [9d 3s]
Davingo25 is disconnected 
Scaaalll: folds 
888lifeIS: folds 
sg.32rus: folds 
polymorhp: folds 
Davingo25: folds 
Uncalled bet ($0.01) returned to NoEff0rt2w1n
NoEff0rt2w1n collected $0.02 from pot
NoEff0rt2w1n: doesn't show hand 
*** SUMMARY ***
Total pot $0.02 | Rake $0 
Seat 1: polymorhp (button) folded before Flop (didn't bet)
Seat 2: Davingo25 (small blind) folded before Flop
Seat 3: NoEff0rt2w1n (big blind) collected ($0.02)
Seat 4: Scaaalll folded before Flop (didn't bet)
Seat 5: 888lifeIS folded before Flop (didn't bet)
Seat 6: sg.32rus folded before Flop (didn't bet)



PokerStars Zoom Hand #229231655707:  Hold'em No Limit ($0.01/$0.02) - 2021/08/21 22:22:09 CET [2021/08/21 16:22:09 ET]
Table 'Halley' 6-max Seat #1 is the button
Seat 1: Scaaalll ($2.83 in chips) 
Seat 2: HubertFroh ($2.70 in chips) 
Seat 3: fellowes1 ($2.03 in chips) 
Seat 4: bananAAbandit ($2.75 in chips) 
Seat 5: ser313131 ($2.44 in chips) 
Seat 6: alexan00 ($1.84 in chips) 
HubertFroh: posts small blind $0.01
fellowes1: posts big blind $0.02
*** HOLE CARDS ***
Dealt to Scaaalll [2c 8d]
bananAAbandit: folds 
ser313131: calls $0.02
alexan00: folds 
Scaaalll: folds 
HubertFroh: folds 
fellowes1: checks 
*** FLOP *** [Tc Ad 5s]
fellowes1 has timed out
fellowes1: checks 
ser313131: bets $0.02
fellowes1: calls $0.02
*** TURN *** [Tc Ad 5s] [Qc]
fellowes1: checks 
ser313131: checks 
*** RIVER *** [Tc Ad 5s Qc] [9s]
fellowes1: bets $0.09
ser313131: folds 
Uncalled bet ($0.09) returned to fellowes1
fellowes1 collected $0.09 from pot
fellowes1: doesn't show hand 
*** SUMMARY ***
Total pot $0.09 | Rake $0 
Board [Tc Ad 5s Qc 9s]
Seat 1: Scaaalll (button) folded before Flop (didn't bet)
Seat 2: HubertFroh (small blind) folded before Flop
Seat 3: fellowes1 (big blind) collected ($0.09)
Seat 4: bananAAbandit folded before Flop (didn't bet)
Seat 5: ser313131 folded on the River
Seat 6: alexan00 folded before Flop (didn't bet)



PokerStars Zoom Hand #229231682249:  Hold'em No Limit ($0.01/$0.02) - 2021/08/21 22:23:07 CET [2021/08/21 16:23:07 ET]
Table 'Halley' 6-max Seat #1 is the button
Seat 1: gy67 ($2.04 in chips) 
Seat 2: h3cTics ($1.54 in chips) 
Seat 3: PECASPKS ($2.64 in chips) 
Seat 4: HellNative ($2.30 in chips) 
Seat 5: elmex886 ($2.85 in chips) 
Seat 6: Scaaalll ($2.80 in chips) 
h3cTics: posts small blind $0.01
PECASPKS: posts big blind $0.02
*** HOLE CARDS ***
Dealt to Scaaalll [4s 9d]
HellNative: folds 
elmex886: folds 
Scaaalll: folds 
gy67: folds 
h3cTics: calls $0.01
PECASPKS: checks 
*** FLOP *** [Kd 5h Qd]
h3cTics: bets $0.02
PECASPKS: folds 
Uncalled bet ($0.02) returned to h3cTics
h3cTics collected $0.04 from pot
h3cTics: doesn't show hand 
*** SUMMARY ***
Total pot $0.04 | Rake $0 
Board [Kd 5h Qd]
Seat 1: gy67 (button) folded before Flop (didn't bet)
Seat 2: h3cTics (small blind) collected ($0.04)
Seat 3: PECASPKS (big blind) folded on the Flop
Seat 4: HellNative folded before Flop (didn't bet)
Seat 5: elmex886 folded before Flop (didn't bet)
Seat 6: Scaaalll folded before Flop (didn't bet)



PokerStars Zoom Hand #229231689580:  Hold'em No Limit ($0.01/$0.02) - 2021/08/21 22:23:23 CET [2021/08/21 16:23:23 ET]
Table 'Halley' 6-max Seat #1 is the button
Seat 1: Scaaalll ($2.80 in chips) 
Seat 2: LucasG155 ($3.12 in chips) 
Seat 3: 77omsk ($3.78 in chips) 
Seat 4: amario89 ($2.82 in chips) 
Seat 5: keb1981 ($2.73 in chips) 
Seat 6: kamikaze2017 ($2 in chips) 
LucasG155: posts small blind $0.01
77omsk: posts big blind $0.02
*** HOLE CARDS ***
Dealt to Scaaalll [Qs 8d]
amario89: folds 
keb1981: folds 
kamikaze2017: folds 
kamikaze2017 is disconnected 
Scaaalll: raises $0.02 to $0.04
LucasG155: folds 
77omsk: folds 
Uncalled bet ($0.02) returned to Scaaalll
Scaaalll collected $0.05 from pot
Scaaalll: doesn't show hand 
*** SUMMARY ***
Total pot $0.05 | Rake $0 
Seat 1: Scaaalll (button) collected ($0.05)
Seat 2: LucasG155 (small blind) folded before Flop
Seat 3: 77omsk (big blind) folded before Flop
Seat 4: amario89 folded before Flop (didn't bet)
Seat 5: keb1981 folded before Flop (didn't bet)
Seat 6: kamikaze2017 folded before Flop (didn't bet)



PokerStars Zoom Hand #229231684065:  Hold'em No Limit ($0.01/$0.02) - 2021/08/21 22:23:11 CET [2021/08/21 16:23:11 ET]
Table 'Halley' 6-max Seat #1 is the button
Seat 1: NIK1973 23 ($2.19 in chips) 
Seat 2: robokop358 ($0.95 in chips) 
Seat 3: Tibelloni ($0.87 in chips) 
Seat 4: pipecmolodec ($2.37 in chips) 
Seat 5: Scaaalll ($2.80 in chips) 
Seat 6: MirkoV224 ($1.55 in chips) 
robokop358: posts small blind $0.01
Tibelloni: posts big blind $0.02
*** HOLE CARDS ***
Dealt to Scaaalll [2h Jd]
pipecmolodec: folds 
Scaaalll: folds 
MirkoV224: folds 
NIK1973 23: raises $0.04 to $0.06
robokop358: folds 
Tibelloni: calls $0.04
*** FLOP *** [Qs 6c Tc]
Tibelloni: checks 
NIK1973 23: bets $0.07
Tibelloni: calls $0.07
*** TURN *** [Qs 6c Tc] [Jc]
Tibelloni: checks 
NIK1973 23: checks 
*** RIVER *** [Qs 6c Tc Jc] [Ts]
Tibelloni: checks 
NIK1973 23: checks 
*** SHOW DOWN ***
Tibelloni: shows [Jh Qd] (two pair, Queens and Jacks)
NIK1973 23: shows [Ah Ac] (two pair, Aces and Tens)
NIK1973 23 collected $0.26 from pot
*** SUMMARY ***
Total pot $0.27 | Rake $0.01 
Board [Qs 6c Tc Jc Ts]
Seat 1: NIK1973 23 (button) showed [Ah Ac] and won ($0.26) with two pair, Aces and Tens
Seat 2: robokop358 (small blind) folded before Flop
Seat 3: Tibelloni (big blind) showed [Jh Qd] and lost with two pair, Queens and Jacks
Seat 4: pipecmolodec folded before Flop (didn't bet)
Seat 5: Scaaalll folded before Flop (didn't bet)
Seat 6: MirkoV224 folded before Flop (didn't bet)



PokerStars Zoom Hand #229231696740:  Hold'em No Limit ($0.01/$0.02) - 2021/08/21 22:23:39 CET [2021/08/21 16:23:39 ET]
Table 'Halley' 6-max Seat #1 is the button
Seat 1: sewq55 ($1.21 in chips) 
Seat 2: Fanatspartak ($1.05 in chips) 
Seat 3: Scaaalll ($2.83 in chips) 
Seat 4: KonopDima ($2.16 in chips) 
Seat 5: WITKOW_AV ($2 in chips) 
Seat 6: jejmcclu ($2.03 in chips) 
Fanatspartak: posts small blind $0.01
Scaaalll: posts big blind $0.02
*** HOLE CARDS ***
Dealt to Scaaalll [3d 4h]
KonopDima: folds 
WITKOW_AV: folds 
jejmcclu: raises $0.03 to $0.05
sewq55: folds 
Fanatspartak: calls $0.04
Scaaalll: folds 
*** FLOP *** [5h Ac Td]
Fanatspartak: bets $0.06
jejmcclu: folds 
Uncalled bet ($0.06) returned to Fanatspartak
Fanatspartak collected $0.12 from pot
Fanatspartak: doesn't show hand 
*** SUMMARY ***
Total pot $0.12 | Rake $0 
Board [5h Ac Td]
Seat 1: sewq55 (button) folded before Flop (didn't bet)
Seat 2: Fanatspartak (small blind) collected ($0.12)
Seat 3: Scaaalll (big blind) folded before Flop
Seat 4: KonopDima folded before Flop (didn't bet)
Seat 5: WITKOW_AV folded before Flop (didn't bet)
Seat 6: jejmcclu folded on the Flop



PokerStars Zoom Hand #229231705883:  Hold'em No Limit ($0.01/$0.02) - 2021/08/21 22:23:59 CET [2021/08/21 16:23:59 ET]
Table 'Halley' 6-max Seat #1 is the button
Seat 1: lucksuckdonk ($1.95 in chips) 
Seat 2: SKV_1985 ($2.38 in chips) 
Seat 3: rzn62665 ($1.75 in chips) 
Seat 4: IWMTW ($1.46 in chips) 
Seat 5: Scaaalll ($2.81 in chips) 
Seat 6: PapiMik3 ($2.76 in chips) 
SKV_1985: posts small blind $0.01
rzn62665: posts big blind $0.02
*** HOLE CARDS ***
Dealt to Scaaalll [7d 6h]
IWMTW: folds 
Scaaalll: folds 
PapiMik3: folds 
lucksuckdonk: raises $0.04 to $0.06
SKV_1985: folds 
rzn62665: folds 
Uncalled bet ($0.04) returned to lucksuckdonk
lucksuckdonk collected $0.05 from pot
lucksuckdonk: doesn't show hand 
*** SUMMARY ***
Total pot $0.05 | Rake $0 
Seat 1: lucksuckdonk (button) collected ($0.05)
Seat 2: SKV_1985 (small blind) folded before Flop
Seat 3: rzn62665 (big blind) folded before Flop
Seat 4: IWMTW folded before Flop (didn't bet)
Seat 5: Scaaalll folded before Flop (didn't bet)
Seat 6: PapiMik3 folded before Flop (didn't bet)



PokerStars Zoom Hand #229231710524:  Hold'em No Limit ($0.01/$0.02) - 2021/08/21 22:24:09 CET [2021/08/21 16:24:09 ET]
Table 'Halley' 6-max Seat #1 is the button
Seat 1: Lacitoo ($2.15 in chips) 
Seat 2: F_oksi(BLR) ($1.64 in chips) 
Seat 3: ADWish ($1.94 in chips) 
Seat 4: z3317111711 ($2.65 in chips) 
Seat 5: 888lifeIS ($2 in chips) 
Seat 6: Scaaalll ($2.80 in chips) 
F_oksi(BLR): posts small blind $0.01
ADWish: posts big blind $0.02
*** HOLE CARDS ***
Dealt to Scaaalll [Jc 6c]
Lacitoo is disconnected 
z3317111711: folds 
888lifeIS: folds 
Scaaalll: folds 
Lacitoo: folds 
F_oksi(BLR): folds 
Uncalled bet ($0.01) returned to ADWish
ADWish collected $0.02 from pot
ADWish: doesn't show hand 
*** SUMMARY ***
Total pot $0.02 | Rake $0 
Seat 1: Lacitoo (button) folded before Flop (didn't bet)
Seat 2: F_oksi(BLR) (small blind) folded before Flop
Seat 3: ADWish (big blind) collected ($0.02)
Seat 4: z3317111711 folded before Flop (didn't bet)
Seat 5: 888lifeIS folded before Flop (didn't bet)
Seat 6: Scaaalll folded before Flop (didn't bet)



PokerStars Zoom Hand #229231714985:  Hold'em No Limit ($0.01/$0.02) - 2021/08/21 22:24:19 CET [2021/08/21 16:24:19 ET]
Table 'Halley' 6-max Seat #1 is the button
Seat 1: Fanatspartak ($1.12 in chips) 
Seat 2: Flankeris ($2.21 in chips) 
Seat 3: Jujiluju ($1.88 in chips) 
Seat 4: Scaaalll ($2.80 in chips) 
Seat 5: Begon505 ($0.78 in chips) 
Seat 6: Mikmaq Caper ($0.89 in chips) 
Flankeris: posts small blind $0.01
Jujiluju: posts big blind $0.02
*** HOLE CARDS ***
Dealt to Scaaalll [6s Jd]
Scaaalll: folds 
Begon505: folds 
Mikmaq Caper: folds 
Fanatspartak: folds 
Mikmaq Caper is disconnected 
Flankeris: raises $0.04 to $0.06
Jujiluju: folds 
Uncalled bet ($0.04) returned to Flankeris
Flankeris collected $0.04 from pot
Flankeris: doesn't show hand 
*** SUMMARY ***
Total pot $0.04 | Rake $0 
Seat 1: Fanatspartak (button) folded before Flop (didn't bet)
Seat 2: Flankeris (small blind) collected ($0.04)
Seat 3: Jujiluju (big blind) folded before Flop
Seat 4: Scaaalll folded before Flop (didn't bet)
Seat 5: Begon505 folded before Flop (didn't bet)
Seat 6: Mikmaq Caper folded before Flop (didn't bet)



PokerStars Zoom Hand #229231708231:  Hold'em No Limit ($0.01/$0.02) - 2021/08/21 22:24:04 CET [2021/08/21 16:24:04 ET]
Table 'Halley' 6-max Seat #1 is the button
Seat 1: Chapaev136 ($2.76 in chips) 
Seat 2: Scaaalll ($2.81 in chips) 
Seat 3: nodtress ($2 in chips) 
Seat 4: BenOKopen ($2.17 in chips) 
Seat 5: BadBeat Bert ($2.15 in chips) 
Seat 6: Thaleshs ($2.68 in chips) 
Scaaalll: posts small blind $0.01
nodtress: posts big blind $0.02
*** HOLE CARDS ***
Dealt to Scaaalll [8s 6c]
BenOKopen: raises $0.03 to $0.05
BadBeat Bert: folds 
Thaleshs: calls $0.05
Chapaev136: folds 
Scaaalll: folds 
nodtress: folds 
*** FLOP *** [5s 3s 8d]
BenOKopen: checks 
Thaleshs: checks 
*** TURN *** [5s 3s 8d] [2d]
BenOKopen: checks 
Thaleshs: checks 
*** RIVER *** [5s 3s 8d 2d] [2h]
BenOKopen: bets $0.06
Thaleshs: folds 
Uncalled bet ($0.06) returned to BenOKopen
BenOKopen collected $0.13 from pot
BenOKopen: doesn't show hand 
*** SUMMARY ***
Total pot $0.13 | Rake $0 
Board [5s 3s 8d 2d 2h]
Seat 1: Chapaev136 (button) folded before Flop (didn't bet)
Seat 2: Scaaalll (small blind) folded before Flop
Seat 3: nodtress (big blind) folded before Flop
Seat 4: BenOKopen collected ($0.13)
Seat 5: BadBeat Bert folded before Flop (didn't bet)
Seat 6: Thaleshs folded on the River



PokerStars Zoom Hand #229231713207:  Hold'em No Limit ($0.01/$0.02) - 2021/08/21 22:24:15 CET [2021/08/21 16:24:15 ET]
Table 'Halley' 6-max Seat #1 is the button
Seat 1: robokop358 ($0.91 in chips) 
Seat 2: olcham7 ($2.90 in chips) 
Seat 3: CROVOSOS-1978 ($3.88 in chips) 
Seat 4: rpycmbEM ($4.09 in chips) 
Seat 5: Scaaalll ($2.80 in chips) 
Seat 6: EdwardF95 ($2 in chips) 
olcham7: posts small blind $0.01
CROVOSOS-1978: posts big blind $0.02
*** HOLE CARDS ***
Dealt to Scaaalll [Qd 5d]
rpycmbEM: raises $0.03 to $0.05
Scaaalll: folds 
EdwardF95: folds 
robokop358: folds 
olcham7: folds 
CROVOSOS-1978: raises $0.15 to $0.20
rpycmbEM: calls $0.15
*** FLOP *** [8s 7d 2d]
CROVOSOS-1978: bets $0.20
rpycmbEM: calls $0.20
*** TURN *** [8s 7d 2d] [Ts]
CROVOSOS-1978: bets $0.39
rpycmbEM: calls $0.39
*** RIVER *** [8s 7d 2d Ts] [Td]
CROVOSOS-1978: checks 
rpycmbEM: checks 
*** SHOW DOWN ***
CROVOSOS-1978: shows [8h Qs] (two pair, Tens and Eights)
rpycmbEM: shows [9c 9d] (two pair, Tens and Nines)
rpycmbEM collected $1.53 from pot
*** SUMMARY ***
Total pot $1.59 | Rake $0.06 
Board [8s 7d 2d Ts Td]
Seat 1: robokop358 (button) folded before Flop (didn't bet)
Seat 2: olcham7 (small blind) folded before Flop
Seat 3: CROVOSOS-1978 (big blind) showed [8h Qs] and lost with two pair, Tens and Eights
Seat 4: rpycmbEM showed [9c 9d] and won ($1.53) with two pair, Tens and Nines
Seat 5: Scaaalll folded before Flop (didn't bet)
Seat 6: EdwardF95 folded before Flop (didn't bet)



PokerStars Zoom Hand #229231716831:  Hold'em No Limit ($0.01/$0.02) - 2021/08/21 22:24:23 CET [2021/08/21 16:24:23 ET]
Table 'Halley' 6-max Seat #1 is the button
Seat 1: Dr.stromg ($2.51 in chips) 
Seat 2: nippurkaunas ($0.87 in chips) 
Seat 3: Scaaalll ($2.80 in chips) 
Seat 4: Smailodon ($1.26 in chips) 
Seat 5: guntren.ps ($2.16 in chips) 
Seat 6: Vanekakqj ($1.53 in chips) 
nippurkaunas: posts small blind $0.01
Scaaalll: posts big blind $0.02
*** HOLE CARDS ***
Dealt to Scaaalll [Qd Js]
Smailodon: folds 
guntren.ps: folds 
Vanekakqj: raises $0.02 to $0.04
Dr.stromg: folds 
nippurkaunas: calls $0.03
Scaaalll: calls $0.02
*** FLOP *** [Th Kd Ad]
nippurkaunas: checks 
Scaaalll: bets $0.08
Vanekakqj: calls $0.08
nippurkaunas: folds 
*** TURN *** [Th Kd Ad] [Td]
Scaaalll: bets $0.16
Vanekakqj: calls $0.16
*** RIVER *** [Th Kd Ad Td] [2h]
Scaaalll: bets $0.34
Vanekakqj: folds 
Uncalled bet ($0.34) returned to Scaaalll
Scaaalll collected $0.58 from pot
Scaaalll: doesn't show hand 
*** SUMMARY ***
Total pot $0.60 | Rake $0.02 
Board [Th Kd Ad Td 2h]
Seat 1: Dr.stromg (button) folded before Flop (didn't bet)
Seat 2: nippurkaunas (small blind) folded on the Flop
Seat 3: Scaaalll (big blind) collected ($0.58)
Seat 4: Smailodon folded before Flop (didn't bet)
Seat 5: guntren.ps folded before Flop (didn't bet)
Seat 6: Vanekakqj folded on the River



PokerStars Zoom Hand #229231746822:  Hold'em No Limit ($0.01/$0.02) - 2021/08/21 22:25:29 CET [2021/08/21 16:25:29 ET]
Table 'Halley' 6-max Seat #1 is the button
Seat 1: Scaaalll ($3.10 in chips) 
Seat 2: LuckyCheewey ($6.49 in chips) 
Seat 3: tazar34_777 ($2.19 in chips) 
Seat 4: kboskov123 ($2.95 in chips) 
Seat 5: arturtsutsaev ($1.29 in chips) 
Seat 6: 78joniboy ($2 in chips) 
LuckyCheewey: posts small blind $0.01
tazar34_777: posts big blind $0.02
*** HOLE CARDS ***
Dealt to Scaaalll [7d 4d]
kboskov123: folds 
arturtsutsaev: folds 
arturtsutsaev is disconnected 
78joniboy: folds 
Scaaalll: raises $0.02 to $0.04
LuckyCheewey: folds 
tazar34_777: calls $0.02
*** FLOP *** [4s Jc Ac]
tazar34_777: checks 
Scaaalll: bets $0.06
tazar34_777: folds 
Uncalled bet ($0.06) returned to Scaaalll
Scaaalll collected $0.09 from pot
Scaaalll: doesn't show hand 
*** SUMMARY ***
Total pot $0.09 | Rake $0 
Board [4s Jc Ac]
Seat 1: Scaaalll (button) collected ($0.09)
Seat 2: LuckyCheewey (small blind) folded before Flop
Seat 3: tazar34_777 (big blind) folded on the Flop
Seat 4: kboskov123 folded before Flop (didn't bet)
Seat 5: arturtsutsaev folded before Flop (didn't bet)
Seat 6: 78joniboy folded before Flop (didn't bet)



PokerStars Zoom Hand #229231760739:  Hold'em No Limit ($0.01/$0.02) - 2021/08/21 22:25:59 CET [2021/08/21 16:25:59 ET]
Table 'Halley' 6-max Seat #1 is the button
Seat 1: EevAA190 ($2 in chips) 
Seat 2: ded serch ($2.19 in chips) 
Seat 3: Scaaalll ($3.15 in chips) 
Seat 4: py100ta ($17.89 in chips) 
Seat 5: ca$hmeoutsid ($2.49 in chips) 
Seat 6: vitorbom222 ($1.19 in chips) 
ded serch: posts small blind $0.01
Scaaalll: posts big blind $0.02
*** HOLE CARDS ***
Dealt to Scaaalll [Ts 2d]
py100ta: folds 
ca$hmeoutsid: folds 
vitorbom222: calls $0.02
EevAA190: folds 
ded serch: folds 
Scaaalll: checks 
*** FLOP *** [6h 9d 9h]
Scaaalll: checks 
vitorbom222: bets $0.05
Scaaalll: folds 
Uncalled bet ($0.05) returned to vitorbom222
vitorbom222 collected $0.05 from pot
vitorbom222: doesn't show hand 
*** SUMMARY ***
Total pot $0.05 | Rake $0 
Board [6h 9d 9h]
Seat 1: EevAA190 (button) folded before Flop (didn't bet)
Seat 2: ded serch (small blind) folded before Flop
Seat 3: Scaaalll (big blind) folded on the Flop
Seat 4: py100ta folded before Flop (didn't bet)
Seat 5: ca$hmeoutsid folded before Flop (didn't bet)
Seat 6: vitorbom222 collected ($0.05)



PokerStars Zoom Hand #229231759149:  Hold'em No Limit ($0.01/$0.02) - 2021/08/21 22:25:56 CET [2021/08/21 16:25:56 ET]
Table 'Halley' 6-max Seat #1 is the button
Seat 1: Kreodont1987 ($2.10 in chips) 
Seat 2: Larson_mfk ($1.05 in chips) 
Seat 3: Axel201388 ($1.41 in chips) 
Seat 4: Scaaalll ($3.15 in chips) 
Seat 5: slipknot956 ($2.67 in chips) 
Seat 6: marcoshig864 ($3.28 in chips) 
Larson_mfk: posts small blind $0.01
Axel201388: posts big blind $0.02
*** HOLE CARDS ***
Dealt to Scaaalll [6c 3d]
Scaaalll: folds 
slipknot956: raises $0.04 to $0.06
marcoshig864: folds 
Kreodont1987: folds 
Larson_mfk: folds 
Larson_mfk is disconnected 
Axel201388: calls $0.04
*** FLOP *** [8d Jh Th]
Axel201388: checks 
slipknot956: bets $0.13
Axel201388: folds 
Uncalled bet ($0.13) returned to slipknot956
slipknot956 collected $0.13 from pot
slipknot956: doesn't show hand 
*** SUMMARY ***
Total pot $0.13 | Rake $0 
Board [8d Jh Th]
Seat 1: Kreodont1987 (button) folded before Flop (didn't bet)
Seat 2: Larson_mfk (small blind) folded before Flop
Seat 3: Axel201388 (big blind) folded on the Flop
Seat 4: Scaaalll folded before Flop (didn't bet)
Seat 5: slipknot956 collected ($0.13)
Seat 6: marcoshig864 folded before Flop (didn't bet)



PokerStars Zoom Hand #229231776421:  Hold'em No Limit ($0.01/$0.02) - 2021/08/21 22:26:34 CET [2021/08/21 16:26:34 ET]
Table 'Halley' 6-max Seat #1 is the button
Seat 1: Flankeris ($6.27 in chips) 
Seat 2: Healthys07 ($2.10 in chips) 
Seat 3: Dulli007 ($5.27 in chips) 
Seat 4: Kb013497 ($1.83 in chips) 
Seat 5: HirotoBeats ($1.54 in chips) 
Seat 6: Scaaalll ($3.12 in chips) 
Healthys07: posts small blind $0.01
Dulli007: posts big blind $0.02
*** HOLE CARDS ***
Dealt to Scaaalll [6d 8c]
Kb013497: folds 
HirotoBeats: folds 
Scaaalll: folds 
Flankeris: folds 
Healthys07: folds 
Uncalled bet ($0.01) returned to Dulli007
Dulli007 collected $0.02 from pot
Dulli007: doesn't show hand 
*** SUMMARY ***
Total pot $0.02 | Rake $0 
Seat 1: Flankeris (button) folded before Flop (didn't bet)
Seat 2: Healthys07 (small blind) folded before Flop
Seat 3: Dulli007 (big blind) collected ($0.02)
Seat 4: Kb013497 folded before Flop (didn't bet)
Seat 5: HirotoBeats folded before Flop (didn't bet)
Seat 6: Scaaalll folded before Flop (didn't bet)



PokerStars Zoom Hand #229231778245:  Hold'em No Limit ($0.01/$0.02) - 2021/08/21 22:26:38 CET [2021/08/21 16:26:38 ET]
Table 'Halley' 6-max Seat #1 is the button
Seat 1: KareAAAA ($1.78 in chips) 
Seat 2: HellNative ($2.44 in chips) 
Seat 3: Adalis1 ($0.94 in chips) 
Seat 4: Scaaalll ($3.12 in chips) 
Seat 5: kahzura ($2.19 in chips) 
Seat 6: ZNFR77 ($0.59 in chips) 
HellNative: posts small blind $0.01
Adalis1: posts big blind $0.02
*** HOLE CARDS ***
Dealt to Scaaalll [6s Tc]
Scaaalll: folds 
kahzura: raises $0.04 to $0.06
ZNFR77: folds 
KareAAAA: raises $0.13 to $0.19
HellNative: folds 
Adalis1: folds 
kahzura: folds 
Uncalled bet ($0.13) returned to KareAAAA
KareAAAA collected $0.15 from pot
KareAAAA: doesn't show hand 
*** SUMMARY ***
Total pot $0.15 | Rake $0 
Seat 1: KareAAAA (button) collected ($0.15)
Seat 2: HellNative (small blind) folded before Flop
Seat 3: Adalis1 (big blind) folded before Flop
Seat 4: Scaaalll folded before Flop (didn't bet)
Seat 5: kahzura folded before Flop
Seat 6: ZNFR77 folded before Flop (didn't bet)



PokerStars Zoom Hand #229231773735:  Hold'em No Limit ($0.01/$0.02) - 2021/08/21 22:26:28 CET [2021/08/21 16:26:28 ET]
Table 'Halley' 6-max Seat #1 is the button
Seat 1: Dr.stromg ($2.01 in chips) 
Seat 2: Scaaalll ($3.13 in chips) 
Seat 3: ppluiaule ($3.89 in chips) 
Seat 4: NoEff0rt2w1n ($2 in chips) 
Seat 5: TomoKondo ($2.14 in chips) 
Seat 6: PapiMik3 ($2.59 in chips) 
Scaaalll: posts small blind $0.01
ppluiaule: posts big blind $0.02
*** HOLE CARDS ***
Dealt to Scaaalll [4c 8c]
NoEff0rt2w1n: raises $0.03 to $0.05
TomoKondo: folds 
PapiMik3: raises $0.11 to $0.16
Dr.stromg: folds 
Scaaalll: folds 
ppluiaule: folds 
NoEff0rt2w1n: calls $0.11
*** FLOP *** [7d Qc Qs]
NoEff0rt2w1n: checks 
PapiMik3: checks 
*** TURN *** [7d Qc Qs] [3c]
NoEff0rt2w1n: bets $0.20
PapiMik3: calls $0.20
*** RIVER *** [7d Qc Qs 3c] [Kc]
NoEff0rt2w1n: checks 
PapiMik3: bets $0.54
NoEff0rt2w1n: folds 
Uncalled bet ($0.54) returned to PapiMik3
PapiMik3 collected $0.72 from pot
PapiMik3: doesn't show hand 
*** SUMMARY ***
Total pot $0.75 | Rake $0.03 
Board [7d Qc Qs 3c Kc]
Seat 1: Dr.stromg (button) folded before Flop (didn't bet)
Seat 2: Scaaalll (small blind) folded before Flop
Seat 3: ppluiaule (big blind) folded before Flop
Seat 4: NoEff0rt2w1n folded on the River
Seat 5: TomoKondo folded before Flop (didn't bet)
Seat 6: PapiMik3 collected ($0.72)



PokerStars Zoom Hand #229231780024:  Hold'em No Limit ($0.01/$0.02) - 2021/08/21 22:26:42 CET [2021/08/21 16:26:42 ET]
Table 'Halley' 6-max Seat #1 is the button
Seat 1: Scaaalll ($3.12 in chips) 
Seat 2: SGALINAE ($1.69 in chips) 
Seat 3: elmex886 ($2 in chips) 
Seat 4: Agno$tic ($2.08 in chips) 
Seat 5: ARS_POLI13 ($2.43 in chips) 
Seat 6: JBPY ($1.64 in chips) 
SGALINAE: posts small blind $0.01
elmex886: posts big blind $0.02
*** HOLE CARDS ***
Dealt to Scaaalll [Js 7d]
Agno$tic: folds 
ARS_POLI13: folds 
JBPY: folds 
Scaaalll: raises $0.02 to $0.04
SGALINAE: calls $0.03
elmex886: folds 
*** FLOP *** [Th 4h 2h]
SGALINAE: checks 
Scaaalll: bets $0.06
SGALINAE: folds 
Uncalled bet ($0.06) returned to Scaaalll
Scaaalll collected $0.10 from pot
Scaaalll: doesn't show hand 
*** SUMMARY ***
Total pot $0.10 | Rake $0 
Board [Th 4h 2h]
Seat 1: Scaaalll (button) collected ($0.10)
Seat 2: SGALINAE (small blind) folded on the Flop
Seat 3: elmex886 (big blind) folded before Flop
Seat 4: Agno$tic folded before Flop (didn't bet)
Seat 5: ARS_POLI13 folded before Flop (didn't bet)
Seat 6: JBPY folded before Flop (didn't bet)



PokerStars Zoom Hand #229231796399:  Hold'em No Limit ($0.01/$0.02) - 2021/08/21 22:27:10 CET [2021/08/21 16:27:10 ET]
Table 'Halley' 6-max Seat #1 is the button
Seat 1: KonopDima ($2.06 in chips) 
Seat 2: BigTestIcicle ($3.33 in chips) 
Seat 3: Andnet ($2 in chips) 
Seat 4: Flyboi92 ($1.83 in chips) 
Seat 5: Scaaalll ($3.18 in chips) 
Seat 6: guntren.ps ($2.56 in chips) 
BigTestIcicle: posts small blind $0.01
Andnet: posts big blind $0.02
*** HOLE CARDS ***
Dealt to Scaaalll [As Kc]
Flyboi92: folds 
Flyboi92 is disconnected 
Scaaalll: raises $0.04 to $0.06
guntren.ps: folds 
KonopDima: folds 
BigTestIcicle: folds 
Andnet: raises $0.15 to $0.21
Scaaalll: calls $0.15
*** FLOP *** [Qs 9c Ac]
Andnet: bets $0.14
Scaaalll: calls $0.14
*** TURN *** [Qs 9c Ac] [Td]
Andnet: bets $0.23
Scaaalll: calls $0.23
*** RIVER *** [Qs 9c Ac Td] [8h]
Andnet: bets $1.42 and is all-in
Scaaalll: folds 
Uncalled bet ($1.42) returned to Andnet
Andnet collected $1.13 from pot
Andnet: doesn't show hand 
*** SUMMARY ***
Total pot $1.17 | Rake $0.04 
Board [Qs 9c Ac Td 8h]
Seat 1: KonopDima (button) folded before Flop (didn't bet)
Seat 2: BigTestIcicle (small blind) folded before Flop
Seat 3: Andnet (big blind) collected ($1.13)
Seat 4: Flyboi92 folded before Flop (didn't bet)
Seat 5: Scaaalll folded on the River
Seat 6: guntren.ps folded before Flop (didn't bet)



PokerStars Zoom Hand #229231831335:  Hold'em No Limit ($0.01/$0.02) - 2021/08/21 22:28:27 CET [2021/08/21 16:28:27 ET]
Table 'Halley' 6-max Seat #1 is the button
Seat 1: Reipinguimm ($2.35 in chips) 
Seat 2: A.luckebeggr ($3.27 in chips) 
Seat 3: Scaaalll ($2.59 in chips) 
Seat 4: sewq55 ($0.55 in chips) 
Seat 5: vovo4kapooh ($2 in chips) 
Seat 6: SaRCh_Ale ($2 in chips) 
A.luckebeggr: posts small blind $0.01
Scaaalll: posts big blind $0.02
*** HOLE CARDS ***
Dealt to Scaaalll [4h 6d]
sewq55: folds 
vovo4kapooh: folds 
SaRCh_Ale: folds 
Reipinguimm: folds 
A.luckebeggr: folds 
Uncalled bet ($0.01) returned to Scaaalll
Scaaalll collected $0.02 from pot
Scaaalll: doesn't show hand 
*** SUMMARY ***
Total pot $0.02 | Rake $0 
Seat 1: Reipinguimm (button) folded before Flop (didn't bet)
Seat 2: A.luckebeggr (small blind) folded before Flop
Seat 3: Scaaalll (big blind) collected ($0.02)
Seat 4: sewq55 folded before Flop (didn't bet)
Seat 5: vovo4kapooh folded before Flop (didn't bet)
Seat 6: SaRCh_Ale folded before Flop (didn't bet)



PokerStars Zoom Hand #229231824543:  Hold'em No Limit ($0.01/$0.02) - 2021/08/21 22:28:12 CET [2021/08/21 16:28:12 ET]
Table 'Halley' 6-max Seat #1 is the button
Seat 1: xxRoseIloveu ($8.50 in chips) 
Seat 2: Scaaalll ($2.60 in chips) 
Seat 3: IIDARKROBOTII ($2.44 in chips) 
Seat 4: Ebbelwoiexp ($2 in chips) 
Seat 5: EdwardF95 ($2.47 in chips) 
Seat 6: Henry Chinasky ($1.16 in chips) 
Scaaalll: posts small blind $0.01
IIDARKROBOTII: posts big blind $0.02
*** HOLE CARDS ***
Dealt to Scaaalll [5s 8s]
Ebbelwoiexp: folds 
Ebbelwoiexp is disconnected 
EdwardF95: folds 
Henry Chinasky: raises $0.04 to $0.06
xxRoseIloveu: folds 
Scaaalll: folds 
IIDARKROBOTII: raises $0.13 to $0.19
Henry Chinasky: raises $0.13 to $0.32
IIDARKROBOTII: folds 
Uncalled bet ($0.13) returned to Henry Chinasky
Henry Chinasky collected $0.39 from pot
Henry Chinasky: doesn't show hand 
IIDARKROBOTII is disconnected 
*** SUMMARY ***
Total pot $0.39 | Rake $0 
Seat 1: xxRoseIloveu (button) folded before Flop (didn't bet)
Seat 2: Scaaalll (small blind) folded before Flop
Seat 3: IIDARKROBOTII (big blind) folded before Flop
Seat 4: Ebbelwoiexp folded before Flop (didn't bet)
Seat 5: EdwardF95 folded before Flop (didn't bet)
Seat 6: Henry Chinasky collected ($0.39)



PokerStars Zoom Hand #229231835330:  Hold'em No Limit ($0.01/$0.02) - 2021/08/21 22:28:36 CET [2021/08/21 16:28:36 ET]
Table 'Halley' 6-max Seat #1 is the button
Seat 1: NoEff0rt2w1n ($3.96 in chips) 
Seat 2: Tacojesuscrisp ($2 in chips) 
Seat 3: Davingo25 ($1.98 in chips) 
Seat 4: ppluiaule ($3.88 in chips) 
Seat 5: golfffffer ($1.07 in chips) 
Seat 6: Scaaalll ($2.60 in chips) 
Tacojesuscrisp: posts small blind $0.01
Davingo25: posts big blind $0.02
*** HOLE CARDS ***
Dealt to Scaaalll [Ts Ac]
ppluiaule: folds 
golfffffer: raises $0.04 to $0.06
Scaaalll: folds 
NoEff0rt2w1n: folds 
Davingo25 is disconnected 
Tacojesuscrisp: folds 
Davingo25: folds 
Uncalled bet ($0.04) returned to golfffffer
golfffffer collected $0.05 from pot
golfffffer: doesn't show hand 
*** SUMMARY ***
Total pot $0.05 | Rake $0 
Seat 1: NoEff0rt2w1n (button) folded before Flop (didn't bet)
Seat 2: Tacojesuscrisp (small blind) folded before Flop
Seat 3: Davingo25 (big blind) folded before Flop
Seat 4: ppluiaule folded before Flop (didn't bet)
Seat 5: golfffffer collected ($0.05)
Seat 6: Scaaalll folded before Flop (didn't bet)



PokerStars Zoom Hand #229231839888:  Hold'em No Limit ($0.01/$0.02) - 2021/08/21 22:28:46 CET [2021/08/21 16:28:46 ET]
Table 'Halley' 6-max Seat #1 is the button
Seat 1: pipecmolodec ($2 in chips) 
Seat 2: roukoun1984 ($1.51 in chips) 
Seat 3: dominik7315 ($3.22 in chips) 
Seat 4: Scaaalll ($2.60 in chips) 
Seat 5: Kergie ($15.42 in chips) 
Seat 6: stealth_ua ($2 in chips) 
roukoun1984: posts small blind $0.01
dominik7315: posts big blind $0.02
*** HOLE CARDS ***
Dealt to Scaaalll [Jh 9h]
Scaaalll: raises $0.04 to $0.06
Kergie: folds 
stealth_ua: folds 
dominik7315 is disconnected 
roukoun1984 is disconnected 
pipecmolodec: folds 
roukoun1984: folds 
dominik7315: folds 
Uncalled bet ($0.04) returned to Scaaalll
Scaaalll collected $0.05 from pot
Scaaalll: doesn't show hand 
*** SUMMARY ***
Total pot $0.05 | Rake $0 
Seat 1: pipecmolodec (button) folded before Flop (didn't bet)
Seat 2: roukoun1984 (small blind) folded before Flop
Seat 3: dominik7315 (big blind) folded before Flop
Seat 4: Scaaalll collected ($0.05)
Seat 5: Kergie folded before Flop (didn't bet)
Seat 6: stealth_ua folded before Flop (didn't bet)



PokerStars Zoom Hand #229231845753:  Hold'em No Limit ($0.01/$0.02) - 2021/08/21 22:28:59 CET [2021/08/21 16:28:59 ET]
Table 'Halley' 6-max Seat #1 is the button
Seat 1: le_vlimeux ($2.53 in chips) 
Seat 2: Scaaalll ($2.63 in chips) 
Seat 3: storo98 ($17.17 in chips) 
Seat 4: ulvitev ($1.97 in chips) 
Seat 5: bananAAbandit ($3.18 in chips) 
Seat 6: SKV_1985 ($3.22 in chips) 
Scaaalll: posts small blind $0.01
storo98: posts big blind $0.02
*** HOLE CARDS ***
Dealt to Scaaalll [3s 6h]
ulvitev: folds 
ulvitev is disconnected 
bananAAbandit: raises $0.04 to $0.06
SKV_1985: folds 
le_vlimeux: folds 
Scaaalll: folds 
storo98: folds 
Uncalled bet ($0.04) returned to bananAAbandit
bananAAbandit collected $0.05 from pot
bananAAbandit: doesn't show hand 
*** SUMMARY ***
Total pot $0.05 | Rake $0 
Seat 1: le_vlimeux (button) folded before Flop (didn't bet)
Seat 2: Scaaalll (small blind) folded before Flop
Seat 3: storo98 (big blind) folded before Flop
Seat 4: ulvitev folded before Flop (didn't bet)
Seat 5: bananAAbandit collected ($0.05)
Seat 6: SKV_1985 folded before Flop (didn't bet)



PokerStars Zoom Hand #229231848879:  Hold'em No Limit ($0.01/$0.02) - 2021/08/21 22:29:06 CET [2021/08/21 16:29:06 ET]
Table 'Halley' 6-max Seat #1 is the button
Seat 1: Scaaalll ($2.62 in chips) 
Seat 2: bbarao ($2.67 in chips) 
Seat 3: TomoKondo ($2.05 in chips) 
Seat 4: Simon190713 ($5.62 in chips) 
Seat 5: rodrigovini ($2 in chips) 
Seat 6: yannikdaehne ($7.39 in chips) 
bbarao: posts small blind $0.01
TomoKondo: posts big blind $0.02
*** HOLE CARDS ***
Dealt to Scaaalll [3c 7s]
Simon190713: folds 
Simon190713 is disconnected 
rodrigovini: folds 
yannikdaehne: raises $0.03 to $0.05
Scaaalll: folds 
bbarao: raises $0.12 to $0.17
TomoKondo: folds 
yannikdaehne: calls $0.12
*** FLOP *** [9d 2d 2c]
bbarao: checks 
yannikdaehne: checks 
*** TURN *** [9d 2d 2c] [Kh]
bbarao: bets $0.20
yannikdaehne: folds 
Uncalled bet ($0.20) returned to bbarao
bbarao collected $0.35 from pot
bbarao: doesn't show hand 
*** SUMMARY ***
Total pot $0.36 | Rake $0.01 
Board [9d 2d 2c Kh]
Seat 1: Scaaalll (button) folded before Flop (didn't bet)
Seat 2: bbarao (small blind) collected ($0.35)
Seat 3: TomoKondo (big blind) folded before Flop
Seat 4: Simon190713 folded before Flop (didn't bet)
Seat 5: rodrigovini folded before Flop (didn't bet)
Seat 6: yannikdaehne folded on the Turn



PokerStars Zoom Hand #229231852831:  Hold'em No Limit ($0.01/$0.02) - 2021/08/21 22:29:15 CET [2021/08/21 16:29:15 ET]
Table 'Halley' 6-max Seat #1 is the button
Seat 1: Ne0net ($2.01 in chips) 
Seat 2: gesaes ($1.02 in chips) 
Seat 3: pokershevela ($2.50 in chips) 
Seat 4: Chapaev136 ($2.85 in chips) 
Seat 5: BexleyBoy ($1.95 in chips) 
Seat 6: Scaaalll ($2.62 in chips) 
gesaes: posts small blind $0.01
pokershevela: posts big blind $0.02
*** HOLE CARDS ***
Dealt to Scaaalll [Qd Ts]
Chapaev136: folds 
BexleyBoy: folds 
Scaaalll: raises $0.04 to $0.06
Ne0net: folds 
gesaes: calls $0.05
pokershevela: calls $0.04
*** FLOP *** [4c Qc 2h]
gesaes: checks 
pokershevela: checks 
Scaaalll: bets $0.10
gesaes: calls $0.10
pokershevela: calls $0.10
*** TURN *** [4c Qc 2h] [Th]
gesaes: checks 
pokershevela: checks 
Scaaalll: bets $0.30
gesaes: calls $0.30
pokershevela: calls $0.30
*** RIVER *** [4c Qc 2h Th] [5d]
gesaes: checks 
pokershevela: checks 
Scaaalll: bets $1
gesaes: folds 
pokershevela: folds 
Uncalled bet ($1) returned to Scaaalll
Scaaalll collected $1.32 from pot
Scaaalll: doesn't show hand 
pokershevela is disconnected 
*** SUMMARY ***
Total pot $1.38 | Rake $0.06 
Board [4c Qc 2h Th 5d]
Seat 1: Ne0net (button) folded before Flop (didn't bet)
Seat 2: gesaes (small blind) folded on the River
Seat 3: pokershevela (big blind) folded on the River
Seat 4: Chapaev136 folded before Flop (didn't bet)
Seat 5: BexleyBoy folded before Flop (didn't bet)
Seat 6: Scaaalll collected ($1.32)



PokerStars Zoom Hand #229231897099:  Hold'em No Limit ($0.01/$0.02) - 2021/08/21 22:30:53 CET [2021/08/21 16:30:53 ET]
Table 'Halley' 6-max Seat #1 is the button
Seat 1: GamblersDream ($2 in chips) 
Seat 2: pavlo8855 ($2 in chips) 
Seat 3: ca$hmeoutsid ($2.20 in chips) 
Seat 4: Tabitaji ($2.66 in chips) 
Seat 5: Scaaalll ($3.48 in chips) 
Seat 6: Umnik_M ($1.79 in chips) 
pavlo8855: posts small blind $0.01
ca$hmeoutsid: posts big blind $0.02
*** HOLE CARDS ***
Dealt to Scaaalll [7h 2d]
Tabitaji: raises $0.04 to $0.06
Scaaalll: folds 
Umnik_M: folds 
GamblersDream: calls $0.06
pavlo8855: folds 
ca$hmeoutsid: folds 
*** FLOP *** [2h 7s 8d]
Tabitaji: checks 
GamblersDream: bets $0.05
Tabitaji: calls $0.05
*** TURN *** [2h 7s 8d] [Jh]
Tabitaji: checks 
GamblersDream: checks 
*** RIVER *** [2h 7s 8d Jh] [3s]
Tabitaji: bets $0.06
GamblersDream: folds 
Uncalled bet ($0.06) returned to Tabitaji
Tabitaji collected $0.24 from pot
Tabitaji: doesn't show hand 
*** SUMMARY ***
Total pot $0.25 | Rake $0.01 
Board [2h 7s 8d Jh 3s]
Seat 1: GamblersDream (button) folded on the River
Seat 2: pavlo8855 (small blind) folded before Flop
Seat 3: ca$hmeoutsid (big blind) folded before Flop
Seat 4: Tabitaji collected ($0.24)
Seat 5: Scaaalll folded before Flop (didn't bet)
Seat 6: Umnik_M folded before Flop (didn't bet)



PokerStars Zoom Hand #229231900201:  Hold'em No Limit ($0.01/$0.02) - 2021/08/21 22:31:00 CET [2021/08/21 16:31:00 ET]
Table 'Halley' 6-max Seat #1 is the button
Seat 1: fran2291 ($2.36 in chips) 
Seat 2: sewq55 ($1.47 in chips) 
Seat 3: Scaaalll ($3.48 in chips) 
Seat 4: olga3021221 ($4.81 in chips) 
Seat 5: JTbukowski ($2.16 in chips) 
Seat 6: mnozz83 ($1.35 in chips) 
sewq55: posts small blind $0.01
Scaaalll: posts big blind $0.02
*** HOLE CARDS ***
Dealt to Scaaalll [5c Kh]
olga3021221: folds 
JTbukowski: folds 
mnozz83: calls $0.02
fran2291: calls $0.02
sewq55: folds 
Scaaalll: checks 
*** FLOP *** [3h As 7h]
Scaaalll: checks 
mnozz83: checks 
fran2291: checks 
*** TURN *** [3h As 7h] [Th]
Scaaalll: checks 
mnozz83: checks 
fran2291: bets $0.07
Scaaalll: folds 
mnozz83: folds 
Uncalled bet ($0.07) returned to fran2291
fran2291 collected $0.07 from pot
fran2291: doesn't show hand 
*** SUMMARY ***
Total pot $0.07 | Rake $0 
Board [3h As 7h Th]
Seat 1: fran2291 (button) collected ($0.07)
Seat 2: sewq55 (small blind) folded before Flop
Seat 3: Scaaalll (big blind) folded on the Turn
Seat 4: olga3021221 folded before Flop (didn't bet)
Seat 5: JTbukowski folded before Flop (didn't bet)
Seat 6: mnozz83 folded on the Turn



PokerStars Zoom Hand #229231924050:  Hold'em No Limit ($0.01/$0.02) - 2021/08/21 22:31:53 CET [2021/08/21 16:31:53 ET]
Table 'Halley' 6-max Seat #1 is the button
Seat 1: olga3021221 ($4.75 in chips) 
Seat 2: fran2291 ($2.15 in chips) 
Seat 3: Artezito ($2 in chips) 
Seat 4: rpycmbEM ($4.54 in chips) 
Seat 5: Scaaalll ($3.46 in chips) 
Seat 6: JTbukowski ($2.10 in chips) 
fran2291: posts small blind $0.01
Artezito: posts big blind $0.02
*** HOLE CARDS ***
Dealt to Scaaalll [8d Ah]
rpycmbEM: folds 
Scaaalll: folds 
JTbukowski: folds 
olga3021221: folds 
fran2291: folds 
Uncalled bet ($0.01) returned to Artezito
Artezito collected $0.02 from pot
Artezito: doesn't show hand 
*** SUMMARY ***
Total pot $0.02 | Rake $0 
Seat 1: olga3021221 (button) folded before Flop (didn't bet)
Seat 2: fran2291 (small blind) folded before Flop
Seat 3: Artezito (big blind) collected ($0.02)
Seat 4: rpycmbEM folded before Flop (didn't bet)
Seat 5: Scaaalll folded before Flop (didn't bet)
Seat 6: JTbukowski folded before Flop (didn't bet)



PokerStars Zoom Hand #229231926838:  Hold'em No Limit ($0.01/$0.02) - 2021/08/21 22:31:59 CET [2021/08/21 16:31:59 ET]
Table 'Halley' 6-max Seat #1 is the button
Seat 1: rpycmbEM ($3.65 in chips) 
Seat 2: Scaaalll ($3.46 in chips) 
Seat 3: Dr.stromg ($2.58 in chips) 
Seat 4: 48159348 ($3.60 in chips) 
Seat 5: Artezito ($2 in chips) 
Seat 6: rodrigoasor ($2.07 in chips) 
Scaaalll: posts small blind $0.01
Dr.stromg: posts big blind $0.02
*** HOLE CARDS ***
Dealt to Scaaalll [As 9d]
48159348: folds 
Artezito: folds 
rodrigoasor: folds 
rpycmbEM: folds 
Scaaalll: folds 
Uncalled bet ($0.01) returned to Dr.stromg
Dr.stromg collected $0.02 from pot
Dr.stromg: doesn't show hand 
*** SUMMARY ***
Total pot $0.02 | Rake $0 
Seat 1: rpycmbEM (button) folded before Flop (didn't bet)
Seat 2: Scaaalll (small blind) folded before Flop
Seat 3: Dr.stromg (big blind) collected ($0.02)
Seat 4: 48159348 folded before Flop (didn't bet)
Seat 5: Artezito folded before Flop (didn't bet)
Seat 6: rodrigoasor folded before Flop (didn't bet)



PokerStars Zoom Hand #229231929994:  Hold'em No Limit ($0.01/$0.02) - 2021/08/21 22:32:06 CET [2021/08/21 16:32:06 ET]
Table 'Halley' 6-max Seat #1 is the button
Seat 1: AlexGTPS ($2.64 in chips) 
Seat 2: Artezito ($2.01 in chips) 
Seat 3: maurivispa10 ($3.52 in chips) 
Seat 4: Scaaalll ($3.45 in chips) 
Seat 5: Daino G ($2 in chips) 
Seat 6: zbixxx ($4.12 in chips) 
Artezito: posts small blind $0.01
maurivispa10: posts big blind $0.02
*** HOLE CARDS ***
Dealt to Scaaalll [Qd 8h]
Scaaalll: folds 
Daino G: raises $0.03 to $0.05
zbixxx: folds 
AlexGTPS: folds 
Artezito: folds 
maurivispa10: folds 
Uncalled bet ($0.03) returned to Daino G
Daino G collected $0.05 from pot
Daino G: doesn't show hand 
*** SUMMARY ***
Total pot $0.05 | Rake $0 
Seat 1: AlexGTPS (button) folded before Flop (didn't bet)
Seat 2: Artezito (small blind) folded before Flop
Seat 3: maurivispa10 (big blind) folded before Flop
Seat 4: Scaaalll folded before Flop (didn't bet)
Seat 5: Daino G collected ($0.05)
Seat 6: zbixxx folded before Flop (didn't bet)



PokerStars Zoom Hand #229231938830:  Hold'em No Limit ($0.01/$0.02) - 2021/08/21 22:32:26 CET [2021/08/21 16:32:26 ET]
Table 'Halley' 6-max Seat #1 is the button
Seat 1: PapiMik3 ($2 in chips) 
Seat 2: DaBaDaBaDooo ($2.99 in chips) 
Seat 3: Scaaalll ($3.45 in chips) 
Seat 4: Ck@tih@ ($2.13 in chips) 
Seat 5: Luben_76 ($3.19 in chips) 
Seat 6: olcham7 ($2.02 in chips) 
DaBaDaBaDooo: posts small blind $0.01
Scaaalll: posts big blind $0.02
*** HOLE CARDS ***
Dealt to Scaaalll [3c 4d]
Ck@tih@: folds 
Luben_76: folds 
olcham7: folds 
PapiMik3: folds 
DaBaDaBaDooo: folds 
Uncalled bet ($0.01) returned to Scaaalll
Scaaalll collected $0.02 from pot
Scaaalll: doesn't show hand 
*** SUMMARY ***
Total pot $0.02 | Rake $0 
Seat 1: PapiMik3 (button) folded before Flop (didn't bet)
Seat 2: DaBaDaBaDooo (small blind) folded before Flop
Seat 3: Scaaalll (big blind) collected ($0.02)
Seat 4: Ck@tih@ folded before Flop (didn't bet)
Seat 5: Luben_76 folded before Flop (didn't bet)
Seat 6: olcham7 folded before Flop (didn't bet)



PokerStars Zoom Hand #229231943379:  Hold'em No Limit ($0.01/$0.02) - 2021/08/21 22:32:36 CET [2021/08/21 16:32:36 ET]
Table 'Halley' 6-max Seat #1 is the button
Seat 1: Scaaalll ($3.46 in chips) 
Seat 2: Stryda00 ($2 in chips) 
Seat 3: gerrit688 ($1.11 in chips) 
Seat 4: zergmiky ($2.40 in chips) 
Seat 5: ded serch ($2.03 in chips) 
Seat 6: romul795 ($0.20 in chips) 
Stryda00: posts small blind $0.01
gerrit688: posts big blind $0.02
*** HOLE CARDS ***
Dealt to Scaaalll [Tc Ac]
zergmiky: folds 
ded serch: folds 
romul795: folds 
romul795 is disconnected 
Scaaalll: raises $0.02 to $0.04
Stryda00: folds 
gerrit688: folds 
Uncalled bet ($0.02) returned to Scaaalll
Scaaalll collected $0.05 from pot
Scaaalll: doesn't show hand 
*** SUMMARY ***
Total pot $0.05 | Rake $0 
Seat 1: Scaaalll (button) collected ($0.05)
Seat 2: Stryda00 (small blind) folded before Flop
Seat 3: gerrit688 (big blind) folded before Flop
Seat 4: zergmiky folded before Flop (didn't bet)
Seat 5: ded serch folded before Flop (didn't bet)
Seat 6: romul795 folded before Flop (didn't bet)



PokerStars Zoom Hand #229231931765:  Hold'em No Limit ($0.01/$0.02) - 2021/08/21 22:32:10 CET [2021/08/21 16:32:10 ET]
Table 'Halley' 6-max Seat #1 is the button
Seat 1: Scaaalll ($3.45 in chips) 
Seat 2: LuckyCheewey ($5.78 in chips) 
Seat 3: Vitalyi1970 ($2.58 in chips) 
Seat 4: thi_spe ($2 in chips) 
Seat 5: sg.32rus ($2.43 in chips) 
Seat 6: Luben_76 ($1.88 in chips) 
LuckyCheewey: posts small blind $0.01
Vitalyi1970: posts big blind $0.02
*** HOLE CARDS ***
Dealt to Scaaalll [5d 4h]
thi_spe: folds 
sg.32rus: folds 
Luben_76: raises $0.03 to $0.05
Scaaalll: folds 
LuckyCheewey: folds 
Vitalyi1970: calls $0.03
*** FLOP *** [9c 2d 5h]
Vitalyi1970: bets $0.06
Luben_76: raises $0.12 to $0.18
Vitalyi1970: calls $0.12
*** TURN *** [9c 2d 5h] [3h]
Vitalyi1970: checks 
Luben_76: bets $0.30
Vitalyi1970: calls $0.30
*** RIVER *** [9c 2d 5h 3h] [4s]
Vitalyi1970: checks 
Luben_76: checks 
*** SHOW DOWN ***
Vitalyi1970: shows [5s Kc] (a pair of Fives)
Luben_76: shows [Qd Qs] (a pair of Queens)
Luben_76 collected $1.03 from pot
*** SUMMARY ***
Total pot $1.07 | Rake $0.04 
Board [9c 2d 5h 3h 4s]
Seat 1: Scaaalll (button) folded before Flop (didn't bet)
Seat 2: LuckyCheewey (small blind) folded before Flop
Seat 3: Vitalyi1970 (big blind) showed [5s Kc] and lost with a pair of Fives
Seat 4: thi_spe folded before Flop (didn't bet)
Seat 5: sg.32rus folded before Flop (didn't bet)
Seat 6: Luben_76 showed [Qd Qs] and won ($1.03) with a pair of Queens



PokerStars Zoom Hand #229231935275:  Hold'em No Limit ($0.01/$0.02) - 2021/08/21 22:32:18 CET [2021/08/21 16:32:18 ET]
Table 'Halley' 6-max Seat #1 is the button
Seat 1: Padde68 ($2.39 in chips) 
Seat 2: Vad-Gadov ($1.84 in chips) 
Seat 3: 5gold jigsaw ($2 in chips) 
Seat 4: Yangyang1407 ($2 in chips) 
Seat 5: sinkthe8 ($1.53 in chips) 
Seat 6: Scaaalll ($3.45 in chips) 
Vad-Gadov: posts small blind $0.01
5gold jigsaw: posts big blind $0.02
*** HOLE CARDS ***
Dealt to Scaaalll [Qd 4s]
Yangyang1407: folds 
sinkthe8: folds 
sinkthe8 is disconnected 
Vad-Gadov is disconnected 
Scaaalll: folds 
Padde68: calls $0.02
Vad-Gadov: folds 
5gold jigsaw: checks 
*** FLOP *** [Jh Qc Jd]
5gold jigsaw: checks 
Padde68: checks 
*** TURN *** [Jh Qc Jd] [2c]
5gold jigsaw: checks 
Padde68: checks 
*** RIVER *** [Jh Qc Jd 2c] [9c]
5gold jigsaw: bets $0.16
Padde68: folds 
Uncalled bet ($0.16) returned to 5gold jigsaw
5gold jigsaw collected $0.05 from pot
5gold jigsaw: doesn't show hand 
Padde68 is disconnected 
*** SUMMARY ***
Total pot $0.05 | Rake $0 
Board [Jh Qc Jd 2c 9c]
Seat 1: Padde68 (button) folded on the River
Seat 2: Vad-Gadov (small blind) folded before Flop
Seat 3: 5gold jigsaw (big blind) collected ($0.05)
Seat 4: Yangyang1407 folded before Flop (didn't bet)
Seat 5: sinkthe8 folded before Flop (didn't bet)
Seat 6: Scaaalll folded before Flop (didn't bet)



PokerStars Zoom Hand #229231953299:  Hold'em No Limit ($0.01/$0.02) - 2021/08/21 22:32:58 CET [2021/08/21 16:32:58 ET]
Table 'Halley' 6-max Seat #1 is the button
Seat 1: Canoinhas37 ($4.89 in chips) 
Seat 2: rodrigoasor ($0.51 in chips) 
Seat 3: ppluiaule ($2 in chips) 
Seat 4: Scaaalll ($3.48 in chips) 
Seat 5: Sinad1302 ($3.95 in chips) 
Seat 6: jejmcclu ($2.80 in chips) 
rodrigoasor: posts small blind $0.01
ppluiaule: posts big blind $0.02
*** HOLE CARDS ***
Dealt to Scaaalll [Kd Ac]
Scaaalll: raises $0.04 to $0.06
Sinad1302: folds 
jejmcclu: folds 
Sinad1302 is disconnected 
Canoinhas37: folds 
rodrigoasor: folds 
ppluiaule: folds 
Uncalled bet ($0.04) returned to Scaaalll
Scaaalll collected $0.05 from pot
Scaaalll: doesn't show hand 
*** SUMMARY ***
Total pot $0.05 | Rake $0 
Seat 1: Canoinhas37 (button) folded before Flop (didn't bet)
Seat 2: rodrigoasor (small blind) folded before Flop
Seat 3: ppluiaule (big blind) folded before Flop
Seat 4: Scaaalll collected ($0.05)
Seat 5: Sinad1302 folded before Flop (didn't bet)
Seat 6: jejmcclu folded before Flop (didn't bet)



PokerStars Zoom Hand #229231951527:  Hold'em No Limit ($0.01/$0.02) - 2021/08/21 22:32:54 CET [2021/08/21 16:32:54 ET]
Table 'Halley' 6-max Seat #1 is the button
Seat 1: Bufre ($3.36 in chips) 
Seat 2: Scaaalll ($3.49 in chips) 
Seat 3: SIGREX ($2.50 in chips) 
Seat 4: Ck@tih@ ($2.13 in chips) 
Seat 5: Baldisback ($1.93 in chips) 
Seat 6: bach444 ($4.39 in chips) 
Scaaalll: posts small blind $0.01
SIGREX: posts big blind $0.02
*** HOLE CARDS ***
Dealt to Scaaalll [3d Ah]
bach444 is disconnected 
Ck@tih@: folds 
Baldisback: folds 
bach444: folds 
Bufre: raises $0.03 to $0.05
Scaaalll: folds 
SIGREX: folds 
Uncalled bet ($0.03) returned to Bufre
Bufre collected $0.05 from pot
Bufre: doesn't show hand 
*** SUMMARY ***
Total pot $0.05 | Rake $0 
Seat 1: Bufre (button) collected ($0.05)
Seat 2: Scaaalll (small blind) folded before Flop
Seat 3: SIGREX (big blind) folded before Flop
Seat 4: Ck@tih@ folded before Flop (didn't bet)
Seat 5: Baldisback folded before Flop (didn't bet)
Seat 6: bach444 folded before Flop (didn't bet)



PokerStars Zoom Hand #229231949252:  Hold'em No Limit ($0.01/$0.02) - 2021/08/21 22:32:49 CET [2021/08/21 16:32:49 ET]
Table 'Halley' 6-max Seat #1 is the button
Seat 1: uniicecube ($4.42 in chips) 
Seat 2: estelionat171 ($1.99 in chips) 
Seat 3: z3317111711 ($2.09 in chips) 
Seat 4: LSDenny ($1.97 in chips) 
Seat 5: Scaaalll ($3.49 in chips) 
Seat 6: Finderra ($1.94 in chips) 
estelionat171: posts small blind $0.01
z3317111711: posts big blind $0.02
*** HOLE CARDS ***
Dealt to Scaaalll [8c 6h]
LSDenny: folds 
Scaaalll: folds 
LSDenny is disconnected 
Finderra: folds 
uniicecube: raises $0.04 to $0.06
estelionat171: folds 
z3317111711: folds 
Uncalled bet ($0.04) returned to uniicecube
uniicecube collected $0.05 from pot
uniicecube: doesn't show hand 
*** SUMMARY ***
Total pot $0.05 | Rake $0 
Seat 1: uniicecube (button) collected ($0.05)
Seat 2: estelionat171 (small blind) folded before Flop
Seat 3: z3317111711 (big blind) folded before Flop
Seat 4: LSDenny folded before Flop (didn't bet)
Seat 5: Scaaalll folded before Flop (didn't bet)
Seat 6: Finderra folded before Flop (didn't bet)



PokerStars Zoom Hand #229231959567:  Hold'em No Limit ($0.01/$0.02) - 2021/08/21 22:33:12 CET [2021/08/21 16:33:12 ET]
Table 'Halley' 6-max Seat #1 is the button
Seat 1: gasmar_29 ($2.47 in chips) 
Seat 2: kahzura ($2.37 in chips) 
Seat 3: RomiSex ($2 in chips) 
Seat 4: le_vlimeux ($2.69 in chips) 
Seat 5: Scaaalll ($3.51 in chips) 
Seat 6: FabOliveira9 ($2.41 in chips) 
kahzura: posts small blind $0.01
RomiSex: posts big blind $0.02
*** HOLE CARDS ***
Dealt to Scaaalll [3c 2h]
le_vlimeux: folds 
Scaaalll: folds 
FabOliveira9: raises $0.03 to $0.05
gasmar_29: folds 
kahzura: folds 
RomiSex: calls $0.03
*** FLOP *** [4s Kd 4d]
RomiSex: checks 
FabOliveira9: bets $0.06
RomiSex: folds 
Uncalled bet ($0.06) returned to FabOliveira9
FabOliveira9 collected $0.11 from pot
FabOliveira9: doesn't show hand 
*** SUMMARY ***
Total pot $0.11 | Rake $0 
Board [4s Kd 4d]
Seat 1: gasmar_29 (button) folded before Flop (didn't bet)
Seat 2: kahzura (small blind) folded before Flop
Seat 3: RomiSex (big blind) folded on the Flop
Seat 4: le_vlimeux folded before Flop (didn't bet)
Seat 5: Scaaalll folded before Flop (didn't bet)
Seat 6: FabOliveira9 collected ($0.11)



PokerStars Zoom Hand #229231961402:  Hold'em No Limit ($0.01/$0.02) - 2021/08/21 22:33:16 CET [2021/08/21 16:33:16 ET]
Table 'Halley' 6-max Seat #1 is the button
Seat 1: Yangyang1407 ($2.03 in chips) 
Seat 2: BadBeat Bert ($1.95 in chips) 
Seat 3: S.P.S...99 ($0.72 in chips) 
Seat 4: Scaaalll ($3.51 in chips) 
Seat 5: parrotman991 ($1.51 in chips) 
Seat 6: rodrigoasor ($0.50 in chips) 
BadBeat Bert: posts small blind $0.01
S.P.S...99: posts big blind $0.02
*** HOLE CARDS ***
Dealt to Scaaalll [2c 9s]
Scaaalll: folds 
parrotman991: calls $0.02
rodrigoasor: folds 
Yangyang1407: folds 
BadBeat Bert: folds 
S.P.S...99: checks 
*** FLOP *** [5s 3s Kd]
S.P.S...99: bets $0.11
parrotman991: calls $0.11
*** TURN *** [5s 3s Kd] [Th]
S.P.S...99: bets $0.59 and is all-in
parrotman991: calls $0.59
*** RIVER *** [5s 3s Kd Th] [3h]
*** SHOW DOWN ***
S.P.S...99: shows [6s 5d] (two pair, Fives and Threes)
parrotman991: shows [Tc Kh] (two pair, Kings and Tens)
parrotman991 cashed out the hand for $1.32 | Cash Out Fee $0.01
*** SUMMARY ***
Total pot $1.45 | Rake $0.05 
Board [5s 3s Kd Th 3h]
Seat 1: Yangyang1407 (button) folded before Flop (didn't bet)
Seat 2: BadBeat Bert (small blind) folded before Flop
Seat 3: S.P.S...99 (big blind) showed [6s 5d] and lost with two pair, Fives and Threes
Seat 4: Scaaalll folded before Flop (didn't bet)
Seat 5: parrotman991 showed [Tc Kh] and won ($1.40) with two pair, Kings and Tens (pot not awarded as player cashed out)
Seat 6: rodrigoasor folded before Flop (didn't bet)



PokerStars Zoom Hand #229231974533:  Hold'em No Limit ($0.01/$0.02) - 2021/08/21 22:33:45 CET [2021/08/21 16:33:45 ET]
Table 'Halley' 6-max Seat #1 is the button
Seat 1: polymorhp ($2.06 in chips) 
Seat 2: Scaaalll ($3.49 in chips) 
Seat 3: alexchamps ($1.48 in chips) 
Seat 4: pavlo8855 ($2 in chips) 
Seat 5: EmperorKurr ($3.10 in chips) 
Seat 6: GVMELLO ($1.98 in chips) 
Scaaalll: posts small blind $0.01
alexchamps: posts big blind $0.02
*** HOLE CARDS ***
Dealt to Scaaalll [6d Qc]
pavlo8855: raises $0.04 to $0.06
EmperorKurr: folds 
GVMELLO: folds 
alexchamps is disconnected 
polymorhp: folds 
Scaaalll: folds 
alexchamps: folds 
Uncalled bet ($0.04) returned to pavlo8855
pavlo8855 collected $0.05 from pot
pavlo8855: doesn't show hand 
*** SUMMARY ***
Total pot $0.05 | Rake $0 
Seat 1: polymorhp (button) folded before Flop (didn't bet)
Seat 2: Scaaalll (small blind) folded before Flop
Seat 3: alexchamps (big blind) folded before Flop
Seat 4: pavlo8855 collected ($0.05)
Seat 5: EmperorKurr folded before Flop (didn't bet)
Seat 6: GVMELLO folded before Flop (didn't bet)



PokerStars Zoom Hand #229231963202:  Hold'em No Limit ($0.01/$0.02) - 2021/08/21 22:33:20 CET [2021/08/21 16:33:20 ET]
Table 'Halley' 6-max Seat #1 is the button
Seat 1: EB-NetCafe ($1 in chips) 
Seat 2: estelionat171 ($0.97 in chips) 
Seat 3: Scaaalll ($3.51 in chips) 
Seat 4: Yangyang1407 ($2.03 in chips) 
Seat 5: JBPY ($1.50 in chips) 
Seat 6: Amsterdam8383 ($0.67 in chips) 
estelionat171: posts small blind $0.01
Scaaalll: posts big blind $0.02
*** HOLE CARDS ***
Dealt to Scaaalll [6h 5s]
Yangyang1407: folds 
JBPY: raises $0.04 to $0.06
Amsterdam8383: folds 
EB-NetCafe: calls $0.06
estelionat171: folds 
Scaaalll: folds 
*** FLOP *** [7c 2c 9h]
JBPY: bets $0.09
EB-NetCafe: calls $0.09
*** TURN *** [7c 2c 9h] [9d]
JBPY: bets $0.16
EB-NetCafe: calls $0.16
*** RIVER *** [7c 2c 9h 9d] [8d]
JBPY: checks 
EB-NetCafe: bets $0.20
JBPY: calls $0.20
*** SHOW DOWN ***
EB-NetCafe: shows [Qs Qh] (two pair, Queens and Nines)
JBPY: mucks hand 
EB-NetCafe collected $1.01 from pot
*** SUMMARY ***
Total pot $1.05 | Rake $0.04 
Board [7c 2c 9h 9d 8d]
Seat 1: EB-NetCafe (button) showed [Qs Qh] and won ($1.01) with two pair, Queens and Nines
Seat 2: estelionat171 (small blind) folded before Flop
Seat 3: Scaaalll (big blind) folded before Flop
Seat 4: Yangyang1407 folded before Flop (didn't bet)
Seat 5: JBPY mucked [Kc Ac]
Seat 6: Amsterdam8383 folded before Flop (didn't bet)



PokerStars Zoom Hand #229231984450:  Hold'em No Limit ($0.01/$0.02) - 2021/08/21 22:34:07 CET [2021/08/21 16:34:07 ET]
Table 'Halley' 6-max Seat #1 is the button
Seat 1: GamblersDream ($2 in chips) 
Seat 2: SIGREX ($2.51 in chips) 
Seat 3: kboskov123 ($1.96 in chips) 
Seat 4: pavlo8855 ($2.03 in chips) 
Seat 5: rzn62665 ($1.30 in chips) 
Seat 6: Scaaalll ($3.48 in chips) 
SIGREX: posts small blind $0.01
kboskov123: posts big blind $0.02
*** HOLE CARDS ***
Dealt to Scaaalll [Ac Jc]
pavlo8855: folds 
rzn62665: folds 
Scaaalll: raises $0.04 to $0.06
GamblersDream: folds 
SIGREX: folds 
kboskov123: folds 
Uncalled bet ($0.04) returned to Scaaalll
Scaaalll collected $0.05 from pot
Scaaalll: doesn't show hand 
*** SUMMARY ***
Total pot $0.05 | Rake $0 
Seat 1: GamblersDream (button) folded before Flop (didn't bet)
Seat 2: SIGREX (small blind) folded before Flop
Seat 3: kboskov123 (big blind) folded before Flop
Seat 4: pavlo8855 folded before Flop (didn't bet)
Seat 5: rzn62665 folded before Flop (didn't bet)
Seat 6: Scaaalll collected ($0.05)



PokerStars Zoom Hand #229231993432:  Hold'em No Limit ($0.01/$0.02) - 2021/08/21 22:34:27 CET [2021/08/21 16:34:27 ET]
Table 'Halley' 6-max Seat #1 is the button
Seat 1: balalaikaRUS47 ($1.54 in chips) 
Seat 2: Kreodont1987 ($4.52 in chips) 
Seat 3: Scaaalll ($3.51 in chips) 
Seat 4: HubertFroh ($2.59 in chips) 
Seat 5: keb1981 ($2.58 in chips) 
Seat 6: Canoinhas37 ($4.96 in chips) 
Kreodont1987: posts small blind $0.01
Scaaalll: posts big blind $0.02
*** HOLE CARDS ***
Dealt to Scaaalll [As 2h]
balalaikaRUS47 is disconnected 
HubertFroh: folds 
keb1981: folds 
Canoinhas37: folds 
balalaikaRUS47: folds 
Kreodont1987: folds 
Uncalled bet ($0.01) returned to Scaaalll
Scaaalll collected $0.02 from pot
Scaaalll: doesn't show hand 
*** SUMMARY ***
Total pot $0.02 | Rake $0 
Seat 1: balalaikaRUS47 (button) folded before Flop (didn't bet)
Seat 2: Kreodont1987 (small blind) folded before Flop
Seat 3: Scaaalll (big blind) collected ($0.02)
Seat 4: HubertFroh folded before Flop (didn't bet)
Seat 5: keb1981 folded before Flop (didn't bet)
Seat 6: Canoinhas37 folded before Flop (didn't bet)



PokerStars Zoom Hand #229231991639:  Hold'em No Limit ($0.01/$0.02) - 2021/08/21 22:34:23 CET [2021/08/21 16:34:23 ET]
Table 'Halley' 6-max Seat #1 is the button
Seat 1: Amsterdam8383 ($0.65 in chips) 
Seat 2: WellWell57 ($3.52 in chips) 
Seat 3: Healthys07 ($5.10 in chips) 
Seat 4: Dipod1991 ($1.91 in chips) 
Seat 5: Fanatspartak ($1.06 in chips) 
Seat 6: Scaaalll ($3.51 in chips) 
WellWell57: posts small blind $0.01
Healthys07: posts big blind $0.02
*** HOLE CARDS ***
Dealt to Scaaalll [6h 3d]
Dipod1991: folds 
Fanatspartak: folds 
Scaaalll: folds 
Amsterdam8383: folds 
WellWell57: raises $0.03 to $0.05
Healthys07: raises $0.10 to $0.15
WellWell57: folds 
Uncalled bet ($0.10) returned to Healthys07
Healthys07 collected $0.10 from pot
Healthys07: doesn't show hand 
*** SUMMARY ***
Total pot $0.10 | Rake $0 
Seat 1: Amsterdam8383 (button) folded before Flop (didn't bet)
Seat 2: WellWell57 (small blind) folded before Flop
Seat 3: Healthys07 (big blind) collected ($0.10)
Seat 4: Dipod1991 folded before Flop (didn't bet)
Seat 5: Fanatspartak folded before Flop (didn't bet)
Seat 6: Scaaalll folded before Flop (didn't bet)



PokerStars Zoom Hand #229231997821:  Hold'em No Limit ($0.01/$0.02) - 2021/08/21 22:34:37 CET [2021/08/21 16:34:37 ET]
Table 'Halley' 6-max Seat #1 is the button
Seat 1: Daino G ($2.38 in chips) 
Seat 2: kahzura ($2 in chips) 
Seat 3: zaharoff74 ($2 in chips) 
Seat 4: LSDenny ($1.83 in chips) 
Seat 5: Scaaalll ($3.52 in chips) 
Seat 6: Agno$tic ($3.36 in chips) 
kahzura: posts small blind $0.01
zaharoff74: posts big blind $0.02
*** HOLE CARDS ***
Dealt to Scaaalll [7s 3c]
LSDenny: folds 
LSDenny is disconnected 
Scaaalll: folds 
Agno$tic: folds 
Daino G: folds 
kahzura: folds 
Uncalled bet ($0.01) returned to zaharoff74
zaharoff74 collected $0.02 from pot
zaharoff74: doesn't show hand 
*** SUMMARY ***
Total pot $0.02 | Rake $0 
Seat 1: Daino G (button) folded before Flop (didn't bet)
Seat 2: kahzura (small blind) folded before Flop
Seat 3: zaharoff74 (big blind) collected ($0.02)
Seat 4: LSDenny folded before Flop (didn't bet)
Seat 5: Scaaalll folded before Flop (didn't bet)
Seat 6: Agno$tic folded before Flop (didn't bet)



PokerStars Zoom Hand #229232000906:  Hold'em No Limit ($0.01/$0.02) - 2021/08/21 22:34:44 CET [2021/08/21 16:34:44 ET]
Table 'Halley' 6-max Seat #1 is the button
Seat 1: Scaaalll ($3.52 in chips) 
Seat 2: rodrigovini ($2.20 in chips) 
Seat 3: derry,me ($1.92 in chips) 
Seat 4: Spo1LT ($1.63 in chips) 
Seat 5: furgalik ($0.61 in chips) 
Seat 6: BaronMax ($0.66 in chips) 
rodrigovini: posts small blind $0.01
derry,me: posts big blind $0.02
*** HOLE CARDS ***
Dealt to Scaaalll [5c 9h]
Spo1LT: folds 
furgalik: folds 
BaronMax: folds 
Scaaalll: folds 
rodrigovini: raises $0.04 to $0.06
derry,me: folds 
Uncalled bet ($0.04) returned to rodrigovini
rodrigovini collected $0.04 from pot
rodrigovini: doesn't show hand 
derry,me is disconnected 
*** SUMMARY ***
Total pot $0.04 | Rake $0 
Seat 1: Scaaalll (button) folded before Flop (didn't bet)
Seat 2: rodrigovini (small blind) collected ($0.04)
Seat 3: derry,me (big blind) folded before Flop
Seat 4: Spo1LT folded before Flop (didn't bet)
Seat 5: furgalik folded before Flop (didn't bet)
Seat 6: BaronMax folded before Flop (didn't bet)



PokerStars Zoom Hand #229232003158:  Hold'em No Limit ($0.01/$0.02) - 2021/08/21 22:34:49 CET [2021/08/21 16:34:49 ET]
Table 'Halley' 6-max Seat #1 is the button
Seat 1: KRITAYA ($1.72 in chips) 
Seat 2: so0love ($6.94 in chips) 
Seat 3: AlexGTPS ($3.20 in chips) 
Seat 4: Scaaalll ($3.52 in chips) 
Seat 5: sal_sagev41 ($2.38 in chips) 
Seat 6: felipeciji ($2 in chips) 
so0love: posts small blind $0.01
AlexGTPS: posts big blind $0.02
*** HOLE CARDS ***
Dealt to Scaaalll [7d 9d]
Scaaalll: raises $0.04 to $0.06
sal_sagev41: folds 
felipeciji: folds 
KRITAYA: raises $0.12 to $0.18
so0love: folds 
AlexGTPS: folds 
Scaaalll: folds 
Uncalled bet ($0.12) returned to KRITAYA
KRITAYA collected $0.15 from pot
KRITAYA: doesn't show hand 
*** SUMMARY ***
Total pot $0.15 | Rake $0 
Seat 1: KRITAYA (button) collected ($0.15)
Seat 2: so0love (small blind) folded before Flop
Seat 3: AlexGTPS (big blind) folded before Flop
Seat 4: Scaaalll folded before Flop
Seat 5: sal_sagev41 folded before Flop (didn't bet)
Seat 6: felipeciji folded before Flop (didn't bet)



PokerStars Zoom Hand #229231979993:  Hold'em No Limit ($0.01/$0.02) - 2021/08/21 22:33:57 CET [2021/08/21 16:33:57 ET]
Table 'Halley' 6-max Seat #1 is the button
Seat 1: Scaaalll ($3.48 in chips) 
Seat 2: lhrk ($1.06 in chips) 
Seat 3: you_my_bich ($1.06 in chips) 
Seat 4: kahzura ($2 in chips) 
Seat 5: Healthys07 ($5.11 in chips) 
Seat 6: El Chicha.CL ($2 in chips) 
lhrk: posts small blind $0.01
you_my_bich: posts big blind $0.02
*** HOLE CARDS ***
Dealt to Scaaalll [7h Ad]
kahzura: folds 
Healthys07: folds 
El Chicha.CL: raises $0.04 to $0.06
Scaaalll: folds 
lhrk: calls $0.05
you_my_bich: folds 
*** FLOP *** [Qc Td 2s]
you_my_bich is disconnected 
lhrk: checks 
El Chicha.CL: checks 
*** TURN *** [Qc Td 2s] [8h]
lhrk: bets $0.07
El Chicha.CL: calls $0.07
*** RIVER *** [Qc Td 2s 8h] [7s]
lhrk: bets $0.18
El Chicha.CL: folds 
Uncalled bet ($0.18) returned to lhrk
lhrk collected $0.27 from pot
lhrk: doesn't show hand 
*** SUMMARY ***
Total pot $0.28 | Rake $0.01 
Board [Qc Td 2s 8h 7s]
Seat 1: Scaaalll (button) folded before Flop (didn't bet)
Seat 2: lhrk (small blind) collected ($0.27)
Seat 3: you_my_bich (big blind) folded before Flop
Seat 4: kahzura folded before Flop (didn't bet)
Seat 5: Healthys07 folded before Flop (didn't bet)
Seat 6: El Chicha.CL folded on the River



PokerStars Zoom Hand #229232011157:  Hold'em No Limit ($0.01/$0.02) - 2021/08/21 22:35:07 CET [2021/08/21 16:35:07 ET]
Table 'Halley' 6-max Seat #1 is the button
Seat 1: dkno77 ($5.22 in chips) 
Seat 2: Scaaalll ($3.46 in chips) 
Seat 3: Haraldo550 ($6.11 in chips) 
Seat 4: pavlo8855 ($2 in chips) 
Seat 5: ser313131 ($9.51 in chips) 
Seat 6: Tabitaji ($2.77 in chips) 
Scaaalll: posts small blind $0.01
Haraldo550: posts big blind $0.02
*** HOLE CARDS ***
Dealt to Scaaalll [3d 8d]
pavlo8855: folds 
ser313131: folds 
Tabitaji: folds 
dkno77: folds 
Scaaalll: folds 
Uncalled bet ($0.01) returned to Haraldo550
Haraldo550 collected $0.02 from pot
Haraldo550: doesn't show hand 
*** SUMMARY ***
Total pot $0.02 | Rake $0 
Seat 1: dkno77 (button) folded before Flop (didn't bet)
Seat 2: Scaaalll (small blind) folded before Flop
Seat 3: Haraldo550 (big blind) collected ($0.02)
Seat 4: pavlo8855 folded before Flop (didn't bet)
Seat 5: ser313131 folded before Flop (didn't bet)
Seat 6: Tabitaji folded before Flop (didn't bet)



PokerStars Zoom Hand #229232017446:  Hold'em No Limit ($0.01/$0.02) - 2021/08/21 22:35:21 CET [2021/08/21 16:35:21 ET]
Table 'Halley' 6-max Seat #1 is the button
Seat 1: 365p2eva ($4.17 in chips) 
Seat 2: Finderra ($2.09 in chips) 
Seat 3: orang_dragon ($1.63 in chips) 
Seat 4: Scaaalll ($3.45 in chips) 
Seat 5: KonopDima ($2 in chips) 
Seat 6: krowio ($2.39 in chips) 
Finderra: posts small blind $0.01
orang_dragon: posts big blind $0.02
*** HOLE CARDS ***
Dealt to Scaaalll [Tc 8c]
Scaaalll: raises $0.04 to $0.06
KonopDima: folds 
krowio: calls $0.06
365p2eva: folds 
Finderra: folds 
orang_dragon: folds 
*** FLOP *** [Jc 4h Ks]
Scaaalll: bets $0.08
krowio: folds 
Uncalled bet ($0.08) returned to Scaaalll
Scaaalll collected $0.14 from pot
Scaaalll: doesn't show hand 
*** SUMMARY ***
Total pot $0.15 | Rake $0.01 
Board [Jc 4h Ks]
Seat 1: 365p2eva (button) folded before Flop (didn't bet)
Seat 2: Finderra (small blind) folded before Flop
Seat 3: orang_dragon (big blind) folded before Flop
Seat 4: Scaaalll collected ($0.14)
Seat 5: KonopDima folded before Flop (didn't bet)
Seat 6: krowio folded on the Flop



PokerStars Zoom Hand #229232027249:  Hold'em No Limit ($0.01/$0.02) - 2021/08/21 22:35:43 CET [2021/08/21 16:35:43 ET]
Table 'Halley' 6-max Seat #1 is the button
Seat 1: Tn 939 ($2 in chips) 
Seat 2: RonilsonCosta ($2 in chips) 
Seat 3: Scaaalll ($3.53 in chips) 
Seat 4: znak312 ($2 in chips) 
Seat 5: juraa14 ($2.15 in chips) 
Seat 6: BlackhawKK's ($2 in chips) 
RonilsonCosta: posts small blind $0.01
Scaaalll: posts big blind $0.02
*** HOLE CARDS ***
Dealt to Scaaalll [Qd 6c]
znak312: folds 
juraa14: folds 
BlackhawKK's: folds 
Tn 939: raises $0.03 to $0.05
RonilsonCosta: folds 
Scaaalll: folds 
Uncalled bet ($0.03) returned to Tn 939
Tn 939 collected $0.05 from pot
Tn 939: doesn't show hand 
*** SUMMARY ***
Total pot $0.05 | Rake $0 
Seat 1: Tn 939 (button) collected ($0.05)
Seat 2: RonilsonCosta (small blind) folded before Flop
Seat 3: Scaaalll (big blind) folded before Flop
Seat 4: znak312 folded before Flop (didn't bet)
Seat 5: juraa14 folded before Flop (didn't bet)
Seat 6: BlackhawKK's folded before Flop (didn't bet)



PokerStars Zoom Hand #229232037542:  Hold'em No Limit ($0.01/$0.02) - 2021/08/21 22:36:06 CET [2021/08/21 16:36:06 ET]
Table 'Halley' 6-max Seat #1 is the button
Seat 1: Vad-Gadov ($1.68 in chips) 
Seat 2: Scaaalll ($3.51 in chips) 
Seat 3: teutonknight ($0.76 in chips) 
Seat 4: gilberto98 ($2.24 in chips) 
Seat 5: KatedratiK ($1.42 in chips) 
Seat 6: fishh_play ($3.89 in chips) 
Scaaalll: posts small blind $0.01
teutonknight: posts big blind $0.02
*** HOLE CARDS ***
Dealt to Scaaalll [Qc 9d]
Vad-Gadov is disconnected 
gilberto98: folds 
KatedratiK: folds 
fishh_play: raises $0.03 to $0.05
Vad-Gadov: folds 
Scaaalll: folds 
teutonknight: folds 
Uncalled bet ($0.03) returned to fishh_play
fishh_play collected $0.05 from pot
fishh_play: doesn't show hand 
*** SUMMARY ***
Total pot $0.05 | Rake $0 
Seat 1: Vad-Gadov (button) folded before Flop (didn't bet)
Seat 2: Scaaalll (small blind) folded before Flop
Seat 3: teutonknight (big blind) folded before Flop
Seat 4: gilberto98 folded before Flop (didn't bet)
Seat 5: KatedratiK folded before Flop (didn't bet)
Seat 6: fishh_play collected ($0.05)



PokerStars Zoom Hand #229232033545:  Hold'em No Limit ($0.01/$0.02) - 2021/08/21 22:35:57 CET [2021/08/21 16:35:57 ET]
Table 'Halley' 6-max Seat #1 is the button
Seat 1: Kb013497 ($1.50 in chips) 
Seat 2: Kreodont1987 ($4.85 in chips) 
Seat 3: Tünn63 ($0.36 in chips) 
Seat 4: NOLUWDtC ($2.01 in chips) 
Seat 5: kboskov123 ($2.48 in chips) 
Seat 6: Scaaalll ($3.51 in chips) 
Kreodont1987: posts small blind $0.01
Tünn63: posts big blind $0.02
*** HOLE CARDS ***
Dealt to Scaaalll [3d 9h]
NOLUWDtC: raises $0.04 to $0.06
kboskov123: folds 
Scaaalll: folds 
Kb013497: raises $0.04 to $0.10
Kreodont1987: folds 
Tünn63: folds 
NOLUWDtC: calls $0.04
*** FLOP *** [4s 4h 6c]
NOLUWDtC: checks 
Kb013497: checks 
*** TURN *** [4s 4h 6c] [Td]
NOLUWDtC: checks 
Kb013497: bets $0.10
NOLUWDtC: folds 
Uncalled bet ($0.10) returned to Kb013497
Kb013497 collected $0.22 from pot
Kb013497: doesn't show hand 
NOLUWDtC is disconnected 
*** SUMMARY ***
Total pot $0.23 | Rake $0.01 
Board [4s 4h 6c Td]
Seat 1: Kb013497 (button) collected ($0.22)
Seat 2: Kreodont1987 (small blind) folded before Flop
Seat 3: Tünn63 (big blind) folded before Flop
Seat 4: NOLUWDtC folded on the Turn
Seat 5: kboskov123 folded before Flop (didn't bet)
Seat 6: Scaaalll folded before Flop (didn't bet)



PokerStars Zoom Hand #229232043283:  Hold'em No Limit ($0.01/$0.02) - 2021/08/21 22:36:19 CET [2021/08/21 16:36:19 ET]
Table 'Halley' 6-max Seat #1 is the button
Seat 1: Scaaalll ($3.50 in chips) 
Seat 2: ash1448 ($3.73 in chips) 
Seat 3: romul795 ($0.25 in chips) 
Seat 4: zallav ($2.70 in chips) 
Seat 5: ricske68 ($5.42 in chips) 
Seat 6: egroj1700 ($2 in chips) 
ash1448: posts small blind $0.01
romul795: posts big blind $0.02
*** HOLE CARDS ***
Dealt to Scaaalll [8c 7h]
zallav: folds 
zallav is disconnected 
ricske68: folds 
egroj1700: folds 
Scaaalll: raises $0.02 to $0.04
ash1448: folds 
romul795: calls $0.02
*** FLOP *** [Jh 5s Ts]
romul795: bets $0.21 and is all-in
Scaaalll: folds 
Uncalled bet ($0.21) returned to romul795
romul795 collected $0.09 from pot
romul795: doesn't show hand 
*** SUMMARY ***
Total pot $0.09 | Rake $0 
Board [Jh 5s Ts]
Seat 1: Scaaalll (button) folded on the Flop
Seat 2: ash1448 (small blind) folded before Flop
Seat 3: romul795 (big blind) collected ($0.09)
Seat 4: zallav folded before Flop (didn't bet)
Seat 5: ricske68 folded before Flop (didn't bet)
Seat 6: egroj1700 folded before Flop (didn't bet)



PokerStars Zoom Hand #229232056762:  Hold'em No Limit ($0.01/$0.02) - 2021/08/21 22:36:49 CET [2021/08/21 16:36:49 ET]
Table 'Halley' 6-max Seat #1 is the button
Seat 1: SKV_1985 ($2 in chips) 
Seat 2: Kreodont1987 ($4.82 in chips) 
Seat 3: caiolima99 ($7.93 in chips) 
Seat 4: M-A-J-P81 ($2.06 in chips) 
Seat 5: gordoatlantico ($4.11 in chips) 
Seat 6: Scaaalll ($3.46 in chips) 
Kreodont1987: posts small blind $0.01
caiolima99: posts big blind $0.02
*** HOLE CARDS ***
Dealt to Scaaalll [8d 8s]
M-A-J-P81: folds 
gordoatlantico: folds 
M-A-J-P81 is disconnected 
Scaaalll: raises $0.04 to $0.06
SKV_1985: raises $0.18 to $0.24
Kreodont1987: folds 
caiolima99: folds 
Scaaalll: folds 
Uncalled bet ($0.18) returned to SKV_1985
SKV_1985 collected $0.15 from pot
SKV_1985: doesn't show hand 
*** SUMMARY ***
Total pot $0.15 | Rake $0 
Seat 1: SKV_1985 (button) collected ($0.15)
Seat 2: Kreodont1987 (small blind) folded before Flop
Seat 3: caiolima99 (big blind) folded before Flop
Seat 4: M-A-J-P81 folded before Flop (didn't bet)
Seat 5: gordoatlantico folded before Flop (didn't bet)
Seat 6: Scaaalll folded before Flop



PokerStars Zoom Hand #229232072081:  Hold'em No Limit ($0.01/$0.02) - 2021/08/21 22:37:23 CET [2021/08/21 16:37:23 ET]
Table 'Halley' 6-max Seat #1 is the button
Seat 1: Umnik_M ($2.06 in chips) 
Seat 2: stipe 31 ($2.84 in chips) 
Seat 3: HellNative ($2.31 in chips) 
Seat 4: EdwardF95 ($3.47 in chips) 
Seat 5: Scaaalll ($3.40 in chips) 
Seat 6: so0love ($2.04 in chips) 
stipe 31: posts small blind $0.01
HellNative: posts big blind $0.02
*** HOLE CARDS ***
Dealt to Scaaalll [6d Jh]
EdwardF95: raises $0.04 to $0.06
Scaaalll: folds 
so0love: calls $0.06
Umnik_M: folds 
stipe 31: folds 
HellNative: folds 
*** FLOP *** [Tc 7d 5s]
EdwardF95: checks 
so0love: bets $0.14
EdwardF95: folds 
Uncalled bet ($0.14) returned to so0love
so0love collected $0.14 from pot
so0love: doesn't show hand 
*** SUMMARY ***
Total pot $0.15 | Rake $0.01 
Board [Tc 7d 5s]
Seat 1: Umnik_M (button) folded before Flop (didn't bet)
Seat 2: stipe 31 (small blind) folded before Flop
Seat 3: HellNative (big blind) folded before Flop
Seat 4: EdwardF95 folded on the Flop
Seat 5: Scaaalll folded before Flop (didn't bet)
Seat 6: so0love collected ($0.14)



PokerStars Zoom Hand #229232073864:  Hold'em No Limit ($0.01/$0.02) - 2021/08/21 22:37:27 CET [2021/08/21 16:37:27 ET]
Table 'Halley' 6-max Seat #1 is the button
Seat 1: Dershura1989 ($3.99 in chips) 
Seat 2: Healthys07 ($5.10 in chips) 
Seat 3: Scaaalll ($3.40 in chips) 
Seat 4: zbixxx ($4.34 in chips) 
Seat 5: camelot230 ($2.31 in chips) 
Seat 6: Clavis Noa ($1.18 in chips) 
Healthys07: posts small blind $0.01
Scaaalll: posts big blind $0.02
*** HOLE CARDS ***
Dealt to Scaaalll [8d As]
zbixxx: folds 
camelot230: folds 
Clavis Noa: raises $0.02 to $0.04
Dershura1989: raises $0.10 to $0.14
Healthys07: folds 
Scaaalll: folds 
Clavis Noa: calls $0.10
*** FLOP *** [Jh Ks 7h]
Clavis Noa: checks 
Dershura1989: bets $0.10
Clavis Noa: folds 
Uncalled bet ($0.10) returned to Dershura1989
Dershura1989 collected $0.30 from pot
Dershura1989: doesn't show hand 
*** SUMMARY ***
Total pot $0.31 | Rake $0.01 
Board [Jh Ks 7h]
Seat 1: Dershura1989 (button) collected ($0.30)
Seat 2: Healthys07 (small blind) folded before Flop
Seat 3: Scaaalll (big blind) folded before Flop
Seat 4: zbixxx folded before Flop (didn't bet)
Seat 5: camelot230 folded before Flop (didn't bet)
Seat 6: Clavis Noa folded on the Flop



PokerStars Zoom Hand #229232081339:  Hold'em No Limit ($0.01/$0.02) - 2021/08/21 22:37:44 CET [2021/08/21 16:37:44 ET]
Table 'Halley' 6-max Seat #1 is the button
Seat 1: EdwardF95 ($3.41 in chips) 
Seat 2: SaRCh_Ale ($2 in chips) 
Seat 3: RaulacateFolds ($2 in chips) 
Seat 4: Scaaalll ($3.38 in chips) 
Seat 5: NoEff0rt2w1n ($2.21 in chips) 
Seat 6: LuckyCheewey ($10.99 in chips) 
SaRCh_Ale: posts small blind $0.01
RaulacateFolds: posts big blind $0.02
*** HOLE CARDS ***
Dealt to Scaaalll [3s Jc]
Scaaalll: folds 
NoEff0rt2w1n: folds 
LuckyCheewey: folds 
EdwardF95: folds 
SaRCh_Ale: folds 
Uncalled bet ($0.01) returned to RaulacateFolds
RaulacateFolds collected $0.02 from pot
RaulacateFolds: doesn't show hand 
*** SUMMARY ***
Total pot $0.02 | Rake $0 
Seat 1: EdwardF95 (button) folded before Flop (didn't bet)
Seat 2: SaRCh_Ale (small blind) folded before Flop
Seat 3: RaulacateFolds (big blind) collected ($0.02)
Seat 4: Scaaalll folded before Flop (didn't bet)
Seat 5: NoEff0rt2w1n folded before Flop (didn't bet)
Seat 6: LuckyCheewey folded before Flop (didn't bet)



PokerStars Zoom Hand #229232083120:  Hold'em No Limit ($0.01/$0.02) - 2021/08/21 22:37:48 CET [2021/08/21 16:37:48 ET]
Table 'Halley' 6-max Seat #1 is the button
Seat 1: SaRCh_Ale ($2.70 in chips) 
Seat 2: kgatihertzavis ($1.38 in chips) 
Seat 3: WITKOW_AV ($2.37 in chips) 
Seat 4: Akrobat94 ($4.71 in chips) 
Seat 5: BigTestIcicle ($2.09 in chips) 
Seat 6: Scaaalll ($3.38 in chips) 
kgatihertzavis: posts small blind $0.01
WITKOW_AV: posts big blind $0.02
*** HOLE CARDS ***
Dealt to Scaaalll [4c Ac]
Akrobat94: folds 
Akrobat94 is disconnected 
kgatihertzavis is disconnected 
BigTestIcicle: folds 
Scaaalll: raises $0.04 to $0.06
SaRCh_Ale: folds 
kgatihertzavis: folds 
WITKOW_AV: folds 
Uncalled bet ($0.04) returned to Scaaalll
Scaaalll collected $0.05 from pot
Scaaalll: doesn't show hand 
*** SUMMARY ***
Total pot $0.05 | Rake $0 
Seat 1: SaRCh_Ale (button) folded before Flop (didn't bet)
Seat 2: kgatihertzavis (small blind) folded before Flop
Seat 3: WITKOW_AV (big blind) folded before Flop
Seat 4: Akrobat94 folded before Flop (didn't bet)
Seat 5: BigTestIcicle folded before Flop (didn't bet)
Seat 6: Scaaalll collected ($0.05)



PokerStars Zoom Hand #229232091124:  Hold'em No Limit ($0.01/$0.02) - 2021/08/21 22:38:06 CET [2021/08/21 16:38:06 ET]
Table 'Halley' 6-max Seat #1 is the button
Seat 1: 78joniboy ($2.48 in chips) 
Seat 2: Scaaalll ($3.41 in chips) 
Seat 3: pavlo8855 ($2 in chips) 
Seat 4: keb1981 ($2 in chips) 
Seat 5: Busya777 ($1.73 in chips) 
Seat 6: Larí ($1.99 in chips) 
Scaaalll: posts small blind $0.01
pavlo8855: posts big blind $0.02
*** HOLE CARDS ***
Dealt to Scaaalll [6c 8d]
keb1981: folds 
Busya777: folds 
Busya777 is disconnected 
Larí: folds 
78joniboy: folds 
Scaaalll: folds 
Uncalled bet ($0.01) returned to pavlo8855
pavlo8855 collected $0.02 from pot
pavlo8855: doesn't show hand 
*** SUMMARY ***
Total pot $0.02 | Rake $0 
Seat 1: 78joniboy (button) folded before Flop (didn't bet)
Seat 2: Scaaalll (small blind) folded before Flop
Seat 3: pavlo8855 (big blind) collected ($0.02)
Seat 4: keb1981 folded before Flop (didn't bet)
Seat 5: Busya777 folded before Flop (didn't bet)
Seat 6: Larí folded before Flop (didn't bet)



PokerStars Zoom Hand #229232089356:  Hold'em No Limit ($0.01/$0.02) - 2021/08/21 22:38:02 CET [2021/08/21 16:38:02 ET]
Table 'Halley' 6-max Seat #1 is the button
Seat 1: Scaaalll ($3.41 in chips) 
Seat 2: traz_uk1 ($1.98 in chips) 
Seat 3: Hantsirg ($1.95 in chips) 
Seat 4: Smailodon ($0.92 in chips) 
Seat 5: arturtsutsaev ($1.17 in chips) 
Seat 6: RichJImen89 ($2.09 in chips) 
traz_uk1: posts small blind $0.01
Hantsirg: posts big blind $0.02
*** HOLE CARDS ***
Dealt to Scaaalll [Jh 6c]
arturtsutsaev is disconnected 
Smailodon: folds 
arturtsutsaev: folds 
RichJImen89: raises $0.03 to $0.05
Scaaalll: folds 
Hantsirg is disconnected 
traz_uk1: calls $0.04
Hantsirg: folds 
*** FLOP *** [4c Ts Js]
traz_uk1: checks 
RichJImen89: bets $0.07
traz_uk1: folds 
Uncalled bet ($0.07) returned to RichJImen89
RichJImen89 collected $0.12 from pot
RichJImen89: doesn't show hand 
traz_uk1 is disconnected 
*** SUMMARY ***
Total pot $0.12 | Rake $0 
Board [4c Ts Js]
Seat 1: Scaaalll (button) folded before Flop (didn't bet)
Seat 2: traz_uk1 (small blind) folded on the Flop
Seat 3: Hantsirg (big blind) folded before Flop
Seat 4: Smailodon folded before Flop (didn't bet)
Seat 5: arturtsutsaev folded before Flop (didn't bet)
Seat 6: RichJImen89 collected ($0.12)



PokerStars Zoom Hand #229232098201:  Hold'em No Limit ($0.01/$0.02) - 2021/08/21 22:38:22 CET [2021/08/21 16:38:22 ET]
Table 'Halley' 6-max Seat #1 is the button
Seat 1: pavlo8855 ($2.58 in chips) 
Seat 2: alphabeta1d ($2.15 in chips) 
Seat 3: Scaaalll ($3.40 in chips) 
Seat 4: HubertFroh ($5.13 in chips) 
Seat 5: jejmcclu ($3.64 in chips) 
Seat 6: Gamer577 ($2.06 in chips) 
alphabeta1d: posts small blind $0.01
Scaaalll: posts big blind $0.02
*** HOLE CARDS ***
Dealt to Scaaalll [2h Ad]
HubertFroh: folds 
jejmcclu: folds 
Gamer577: folds 
pavlo8855: folds 
alphabeta1d: folds 
Uncalled bet ($0.01) returned to Scaaalll
Scaaalll collected $0.02 from pot
Scaaalll: doesn't show hand 
*** SUMMARY ***
Total pot $0.02 | Rake $0 
Seat 1: pavlo8855 (button) folded before Flop (didn't bet)
Seat 2: alphabeta1d (small blind) folded before Flop
Seat 3: Scaaalll (big blind) collected ($0.02)
Seat 4: HubertFroh folded before Flop (didn't bet)
Seat 5: jejmcclu folded before Flop (didn't bet)
Seat 6: Gamer577 folded before Flop (didn't bet)



PokerStars Zoom Hand #229232095513:  Hold'em No Limit ($0.01/$0.02) - 2021/08/21 22:38:16 CET [2021/08/21 16:38:16 ET]
Table 'Halley' 6-max Seat #1 is the button
Seat 1: Hantsirg ($1.93 in chips) 
Seat 2: alphabeta1d ($2.12 in chips) 
Seat 3: Posaunengodi ($2.18 in chips) 
Seat 4: Scaaalll ($3.40 in chips) 
Seat 5: wstanula ($1.34 in chips) 
Seat 6: pavlo8855 ($2.01 in chips) 
alphabeta1d: posts small blind $0.01
Posaunengodi: posts big blind $0.02
*** HOLE CARDS ***
Dealt to Scaaalll [9d 3h]
Scaaalll: folds 
wstanula: folds 
pavlo8855: raises $0.03 to $0.05
Hantsirg: raises $0.07 to $0.12
alphabeta1d: folds 
Posaunengodi: folds 
pavlo8855: calls $0.07
*** FLOP *** [Jc Jh 7d]
pavlo8855: checks 
Hantsirg: checks 
*** TURN *** [Jc Jh 7d] [Ac]
pavlo8855: checks 
Hantsirg: bets $0.13
pavlo8855: folds 
Uncalled bet ($0.13) returned to Hantsirg
Hantsirg collected $0.26 from pot
Hantsirg: doesn't show hand 
*** SUMMARY ***
Total pot $0.27 | Rake $0.01 
Board [Jc Jh 7d Ac]
Seat 1: Hantsirg (button) collected ($0.26)
Seat 2: alphabeta1d (small blind) folded before Flop
Seat 3: Posaunengodi (big blind) folded before Flop
Seat 4: Scaaalll folded before Flop (didn't bet)
Seat 5: wstanula folded before Flop (didn't bet)
Seat 6: pavlo8855 folded on the Turn



PokerStars Zoom Hand #229232103991:  Hold'em No Limit ($0.01/$0.02) - 2021/08/21 22:38:35 CET [2021/08/21 16:38:35 ET]
Table 'Halley' 6-max Seat #1 is the button
Seat 1: storo98 ($16.69 in chips) 
Seat 2: Scaaalll ($3.41 in chips) 
Seat 3: pipecmolodec ($2.19 in chips) 
Seat 4: pavlo8855 ($2.58 in chips) 
Seat 5: znak312 ($2.26 in chips) 
Seat 6: ppluiaule ($2.03 in chips) 
Scaaalll: posts small blind $0.01
pipecmolodec: posts big blind $0.02
*** HOLE CARDS ***
Dealt to Scaaalll [6c 8s]
pavlo8855: folds 
znak312: folds 
ppluiaule: folds 
storo98: raises $0.03 to $0.05
Scaaalll: folds 
pipecmolodec: folds 
Uncalled bet ($0.03) returned to storo98
storo98 collected $0.05 from pot
storo98: doesn't show hand 
*** SUMMARY ***
Total pot $0.05 | Rake $0 
Seat 1: storo98 (button) collected ($0.05)
Seat 2: Scaaalll (small blind) folded before Flop
Seat 3: pipecmolodec (big blind) folded before Flop
Seat 4: pavlo8855 folded before Flop (didn't bet)
Seat 5: znak312 folded before Flop (didn't bet)
Seat 6: ppluiaule folded before Flop (didn't bet)



PokerStars Zoom Hand #229232092928:  Hold'em No Limit ($0.01/$0.02) - 2021/08/21 22:38:10 CET [2021/08/21 16:38:10 ET]
Table 'Halley' 6-max Seat #1 is the button
Seat 1: Enoffllescini ($2 in chips) 
Seat 2: Baldisback ($2.74 in chips) 
Seat 3: SirBatish ($2.01 in chips) 
Seat 4: Chapaev136 ($5.27 in chips) 
Seat 5: Scaaalll ($3.40 in chips) 
Seat 6: LuckyCheewey ($5.35 in chips) 
Baldisback: posts small blind $0.01
SirBatish: posts big blind $0.02
*** HOLE CARDS ***
Dealt to Scaaalll [5s 6h]
Chapaev136: folds 
Scaaalll: folds 
LuckyCheewey: raises $0.05 to $0.07
Enoffllescini: folds 
Baldisback: folds 
SirBatish: calls $0.05
*** FLOP *** [2d 4s 9c]
SirBatish: checks 
LuckyCheewey: checks 
*** TURN *** [2d 4s 9c] [6d]
SirBatish: bets $0.10
LuckyCheewey: folds 
Uncalled bet ($0.10) returned to SirBatish
SirBatish collected $0.14 from pot
SirBatish: doesn't show hand 
*** SUMMARY ***
Total pot $0.15 | Rake $0.01 
Board [2d 4s 9c 6d]
Seat 1: Enoffllescini (button) folded before Flop (didn't bet)
Seat 2: Baldisback (small blind) folded before Flop
Seat 3: SirBatish (big blind) collected ($0.14)
Seat 4: Chapaev136 folded before Flop (didn't bet)
Seat 5: Scaaalll folded before Flop (didn't bet)
Seat 6: LuckyCheewey folded on the Turn



PokerStars Zoom Hand #229232108858:  Hold'em No Limit ($0.01/$0.02) - 2021/08/21 22:38:46 CET [2021/08/21 16:38:46 ET]
Table 'Halley' 6-max Seat #1 is the button
Seat 1: FabOliveira9 ($2 in chips) 
Seat 2: rancing87 ($2 in chips) 
Seat 3: alecha11 ($3.54 in chips) 
Seat 4: carlomagno ($2.37 in chips) 
Seat 5: Scaaalll ($3.40 in chips) 
Seat 6: HellNative ($2.25 in chips) 
rancing87: posts small blind $0.01
alecha11: posts big blind $0.02
*** HOLE CARDS ***
Dealt to Scaaalll [Ac 5d]
carlomagno: folds 
Scaaalll: folds 
HellNative: folds 
FabOliveira9: folds 
rancing87: folds 
Uncalled bet ($0.01) returned to alecha11
alecha11 collected $0.02 from pot
alecha11: doesn't show hand 
*** SUMMARY ***
Total pot $0.02 | Rake $0 
Seat 1: FabOliveira9 (button) folded before Flop (didn't bet)
Seat 2: rancing87 (small blind) folded before Flop
Seat 3: alecha11 (big blind) collected ($0.02)
Seat 4: carlomagno folded before Flop (didn't bet)
Seat 5: Scaaalll folded before Flop (didn't bet)
Seat 6: HellNative folded before Flop (didn't bet)



PokerStars Zoom Hand #229232102196:  Hold'em No Limit ($0.01/$0.02) - 2021/08/21 22:38:31 CET [2021/08/21 16:38:31 ET]
Table 'Halley' 6-max Seat #1 is the button
Seat 1: Scaaalll ($3.41 in chips) 
Seat 2: mheronmagno ($1 in chips) 
Seat 3: twiti174 ($1.57 in chips) 
Seat 4: grammy54 ($1.15 in chips) 
Seat 5: AdriPato ($2.34 in chips) 
Seat 6: KRITAYA ($2.37 in chips) 
mheronmagno: posts small blind $0.01
twiti174: posts big blind $0.02
*** HOLE CARDS ***
Dealt to Scaaalll [Qh 5s]
grammy54: folds 
AdriPato: folds 
KRITAYA: raises $0.04 to $0.06
Scaaalll: folds 
mheronmagno: folds 
twiti174: calls $0.04
*** FLOP *** [Qs 4s 6s]
twiti174: bets $0.13
KRITAYA: calls $0.13
*** TURN *** [Qs 4s 6s] [Jd]
twiti174: bets $0.38
KRITAYA: calls $0.38
*** RIVER *** [Qs 4s 6s Jd] [Ah]
twiti174: bets $1 and is all-in
KRITAYA: calls $1
*** SHOW DOWN ***
twiti174: shows [Kc 6d] (a pair of Sixes)
KRITAYA: shows [Ad As] (three of a kind, Aces)
KRITAYA collected $3.04 from pot
*** SUMMARY ***
Total pot $3.15 | Rake $0.11 
Board [Qs 4s 6s Jd Ah]
Seat 1: Scaaalll (button) folded before Flop (didn't bet)
Seat 2: mheronmagno (small blind) folded before Flop
Seat 3: twiti174 (big blind) showed [Kc 6d] and lost with a pair of Sixes
Seat 4: grammy54 folded before Flop (didn't bet)
Seat 5: AdriPato folded before Flop (didn't bet)
Seat 6: KRITAYA showed [Ad As] and won ($3.04) with three of a kind, Aces



PokerStars Zoom Hand #229232114140:  Hold'em No Limit ($0.01/$0.02) - 2021/08/21 22:38:58 CET [2021/08/21 16:38:58 ET]
Table 'Halley' 6-max Seat #1 is the button
Seat 1: BadBeat Bert ($1.95 in chips) 
Seat 2: SirBatish ($2.08 in chips) 
Seat 3: SIGREX ($2.83 in chips) 
Seat 4: Scaaalll ($3.40 in chips) 
Seat 5: Kkamm ($2.19 in chips) 
Seat 6: BlackhawKK's ($2.16 in chips) 
SirBatish: posts small blind $0.01
SIGREX: posts big blind $0.02
*** HOLE CARDS ***
Dealt to Scaaalll [4h 3d]
Scaaalll: folds 
Kkamm: folds 
BlackhawKK's: folds 
BadBeat Bert: folds 
SirBatish: raises $0.04 to $0.06
SIGREX: calls $0.04
*** FLOP *** [2s 3c 7d]
SirBatish: bets $0.08
SIGREX: folds 
Uncalled bet ($0.08) returned to SirBatish
SirBatish collected $0.12 from pot
SirBatish: doesn't show hand 
*** SUMMARY ***
Total pot $0.12 | Rake $0 
Board [2s 3c 7d]
Seat 1: BadBeat Bert (button) folded before Flop (didn't bet)
Seat 2: SirBatish (small blind) collected ($0.12)
Seat 3: SIGREX (big blind) folded on the Flop
Seat 4: Scaaalll folded before Flop (didn't bet)
Seat 5: Kkamm folded before Flop (didn't bet)
Seat 6: BlackhawKK's folded before Flop (didn't bet)



PokerStars Zoom Hand #229232111943:  Hold'em No Limit ($0.01/$0.02) - 2021/08/21 22:38:53 CET [2021/08/21 16:38:53 ET]
Table 'Halley' 6-max Seat #1 is the button
Seat 1: Gamer577 ($2.04 in chips) 
Seat 2: Red Sky 15 ($10.61 in chips) 
Seat 3: Emilmoller1 ($0.94 in chips) 
Seat 4: bananAAbandit ($4.29 in chips) 
Seat 5: Chapaev136 ($5.18 in chips) 
Seat 6: Scaaalll ($3.40 in chips) 
Red Sky 15: posts small blind $0.01
Emilmoller1: posts big blind $0.02
*** HOLE CARDS ***
Dealt to Scaaalll [5c 8s]
bananAAbandit: folds 
Chapaev136: folds 
Scaaalll: folds 
Gamer577: raises $0.04 to $0.06
Red Sky 15: calls $0.05
Emilmoller1: folds 
*** FLOP *** [4d 8d 3h]
Red Sky 15: checks 
Gamer577: checks 
*** TURN *** [4d 8d 3h] [5h]
Red Sky 15: bets $0.09
Gamer577: calls $0.09
*** RIVER *** [4d 8d 3h 5h] [7d]
Red Sky 15: checks 
Gamer577: bets $0.23
Red Sky 15: folds 
Uncalled bet ($0.23) returned to Gamer577
Gamer577 collected $0.31 from pot
Gamer577: doesn't show hand 
Red Sky 15 is disconnected 
*** SUMMARY ***
Total pot $0.32 | Rake $0.01 
Board [4d 8d 3h 5h 7d]
Seat 1: Gamer577 (button) collected ($0.31)
Seat 2: Red Sky 15 (small blind) folded on the River
Seat 3: Emilmoller1 (big blind) folded before Flop
Seat 4: bananAAbandit folded before Flop (didn't bet)
Seat 5: Chapaev136 folded before Flop (didn't bet)
Seat 6: Scaaalll folded before Flop (didn't bet)



PokerStars Zoom Hand #229232115894:  Hold'em No Limit ($0.01/$0.02) - 2021/08/21 22:39:02 CET [2021/08/21 16:39:02 ET]
Table 'Halley' 6-max Seat #1 is the button
Seat 1: AlexGTPS ($3.18 in chips) 
Seat 2: Axel201388 ($0.75 in chips) 
Seat 3: Scaaalll ($3.40 in chips) 
Seat 4: shingo594 ($4.25 in chips) 
Seat 5: NoEff0rt2w1n ($2.76 in chips) 
Seat 6: vovo4kapooh ($3.64 in chips) 
Axel201388: posts small blind $0.01
Scaaalll: posts big blind $0.02
*** HOLE CARDS ***
Dealt to Scaaalll [Jc Qc]
shingo594: folds 
shingo594 is disconnected 
NoEff0rt2w1n: folds 
vovo4kapooh: raises $0.04 to $0.06
AlexGTPS: folds 
Axel201388: folds 
Scaaalll: calls $0.04
*** FLOP *** [Ad Qs 2s]
Scaaalll: checks 
vovo4kapooh: bets $0.10
Scaaalll: calls $0.10
*** TURN *** [Ad Qs 2s] [2h]
Scaaalll: checks 
vovo4kapooh: bets $0.24
Scaaalll: folds 
Uncalled bet ($0.24) returned to vovo4kapooh
vovo4kapooh collected $0.32 from pot
vovo4kapooh: doesn't show hand 
*** SUMMARY ***
Total pot $0.33 | Rake $0.01 
Board [Ad Qs 2s 2h]
Seat 1: AlexGTPS (button) folded before Flop (didn't bet)
Seat 2: Axel201388 (small blind) folded before Flop
Seat 3: Scaaalll (big blind) folded on the Turn
Seat 4: shingo594 folded before Flop (didn't bet)
Seat 5: NoEff0rt2w1n folded before Flop (didn't bet)
Seat 6: vovo4kapooh collected ($0.32)



PokerStars Zoom Hand #229232143504:  Hold'em No Limit ($0.01/$0.02) - 2021/08/21 22:40:03 CET [2021/08/21 16:40:03 ET]
Table 'Halley' 6-max Seat #1 is the button
Seat 1: porkie23 ($1.96 in chips) 
Seat 2: pipecmolodec ($2 in chips) 
Seat 3: zergmiky ($2.35 in chips) 
Seat 4: Demidov V.S. ($2 in chips) 
Seat 5: Scaaalll ($3.23 in chips) 
Seat 6: STE1NBERG ($3.09 in chips) 
pipecmolodec: posts small blind $0.01
zergmiky: posts big blind $0.02
*** HOLE CARDS ***
Dealt to Scaaalll [5c Js]
Demidov V.S.: folds 
Scaaalll: folds 
STE1NBERG: folds 
porkie23: folds 
Demidov V.S. is disconnected 
pipecmolodec: folds 
Uncalled bet ($0.01) returned to zergmiky
zergmiky collected $0.02 from pot
zergmiky: doesn't show hand 
*** SUMMARY ***
Total pot $0.02 | Rake $0 
Seat 1: porkie23 (button) folded before Flop (didn't bet)
Seat 2: pipecmolodec (small blind) folded before Flop
Seat 3: zergmiky (big blind) collected ($0.02)
Seat 4: Demidov V.S. folded before Flop (didn't bet)
Seat 5: Scaaalll folded before Flop (didn't bet)
Seat 6: STE1NBERG folded before Flop (didn't bet)



PokerStars Zoom Hand #229232145284:  Hold'em No Limit ($0.01/$0.02) - 2021/08/21 22:40:07 CET [2021/08/21 16:40:07 ET]
Table 'Halley' 6-max Seat #1 is the button
Seat 1: Gamer577 ($2.03 in chips) 
Seat 2: 78joniboy ($2 in chips) 
Seat 3: SGALINAE ($2.23 in chips) 
Seat 4: Tn 939 ($2.29 in chips) 
Seat 5: Antipirate ($2.66 in chips) 
Seat 6: Scaaalll ($3.23 in chips) 
78joniboy: posts small blind $0.01
SGALINAE: posts big blind $0.02
*** HOLE CARDS ***
Dealt to Scaaalll [Tc 5d]
Antipirate is disconnected 
Tn 939: folds 
Antipirate: folds 
Scaaalll: folds 
Gamer577: folds 
78joniboy: folds 
Uncalled bet ($0.01) returned to SGALINAE
SGALINAE collected $0.02 from pot
SGALINAE: doesn't show hand 
*** SUMMARY ***
Total pot $0.02 | Rake $0 
Seat 1: Gamer577 (button) folded before Flop (didn't bet)
Seat 2: 78joniboy (small blind) folded before Flop
Seat 3: SGALINAE (big blind) collected ($0.02)
Seat 4: Tn 939 folded before Flop (didn't bet)
Seat 5: Antipirate folded before Flop (didn't bet)
Seat 6: Scaaalll folded before Flop (didn't bet)



PokerStars Zoom Hand #229232136493:  Hold'em No Limit ($0.01/$0.02) - 2021/08/21 22:39:47 CET [2021/08/21 16:39:47 ET]
Table 'Halley' 6-max Seat #1 is the button
Seat 1: KatedratiK ($2.07 in chips) 
Seat 2: Scaaalll ($3.24 in chips) 
Seat 3: MrTarpey ($0.51 in chips) 
Seat 4: El Chicha.CL ($2.05 in chips) 
Seat 5: KonopDima ($2.18 in chips) 
Seat 6: lumpek1112 ($2 in chips) 
Scaaalll: posts small blind $0.01
MrTarpey: posts big blind $0.02
*** HOLE CARDS ***
Dealt to Scaaalll [3s 5h]
El Chicha.CL: folds 
KonopDima: raises $0.04 to $0.06
lumpek1112: folds 
KatedratiK: folds 
Scaaalll: folds 
MrTarpey: calls $0.04
*** FLOP *** [5c 9h 5s]
MrTarpey: checks 
KonopDima: checks 
*** TURN *** [5c 9h 5s] [7d]
MrTarpey: bets $0.13
KonopDima: folds 
Uncalled bet ($0.13) returned to MrTarpey
MrTarpey collected $0.13 from pot
MrTarpey: doesn't show hand 
*** SUMMARY ***
Total pot $0.13 | Rake $0 
Board [5c 9h 5s 7d]
Seat 1: KatedratiK (button) folded before Flop (didn't bet)
Seat 2: Scaaalll (small blind) folded before Flop
Seat 3: MrTarpey (big blind) collected ($0.13)
Seat 4: El Chicha.CL folded before Flop (didn't bet)
Seat 5: KonopDima folded on the Turn
Seat 6: lumpek1112 folded before Flop (didn't bet)



PokerStars Zoom Hand #229232140855:  Hold'em No Limit ($0.01/$0.02) - 2021/08/21 22:39:57 CET [2021/08/21 16:39:57 ET]
Table 'Halley' 6-max Seat #1 is the button
Seat 1: Scaaalll ($3.23 in chips) 
Seat 2: sal_sagev41 ($2.56 in chips) 
Seat 3: Artezito ($2.25 in chips) 
Seat 4: prez_25789 ($1.92 in chips) 
Seat 5: GVMELLO ($2.06 in chips) 
Seat 6: Enoffllescini ($2 in chips) 
sal_sagev41: posts small blind $0.01
Artezito: posts big blind $0.02
*** HOLE CARDS ***
Dealt to Scaaalll [2h 9s]
prez_25789: raises $0.02 to $0.04
GVMELLO: raises $0.10 to $0.14
Enoffllescini: calls $0.14
Scaaalll: folds 
sal_sagev41: folds 
Artezito: folds 
prez_25789: folds 
*** FLOP *** [3d 3h Th]
GVMELLO: checks 
Enoffllescini: bets $0.22
GVMELLO: folds 
Uncalled bet ($0.22) returned to Enoffllescini
Enoffllescini collected $0.34 from pot
Enoffllescini: doesn't show hand 
*** SUMMARY ***
Total pot $0.35 | Rake $0.01 
Board [3d 3h Th]
Seat 1: Scaaalll (button) folded before Flop (didn't bet)
Seat 2: sal_sagev41 (small blind) folded before Flop
Seat 3: Artezito (big blind) folded before Flop
Seat 4: prez_25789 folded before Flop
Seat 5: GVMELLO folded on the Flop
Seat 6: Enoffllescini collected ($0.34)



PokerStars Zoom Hand #229232149660:  Hold'em No Limit ($0.01/$0.02) - 2021/08/21 22:40:17 CET [2021/08/21 16:40:17 ET]
Table 'Halley' 6-max Seat #1 is the button
Seat 1: CRODeny ($2 in chips) 
Seat 2: olcham7 ($2 in chips) 
Seat 3: djewlz ($2.92 in chips) 
Seat 4: sg.32rus ($1.02 in chips) 
Seat 5: mheronmagno ($0.92 in chips) 
Seat 6: Scaaalll ($3.23 in chips) 
olcham7: posts small blind $0.01
djewlz: posts big blind $0.02
*** HOLE CARDS ***
Dealt to Scaaalll [2h 4c]
sg.32rus: folds 
mheronmagno: folds 
Scaaalll: folds 
CRODeny: folds 
olcham7: raises $0.04 to $0.06
djewlz: calls $0.04
*** FLOP *** [Qd 4h 6c]
olcham7: checks 
djewlz: bets $0.06
olcham7: folds 
Uncalled bet ($0.06) returned to djewlz
djewlz collected $0.12 from pot
djewlz: doesn't show hand 
*** SUMMARY ***
Total pot $0.12 | Rake $0 
Board [Qd 4h 6c]
Seat 1: CRODeny (button) folded before Flop (didn't bet)
Seat 2: olcham7 (small blind) folded on the Flop
Seat 3: djewlz (big blind) collected ($0.12)
Seat 4: sg.32rus folded before Flop (didn't bet)
Seat 5: mheronmagno folded before Flop (didn't bet)
Seat 6: Scaaalll folded before Flop (didn't bet)



PokerStars Zoom Hand #229232151446:  Hold'em No Limit ($0.01/$0.02) - 2021/08/21 22:40:21 CET [2021/08/21 16:40:21 ET]
Table 'Halley' 6-max Seat #1 is the button
Seat 1: KonopDima ($2.12 in chips) 
Seat 2: Lilica494 ($1.11 in chips) 
Seat 3: Scaaalll ($3.23 in chips) 
Seat 4: vovo4kapooh ($4.74 in chips) 
Seat 5: Kkamm ($2 in chips) 
Seat 6: Agno$tic ($3.30 in chips) 
Lilica494: posts small blind $0.01
Scaaalll: posts big blind $0.02
*** HOLE CARDS ***
Dealt to Scaaalll [5d Ah]
vovo4kapooh: folds 
Kkamm: folds 
Agno$tic: folds 
KonopDima: raises $0.04 to $0.06
Lilica494: raises $0.04 to $0.10
Scaaalll: folds 
KonopDima: calls $0.04
*** FLOP *** [Ac Qd 7s]
Lilica494: checks 
KonopDima: bets $0.14
Lilica494: folds 
Uncalled bet ($0.14) returned to KonopDima
KonopDima collected $0.21 from pot
KonopDima: doesn't show hand 
*** SUMMARY ***
Total pot $0.22 | Rake $0.01 
Board [Ac Qd 7s]
Seat 1: KonopDima (button) collected ($0.21)
Seat 2: Lilica494 (small blind) folded on the Flop
Seat 3: Scaaalll (big blind) folded before Flop
Seat 4: vovo4kapooh folded before Flop (didn't bet)
Seat 5: Kkamm folded before Flop (didn't bet)
Seat 6: Agno$tic folded before Flop (didn't bet)



PokerStars Zoom Hand #229232147908:  Hold'em No Limit ($0.01/$0.02) - 2021/08/21 22:40:13 CET [2021/08/21 16:40:13 ET]
Table 'Halley' 6-max Seat #1 is the button
Seat 1: Clavis Noa ($4.19 in chips) 
Seat 2: Earl_greyPL ($2.26 in chips) 
Seat 3: Ne0net ($2 in chips) 
Seat 4: Scaaalll ($3.23 in chips) 
Seat 5: Coldact ($0.78 in chips) 
Seat 6: olcham7 ($2 in chips) 
Earl_greyPL: posts small blind $0.01
Ne0net: posts big blind $0.02
*** HOLE CARDS ***
Dealt to Scaaalll [3h 8h]
Scaaalll: folds 
Coldact: raises $0.04 to $0.06
olcham7: folds 
Clavis Noa: calls $0.06
Earl_greyPL: folds 
Ne0net: folds 
*** FLOP *** [7d Th 9s]
Coldact: bets $0.16
Clavis Noa: calls $0.16
*** TURN *** [7d Th 9s] [8c]
Coldact: bets $0.08
Clavis Noa: raises $0.08 to $0.16
Coldact: calls $0.08
*** RIVER *** [7d Th 9s 8c] [5d]
Coldact: bets $0.06
Clavis Noa: raises $0.44 to $0.50
Coldact: calls $0.34 and is all-in
Uncalled bet ($0.10) returned to Clavis Noa
*** SHOW DOWN ***
Clavis Noa: shows [Qc Jd] (a straight, Eight to Queen)
Coldact: shows [Ts Ad] (a pair of Tens)
Clavis Noa collected $1.53 from pot
*** SUMMARY ***
Total pot $1.59 | Rake $0.06 
Board [7d Th 9s 8c 5d]
Seat 1: Clavis Noa (button) showed [Qc Jd] and won ($1.53) with a straight, Eight to Queen
Seat 2: Earl_greyPL (small blind) folded before Flop
Seat 3: Ne0net (big blind) folded before Flop
Seat 4: Scaaalll folded before Flop (didn't bet)
Seat 5: Coldact showed [Ts Ad] and lost with a pair of Tens
Seat 6: olcham7 folded before Flop (didn't bet)



PokerStars Zoom Hand #229232161278:  Hold'em No Limit ($0.01/$0.02) - 2021/08/21 22:40:43 CET [2021/08/21 16:40:43 ET]
Table 'Halley' 6-max Seat #1 is the button
Seat 1: zergmiky ($2.18 in chips) 
Seat 2: Scaaalll ($3.21 in chips) 
Seat 3: lexus00174 ($1.62 in chips) 
Seat 4: Artezito ($2.22 in chips) 
Seat 5: WITKOW_AV ($2.24 in chips) 
Seat 6: you_my_bich ($1.12 in chips) 
Scaaalll: posts small blind $0.01
lexus00174: posts big blind $0.02
*** HOLE CARDS ***
Dealt to Scaaalll [Qs Js]
Artezito: folds 
WITKOW_AV: folds 
you_my_bich: folds 
zergmiky: folds 
you_my_bich is disconnected 
Scaaalll: raises $0.04 to $0.06
lexus00174: calls $0.04
*** FLOP *** [Ts As 7h]
Scaaalll: bets $0.08
lexus00174: folds 
Uncalled bet ($0.08) returned to Scaaalll
Scaaalll collected $0.12 from pot
Scaaalll: doesn't show hand 
*** SUMMARY ***
Total pot $0.12 | Rake $0 
Board [Ts As 7h]
Seat 1: zergmiky (button) folded before Flop (didn't bet)
Seat 2: Scaaalll (small blind) collected ($0.12)
Seat 3: lexus00174 (big blind) folded on the Flop
Seat 4: Artezito folded before Flop (didn't bet)
Seat 5: WITKOW_AV folded before Flop (didn't bet)
Seat 6: you_my_bich folded before Flop (didn't bet)



PokerStars Zoom Hand #229232171457:  Hold'em No Limit ($0.01/$0.02) - 2021/08/21 22:41:03 CET [2021/08/21 16:41:03 ET]
Table 'Halley' 6-max Seat #1 is the button
Seat 1: Scaaalll ($3.27 in chips) 
Seat 2: sinkthe8 ($1.88 in chips) 
Seat 3: gasmar_29 ($2.13 in chips) 
Seat 4: RaulacateFolds ($2.08 in chips) 
Seat 5: Clavis Noa ($4.94 in chips) 
Seat 6: MysticTrader2 ($3.35 in chips) 
sinkthe8: posts small blind $0.01
gasmar_29: posts big blind $0.02
*** HOLE CARDS ***
Dealt to Scaaalll [8h 3s]
sinkthe8 is disconnected 
RaulacateFolds: folds 
Clavis Noa: folds 
MysticTrader2: folds 
Scaaalll: folds 
sinkthe8: folds 
Uncalled bet ($0.01) returned to gasmar_29
gasmar_29 collected $0.02 from pot
gasmar_29: doesn't show hand 
*** SUMMARY ***
Total pot $0.02 | Rake $0 
Seat 1: Scaaalll (button) folded before Flop (didn't bet)
Seat 2: sinkthe8 (small blind) folded before Flop
Seat 3: gasmar_29 (big blind) collected ($0.02)
Seat 4: RaulacateFolds folded before Flop (didn't bet)
Seat 5: Clavis Noa folded before Flop (didn't bet)
Seat 6: MysticTrader2 folded before Flop (didn't bet)



PokerStars Zoom Hand #229232175763:  Hold'em No Limit ($0.01/$0.02) - 2021/08/21 22:41:13 CET [2021/08/21 16:41:13 ET]
Table 'Halley' 6-max Seat #1 is the button
Seat 1: GUN118 ($1.95 in chips) 
Seat 2: VasquezSancho96 ($1.38 in chips) 
Seat 3: Agno$tic ($3.29 in chips) 
Seat 4: BadBeat Bert ($1.81 in chips) 
Seat 5: Scaaalll ($3.27 in chips) 
Seat 6: NIK1973 23 ($2.36 in chips) 
VasquezSancho96: posts small blind $0.01
Agno$tic: posts big blind $0.02
*** HOLE CARDS ***
Dealt to Scaaalll [Jc 8h]
BadBeat Bert: folds 
Scaaalll: folds 
NIK1973 23: folds 
GUN118: folds 
VasquezSancho96: raises $1.36 to $1.38 and is all-in
Agno$tic: folds 
Uncalled bet ($1.36) returned to VasquezSancho96
VasquezSancho96 collected $0.04 from pot
VasquezSancho96: doesn't show hand 
*** SUMMARY ***
Total pot $0.04 | Rake $0 
Seat 1: GUN118 (button) folded before Flop (didn't bet)
Seat 2: VasquezSancho96 (small blind) collected ($0.04)
Seat 3: Agno$tic (big blind) folded before Flop
Seat 4: BadBeat Bert folded before Flop (didn't bet)
Seat 5: Scaaalll folded before Flop (didn't bet)
Seat 6: NIK1973 23 folded before Flop (didn't bet)



PokerStars Zoom Hand #229232179288:  Hold'em No Limit ($0.01/$0.02) - 2021/08/21 22:41:21 CET [2021/08/21 16:41:21 ET]
Table 'Halley' 6-max Seat #1 is the button
Seat 1: Busya777 ($1.98 in chips) 
Seat 2: so0love ($5.50 in chips) 
Seat 3: Clavis Noa ($4.97 in chips) 
Seat 4: Kb013497 ($1.16 in chips) 
Seat 5: Scaaalll ($3.27 in chips) 
Seat 6: Gamer577 ($2 in chips) 
so0love: posts small blind $0.01
Clavis Noa: posts big blind $0.02
*** HOLE CARDS ***
Dealt to Scaaalll [Kd Qh]
Busya777 is disconnected 
Kb013497: folds 
Scaaalll: raises $0.04 to $0.06
Gamer577: folds 
Busya777: folds 
so0love: folds 
Clavis Noa: calls $0.04
*** FLOP *** [3c Td Jd]
Clavis Noa: checks 
Scaaalll: bets $0.09
Clavis Noa: folds 
Uncalled bet ($0.09) returned to Scaaalll
Scaaalll collected $0.13 from pot
Scaaalll: doesn't show hand 
*** SUMMARY ***
Total pot $0.13 | Rake $0 
Board [3c Td Jd]
Seat 1: Busya777 (button) folded before Flop (didn't bet)
Seat 2: so0love (small blind) folded before Flop
Seat 3: Clavis Noa (big blind) folded on the Flop
Seat 4: Kb013497 folded before Flop (didn't bet)
Seat 5: Scaaalll collected ($0.13)
Seat 6: Gamer577 folded before Flop (didn't bet)



PokerStars Zoom Hand #229232191184:  Hold'em No Limit ($0.01/$0.02) - 2021/08/21 22:41:48 CET [2021/08/21 16:41:48 ET]
Table 'Halley' 6-max Seat #1 is the button
Seat 1: guntren.ps ($2 in chips) 
Seat 2: alphabeta1d ($2.23 in chips) 
Seat 3: NoEff0rt2w1n ($2 in chips) 
Seat 4: Scaaalll ($3.34 in chips) 
Seat 5: SKV_1985 ($2.73 in chips) 
Seat 6: LuckyCheewey ($2.48 in chips) 
alphabeta1d: posts small blind $0.01
NoEff0rt2w1n: posts big blind $0.02
*** HOLE CARDS ***
Dealt to Scaaalll [3d 9s]
Scaaalll: folds 
SKV_1985: folds 
LuckyCheewey: folds 
guntren.ps: folds 
alphabeta1d: folds 
Uncalled bet ($0.01) returned to NoEff0rt2w1n
NoEff0rt2w1n collected $0.02 from pot
NoEff0rt2w1n: doesn't show hand 
*** SUMMARY ***
Total pot $0.02 | Rake $0 
Seat 1: guntren.ps (button) folded before Flop (didn't bet)
Seat 2: alphabeta1d (small blind) folded before Flop
Seat 3: NoEff0rt2w1n (big blind) collected ($0.02)
Seat 4: Scaaalll folded before Flop (didn't bet)
Seat 5: SKV_1985 folded before Flop (didn't bet)
Seat 6: LuckyCheewey folded before Flop (didn't bet)



PokerStars Zoom Hand #229232196395:  Hold'em No Limit ($0.01/$0.02) - 2021/08/21 22:42:00 CET [2021/08/21 16:42:00 ET]
Table 'Halley' 6-max Seat #1 is the button
Seat 1: Pechorin.G ($2 in chips) 
Seat 2: Scaaalll ($3.32 in chips) 
Seat 3: dorro61966 ($1.66 in chips) 
Seat 4: CrazyyParis ($2.14 in chips) 
Seat 5: El Chicha.CL ($2.09 in chips) 
Seat 6: Umnik_M ($1.98 in chips) 
Scaaalll: posts small blind $0.01
dorro61966: posts big blind $0.02
*** HOLE CARDS ***
Dealt to Scaaalll [Js Qd]
CrazyyParis: raises $0.03 to $0.05
El Chicha.CL: folds 
Umnik_M: folds 
Pechorin.G: folds 
Scaaalll: folds 
dorro61966: folds 
Uncalled bet ($0.03) returned to CrazyyParis
CrazyyParis collected $0.05 from pot
CrazyyParis: doesn't show hand 
*** SUMMARY ***
Total pot $0.05 | Rake $0 
Seat 1: Pechorin.G (button) folded before Flop (didn't bet)
Seat 2: Scaaalll (small blind) folded before Flop
Seat 3: dorro61966 (big blind) folded before Flop
Seat 4: CrazyyParis collected ($0.05)
Seat 5: El Chicha.CL folded before Flop (didn't bet)
Seat 6: Umnik_M folded before Flop (didn't bet)



PokerStars Zoom Hand #229232192908:  Hold'em No Limit ($0.01/$0.02) - 2021/08/21 22:41:52 CET [2021/08/21 16:41:52 ET]
Table 'Halley' 6-max Seat #1 is the button
Seat 1: alphabeta1d ($2.22 in chips) 
Seat 2: feybys ($2.15 in chips) 
Seat 3: Scaaalll ($3.34 in chips) 
Seat 4: AlexGTPS ($2.22 in chips) 
Seat 5: bananAAbandit ($4.40 in chips) 
Seat 6: dyuh555 ($1.54 in chips) 
feybys: posts small blind $0.01
Scaaalll: posts big blind $0.02
*** HOLE CARDS ***
Dealt to Scaaalll [5s Qs]
AlexGTPS: raises $0.03 to $0.05
bananAAbandit: calls $0.05
dyuh555: folds 
alphabeta1d: folds 
feybys: folds 
Scaaalll: folds 
*** FLOP *** [As 4d 2d]
AlexGTPS: bets $0.06
bananAAbandit: folds 
Uncalled bet ($0.06) returned to AlexGTPS
AlexGTPS collected $0.13 from pot
AlexGTPS: doesn't show hand 
*** SUMMARY ***
Total pot $0.13 | Rake $0 
Board [As 4d 2d]
Seat 1: alphabeta1d (button) folded before Flop (didn't bet)
Seat 2: feybys (small blind) folded before Flop
Seat 3: Scaaalll (big blind) folded before Flop
Seat 4: AlexGTPS collected ($0.13)
Seat 5: bananAAbandit folded on the Flop
Seat 6: dyuh555 folded before Flop (didn't bet)



PokerStars Zoom Hand #229232201172:  Hold'em No Limit ($0.01/$0.02) - 2021/08/21 22:42:11 CET [2021/08/21 16:42:11 ET]
Table 'Halley' 6-max Seat #1 is the button
Seat 1: Scaaalll ($3.31 in chips) 
Seat 2: Allekccc ($2.17 in chips) 
Seat 3: Summerstrike ($3.43 in chips) 
Seat 4: SaRCh_Ale ($3.03 in chips) 
Seat 5: kresooo ($0.60 in chips) 
Seat 6: Sergio Rigel ($2.45 in chips) 
Allekccc: posts small blind $0.01
Summerstrike: posts big blind $0.02
*** HOLE CARDS ***
Dealt to Scaaalll [8h 9d]
SaRCh_Ale: folds 
kresooo: folds 
Sergio Rigel: folds 
Scaaalll: folds 
Allekccc: folds 
Uncalled bet ($0.01) returned to Summerstrike
Summerstrike collected $0.02 from pot
Summerstrike: doesn't show hand 
*** SUMMARY ***
Total pot $0.02 | Rake $0 
Seat 1: Scaaalll (button) folded before Flop (didn't bet)
Seat 2: Allekccc (small blind) folded before Flop
Seat 3: Summerstrike (big blind) collected ($0.02)
Seat 4: SaRCh_Ale folded before Flop (didn't bet)
Seat 5: kresooo folded before Flop (didn't bet)
Seat 6: Sergio Rigel folded before Flop (didn't bet)



PokerStars Zoom Hand #229232207715:  Hold'em No Limit ($0.01/$0.02) - 2021/08/21 22:42:26 CET [2021/08/21 16:42:26 ET]
Table 'Halley' 6-max Seat #1 is the button
Seat 1: Dr.stromg ($2.27 in chips) 
Seat 2: Hallyson_23 ($4.62 in chips) 
Seat 3: Scaaalll ($3.31 in chips) 
Seat 4: EmperorKurr ($4.10 in chips) 
Seat 5: gasmar_29 ($3.74 in chips) 
Seat 6: sewq55 ($1.40 in chips) 
Hallyson_23: posts small blind $0.01
Scaaalll: posts big blind $0.02
*** HOLE CARDS ***
Dealt to Scaaalll [5d Js]
EmperorKurr: folds 
gasmar_29: folds 
sewq55: folds 
Dr.stromg: folds 
Hallyson_23: raises $0.04 to $0.06
Scaaalll: folds 
Uncalled bet ($0.04) returned to Hallyson_23
Hallyson_23 collected $0.04 from pot
Hallyson_23: doesn't show hand 
*** SUMMARY ***
Total pot $0.04 | Rake $0 
Seat 1: Dr.stromg (button) folded before Flop (didn't bet)
Seat 2: Hallyson_23 (small blind) collected ($0.04)
Seat 3: Scaaalll (big blind) folded before Flop
Seat 4: EmperorKurr folded before Flop (didn't bet)
Seat 5: gasmar_29 folded before Flop (didn't bet)
Seat 6: sewq55 folded before Flop (didn't bet)



PokerStars Zoom Hand #229232205964:  Hold'em No Limit ($0.01/$0.02) - 2021/08/21 22:42:22 CET [2021/08/21 16:42:22 ET]
Table 'Halley' 6-max Seat #1 is the button
Seat 1: pepope ($2 in chips) 
Seat 2: SaVe KeNn500 ($0.92 in chips) 
Seat 3: NickAlex18 ($2.29 in chips) 
Seat 4: alecha11 ($2 in chips) 
Seat 5: Scaaalll ($3.31 in chips) 
Seat 6: Vanekakqj ($3.20 in chips) 
SaVe KeNn500: posts small blind $0.01
NickAlex18: posts big blind $0.02
*** HOLE CARDS ***
Dealt to Scaaalll [5h 9c]
alecha11: folds 
Scaaalll: folds 
Vanekakqj: folds 
pepope: raises $0.04 to $0.06
SaVe KeNn500: folds 
NickAlex18: calls $0.04
*** FLOP *** [9h Jd 2h]
NickAlex18: checks 
pepope: bets $0.09
NickAlex18: folds 
Uncalled bet ($0.09) returned to pepope
pepope collected $0.13 from pot
pepope: doesn't show hand 
*** SUMMARY ***
Total pot $0.13 | Rake $0 
Board [9h Jd 2h]
Seat 1: pepope (button) collected ($0.13)
Seat 2: SaVe KeNn500 (small blind) folded before Flop
Seat 3: NickAlex18 (big blind) folded on the Flop
Seat 4: alecha11 folded before Flop (didn't bet)
Seat 5: Scaaalll folded before Flop (didn't bet)
Seat 6: Vanekakqj folded before Flop (didn't bet)



PokerStars Zoom Hand #229232213902:  Hold'em No Limit ($0.01/$0.02) - 2021/08/21 22:42:40 CET [2021/08/21 16:42:40 ET]
Table 'Halley' 6-max Seat #1 is the button
Seat 1: Scaaalll ($3.29 in chips) 
Seat 2: sewq55 ($0.82 in chips) 
Seat 3: Clownyara ($2.38 in chips) 
Seat 4: LSDenny ($2.68 in chips) 
Seat 5: davidalejag ($3.53 in chips) 
Seat 6: HDYD18 ($5.74 in chips) 
sewq55: posts small blind $0.01
Clownyara: posts big blind $0.02
*** HOLE CARDS ***
Dealt to Scaaalll [5h 8d]
LSDenny: folds 
LSDenny is disconnected 
davidalejag: folds 
HDYD18: folds 
Scaaalll: folds 
sewq55: folds 
Uncalled bet ($0.01) returned to Clownyara
Clownyara collected $0.02 from pot
Clownyara: doesn't show hand 
*** SUMMARY ***
Total pot $0.02 | Rake $0 
Seat 1: Scaaalll (button) folded before Flop (didn't bet)
Seat 2: sewq55 (small blind) folded before Flop
Seat 3: Clownyara (big blind) collected ($0.02)
Seat 4: LSDenny folded before Flop (didn't bet)
Seat 5: davidalejag folded before Flop (didn't bet)
Seat 6: HDYD18 folded before Flop (didn't bet)



PokerStars Zoom Hand #229232203343:  Hold'em No Limit ($0.01/$0.02) - 2021/08/21 22:42:16 CET [2021/08/21 16:42:16 ET]
Table 'Halley' 6-max Seat #1 is the button
Seat 1: polymorhp ($3.15 in chips) 
Seat 2: Herr.Hikke ($2.30 in chips) 
Seat 3: dkno77 ($2.08 in chips) 
Seat 4: sinkthe8 ($1.78 in chips) 
Seat 5: vovo4kapooh ($3.59 in chips) 
Seat 6: Scaaalll ($3.31 in chips) 
Herr.Hikke: posts small blind $0.01
dkno77: posts big blind $0.02
*** HOLE CARDS ***
Dealt to Scaaalll [Ks 9h]
sinkthe8: calls $0.02
vovo4kapooh: folds 
Scaaalll: folds 
polymorhp: calls $0.02
Herr.Hikke: calls $0.01
dkno77: checks 
*** FLOP *** [4d 6h Jc]
Herr.Hikke: checks 
dkno77: checks 
sinkthe8: bets $0.04
polymorhp: calls $0.04
Herr.Hikke: calls $0.04
dkno77: raises $2.02 to $2.06 and is all-in
sinkthe8: folds 
sinkthe8 is disconnected 
polymorhp: folds 
Herr.Hikke: folds 
Uncalled bet ($2.02) returned to dkno77
dkno77 collected $0.23 from pot
dkno77: doesn't show hand 
*** SUMMARY ***
Total pot $0.24 | Rake $0.01 
Board [4d 6h Jc]
Seat 1: polymorhp (button) folded on the Flop
Seat 2: Herr.Hikke (small blind) folded on the Flop
Seat 3: dkno77 (big blind) collected ($0.23)
Seat 4: sinkthe8 folded on the Flop
Seat 5: vovo4kapooh folded before Flop (didn't bet)
Seat 6: Scaaalll folded before Flop (didn't bet)



PokerStars Zoom Hand #229232217829:  Hold'em No Limit ($0.01/$0.02) - 2021/08/21 22:42:49 CET [2021/08/21 16:42:49 ET]
Table 'Halley' 6-max Seat #1 is the button
Seat 1: GVMELLO ($2.27 in chips) 
Seat 2: Fedor_Gar ($4.02 in chips) 
Seat 3: El Chicha.CL ($2 in chips) 
Seat 4: golfffffer ($1.07 in chips) 
Seat 5: Scaaalll ($3.29 in chips) 
Seat 6: Baldisback ($3.55 in chips) 
Fedor_Gar: posts small blind $0.01
El Chicha.CL: posts big blind $0.02
*** HOLE CARDS ***
Dealt to Scaaalll [2c Qc]
golfffffer: folds 
golfffffer is disconnected 
Scaaalll: folds 
Baldisback: raises $0.02 to $0.04
GVMELLO: raises $0.10 to $0.14
Fedor_Gar: folds 
El Chicha.CL: folds 
Baldisback: folds 
Uncalled bet ($0.10) returned to GVMELLO
GVMELLO collected $0.11 from pot
GVMELLO: doesn't show hand 
*** SUMMARY ***
Total pot $0.11 | Rake $0 
Seat 1: GVMELLO (button) collected ($0.11)
Seat 2: Fedor_Gar (small blind) folded before Flop
Seat 3: El Chicha.CL (big blind) folded before Flop
Seat 4: golfffffer folded before Flop (didn't bet)
Seat 5: Scaaalll folded before Flop (didn't bet)
Seat 6: Baldisback folded before Flop



PokerStars Zoom Hand #229232220399:  Hold'em No Limit ($0.01/$0.02) - 2021/08/21 22:42:55 CET [2021/08/21 16:42:55 ET]
Table 'Halley' 6-max Seat #1 is the button
Seat 1: Han_Solo_71 ($1.35 in chips) 
Seat 2: Scaaalll ($3.29 in chips) 
Seat 3: Kojak34 ($6.45 in chips) 
Seat 4: ryokun@tps ($0.93 in chips) 
Seat 5: norbe4 ($2.08 in chips) 
Seat 6: HellNative ($4.08 in chips) 
Scaaalll: posts small blind $0.01
Kojak34: posts big blind $0.02
*** HOLE CARDS ***
Dealt to Scaaalll [Jh Kc]
ryokun@tps: folds 
norbe4: folds 
HellNative: folds 
Han_Solo_71: folds 
Han_Solo_71 is disconnected 
Scaaalll: raises $0.04 to $0.06
Kojak34: raises $0.12 to $0.18
Scaaalll: folds 
Uncalled bet ($0.12) returned to Kojak34
Kojak34 collected $0.12 from pot
Kojak34: doesn't show hand 
*** SUMMARY ***
Total pot $0.12 | Rake $0 
Seat 1: Han_Solo_71 (button) folded before Flop (didn't bet)
Seat 2: Scaaalll (small blind) folded before Flop
Seat 3: Kojak34 (big blind) collected ($0.12)
Seat 4: ryokun@tps folded before Flop (didn't bet)
Seat 5: norbe4 folded before Flop (didn't bet)
Seat 6: HellNative folded before Flop (didn't bet)



PokerStars Zoom Hand #229232228516:  Hold'em No Limit ($0.01/$0.02) - 2021/08/21 22:43:14 CET [2021/08/21 16:43:14 ET]
Table 'Halley' 6-max Seat #1 is the button
Seat 1: PEDACIT0 ($3.23 in chips) 
Seat 2: Axel201388 ($0.69 in chips) 
Seat 3: Scaaalll ($3.23 in chips) 
Seat 4: alphabeta1d ($2.14 in chips) 
Seat 5: so0love ($5.50 in chips) 
Seat 6: Tn 939 ($2.17 in chips) 
Axel201388: posts small blind $0.01
Scaaalll: posts big blind $0.02
*** HOLE CARDS ***
Dealt to Scaaalll [Jc 6c]
alphabeta1d: folds 
so0love: folds 
Tn 939: raises $0.04 to $0.06
PEDACIT0: folds 
Axel201388: folds 
Scaaalll: folds 
Uncalled bet ($0.04) returned to Tn 939
Tn 939 collected $0.05 from pot
Tn 939: doesn't show hand 
*** SUMMARY ***
Total pot $0.05 | Rake $0 
Seat 1: PEDACIT0 (button) folded before Flop (didn't bet)
Seat 2: Axel201388 (small blind) folded before Flop
Seat 3: Scaaalll (big blind) folded before Flop
Seat 4: alphabeta1d folded before Flop (didn't bet)
Seat 5: so0love folded before Flop (didn't bet)
Seat 6: Tn 939 collected ($0.05)



PokerStars Zoom Hand #229232235421:  Hold'em No Limit ($0.01/$0.02) - 2021/08/21 22:43:30 CET [2021/08/21 16:43:30 ET]
Table 'Halley' 6-max Seat #1 is the button
Seat 1: Busya777 ($1.92 in chips) 
Seat 2: MarioDios ($2 in chips) 
Seat 3: CordiPS ($6.27 in chips) 
Seat 4: Artezito ($2.05 in chips) 
Seat 5: fishh_play ($5.37 in chips) 
Seat 6: Scaaalll ($3.21 in chips) 
MarioDios: posts small blind $0.01
CordiPS: posts big blind $0.02
*** HOLE CARDS ***
Dealt to Scaaalll [Qd Kc]
Busya777 is disconnected 
Artezito: folds 
fishh_play: raises $0.03 to $0.05
Scaaalll: calls $0.05
Busya777: folds 
MarioDios: folds 
CordiPS: folds 
*** FLOP *** [Tc 5d 5s]
fishh_play: bets $0.08
Scaaalll: folds 
Uncalled bet ($0.08) returned to fishh_play
fishh_play collected $0.13 from pot
fishh_play: doesn't show hand 
*** SUMMARY ***
Total pot $0.13 | Rake $0 
Board [Tc 5d 5s]
Seat 1: Busya777 (button) folded before Flop (didn't bet)
Seat 2: MarioDios (small blind) folded before Flop
Seat 3: CordiPS (big blind) folded before Flop
Seat 4: Artezito folded before Flop (didn't bet)
Seat 5: fishh_play collected ($0.13)
Seat 6: Scaaalll folded on the Flop



PokerStars Zoom Hand #229232263583:  Hold'em No Limit ($0.01/$0.02) - 2021/08/21 22:44:36 CET [2021/08/21 16:44:36 ET]
Table 'Halley' 6-max Seat #1 is the button
Seat 1: EdwardF95 ($2.13 in chips) 
Seat 2: tomsa01 ($0.91 in chips) 
Seat 3: egopi ($1 in chips) 
Seat 4: estelionat171 ($0.81 in chips) 
Seat 5: Scaaalll ($3.10 in chips) 
Seat 6: LuckyCheewey ($6.23 in chips) 
tomsa01: posts small blind $0.01
egopi: posts big blind $0.02
*** HOLE CARDS ***
Dealt to Scaaalll [5c Kd]
tomsa01 is disconnected 
estelionat171: folds 
Scaaalll: folds 
LuckyCheewey: folds 
EdwardF95: folds 
tomsa01: folds 
Uncalled bet ($0.01) returned to egopi
egopi collected $0.02 from pot
egopi: doesn't show hand 
*** SUMMARY ***
Total pot $0.02 | Rake $0 
Seat 1: EdwardF95 (button) folded before Flop (didn't bet)
Seat 2: tomsa01 (small blind) folded before Flop
Seat 3: egopi (big blind) collected ($0.02)
Seat 4: estelionat171 folded before Flop (didn't bet)
Seat 5: Scaaalll folded before Flop (didn't bet)
Seat 6: LuckyCheewey folded before Flop (didn't bet)



PokerStars Zoom Hand #229232250888:  Hold'em No Limit ($0.01/$0.02) - 2021/08/21 22:44:06 CET [2021/08/21 16:44:06 ET]
Table 'Halley' 6-max Seat #1 is the button
Seat 1: rpycmbEM ($3.18 in chips) 
Seat 2: guntren.ps ($2.30 in chips) 
Seat 3: EdwardF95 ($3.16 in chips) 
Seat 4: Scaaalll ($3.16 in chips) 
Seat 5: Artezito ($2.02 in chips) 
Seat 6: z3317111711 ($1.86 in chips) 
guntren.ps: posts small blind $0.01
EdwardF95: posts big blind $0.02
*** HOLE CARDS ***
Dealt to Scaaalll [9c 9s]
Scaaalll: raises $0.04 to $0.06
Artezito: calls $0.06
z3317111711: folds 
rpycmbEM: calls $0.06
guntren.ps: raises $0.26 to $0.32
EdwardF95: folds 
Scaaalll: folds 
Artezito: calls $0.26
rpycmbEM: folds 
*** FLOP *** [Jd 6h 2c]
guntren.ps: bets $0.28
Artezito: calls $0.28
*** TURN *** [Jd 6h 2c] [6c]
guntren.ps: checks 
Artezito: checks 
*** RIVER *** [Jd 6h 2c 6c] [Qd]
guntren.ps: checks 
Artezito: checks 
*** SHOW DOWN ***
guntren.ps: shows [2h Ah] (two pair, Sixes and Deuces)
Artezito: shows [Td Tc] (two pair, Tens and Sixes)
Artezito collected $1.29 from pot
*** SUMMARY ***
Total pot $1.34 | Rake $0.05 
Board [Jd 6h 2c 6c Qd]
Seat 1: rpycmbEM (button) folded before Flop
Seat 2: guntren.ps (small blind) showed [2h Ah] and lost with two pair, Sixes and Deuces
Seat 3: EdwardF95 (big blind) folded before Flop
Seat 4: Scaaalll folded before Flop
Seat 5: Artezito showed [Td Tc] and won ($1.29) with two pair, Tens and Sixes
Seat 6: z3317111711 folded before Flop (didn't bet)



PokerStars Zoom Hand #229232265735:  Hold'em No Limit ($0.01/$0.02) - 2021/08/21 22:44:41 CET [2021/08/21 16:44:41 ET]
Table 'Halley' 6-max Seat #1 is the button
Seat 1: Scaaalll ($3.10 in chips) 
Seat 2: giselerebelo ($2.90 in chips) 
Seat 3: Stryda00 ($2.18 in chips) 
Seat 4: GVMELLO ($2.59 in chips) 
Seat 5: HubertFroh ($5.28 in chips) 
Seat 6: FabOliveira9 ($3.38 in chips) 
giselerebelo: posts small blind $0.01
Stryda00: posts big blind $0.02
*** HOLE CARDS ***
Dealt to Scaaalll [9h 9s]
GVMELLO: raises $0.03 to $0.05
HubertFroh: folds 
FabOliveira9: folds 
Scaaalll: calls $0.05
giselerebelo: folds 
Stryda00: folds 
*** FLOP *** [6c Td Ah]
GVMELLO: checks 
Scaaalll: checks 
*** TURN *** [6c Td Ah] [4s]
GVMELLO: bets $0.09
Scaaalll: folds 
Uncalled bet ($0.09) returned to GVMELLO
GVMELLO collected $0.13 from pot
GVMELLO: doesn't show hand 
*** SUMMARY ***
Total pot $0.13 | Rake $0 
Board [6c Td Ah 4s]
Seat 1: Scaaalll (button) folded on the Turn
Seat 2: giselerebelo (small blind) folded before Flop
Seat 3: Stryda00 (big blind) folded before Flop
Seat 4: GVMELLO collected ($0.13)
Seat 5: HubertFroh folded before Flop (didn't bet)
Seat 6: FabOliveira9 folded before Flop (didn't bet)



PokerStars Zoom Hand #229232282715:  Hold'em No Limit ($0.01/$0.02) - 2021/08/21 22:45:20 CET [2021/08/21 16:45:20 ET]
Table 'Halley' 6-max Seat #1 is the button
Seat 1: Gamer577 ($2.20 in chips) 
Seat 2: Scaaalll ($3.05 in chips) 
Seat 3: zbixxx ($3.95 in chips) 
Seat 4: WellWell57 ($4.84 in chips) 
Seat 5: olga3021221 ($2.01 in chips) 
Seat 6: znak312 ($2 in chips) 
Scaaalll: posts small blind $0.01
zbixxx: posts big blind $0.02
*** HOLE CARDS ***
Dealt to Scaaalll [7c Kh]
WellWell57: folds 
olga3021221: folds 
znak312: raises $0.03 to $0.05
Gamer577: folds 
Scaaalll: folds 
zbixxx: folds 
Uncalled bet ($0.03) returned to znak312
znak312 collected $0.05 from pot
znak312: doesn't show hand 
*** SUMMARY ***
Total pot $0.05 | Rake $0 
Seat 1: Gamer577 (button) folded before Flop (didn't bet)
Seat 2: Scaaalll (small blind) folded before Flop
Seat 3: zbixxx (big blind) folded before Flop
Seat 4: WellWell57 folded before Flop (didn't bet)
Seat 5: olga3021221 folded before Flop (didn't bet)
Seat 6: znak312 collected ($0.05)



PokerStars Zoom Hand #229232287527:  Hold'em No Limit ($0.01/$0.02) - 2021/08/21 22:45:31 CET [2021/08/21 16:45:31 ET]
Table 'Halley' 6-max Seat #1 is the button
Seat 1: Flo_Ned ($2.11 in chips) 
Seat 2: Fanatspartak ($1.15 in chips) 
Seat 3: BigTestIcicle ($2 in chips) 
Seat 4: Scaaalll ($3.04 in chips) 
Seat 5: gasmar_29 ($3.01 in chips) 
Seat 6: T-saitama ($2.58 in chips) 
Fanatspartak: posts small blind $0.01
BigTestIcicle: posts big blind $0.02
*** HOLE CARDS ***
Dealt to Scaaalll [4d 4h]
Scaaalll: raises $0.04 to $0.06
gasmar_29: folds 
T-saitama: raises $0.12 to $0.18
Flo_Ned: folds 
Fanatspartak: folds 
BigTestIcicle: folds 
Scaaalll: folds 
Uncalled bet ($0.12) returned to T-saitama
T-saitama collected $0.15 from pot
T-saitama: doesn't show hand 
*** SUMMARY ***
Total pot $0.15 | Rake $0 
Seat 1: Flo_Ned (button) folded before Flop (didn't bet)
Seat 2: Fanatspartak (small blind) folded before Flop
Seat 3: BigTestIcicle (big blind) folded before Flop
Seat 4: Scaaalll folded before Flop
Seat 5: gasmar_29 folded before Flop (didn't bet)
Seat 6: T-saitama collected ($0.15)



PokerStars Zoom Hand #229232314113:  Hold'em No Limit ($0.01/$0.02) - 2021/08/21 22:46:02 CET [2021/08/21 16:46:02 ET]
Table 'Halley' 6-max Seat #1 is the button
Seat 1: ash1448 ($10.97 in chips) 
Seat 2: gilberto98 ($2.30 in chips) 
Seat 3: Scaaalll ($2.98 in chips) 
Seat 4: sewq55 ($1.22 in chips) 
Seat 5: TomoKondo ($2.58 in chips) 
Seat 6: sg.32rus ($1 in chips) 
gilberto98: posts small blind $0.01
Scaaalll: posts big blind $0.02
*** HOLE CARDS ***
Dealt to Scaaalll [Tc Ad]
sewq55: folds 
TomoKondo: raises $0.04 to $0.06
sg.32rus: folds 
ash1448: folds 
gilberto98: folds 
Scaaalll: raises $0.14 to $0.20
TomoKondo: calls $0.14
*** FLOP *** [9c 4h 3d]
Scaaalll: bets $0.23
TomoKondo: raises $0.45 to $0.68
Scaaalll: folds 
Uncalled bet ($0.45) returned to TomoKondo
TomoKondo collected $0.84 from pot
TomoKondo: doesn't show hand 
*** SUMMARY ***
Total pot $0.87 | Rake $0.03 
Board [9c 4h 3d]
Seat 1: ash1448 (button) folded before Flop (didn't bet)
Seat 2: gilberto98 (small blind) folded before Flop
Seat 3: Scaaalll (big blind) folded on the Flop
Seat 4: sewq55 folded before Flop (didn't bet)
Seat 5: TomoKondo collected ($0.84)
Seat 6: sg.32rus folded before Flop (didn't bet)



PokerStars Zoom Hand #229232327134:  Hold'em No Limit ($0.01/$0.02) - 2021/08/21 22:46:32 CET [2021/08/21 16:46:32 ET]
Table 'Halley' 6-max Seat #1 is the button
Seat 1: Gek77 ($5.43 in chips) 
Seat 2: BadBeat Bert ($1.20 in chips) 
Seat 3: baksu12 ($3.36 in chips) 
Seat 4: Enoffllescini ($3.12 in chips) 
Seat 5: zallav ($3.24 in chips) 
Seat 6: Scaaalll ($2.55 in chips) 
BadBeat Bert: posts small blind $0.01
baksu12: posts big blind $0.02
*** HOLE CARDS ***
Dealt to Scaaalll [4s Ad]
Enoffllescini: folds 
zallav: folds 
zallav is disconnected 
Scaaalll: folds 
Gek77: folds 
BadBeat Bert: folds 
Uncalled bet ($0.01) returned to baksu12
baksu12 collected $0.02 from pot
baksu12: doesn't show hand 
*** SUMMARY ***
Total pot $0.02 | Rake $0 
Seat 1: Gek77 (button) folded before Flop (didn't bet)
Seat 2: BadBeat Bert (small blind) folded before Flop
Seat 3: baksu12 (big blind) collected ($0.02)
Seat 4: Enoffllescini folded before Flop (didn't bet)
Seat 5: zallav folded before Flop (didn't bet)
Seat 6: Scaaalll folded before Flop (didn't bet)



PokerStars Zoom Hand #229232332434:  Hold'em No Limit ($0.01/$0.02) - 2021/08/21 22:46:44 CET [2021/08/21 16:46:44 ET]
Table 'Halley' 6-max Seat #1 is the button
Seat 1: TheW3irdo ($2 in chips) 
Seat 2: Scaaalll ($2.55 in chips) 
Seat 3: KonopDima ($3.62 in chips) 
Seat 4: Phoenixxxxxxxx ($3.48 in chips) 
Seat 5: Fedor_Gar ($3.89 in chips) 
Seat 6: zbixxx ($10.05 in chips) 
Scaaalll: posts small blind $0.01
KonopDima: posts big blind $0.02
*** HOLE CARDS ***
Dealt to Scaaalll [5h 6s]
Phoenixxxxxxxx: folds 
Fedor_Gar: folds 
zbixxx: folds 
TheW3irdo: folds 
Scaaalll: folds 
Uncalled bet ($0.01) returned to KonopDima
KonopDima collected $0.02 from pot
KonopDima: doesn't show hand 
*** SUMMARY ***
Total pot $0.02 | Rake $0 
Seat 1: TheW3irdo (button) folded before Flop (didn't bet)
Seat 2: Scaaalll (small blind) folded before Flop
Seat 3: KonopDima (big blind) collected ($0.02)
Seat 4: Phoenixxxxxxxx folded before Flop (didn't bet)
Seat 5: Fedor_Gar folded before Flop (didn't bet)
Seat 6: zbixxx folded before Flop (didn't bet)



PokerStars Zoom Hand #229232338131:  Hold'em No Limit ($0.01/$0.02) - 2021/08/21 22:46:57 CET [2021/08/21 16:46:57 ET]
Table 'Halley' 6-max Seat #1 is the button
Seat 1: Akrobat94 ($1.24 in chips) 
Seat 2: pavlo8855 ($2.11 in chips) 
Seat 3: TomoKondo ($2.05 in chips) 
Seat 4: The-End-snglr ($2 in chips) 
Seat 5: Scaaalll ($2.54 in chips) 
Seat 6: Habarovs18 ($2 in chips) 
pavlo8855: posts small blind $0.01
TomoKondo: posts big blind $0.02
*** HOLE CARDS ***
Dealt to Scaaalll [5c Td]
The-End-snglr: folds 
Akrobat94 is disconnected 
Habarovs18 is disconnected 
Scaaalll: folds 
Habarovs18: folds 
Akrobat94: folds 
pavlo8855: folds 
Uncalled bet ($0.01) returned to TomoKondo
TomoKondo collected $0.02 from pot
TomoKondo: doesn't show hand 
*** SUMMARY ***
Total pot $0.02 | Rake $0 
Seat 1: Akrobat94 (button) folded before Flop (didn't bet)
Seat 2: pavlo8855 (small blind) folded before Flop
Seat 3: TomoKondo (big blind) collected ($0.02)
Seat 4: The-End-snglr folded before Flop (didn't bet)
Seat 5: Scaaalll folded before Flop (didn't bet)
Seat 6: Habarovs18 folded before Flop (didn't bet)



PokerStars Zoom Hand #229232334625:  Hold'em No Limit ($0.01/$0.02) - 2021/08/21 22:46:49 CET [2021/08/21 16:46:49 ET]
Table 'Halley' 6-max Seat #1 is the button
Seat 1: Scaaalll ($2.54 in chips) 
Seat 2: SirBatish ($2.83 in chips) 
Seat 3: coltrain1986 ($1.87 in chips) 
Seat 4: SIGREX ($2 in chips) 
Seat 5: MATIdf365 ($3.87 in chips) 
Seat 6: ulvitev ($2.97 in chips) 
SirBatish: posts small blind $0.01
coltrain1986: posts big blind $0.02
*** HOLE CARDS ***
Dealt to Scaaalll [6c 9d]
SIGREX: raises $0.02 to $0.04
MATIdf365: folds 
ulvitev: folds 
Scaaalll: folds 
ulvitev is disconnected 
SirBatish: folds 
coltrain1986: calls $0.02
*** FLOP *** [8h 7h 2h]
coltrain1986: checks 
SIGREX: checks 
*** TURN *** [8h 7h 2h] [Jh]
coltrain1986: bets $0.03
SIGREX: calls $0.03
*** RIVER *** [8h 7h 2h Jh] [Qh]
coltrain1986: bets $0.18
SIGREX: folds 
Uncalled bet ($0.18) returned to coltrain1986
coltrain1986 collected $0.14 from pot
coltrain1986: doesn't show hand 
*** SUMMARY ***
Total pot $0.15 | Rake $0.01 
Board [8h 7h 2h Jh Qh]
Seat 1: Scaaalll (button) folded before Flop (didn't bet)
Seat 2: SirBatish (small blind) folded before Flop
Seat 3: coltrain1986 (big blind) collected ($0.14)
Seat 4: SIGREX folded on the River
Seat 5: MATIdf365 folded before Flop (didn't bet)
Seat 6: ulvitev folded before Flop (didn't bet)



PokerStars Zoom Hand #229232340800:  Hold'em No Limit ($0.01/$0.02) - 2021/08/21 22:47:03 CET [2021/08/21 16:47:03 ET]
Table 'Halley' 6-max Seat #1 is the button
Seat 1: keb1981 ($2 in chips) 
Seat 2: SKV_1985 ($2.28 in chips) 
Seat 3: Fedor_Gar ($3.89 in chips) 
Seat 4: Scaaalll ($2.54 in chips) 
Seat 5: AlexGTPS ($2.11 in chips) 
Seat 6: Fen4ik59 ($0.30 in chips) 
SKV_1985: posts small blind $0.01
Fedor_Gar: posts big blind $0.02
*** HOLE CARDS ***
Dealt to Scaaalll [5d 5s]
Scaaalll: raises $0.04 to $0.06
AlexGTPS: folds 
Fen4ik59: folds 
keb1981: folds 
SKV_1985: folds 
Fedor_Gar: folds 
Uncalled bet ($0.04) returned to Scaaalll
Scaaalll collected $0.05 from pot
Scaaalll: doesn't show hand 
*** SUMMARY ***
Total pot $0.05 | Rake $0 
Seat 1: keb1981 (button) folded before Flop (didn't bet)
Seat 2: SKV_1985 (small blind) folded before Flop
Seat 3: Fedor_Gar (big blind) folded before Flop
Seat 4: Scaaalll collected ($0.05)
Seat 5: AlexGTPS folded before Flop (didn't bet)
Seat 6: Fen4ik59 folded before Flop (didn't bet)



PokerStars Zoom Hand #229232348292:  Hold'em No Limit ($0.01/$0.02) - 2021/08/21 22:47:20 CET [2021/08/21 16:47:20 ET]
Table 'Halley' 6-max Seat #1 is the button
Seat 1: vovo4kapooh ($2.30 in chips) 
Seat 2: CordiPS ($6.25 in chips) 
Seat 3: Baldisback ($2.64 in chips) 
Seat 4: keb1981 ($2.01 in chips) 
Seat 5: EdwardF95 ($3.14 in chips) 
Seat 6: Scaaalll ($2.57 in chips) 
CordiPS: posts small blind $0.01
Baldisback: posts big blind $0.02
*** HOLE CARDS ***
Dealt to Scaaalll [4h Js]
keb1981: folds 
EdwardF95: folds 
Scaaalll: folds 
vovo4kapooh: folds 
CordiPS: folds 
Uncalled bet ($0.01) returned to Baldisback
Baldisback collected $0.02 from pot
Baldisback: doesn't show hand 
*** SUMMARY ***
Total pot $0.02 | Rake $0 
Seat 1: vovo4kapooh (button) folded before Flop (didn't bet)
Seat 2: CordiPS (small blind) folded before Flop
Seat 3: Baldisback (big blind) collected ($0.02)
Seat 4: keb1981 folded before Flop (didn't bet)
Seat 5: EdwardF95 folded before Flop (didn't bet)
Seat 6: Scaaalll folded before Flop (didn't bet)



PokerStars Zoom Hand #229232352760:  Hold'em No Limit ($0.01/$0.02) - 2021/08/21 22:47:30 CET [2021/08/21 16:47:30 ET]
Table 'Halley' 6-max Seat #1 is the button
Seat 1: Scaaalll ($2.57 in chips) 
Seat 2: znak312 ($2 in chips) 
Seat 3: NIK1973 23 ($2.07 in chips) 
Seat 4: pipecmolodec ($2.10 in chips) 
Seat 5: lucksuckdonk ($4.54 in chips) 
Seat 6: 365p2eva ($4.25 in chips) 
znak312: posts small blind $0.01
NIK1973 23: posts big blind $0.02
*** HOLE CARDS ***
Dealt to Scaaalll [9c Jh]
pipecmolodec: folds 
lucksuckdonk: raises $0.04 to $0.06
365p2eva: folds 
Scaaalll: folds 
znak312: folds 
NIK1973 23: folds 
Uncalled bet ($0.04) returned to lucksuckdonk
lucksuckdonk collected $0.05 from pot
lucksuckdonk: doesn't show hand 
*** SUMMARY ***
Total pot $0.05 | Rake $0 
Seat 1: Scaaalll (button) folded before Flop (didn't bet)
Seat 2: znak312 (small blind) folded before Flop
Seat 3: NIK1973 23 (big blind) folded before Flop
Seat 4: pipecmolodec folded before Flop (didn't bet)
Seat 5: lucksuckdonk collected ($0.05)
Seat 6: 365p2eva folded before Flop (didn't bet)



PokerStars Zoom Hand #229232356190:  Hold'em No Limit ($0.01/$0.02) - 2021/08/21 22:47:38 CET [2021/08/21 16:47:38 ET]
Table 'Halley' 6-max Seat #1 is the button
Seat 1: Enoffllescini ($2.98 in chips) 
Seat 2: Habarovs18 ($2.04 in chips) 
Seat 3: Scaaalll ($2.57 in chips) 
Seat 4: ytras ($1.77 in chips) 
Seat 5: RChinenov ($2.44 in chips) 
Seat 6: Mad_Clock ($3.53 in chips) 
Habarovs18: posts small blind $0.01
Scaaalll: posts big blind $0.02
*** HOLE CARDS ***
Dealt to Scaaalll [Kc Qc]
ytras: raises $0.03 to $0.05
RChinenov: folds 
Mad_Clock: folds 
Habarovs18 is disconnected 
Enoffllescini: calls $0.05
Habarovs18: folds 
Scaaalll: calls $0.03
*** FLOP *** [Jh Ac 9d]
Scaaalll: checks 
ytras: checks 
Enoffllescini: checks 
*** TURN *** [Jh Ac 9d] [As]
Scaaalll: checks 
ytras: checks 
Enoffllescini: checks 
*** RIVER *** [Jh Ac 9d As] [3d]
Scaaalll: checks 
ytras: checks 
Enoffllescini: checks 
*** SHOW DOWN ***
Scaaalll: shows [Kc Qc] (a pair of Aces)
ytras: shows [Qs Kh] (a pair of Aces)
Enoffllescini: shows [2s 2c] (two pair, Aces and Deuces)
Enoffllescini collected $0.15 from pot
*** SUMMARY ***
Total pot $0.16 | Rake $0.01 
Board [Jh Ac 9d As 3d]
Seat 1: Enoffllescini (button) showed [2s 2c] and won ($0.15) with two pair, Aces and Deuces
Seat 2: Habarovs18 (small blind) folded before Flop
Seat 3: Scaaalll (big blind) showed [Kc Qc] and lost with a pair of Aces
Seat 4: ytras showed [Qs Kh] and lost with a pair of Aces
Seat 5: RChinenov folded before Flop (didn't bet)
Seat 6: Mad_Clock folded before Flop (didn't bet)



PokerStars Zoom Hand #229232376831:  Hold'em No Limit ($0.01/$0.02) - 2021/08/21 22:48:25 CET [2021/08/21 16:48:25 ET]
Table 'Halley' 6-max Seat #1 is the button
Seat 1: stanthema661 ($2 in chips) 
Seat 2: Scaaalll ($2.52 in chips) 
Seat 3: polymorhp ($4.20 in chips) 
Seat 4: Bufre ($3.12 in chips) 
Seat 5: BadBeat Bert ($1.19 in chips) 
Seat 6: Kb013497 ($1.69 in chips) 
Scaaalll: posts small blind $0.01
polymorhp: posts big blind $0.02
*** HOLE CARDS ***
Dealt to Scaaalll [Js Qs]
Bufre: folds 
BadBeat Bert: folds 
Kb013497: folds 
stanthema661: raises $0.09 to $0.11
Scaaalll: folds 
polymorhp: folds 
Uncalled bet ($0.09) returned to stanthema661
stanthema661 collected $0.05 from pot
stanthema661: doesn't show hand 
*** SUMMARY ***
Total pot $0.05 | Rake $0 
Seat 1: stanthema661 (button) collected ($0.05)
Seat 2: Scaaalll (small blind) folded before Flop
Seat 3: polymorhp (big blind) folded before Flop
Seat 4: Bufre folded before Flop (didn't bet)
Seat 5: BadBeat Bert folded before Flop (didn't bet)
Seat 6: Kb013497 folded before Flop (didn't bet)



PokerStars Zoom Hand #229232385237:  Hold'em No Limit ($0.01/$0.02) - 2021/08/21 22:48:44 CET [2021/08/21 16:48:44 ET]
Table 'Halley' 6-max Seat #1 is the button
Seat 1: sewq55 ($0.39 in chips) 
Seat 2: jribeiros ($2.41 in chips) 
Seat 3: porkie23 ($1.71 in chips) 
Seat 4: Scaaalll ($2.51 in chips) 
Seat 5: ppluiaule ($5.37 in chips) 
Seat 6: MATIdf365 ($1.84 in chips) 
jribeiros: posts small blind $0.01
porkie23: posts big blind $0.02
*** HOLE CARDS ***
Dealt to Scaaalll [9s Ah]
Scaaalll: folds 
ppluiaule: folds 
MATIdf365: folds 
sewq55: folds 
jribeiros: folds 
Uncalled bet ($0.01) returned to porkie23
porkie23 collected $0.02 from pot
porkie23: doesn't show hand 
*** SUMMARY ***
Total pot $0.02 | Rake $0 
Seat 1: sewq55 (button) folded before Flop (didn't bet)
Seat 2: jribeiros (small blind) folded before Flop
Seat 3: porkie23 (big blind) collected ($0.02)
Seat 4: Scaaalll folded before Flop (didn't bet)
Seat 5: ppluiaule folded before Flop (didn't bet)
Seat 6: MATIdf365 folded before Flop (didn't bet)



PokerStars Zoom Hand #229232389177:  Hold'em No Limit ($0.01/$0.02) - 2021/08/21 22:48:53 CET [2021/08/21 16:48:53 ET]
Table 'Halley' 6-max Seat #1 is the button
Seat 1: Fedor_Gar ($4.76 in chips) 
Seat 2: maressen ($2 in chips) 
Seat 3: REDCOBRA 1 ($0.92 in chips) 
Seat 4: Clownyara ($2.64 in chips) 
Seat 5: 888lifeIS ($2.22 in chips) 
Seat 6: Scaaalll ($2.51 in chips) 
maressen: posts small blind $0.01
REDCOBRA 1: posts big blind $0.02
*** HOLE CARDS ***
Dealt to Scaaalll [2h 8h]
Clownyara: folds 
888lifeIS: folds 
Scaaalll: folds 
Fedor_Gar: folds 
maressen: folds 
Uncalled bet ($0.01) returned to REDCOBRA 1
REDCOBRA 1 collected $0.02 from pot
REDCOBRA 1: doesn't show hand 
*** SUMMARY ***
Total pot $0.02 | Rake $0 
Seat 1: Fedor_Gar (button) folded before Flop (didn't bet)
Seat 2: maressen (small blind) folded before Flop
Seat 3: REDCOBRA 1 (big blind) collected ($0.02)
Seat 4: Clownyara folded before Flop (didn't bet)
Seat 5: 888lifeIS folded before Flop (didn't bet)
Seat 6: Scaaalll folded before Flop (didn't bet)



PokerStars Zoom Hand #229232392686:  Hold'em No Limit ($0.01/$0.02) - 2021/08/21 22:49:01 CET [2021/08/21 16:49:01 ET]
Table 'Halley' 6-max Seat #1 is the button
Seat 1: ytras ($1.67 in chips) 
Seat 2: SKV_1985 ($2.25 in chips) 
Seat 3: 48159348 ($4.16 in chips) 
Seat 4: Scaaalll ($2.51 in chips) 
Seat 5: 09mexanik09 ($2.82 in chips) 
Seat 6: slipknot956 ($2.09 in chips) 
SKV_1985: posts small blind $0.01
48159348: posts big blind $0.02
*** HOLE CARDS ***
Dealt to Scaaalll [8d 8s]
Scaaalll: raises $0.04 to $0.06
09mexanik09: folds 
slipknot956: folds 
ytras: folds 
SKV_1985: folds 
48159348: folds 
Uncalled bet ($0.04) returned to Scaaalll
Scaaalll collected $0.05 from pot
Scaaalll: doesn't show hand 
*** SUMMARY ***
Total pot $0.05 | Rake $0 
Seat 1: ytras (button) folded before Flop (didn't bet)
Seat 2: SKV_1985 (small blind) folded before Flop
Seat 3: 48159348 (big blind) folded before Flop
Seat 4: Scaaalll collected ($0.05)
Seat 5: 09mexanik09 folded before Flop (didn't bet)
Seat 6: slipknot956 folded before Flop (didn't bet)



PokerStars Zoom Hand #229232373692:  Hold'em No Limit ($0.01/$0.02) - 2021/08/21 22:48:18 CET [2021/08/21 16:48:18 ET]
Table 'Halley' 6-max Seat #1 is the button
Seat 1: lumpek1112 ($2.98 in chips) 
Seat 2: lucksuckdonk ($3.67 in chips) 
Seat 3: davidalejag ($3.10 in chips) 
Seat 4: tazar34_777 ($5.23 in chips) 
Seat 5: Scaaalll ($2.52 in chips) 
Seat 6: Hallyson_23 ($4.39 in chips) 
lucksuckdonk: posts small blind $0.01
davidalejag: posts big blind $0.02
*** HOLE CARDS ***
Dealt to Scaaalll [Td 4d]
tazar34_777: folds 
Scaaalll: folds 
Hallyson_23: folds 
lumpek1112: raises $0.02 to $0.04
lucksuckdonk: calls $0.03
davidalejag: calls $0.02
*** FLOP *** [Qd 9c Kc]
lucksuckdonk: checks 
davidalejag: checks 
lumpek1112: checks 
*** TURN *** [Qd 9c Kc] [6d]
lucksuckdonk: checks 
davidalejag: checks 
lumpek1112: checks 
*** RIVER *** [Qd 9c Kc 6d] [9d]
lucksuckdonk: checks 
davidalejag: bets $0.06
lumpek1112: raises $0.22 to $0.28
lucksuckdonk: folds 
davidalejag: folds 
Uncalled bet ($0.22) returned to lumpek1112
lumpek1112 collected $0.23 from pot
lumpek1112: doesn't show hand 
*** SUMMARY ***
Total pot $0.24 | Rake $0.01 
Board [Qd 9c Kc 6d 9d]
Seat 1: lumpek1112 (button) collected ($0.23)
Seat 2: lucksuckdonk (small blind) folded on the River
Seat 3: davidalejag (big blind) folded on the River
Seat 4: tazar34_777 folded before Flop (didn't bet)
Seat 5: Scaaalll folded before Flop (didn't bet)
Seat 6: Hallyson_23 folded before Flop (didn't bet)



PokerStars Zoom Hand #229232398446:  Hold'em No Limit ($0.01/$0.02) - 2021/08/21 22:49:14 CET [2021/08/21 16:49:14 ET]
Table 'Halley' 6-max Seat #1 is the button
Seat 1: Apollonnn_13 ($1.97 in chips) 
Seat 2: Smirandal ($2.96 in chips) 
Seat 3: Scaaalll ($2.54 in chips) 
Seat 4: Astel88 ($2.31 in chips) 
Seat 5: RrriotGrrrl ($4.48 in chips) 
Seat 6: SirBatish ($2.84 in chips) 
Smirandal: posts small blind $0.01
Scaaalll: posts big blind $0.02
*** HOLE CARDS ***
Dealt to Scaaalll [7h 2s]
Astel88: folds 
Astel88 is disconnected 
RrriotGrrrl: folds 
SirBatish: folds 
Apollonnn_13: folds 
Smirandal: raises $0.02 to $0.04
Scaaalll: folds 
Uncalled bet ($0.02) returned to Smirandal
Smirandal collected $0.04 from pot
Smirandal: doesn't show hand 
*** SUMMARY ***
Total pot $0.04 | Rake $0 
Seat 1: Apollonnn_13 (button) folded before Flop (didn't bet)
Seat 2: Smirandal (small blind) collected ($0.04)
Seat 3: Scaaalll (big blind) folded before Flop
Seat 4: Astel88 folded before Flop (didn't bet)
Seat 5: RrriotGrrrl folded before Flop (didn't bet)
Seat 6: SirBatish folded before Flop (didn't bet)



PokerStars Zoom Hand #229232415285:  Hold'em No Limit ($0.01/$0.02) - 2021/08/21 22:49:52 CET [2021/08/21 16:49:52 ET]
Table 'Halley' 6-max Seat #1 is the button
Seat 1: RrriotGrrrl ($9.14 in chips) 
Seat 2: Scaaalll ($2.52 in chips) 
Seat 3: fishh_play ($3.26 in chips) 
Seat 4: lucksuckdonk ($3.64 in chips) 
Seat 5: sergeyl01 ($0.39 in chips) 
Seat 6: 888lifeIS ($2 in chips) 
Scaaalll: posts small blind $0.01
fishh_play: posts big blind $0.02
*** HOLE CARDS ***
Dealt to Scaaalll [7d As]
lucksuckdonk: folds 
sergeyl01: folds 
888lifeIS: folds 
RrriotGrrrl: raises $0.02 to $0.04
Scaaalll: folds 
fishh_play: folds 
Uncalled bet ($0.02) returned to RrriotGrrrl
RrriotGrrrl collected $0.05 from pot
RrriotGrrrl: doesn't show hand 
*** SUMMARY ***
Total pot $0.05 | Rake $0 
Seat 1: RrriotGrrrl (button) collected ($0.05)
Seat 2: Scaaalll (small blind) folded before Flop
Seat 3: fishh_play (big blind) folded before Flop
Seat 4: lucksuckdonk folded before Flop (didn't bet)
Seat 5: sergeyl01 folded before Flop (didn't bet)
Seat 6: 888lifeIS folded before Flop (didn't bet)



PokerStars Zoom Hand #229232403734:  Hold'em No Limit ($0.01/$0.02) - 2021/08/21 22:49:26 CET [2021/08/21 16:49:26 ET]
Table 'Halley' 6-max Seat #1 is the button
Seat 1: Scaaalll ($2.52 in chips) 
Seat 2: Kelingor ($2 in chips) 
Seat 3: vxDARK_CATxv ($1.33 in chips) 
Seat 4: Larson_mfk ($0.32 in chips) 
Seat 5: TRI MEDVEDYA ($1.83 in chips) 
Seat 6: Laonikos ($6.78 in chips) 
Kelingor: posts small blind $0.01
vxDARK_CATxv: posts big blind $0.02
*** HOLE CARDS ***
Dealt to Scaaalll [7d Ks]
Larson_mfk: folds 
Larson_mfk is disconnected 
TRI MEDVEDYA: folds 
TRI MEDVEDYA is disconnected 
Laonikos: raises $0.03 to $0.05
Scaaalll: folds 
Kelingor: folds 
vxDARK_CATxv: calls $0.03
*** FLOP *** [7c As 9d]
vxDARK_CATxv: bets $0.11
Laonikos: folds 
Uncalled bet ($0.11) returned to vxDARK_CATxv
vxDARK_CATxv collected $0.11 from pot
vxDARK_CATxv: doesn't show hand 
*** SUMMARY ***
Total pot $0.11 | Rake $0 
Board [7c As 9d]
Seat 1: Scaaalll (button) folded before Flop (didn't bet)
Seat 2: Kelingor (small blind) folded before Flop
Seat 3: vxDARK_CATxv (big blind) collected ($0.11)
Seat 4: Larson_mfk folded before Flop (didn't bet)
Seat 5: TRI MEDVEDYA folded before Flop (didn't bet)
Seat 6: Laonikos folded on the Flop



PokerStars Zoom Hand #229232419247:  Hold'em No Limit ($0.01/$0.02) - 2021/08/21 22:50:01 CET [2021/08/21 16:50:01 ET]
Table 'Halley' 6-max Seat #1 is the button
Seat 1: znak312 ($2.02 in chips) 
Seat 2: zergmiky ($2 in chips) 
Seat 3: sakourtele ($2.47 in chips) 
Seat 4: Scaaalll ($2.51 in chips) 
Seat 5: Chapaev136 ($5.14 in chips) 
Seat 6: Xlavariable ($2.25 in chips) 
zergmiky: posts small blind $0.01
sakourtele: posts big blind $0.02
*** HOLE CARDS ***
Dealt to Scaaalll [Jc Kc]
Scaaalll: raises $0.04 to $0.06
Chapaev136: folds 
Xlavariable: folds 
znak312: folds 
zergmiky: folds 
sakourtele: folds 
Uncalled bet ($0.04) returned to Scaaalll
Scaaalll collected $0.05 from pot
Scaaalll: doesn't show hand 
*** SUMMARY ***
Total pot $0.05 | Rake $0 
Seat 1: znak312 (button) folded before Flop (didn't bet)
Seat 2: zergmiky (small blind) folded before Flop
Seat 3: sakourtele (big blind) folded before Flop
Seat 4: Scaaalll collected ($0.05)
Seat 5: Chapaev136 folded before Flop (didn't bet)
Seat 6: Xlavariable folded before Flop (didn't bet)



PokerStars Zoom Hand #229232427581:  Hold'em No Limit ($0.01/$0.02) - 2021/08/21 22:50:20 CET [2021/08/21 16:50:20 ET]
Table 'Halley' 6-max Seat #1 is the button
Seat 1: sewq55 ($0.82 in chips) 
Seat 2: NickAlex18 ($2.03 in chips) 
Seat 3: Scaaalll ($2.54 in chips) 
Seat 4: polymorhp ($2.94 in chips) 
Seat 5: osantos401 ($5.05 in chips) 
Seat 6: Kreodont1987 ($6.02 in chips) 
NickAlex18: posts small blind $0.01
Scaaalll: posts big blind $0.02
*** HOLE CARDS ***
Dealt to Scaaalll [2c 3c]
polymorhp: folds 
osantos401: folds 
Kreodont1987: folds 
sewq55: raises $0.02 to $0.04
NickAlex18: folds 
Scaaalll: folds 
Uncalled bet ($0.02) returned to sewq55
sewq55 collected $0.05 from pot
sewq55: doesn't show hand 
*** SUMMARY ***
Total pot $0.05 | Rake $0 
Seat 1: sewq55 (button) collected ($0.05)
Seat 2: NickAlex18 (small blind) folded before Flop
Seat 3: Scaaalll (big blind) folded before Flop
Seat 4: polymorhp folded before Flop (didn't bet)
Seat 5: osantos401 folded before Flop (didn't bet)
Seat 6: Kreodont1987 folded before Flop (didn't bet)



PokerStars Zoom Hand #229232412669:  Hold'em No Limit ($0.01/$0.02) - 2021/08/21 22:49:46 CET [2021/08/21 16:49:46 ET]
Table 'Halley' 6-max Seat #1 is the button
Seat 1: Colby1771 ($3.31 in chips) 
Seat 2: HitEmUpWatz9420 ($2.04 in chips) 
Seat 3: El Chicha.CL ($2.55 in chips) 
Seat 4: Fedor_Gar ($3.83 in chips) 
Seat 5: Scaaalll ($2.52 in chips) 
Seat 6: GVMELLO ($2.07 in chips) 
HitEmUpWatz9420: posts small blind $0.01
El Chicha.CL: posts big blind $0.02
*** HOLE CARDS ***
Dealt to Scaaalll [6c 7h]
Fedor_Gar: folds 
Scaaalll: folds 
GVMELLO: folds 
Colby1771: raises $0.04 to $0.06
HitEmUpWatz9420: calls $0.05
El Chicha.CL: calls $0.04
*** FLOP *** [6d Kc 2s]
HitEmUpWatz9420: checks 
El Chicha.CL: checks 
Colby1771: bets $0.12
HitEmUpWatz9420: calls $0.12
El Chicha.CL: folds 
*** TURN *** [6d Kc 2s] [Ts]
HitEmUpWatz9420: checks 
Colby1771: checks 
*** RIVER *** [6d Kc 2s Ts] [6s]
HitEmUpWatz9420: bets $0.20
Colby1771: folds 
Uncalled bet ($0.20) returned to HitEmUpWatz9420
HitEmUpWatz9420 collected $0.41 from pot
HitEmUpWatz9420: doesn't show hand 
*** SUMMARY ***
Total pot $0.42 | Rake $0.01 
Board [6d Kc 2s Ts 6s]
Seat 1: Colby1771 (button) folded on the River
Seat 2: HitEmUpWatz9420 (small blind) collected ($0.41)
Seat 3: El Chicha.CL (big blind) folded on the Flop
Seat 4: Fedor_Gar folded before Flop (didn't bet)
Seat 5: Scaaalll folded before Flop (didn't bet)
Seat 6: GVMELLO folded before Flop (didn't bet)



PokerStars Zoom Hand #229232438713:  Hold'em No Limit ($0.01/$0.02) - 2021/08/21 22:50:45 CET [2021/08/21 16:50:45 ET]
Table 'Halley' 6-max Seat #1 is the button
Seat 1: Scaaalll ($2.52 in chips) 
Seat 2: WITKOW_AV ($2 in chips) 
Seat 3: zbixxx ($2.10 in chips) 
Seat 4: HubertFroh ($2 in chips) 
Seat 5: KareAAAA ($6.06 in chips) 
Seat 6: kukulagosleep ($2.01 in chips) 
WITKOW_AV: posts small blind $0.01
zbixxx: posts big blind $0.02
*** HOLE CARDS ***
Dealt to Scaaalll [Jh 9c]
HubertFroh: folds 
KareAAAA: folds 
KareAAAA is disconnected 
kukulagosleep: folds 
Scaaalll: folds 
WITKOW_AV: raises $0.04 to $0.06
zbixxx: folds 
Uncalled bet ($0.04) returned to WITKOW_AV
WITKOW_AV collected $0.04 from pot
WITKOW_AV: doesn't show hand 
*** SUMMARY ***
Total pot $0.04 | Rake $0 
Seat 1: Scaaalll (button) folded before Flop (didn't bet)
Seat 2: WITKOW_AV (small blind) collected ($0.04)
Seat 3: zbixxx (big blind) folded before Flop
Seat 4: HubertFroh folded before Flop (didn't bet)
Seat 5: KareAAAA folded before Flop (didn't bet)
Seat 6: kukulagosleep folded before Flop (didn't bet)



PokerStars Zoom Hand #229232440878:  Hold'em No Limit ($0.01/$0.02) - 2021/08/21 22:50:50 CET [2021/08/21 16:50:50 ET]
Table 'Halley' 6-max Seat #1 is the button
Seat 1: wieksi9845 ($1.02 in chips) 
Seat 2: Smailodon ($0.90 in chips) 
Seat 3: MEZz828 ($1.98 in chips) 
Seat 4: tazar34_777 ($4.83 in chips) 
Seat 5: alexan00 ($4.72 in chips) 
Seat 6: Scaaalll ($2.52 in chips) 
Smailodon: posts small blind $0.01
MEZz828: posts big blind $0.02
*** HOLE CARDS ***
Dealt to Scaaalll [8s Jd]
tazar34_777: folds 
alexan00: folds 
Scaaalll: folds 
wieksi9845: folds 
wieksi9845 is disconnected 
Smailodon: raises $0.04 to $0.06
MEZz828: folds 
Uncalled bet ($0.04) returned to Smailodon
Smailodon collected $0.04 from pot
Smailodon: doesn't show hand 
*** SUMMARY ***
Total pot $0.04 | Rake $0 
Seat 1: wieksi9845 (button) folded before Flop (didn't bet)
Seat 2: Smailodon (small blind) collected ($0.04)
Seat 3: MEZz828 (big blind) folded before Flop
Seat 4: tazar34_777 folded before Flop (didn't bet)
Seat 5: alexan00 folded before Flop (didn't bet)
Seat 6: Scaaalll folded before Flop (didn't bet)



PokerStars Zoom Hand #229232444354:  Hold'em No Limit ($0.01/$0.02) - 2021/08/21 22:50:58 CET [2021/08/21 16:50:58 ET]
Table 'Halley' 6-max Seat #1 is the button
Seat 1: juraa14 ($2.27 in chips) 
Seat 2: Scaaalll ($2.52 in chips) 
Seat 3: KonopDima ($2.68 in chips) 
Seat 4: Baldisback ($3.57 in chips) 
Seat 5: Ramirres ($2.23 in chips) 
Seat 6: WITKOW_AV ($2.02 in chips) 
Scaaalll: posts small blind $0.01
KonopDima: posts big blind $0.02
*** HOLE CARDS ***
Dealt to Scaaalll [9c 5h]
Baldisback: raises $0.02 to $0.04
Ramirres: folds 
WITKOW_AV: folds 
juraa14: folds 
Scaaalll: folds 
KonopDima: folds 
Uncalled bet ($0.02) returned to Baldisback
Baldisback collected $0.05 from pot
Baldisback: doesn't show hand 
*** SUMMARY ***
Total pot $0.05 | Rake $0 
Seat 1: juraa14 (button) folded before Flop (didn't bet)
Seat 2: Scaaalll (small blind) folded before Flop
Seat 3: KonopDima (big blind) folded before Flop
Seat 4: Baldisback collected ($0.05)
Seat 5: Ramirres folded before Flop (didn't bet)
Seat 6: WITKOW_AV folded before Flop (didn't bet)



PokerStars Zoom Hand #229232451378:  Hold'em No Limit ($0.01/$0.02) - 2021/08/21 22:51:14 CET [2021/08/21 16:51:14 ET]
Table 'Halley' 6-max Seat #1 is the button
Seat 1: sg.32rus ($0.65 in chips) 
Seat 2: SirBatish ($5.48 in chips) 
Seat 3: ppluiaule ($2.34 in chips) 
Seat 4: Scaaalll ($2.51 in chips) 
Seat 5: Takkeee ($1.97 in chips) 
Seat 6: Tabitaji ($2.45 in chips) 
SirBatish: posts small blind $0.01
ppluiaule: posts big blind $0.02
*** HOLE CARDS ***
Dealt to Scaaalll [6h Jc]
Scaaalll: folds 
Takkeee: folds 
Tabitaji: folds 
sg.32rus: folds 
SirBatish: raises $0.04 to $0.06
ppluiaule: folds 
Uncalled bet ($0.04) returned to SirBatish
SirBatish collected $0.04 from pot
SirBatish: doesn't show hand 
*** SUMMARY ***
Total pot $0.04 | Rake $0 
Seat 1: sg.32rus (button) folded before Flop (didn't bet)
Seat 2: SirBatish (small blind) collected ($0.04)
Seat 3: ppluiaule (big blind) folded before Flop
Seat 4: Scaaalll folded before Flop (didn't bet)
Seat 5: Takkeee folded before Flop (didn't bet)
Seat 6: Tabitaji folded before Flop (didn't bet)



PokerStars Zoom Hand #229232453213:  Hold'em No Limit ($0.01/$0.02) - 2021/08/21 22:51:18 CET [2021/08/21 16:51:18 ET]
Table 'Halley' 6-max Seat #1 is the button
Seat 1: HDYD18 ($5.74 in chips) 
Seat 2: RzkPoker ($2.08 in chips) 
Seat 3: medyza111 ($5.61 in chips) 
Seat 4: staviko ($2.15 in chips) 
Seat 5: olcham7 ($2.06 in chips) 
Seat 6: Scaaalll ($2.51 in chips) 
RzkPoker: posts small blind $0.01
medyza111: posts big blind $0.02
*** HOLE CARDS ***
Dealt to Scaaalll [Qs 9c]
staviko: raises $0.04 to $0.06
olcham7: folds 
Scaaalll: folds 
HDYD18: folds 
RzkPoker: folds 
medyza111 has timed out while disconnected
medyza111: folds 
Uncalled bet ($0.04) returned to staviko
staviko collected $0.05 from pot
staviko: doesn't show hand 
*** SUMMARY ***
Total pot $0.05 | Rake $0 
Seat 1: HDYD18 (button) folded before Flop (didn't bet)
Seat 2: RzkPoker (small blind) folded before Flop
Seat 3: medyza111 (big blind) folded before Flop
Seat 4: staviko collected ($0.05)
Seat 5: olcham7 folded before Flop (didn't bet)
Seat 6: Scaaalll folded before Flop (didn't bet)



PokerStars Zoom Hand #229232460683:  Hold'em No Limit ($0.01/$0.02) - 2021/08/21 22:51:35 CET [2021/08/21 16:51:35 ET]
Table 'Halley' 6-max Seat #1 is the button
Seat 1: ytras ($1.90 in chips) 
Seat 2: 01527368 ($5.76 in chips) 
Seat 3: Scaaalll ($2.50 in chips) 
Seat 4: OmahaWheels ($2 in chips) 
Seat 5: boa juice ($2.09 in chips) 
Seat 6: Finderra ($1.83 in chips) 
01527368: posts small blind $0.01
Scaaalll: posts big blind $0.02
*** HOLE CARDS ***
Dealt to Scaaalll [Qc 4s]
OmahaWheels: folds 
boa juice: folds 
boa juice is disconnected 
Finderra: folds 
ytras: raises $0.03 to $0.05
01527368: folds 
Scaaalll: folds 
Uncalled bet ($0.03) returned to ytras
ytras collected $0.05 from pot
ytras: doesn't show hand 
*** SUMMARY ***
Total pot $0.05 | Rake $0 
Seat 1: ytras (button) collected ($0.05)
Seat 2: 01527368 (small blind) folded before Flop
Seat 3: Scaaalll (big blind) folded before Flop
Seat 4: OmahaWheels folded before Flop (didn't bet)
Seat 5: boa juice folded before Flop (didn't bet)
Seat 6: Finderra folded before Flop (didn't bet)



PokerStars Zoom Hand #229232454941:  Hold'em No Limit ($0.01/$0.02) - 2021/08/21 22:51:22 CET [2021/08/21 16:51:22 ET]
Table 'Halley' 6-max Seat #1 is the button
Seat 1: Mustang01373 ($1.97 in chips) 
Seat 2: Scaaalll ($2.51 in chips) 
Seat 3: ppluiaule ($4.81 in chips) 
Seat 4: A.luckebeggr ($5.68 in chips) 
Seat 5: Pulp Hands ($1.66 in chips) 
Seat 6: MarioDios ($2 in chips) 
Scaaalll: posts small blind $0.01
ppluiaule: posts big blind $0.02
*** HOLE CARDS ***
Dealt to Scaaalll [Ah 9c]
A.luckebeggr: raises $0.04 to $0.06
Pulp Hands: folds 
MarioDios: folds 
Mustang01373: folds 
Scaaalll: folds 
ppluiaule: calls $0.04
*** FLOP *** [7c 5c 5d]
ppluiaule: checks 
A.luckebeggr: bets $0.06
ppluiaule: calls $0.06
*** TURN *** [7c 5c 5d] [7d]
ppluiaule: checks 
A.luckebeggr: bets $0.24
ppluiaule: folds 
Uncalled bet ($0.24) returned to A.luckebeggr
A.luckebeggr collected $0.24 from pot
A.luckebeggr: doesn't show hand 
*** SUMMARY ***
Total pot $0.25 | Rake $0.01 
Board [7c 5c 5d 7d]
Seat 1: Mustang01373 (button) folded before Flop (didn't bet)
Seat 2: Scaaalll (small blind) folded before Flop
Seat 3: ppluiaule (big blind) folded on the Turn
Seat 4: A.luckebeggr collected ($0.24)
Seat 5: Pulp Hands folded before Flop (didn't bet)
Seat 6: MarioDios folded before Flop (didn't bet)



PokerStars Zoom Hand #229232469093:  Hold'em No Limit ($0.01/$0.02) - 2021/08/21 22:51:54 CET [2021/08/21 16:51:54 ET]
Table 'Halley' 6-max Seat #1 is the button
Seat 1: Scaaalll ($2.48 in chips) 
Seat 2: Apollonnn_13 ($2.19 in chips) 
Seat 3: MATIdf365 ($1.72 in chips) 
Seat 4: 78joniboy ($4.20 in chips) 
Seat 5: zallav ($3.29 in chips) 
Seat 6: RATAKEY41673 ($2 in chips) 
Apollonnn_13: posts small blind $0.01
MATIdf365: posts big blind $0.02
*** HOLE CARDS ***
Dealt to Scaaalll [Ks 2d]
zallav is disconnected 
78joniboy: folds 
zallav: folds 
RATAKEY41673: folds 
Scaaalll: folds 
Apollonnn_13: folds 
Uncalled bet ($0.01) returned to MATIdf365
MATIdf365 collected $0.02 from pot
MATIdf365: doesn't show hand 
*** SUMMARY ***
Total pot $0.02 | Rake $0 
Seat 1: Scaaalll (button) folded before Flop (didn't bet)
Seat 2: Apollonnn_13 (small blind) folded before Flop
Seat 3: MATIdf365 (big blind) collected ($0.02)
Seat 4: 78joniboy folded before Flop (didn't bet)
Seat 5: zallav folded before Flop (didn't bet)
Seat 6: RATAKEY41673 folded before Flop (didn't bet)



PokerStars Zoom Hand #229232449164:  Hold'em No Limit ($0.01/$0.02) - 2021/08/21 22:51:09 CET [2021/08/21 16:51:09 ET]
Table 'Halley' 6-max Seat #1 is the button
Seat 1: Baksit79 ($1.17 in chips) 
Seat 2: nagiloR ($1.67 in chips) 
Seat 3: bananAAbandit ($6.54 in chips) 
Seat 4: kahzura ($2 in chips) 
Seat 5: Scaaalll ($2.51 in chips) 
Seat 6: amand14 ($1.65 in chips) 
nagiloR: posts small blind $0.01
bananAAbandit: posts big blind $0.02
*** HOLE CARDS ***
Dealt to Scaaalll [7d Qc]
kahzura: folds 
Scaaalll: folds 
amand14: folds 
Baksit79: folds 
Baksit79 is disconnected 
nagiloR: raises $0.04 to $0.06
bananAAbandit: raises $0.15 to $0.21
nagiloR: calls $0.15
*** FLOP *** [3s 6c 4s]
nagiloR: checks 
bananAAbandit: bets $0.21
nagiloR: calls $0.21
*** TURN *** [3s 6c 4s] [Kc]
nagiloR: checks 
bananAAbandit: bets $0.41
nagiloR: calls $0.41
*** RIVER *** [3s 6c 4s Kc] [4d]
nagiloR: bets $0.84 and is all-in
bananAAbandit: calls $0.84
*** SHOW DOWN ***
nagiloR: shows [Ts 7s] (a pair of Fours)
bananAAbandit: shows [Qd Kd] (two pair, Kings and Fours)
bananAAbandit collected $3.22 from pot
*** SUMMARY ***
Total pot $3.34 | Rake $0.12 
Board [3s 6c 4s Kc 4d]
Seat 1: Baksit79 (button) folded before Flop (didn't bet)
Seat 2: nagiloR (small blind) showed [Ts 7s] and lost with a pair of Fours
Seat 3: bananAAbandit (big blind) showed [Qd Kd] and won ($3.22) with two pair, Kings and Fours
Seat 4: kahzura folded before Flop (didn't bet)
Seat 5: Scaaalll folded before Flop (didn't bet)
Seat 6: amand14 folded before Flop (didn't bet)



PokerStars Zoom Hand #229232473050:  Hold'em No Limit ($0.01/$0.02) - 2021/08/21 22:52:03 CET [2021/08/21 16:52:03 ET]
Table 'Halley' 6-max Seat #1 is the button
Seat 1: BMRB1991 ($1.74 in chips) 
Seat 2: giselerebelo ($2.61 in chips) 
Seat 3: estelionat171 ($0.68 in chips) 
Seat 4: SniperTano ($1.47 in chips) 
Seat 5: Scaaalll ($2.48 in chips) 
Seat 6: Daiting1 ($1.47 in chips) 
giselerebelo: posts small blind $0.01
estelionat171: posts big blind $0.02
*** HOLE CARDS ***
Dealt to Scaaalll [2h Qc]
SniperTano: raises $0.03 to $0.05
Scaaalll: folds 
Daiting1: folds 
BMRB1991: folds 
giselerebelo: folds 
estelionat171: folds 
Uncalled bet ($0.03) returned to SniperTano
SniperTano collected $0.05 from pot
SniperTano: doesn't show hand 
*** SUMMARY ***
Total pot $0.05 | Rake $0 
Seat 1: BMRB1991 (button) folded before Flop (didn't bet)
Seat 2: giselerebelo (small blind) folded before Flop
Seat 3: estelionat171 (big blind) folded before Flop
Seat 4: SniperTano collected ($0.05)
Seat 5: Scaaalll folded before Flop (didn't bet)
Seat 6: Daiting1 folded before Flop (didn't bet)



PokerStars Zoom Hand #229232475229:  Hold'em No Limit ($0.01/$0.02) - 2021/08/21 22:52:08 CET [2021/08/21 16:52:08 ET]
Table 'Halley' 6-max Seat #1 is the button
Seat 1: pipecmolodec ($2 in chips) 
Seat 2: astapowitsch ($2.51 in chips) 
Seat 3: MarselTop ($1.85 in chips) 
Seat 4: pavel play pay ($2.84 in chips) 
Seat 5: Habarovs18 ($2.44 in chips) 
Seat 6: Scaaalll ($2.48 in chips) 
astapowitsch: posts small blind $0.01
MarselTop: posts big blind $0.02
*** HOLE CARDS ***
Dealt to Scaaalll [3h Qs]
pavel play pay: folds 
pavel play pay is disconnected 
Habarovs18: raises $0.05 to $0.07
Scaaalll: folds 
pipecmolodec: raises $0.13 to $0.20
astapowitsch: folds 
MarselTop: folds 
Habarovs18: folds 
Uncalled bet ($0.13) returned to pipecmolodec
Habarovs18 is disconnected 
MarselTop is disconnected 
pipecmolodec collected $0.17 from pot
pipecmolodec: doesn't show hand 
*** SUMMARY ***
Total pot $0.17 | Rake $0 
Seat 1: pipecmolodec (button) collected ($0.17)
Seat 2: astapowitsch (small blind) folded before Flop
Seat 3: MarselTop (big blind) folded before Flop
Seat 4: pavel play pay folded before Flop (didn't bet)
Seat 5: Habarovs18 folded before Flop
Seat 6: Scaaalll folded before Flop (didn't bet)



PokerStars Zoom Hand #229232479143:  Hold'em No Limit ($0.01/$0.02) - 2021/08/21 22:52:17 CET [2021/08/21 16:52:17 ET]
Table 'Halley' 6-max Seat #1 is the button
Seat 1: didiclavi777 ($2.67 in chips) 
Seat 2: Bubobubob ($4.51 in chips) 
Seat 3: DaBaDaBaDooo ($3.42 in chips) 
Seat 4: Scaaalll ($2.48 in chips) 
Seat 5: STE1NBERG ($3.96 in chips) 
Seat 6: Kojak34 ($5.27 in chips) 
Bubobubob: posts small blind $0.01
DaBaDaBaDooo: posts big blind $0.02
*** HOLE CARDS ***
Dealt to Scaaalll [Kc 7c]
Scaaalll: folds 
STE1NBERG: folds 
Kojak34: folds 
didiclavi777: folds 
Bubobubob: folds 
Uncalled bet ($0.01) returned to DaBaDaBaDooo
DaBaDaBaDooo collected $0.02 from pot
DaBaDaBaDooo: doesn't show hand 
*** SUMMARY ***
Total pot $0.02 | Rake $0 
Seat 1: didiclavi777 (button) folded before Flop (didn't bet)
Seat 2: Bubobubob (small blind) folded before Flop
Seat 3: DaBaDaBaDooo (big blind) collected ($0.02)
Seat 4: Scaaalll folded before Flop (didn't bet)
Seat 5: STE1NBERG folded before Flop (didn't bet)
Seat 6: Kojak34 folded before Flop (didn't bet)



PokerStars Zoom Hand #229232488564:  Hold'em No Limit ($0.01/$0.02) - 2021/08/21 22:52:38 CET [2021/08/21 16:52:38 ET]
Table 'Halley' 6-max Seat #1 is the button
Seat 1: xxRoseIloveu ($11.64 in chips) 
Seat 2: Scaaalll ($2.46 in chips) 
Seat 3: rekopo203 ($5.61 in chips) 
Seat 4: Xlavariable ($2.12 in chips) 
Seat 5: Dr.stromg ($3.95 in chips) 
Seat 6: HubertFroh ($2 in chips) 
Scaaalll: posts small blind $0.01
rekopo203: posts big blind $0.02
*** HOLE CARDS ***
Dealt to Scaaalll [Qh Ts]
Xlavariable: folds 
Dr.stromg: folds 
HubertFroh: folds 
xxRoseIloveu: folds 
Scaaalll: raises $0.04 to $0.06
rekopo203: folds 
Uncalled bet ($0.04) returned to Scaaalll
Scaaalll collected $0.04 from pot
Scaaalll: doesn't show hand 
*** SUMMARY ***
Total pot $0.04 | Rake $0 
Seat 1: xxRoseIloveu (button) folded before Flop (didn't bet)
Seat 2: Scaaalll (small blind) collected ($0.04)
Seat 3: rekopo203 (big blind) folded before Flop
Seat 4: Xlavariable folded before Flop (didn't bet)
Seat 5: Dr.stromg folded before Flop (didn't bet)
Seat 6: HubertFroh folded before Flop (didn't bet)



PokerStars Zoom Hand #229232482336:  Hold'em No Limit ($0.01/$0.02) - 2021/08/21 22:52:24 CET [2021/08/21 16:52:24 ET]
Table 'Halley' 6-max Seat #1 is the button
Seat 1: Busya777 ($1.61 in chips) 
Seat 2: NickAlex18 ($2.64 in chips) 
Seat 3: Scaaalll ($2.48 in chips) 
Seat 4: Tacojesuscrisp ($2 in chips) 
Seat 5: EzukoChan ($3.15 in chips) 
Seat 6: HDYD18 ($5.69 in chips) 
NickAlex18: posts small blind $0.01
Scaaalll: posts big blind $0.02
*** HOLE CARDS ***
Dealt to Scaaalll [Jh 3h]
Busya777 is disconnected 
Tacojesuscrisp: raises $0.03 to $0.05
EzukoChan: folds 
HDYD18: folds 
Busya777: folds 
NickAlex18: calls $0.04
Scaaalll: folds 
*** FLOP *** [9d 3d Qh]
NickAlex18: checks 
Tacojesuscrisp: checks 
*** TURN *** [9d 3d Qh] [7c]
NickAlex18: bets $0.08
Tacojesuscrisp: calls $0.08
*** RIVER *** [9d 3d Qh 7c] [7d]
NickAlex18: checks 
Tacojesuscrisp: bets $0.20
NickAlex18: calls $0.20
*** SHOW DOWN ***
Tacojesuscrisp: shows [7h Ah] (three of a kind, Sevens)
NickAlex18: mucks hand 
Tacojesuscrisp collected $0.66 from pot
*** SUMMARY ***
Total pot $0.68 | Rake $0.02 
Board [9d 3d Qh 7c 7d]
Seat 1: Busya777 (button) folded before Flop (didn't bet)
Seat 2: NickAlex18 (small blind) mucked [8c 8h]
Seat 3: Scaaalll (big blind) folded before Flop
Seat 4: Tacojesuscrisp showed [7h Ah] and won ($0.66) with three of a kind, Sevens
Seat 5: EzukoChan folded before Flop (didn't bet)
Seat 6: HDYD18 folded before Flop (didn't bet)



PokerStars Zoom Hand #229232498180:  Hold'em No Limit ($0.01/$0.02) - 2021/08/21 22:53:00 CET [2021/08/21 16:53:00 ET]
Table 'Halley' 6-max Seat #1 is the button
Seat 1: elenka757 ($0.33 in chips) 
Seat 2: py100ta ($23.81 in chips) 
Seat 3: 78joniboy ($2.87 in chips) 
Seat 4: Scaaalll ($2.48 in chips) 
Seat 5: kukulagosleep ($2.55 in chips) 
Seat 6: olga3021221 ($2.16 in chips) 
py100ta: posts small blind $0.01
78joniboy: posts big blind $0.02
*** HOLE CARDS ***
Dealt to Scaaalll [Kd 2s]
Scaaalll: folds 
kukulagosleep: folds 
olga3021221: folds 
elenka757: raises $0.31 to $0.33 and is all-in
py100ta: folds 
78joniboy: folds 
Uncalled bet ($0.31) returned to elenka757
elenka757 collected $0.05 from pot
elenka757: doesn't show hand 
*** SUMMARY ***
Total pot $0.05 | Rake $0 
Seat 1: elenka757 (button) collected ($0.05)
Seat 2: py100ta (small blind) folded before Flop
Seat 3: 78joniboy (big blind) folded before Flop
Seat 4: Scaaalll folded before Flop (didn't bet)
Seat 5: kukulagosleep folded before Flop (didn't bet)
Seat 6: olga3021221 folded before Flop (didn't bet)



PokerStars Zoom Hand #229232494681:  Hold'em No Limit ($0.01/$0.02) - 2021/08/21 22:52:52 CET [2021/08/21 16:52:52 ET]
Table 'Halley' 6-max Seat #1 is the button
Seat 1: Scaaalll ($2.48 in chips) 
Seat 2: Koldun 2636 ($4.08 in chips) 
Seat 3: Herr.Hikke ($2.97 in chips) 
Seat 4: BexleyBoy ($3.14 in chips) 
Seat 5: KareAAAA ($6.02 in chips) 
Seat 6: Earl_greyPL ($1 in chips) 
Koldun 2636: posts small blind $0.01
Herr.Hikke: posts big blind $0.02
*** HOLE CARDS ***
Dealt to Scaaalll [8h 2s]
BexleyBoy: folds 
KareAAAA: folds 
KareAAAA is disconnected 
Earl_greyPL: raises $0.04 to $0.06
Scaaalll: folds 
Koldun 2636: calls $0.05
Herr.Hikke: folds 
*** FLOP *** [Ah Td 2c]
Koldun 2636: checks 
Earl_greyPL: bets $0.09
Koldun 2636: folds 
Uncalled bet ($0.09) returned to Earl_greyPL
Earl_greyPL collected $0.14 from pot
Earl_greyPL: doesn't show hand 
*** SUMMARY ***
Total pot $0.14 | Rake $0 
Board [Ah Td 2c]
Seat 1: Scaaalll (button) folded before Flop (didn't bet)
Seat 2: Koldun 2636 (small blind) folded on the Flop
Seat 3: Herr.Hikke (big blind) folded before Flop
Seat 4: BexleyBoy folded before Flop (didn't bet)
Seat 5: KareAAAA folded before Flop (didn't bet)
Seat 6: Earl_greyPL collected ($0.14)



PokerStars Zoom Hand #229232506566:  Hold'em No Limit ($0.01/$0.02) - 2021/08/21 22:53:19 CET [2021/08/21 16:53:19 ET]
Table 'Halley' 6-max Seat #1 is the button
Seat 1: Koldun 2636 ($4.02 in chips) 
Seat 2: smileakafray ($3.91 in chips) 
Seat 3: WITKOW_AV ($2 in chips) 
Seat 4: newen83 ($1.77 in chips) 
Seat 5: STE1NBERG ($3.11 in chips) 
Seat 6: Scaaalll ($2.46 in chips) 
smileakafray: posts small blind $0.01
WITKOW_AV: posts big blind $0.02
*** HOLE CARDS ***
Dealt to Scaaalll [Kh Td]
newen83: folds 
newen83 is disconnected 
STE1NBERG: raises $0.03 to $0.05
Scaaalll: raises $0.13 to $0.18
Koldun 2636: folds 
smileakafray: folds 
WITKOW_AV: folds 
STE1NBERG: folds 
Uncalled bet ($0.13) returned to Scaaalll
Scaaalll collected $0.13 from pot
Scaaalll: doesn't show hand 
*** SUMMARY ***
Total pot $0.13 | Rake $0 
Seat 1: Koldun 2636 (button) folded before Flop (didn't bet)
Seat 2: smileakafray (small blind) folded before Flop
Seat 3: WITKOW_AV (big blind) folded before Flop
Seat 4: newen83 folded before Flop (didn't bet)
Seat 5: STE1NBERG folded before Flop
Seat 6: Scaaalll collected ($0.13)



PokerStars Zoom Hand #229232496446:  Hold'em No Limit ($0.01/$0.02) - 2021/08/21 22:52:56 CET [2021/08/21 16:52:56 ET]
Table 'Halley' 6-max Seat #1 is the button
Seat 1: boa juice ($2.75 in chips) 
Seat 2: CronZ86 ($1.05 in chips) 
Seat 3: Tacojesuscrisp ($2.32 in chips) 
Seat 4: so0love ($7.39 in chips) 
Seat 5: Scaaalll ($2.48 in chips) 
Seat 6: STE1NBERG ($4.02 in chips) 
CronZ86: posts small blind $0.01
Tacojesuscrisp: posts big blind $0.02
*** HOLE CARDS ***
Dealt to Scaaalll [3c 7h]
so0love: folds 
Scaaalll: folds 
STE1NBERG: folds 
boa juice: folds 
boa juice is disconnected 
CronZ86: calls $0.01
Tacojesuscrisp: raises $0.08 to $0.10
CronZ86: calls $0.08
*** FLOP *** [4c 2c As]
CronZ86: checks 
Tacojesuscrisp: checks 
*** TURN *** [4c 2c As] [Ks]
CronZ86: checks 
Tacojesuscrisp: checks 
*** RIVER *** [4c 2c As Ks] [5h]
CronZ86: bets $0.05
Tacojesuscrisp: folds 
Uncalled bet ($0.05) returned to CronZ86
CronZ86 collected $0.19 from pot
CronZ86: doesn't show hand 
*** SUMMARY ***
Total pot $0.20 | Rake $0.01 
Board [4c 2c As Ks 5h]
Seat 1: boa juice (button) folded before Flop (didn't bet)
Seat 2: CronZ86 (small blind) collected ($0.19)
Seat 3: Tacojesuscrisp (big blind) folded on the River
Seat 4: so0love folded before Flop (didn't bet)
Seat 5: Scaaalll folded before Flop (didn't bet)
Seat 6: STE1NBERG folded before Flop (didn't bet)



PokerStars Zoom Hand #229232499975:  Hold'em No Limit ($0.01/$0.02) - 2021/08/21 22:53:04 CET [2021/08/21 16:53:04 ET]
Table 'Halley' 6-max Seat #1 is the button
Seat 1: Treadero ($2.36 in chips) 
Seat 2: trickywizard64 ($1.42 in chips) 
Seat 3: Scaaalll ($2.48 in chips) 
Seat 4: BIITRU ($2 in chips) 
Seat 5: BigTestIcicle ($2.62 in chips) 
Seat 6: tisadaisy ($2 in chips) 
trickywizard64: posts small blind $0.01
Scaaalll: posts big blind $0.02
*** HOLE CARDS ***
Dealt to Scaaalll [5s Js]
BIITRU: raises $0.04 to $0.06
BigTestIcicle: folds 
tisadaisy: folds 
Treadero: raises $0.10 to $0.16
trickywizard64: folds 
Scaaalll: folds 
BIITRU: calls $0.10
*** FLOP *** [Kd 8h 3c]
BIITRU: checks 
Treadero: bets $0.17
BIITRU: folds 
Uncalled bet ($0.17) returned to Treadero
Treadero collected $0.34 from pot
Treadero: doesn't show hand 
*** SUMMARY ***
Total pot $0.35 | Rake $0.01 
Board [Kd 8h 3c]
Seat 1: Treadero (button) collected ($0.34)
Seat 2: trickywizard64 (small blind) folded before Flop
Seat 3: Scaaalll (big blind) folded before Flop
Seat 4: BIITRU folded on the Flop
Seat 5: BigTestIcicle folded before Flop (didn't bet)
Seat 6: tisadaisy folded before Flop (didn't bet)



PokerStars Zoom Hand #229232513652:  Hold'em No Limit ($0.01/$0.02) - 2021/08/21 22:53:35 CET [2021/08/21 16:53:35 ET]
Table 'Halley' 6-max Seat #1 is the button
Seat 1: Scaaalll ($2.54 in chips) 
Seat 2: Sergio Rigel ($2.77 in chips) 
Seat 3: Boris_Garich ($2.03 in chips) 
Seat 4: HDYD18 ($2.43 in chips) 
Seat 5: FabOliveira9 ($3.33 in chips) 
Seat 6: Ramirres ($2.16 in chips) 
Sergio Rigel: posts small blind $0.01
Boris_Garich: posts big blind $0.02
*** HOLE CARDS ***
Dealt to Scaaalll [4h 5s]
HDYD18: folds 
FabOliveira9: folds 
Ramirres: folds 
Scaaalll: folds 
Sergio Rigel: raises $0.03 to $0.05
Boris_Garich: calls $0.03
*** FLOP *** [3d Ad 6s]
Sergio Rigel: bets $0.05
Boris_Garich: calls $0.05
*** TURN *** [3d Ad 6s] [3h]
Sergio Rigel: bets $0.14
Boris_Garich: calls $0.14
*** RIVER *** [3d Ad 6s 3h] [6d]
Sergio Rigel: checks 
Boris_Garich: checks 
*** SHOW DOWN ***
Sergio Rigel: shows [Th Ah] (two pair, Aces and Sixes)
Boris_Garich: mucks hand 
Sergio Rigel collected $0.46 from pot
*** SUMMARY ***
Total pot $0.48 | Rake $0.02 
Board [3d Ad 6s 3h 6d]
Seat 1: Scaaalll (button) folded before Flop (didn't bet)
Seat 2: Sergio Rigel (small blind) showed [Th Ah] and won ($0.46) with two pair, Aces and Sixes
Seat 3: Boris_Garich (big blind) mucked [9s As]
Seat 4: HDYD18 folded before Flop (didn't bet)
Seat 5: FabOliveira9 folded before Flop (didn't bet)
Seat 6: Ramirres folded before Flop (didn't bet)



PokerStars Zoom Hand #229232527040:  Hold'em No Limit ($0.01/$0.02) - 2021/08/21 22:54:05 CET [2021/08/21 16:54:05 ET]
Table 'Halley' 6-max Seat #1 is the button
Seat 1: smileakafray ($3.87 in chips) 
Seat 2: Dr.stromg ($3.44 in chips) 
Seat 3: Tabitaji ($2.47 in chips) 
Seat 4: Scaaalll ($2.53 in chips) 
Seat 5: Marcus579 ($1.71 in chips) 
Seat 6: eutepegu ($1.60 in chips) 
Dr.stromg: posts small blind $0.01
Tabitaji: posts big blind $0.02
*** HOLE CARDS ***
Dealt to Scaaalll [Qd 3d]
Scaaalll: folds 
Marcus579: folds 
eutepegu: folds 
smileakafray: folds 
Dr.stromg: folds 
Uncalled bet ($0.01) returned to Tabitaji
eutepegu is disconnected 
Tabitaji collected $0.02 from pot
Tabitaji: doesn't show hand 
*** SUMMARY ***
Total pot $0.02 | Rake $0 
Seat 1: smileakafray (button) folded before Flop (didn't bet)
Seat 2: Dr.stromg (small blind) folded before Flop
Seat 3: Tabitaji (big blind) collected ($0.02)
Seat 4: Scaaalll folded before Flop (didn't bet)
Seat 5: Marcus579 folded before Flop (didn't bet)
Seat 6: eutepegu folded before Flop (didn't bet)



PokerStars Zoom Hand #229232531061:  Hold'em No Limit ($0.01/$0.02) - 2021/08/21 22:54:14 CET [2021/08/21 16:54:14 ET]
Table 'Halley' 6-max Seat #1 is the button
Seat 1: Dr.stromg ($5.60 in chips) 
Seat 2: zallav ($3.32 in chips) 
Seat 3: Scaaalll ($2.53 in chips) 
Seat 4: botyesz999 ($3.18 in chips) 
Seat 5: 888lifeIS ($2.37 in chips) 
Seat 6: FabOliveira9 ($2 in chips) 
zallav: posts small blind $0.01
Scaaalll: posts big blind $0.02
*** HOLE CARDS ***
Dealt to Scaaalll [7h 3c]
zallav is disconnected 
botyesz999: folds 
888lifeIS: folds 
FabOliveira9: folds 
Dr.stromg: folds 
zallav: folds 
Uncalled bet ($0.01) returned to Scaaalll
Scaaalll collected $0.02 from pot
Scaaalll: doesn't show hand 
*** SUMMARY ***
Total pot $0.02 | Rake $0 
Seat 1: Dr.stromg (button) folded before Flop (didn't bet)
Seat 2: zallav (small blind) folded before Flop
Seat 3: Scaaalll (big blind) collected ($0.02)
Seat 4: botyesz999 folded before Flop (didn't bet)
Seat 5: 888lifeIS folded before Flop (didn't bet)
Seat 6: FabOliveira9 folded before Flop (didn't bet)



PokerStars Zoom Hand #229232520786:  Hold'em No Limit ($0.01/$0.02) - 2021/08/21 22:53:51 CET [2021/08/21 16:53:51 ET]
Table 'Halley' 6-max Seat #1 is the button
Seat 1: saul_good246 ($1.91 in chips) 
Seat 2: Hallyson_23 ($4.90 in chips) 
Seat 3: Umnik_M ($1.88 in chips) 
Seat 4: MarioDios ($2.04 in chips) 
Seat 5: znak312 ($2 in chips) 
Seat 6: Scaaalll ($2.53 in chips) 
Hallyson_23: posts small blind $0.01
Umnik_M: posts big blind $0.02
*** HOLE CARDS ***
Dealt to Scaaalll [4s 3c]
MarioDios: raises $0.06 to $0.08
znak312: folds 
Scaaalll: folds 
saul_good246: calls $0.08
Hallyson_23: folds 
Umnik_M: folds 
*** FLOP *** [6s 2c 6d]
MarioDios: bets $0.09
saul_good246: calls $0.09
*** TURN *** [6s 2c 6d] [9d]
MarioDios: bets $0.24
saul_good246: calls $0.24
*** RIVER *** [6s 2c 6d 9d] [8h]
MarioDios: checks 
saul_good246: checks 
*** SHOW DOWN ***
MarioDios: shows [Qs Ks] (a pair of Sixes)
saul_good246: shows [7d 7h] (two pair, Sevens and Sixes)
saul_good246 collected $0.82 from pot
*** SUMMARY ***
Total pot $0.85 | Rake $0.03 
Board [6s 2c 6d 9d 8h]
Seat 1: saul_good246 (button) showed [7d 7h] and won ($0.82) with two pair, Sevens and Sixes
Seat 2: Hallyson_23 (small blind) folded before Flop
Seat 3: Umnik_M (big blind) folded before Flop
Seat 4: MarioDios showed [Qs Ks] and lost with a pair of Sixes
Seat 5: znak312 folded before Flop (didn't bet)
Seat 6: Scaaalll folded before Flop (didn't bet)



PokerStars Zoom Hand #229232518137:  Hold'em No Limit ($0.01/$0.02) - 2021/08/21 22:53:45 CET [2021/08/21 16:53:45 ET]
Table 'Halley' 6-max Seat #1 is the button
Seat 1: Posaunengodi ($2.89 in chips) 
Seat 2: Scaaalll ($2.54 in chips) 
Seat 3: Laonikos ($5.28 in chips) 
Seat 4: T-saitama ($2.02 in chips) 
Seat 5: NickAlex18 ($2.29 in chips) 
Seat 6: Yangyang1407 ($2.06 in chips) 
Scaaalll: posts small blind $0.01
Laonikos: posts big blind $0.02
*** HOLE CARDS ***
Dealt to Scaaalll [3c 2h]
T-saitama: folds 
NickAlex18: folds 
Yangyang1407: folds 
Posaunengodi: raises $0.03 to $0.05
Scaaalll: folds 
Laonikos: raises $0.18 to $0.23
Posaunengodi: calls $0.18
*** FLOP *** [Kc Ks 9c]
Laonikos: bets $0.13
Posaunengodi: raises $0.26 to $0.39
Laonikos: raises $0.36 to $0.75
Posaunengodi: folds 
Uncalled bet ($0.36) returned to Laonikos
Laonikos collected $1.21 from pot
Laonikos: doesn't show hand 
*** SUMMARY ***
Total pot $1.25 | Rake $0.04 
Board [Kc Ks 9c]
Seat 1: Posaunengodi (button) folded on the Flop
Seat 2: Scaaalll (small blind) folded before Flop
Seat 3: Laonikos (big blind) collected ($1.21)
Seat 4: T-saitama folded before Flop (didn't bet)
Seat 5: NickAlex18 folded before Flop (didn't bet)
Seat 6: Yangyang1407 folded before Flop (didn't bet)



PokerStars Zoom Hand #229232534060:  Hold'em No Limit ($0.01/$0.02) - 2021/08/21 22:54:21 CET [2021/08/21 16:54:21 ET]
Table 'Halley' 6-max Seat #1 is the button
Seat 1: Scaaalll ($2.54 in chips) 
Seat 2: 888lifeIS ($2 in chips) 
Seat 3: iampipin ($1.31 in chips) 
Seat 4: znak312 ($2 in chips) 
Seat 5: Xlavariable ($2.06 in chips) 
Seat 6: NickAlex18 ($2.29 in chips) 
888lifeIS: posts small blind $0.01
iampipin: posts big blind $0.02
*** HOLE CARDS ***
Dealt to Scaaalll [Kh 7s]
znak312: folds 
Xlavariable has timed out
Xlavariable: folds 
NickAlex18: folds 
Scaaalll: raises $0.02 to $0.04
888lifeIS: folds 
iampipin has timed out
iampipin: folds 
Uncalled bet ($0.02) returned to Scaaalll
Scaaalll collected $0.05 from pot
Scaaalll: doesn't show hand 
iampipin is disconnected 
*** SUMMARY ***
Total pot $0.05 | Rake $0 
Seat 1: Scaaalll (button) collected ($0.05)
Seat 2: 888lifeIS (small blind) folded before Flop
Seat 3: iampipin (big blind) folded before Flop
Seat 4: znak312 folded before Flop (didn't bet)
Seat 5: Xlavariable folded before Flop (didn't bet)
Seat 6: NickAlex18 folded before Flop (didn't bet)



PokerStars Zoom Hand #229232529288:  Hold'em No Limit ($0.01/$0.02) - 2021/08/21 22:54:10 CET [2021/08/21 16:54:10 ET]
Table 'Halley' 6-max Seat #1 is the button
Seat 1: alexan00 ($2.87 in chips) 
Seat 2: Finderra ($2.28 in chips) 
Seat 3: renansoumarques ($1.28 in chips) 
Seat 4: Scaaalll ($2.53 in chips) 
Seat 5: vovo4kapooh ($3.24 in chips) 
Seat 6: El Chicha.CL ($3.55 in chips) 
Finderra: posts small blind $0.01
renansoumarques: posts big blind $0.02
*** HOLE CARDS ***
Dealt to Scaaalll [8h Tc]
Scaaalll: folds 
vovo4kapooh: folds 
El Chicha.CL: folds 
alexan00: folds 
Finderra: calls $0.01
renansoumarques: checks 
*** FLOP *** [Td Jd 3h]
Finderra: checks 
renansoumarques: checks 
*** TURN *** [Td Jd 3h] [Qh]
Finderra: checks 
renansoumarques: bets $0.02
Finderra: folds 
Uncalled bet ($0.02) returned to renansoumarques
renansoumarques collected $0.04 from pot
renansoumarques: doesn't show hand 
*** SUMMARY ***
Total pot $0.04 | Rake $0 
Board [Td Jd 3h Qh]
Seat 1: alexan00 (button) folded before Flop (didn't bet)
Seat 2: Finderra (small blind) folded on the Turn
Seat 3: renansoumarques (big blind) collected ($0.04)
Seat 4: Scaaalll folded before Flop (didn't bet)
Seat 5: vovo4kapooh folded before Flop (didn't bet)
Seat 6: El Chicha.CL folded before Flop (didn't bet)



PokerStars Zoom Hand #229232557048:  Hold'em No Limit ($0.01/$0.02) - 2021/08/21 22:55:17 CET [2021/08/21 16:55:17 ET]
Table 'Halley' 6-max Seat #1 is the button
Seat 1: Apollonnn_13 ($1.73 in chips) 
Seat 2: Scaaalll ($2.57 in chips) 
Seat 3: juraa14 ($3.40 in chips) 
Seat 4: trickywizard64 ($1.51 in chips) 
Seat 5: NecromiconP ($5.07 in chips) 
Seat 6: BlackhawKK's ($2.46 in chips) 
Scaaalll: posts small blind $0.01
juraa14: posts big blind $0.02
*** HOLE CARDS ***
Dealt to Scaaalll [4c Th]
trickywizard64 has timed out
trickywizard64: folds 
NecromiconP: folds 
BlackhawKK's: folds 
Apollonnn_13: raises $0.04 to $0.06
Scaaalll: folds 
juraa14: folds 
Uncalled bet ($0.04) returned to Apollonnn_13
Apollonnn_13 collected $0.05 from pot
Apollonnn_13: doesn't show hand 
*** SUMMARY ***
Total pot $0.05 | Rake $0 
Seat 1: Apollonnn_13 (button) collected ($0.05)
Seat 2: Scaaalll (small blind) folded before Flop
Seat 3: juraa14 (big blind) folded before Flop
Seat 4: trickywizard64 folded before Flop (didn't bet)
Seat 5: NecromiconP folded before Flop (didn't bet)
Seat 6: BlackhawKK's folded before Flop (didn't bet)



PokerStars Zoom Hand #229232558628:  Hold'em No Limit ($0.01/$0.02) - 2021/08/21 22:55:22 CET [2021/08/21 16:55:22 ET]
Table 'Halley' 6-max Seat #1 is the button
Seat 1: tolstii906 ($0.97 in chips) 
Seat 2: Koldun 2636 ($2.91 in chips) 
Seat 3: sg.32rus ($1.21 in chips) 
Seat 4: Thaleshs ($2.02 in chips) 
Seat 5: Bufre ($2.11 in chips) 
Seat 6: Scaaalll ($2.56 in chips) 
Koldun 2636: posts small blind $0.01
sg.32rus: posts big blind $0.02
*** HOLE CARDS ***
Dealt to Scaaalll [5s Ad]
Thaleshs: folds 
Bufre: folds 
Scaaalll: folds 
tolstii906: folds 
Koldun 2636: folds 
Uncalled bet ($0.01) returned to sg.32rus
sg.32rus collected $0.02 from pot
sg.32rus: doesn't show hand 
*** SUMMARY ***
Total pot $0.02 | Rake $0 
Seat 1: tolstii906 (button) folded before Flop (didn't bet)
Seat 2: Koldun 2636 (small blind) folded before Flop
Seat 3: sg.32rus (big blind) collected ($0.02)
Seat 4: Thaleshs folded before Flop (didn't bet)
Seat 5: Bufre folded before Flop (didn't bet)
Seat 6: Scaaalll folded before Flop (didn't bet)



PokerStars Zoom Hand #229232563435:  Hold'em No Limit ($0.01/$0.02) - 2021/08/21 22:55:37 CET [2021/08/21 16:55:37 ET]
Table 'Halley' 6-max Seat #1 is the button
Seat 1: MattieBOZ ($2.04 in chips) 
Seat 2: vvk22 ($2.24 in chips) 
Seat 3: ChowMangao ($3.92 in chips) 
Seat 4: CrazyyParis ($2 in chips) 
Seat 5: Scaaalll ($2.56 in chips) 
Seat 6: udav26 ($2.61 in chips) 
vvk22: posts small blind $0.01
ChowMangao: posts big blind $0.02
*** HOLE CARDS ***
Dealt to Scaaalll [6c Kd]
CrazyyParis: raises $0.03 to $0.05
MattieBOZ is disconnected 
Scaaalll: folds 
udav26: folds 
MattieBOZ: folds 
vvk22: folds 
ChowMangao: folds 
Uncalled bet ($0.03) returned to CrazyyParis
CrazyyParis collected $0.05 from pot
CrazyyParis: doesn't show hand 
*** SUMMARY ***
Total pot $0.05 | Rake $0 
Seat 1: MattieBOZ (button) folded before Flop (didn't bet)
Seat 2: vvk22 (small blind) folded before Flop
Seat 3: ChowMangao (big blind) folded before Flop
Seat 4: CrazyyParis collected ($0.05)
Seat 5: Scaaalll folded before Flop (didn't bet)
Seat 6: udav26 folded before Flop (didn't bet)



PokerStars Zoom Hand #229232565691:  Hold'em No Limit ($0.01/$0.02) - 2021/08/21 22:55:44 CET [2021/08/21 16:55:44 ET]
Table 'Halley' 6-max Seat #1 is the button
Seat 1: Mad_Clock ($2.87 in chips) 
Seat 2: estelionat171 ($0.81 in chips) 
Seat 3: Hejpåre ($2 in chips) 
Seat 4: Scaaalll ($2.56 in chips) 
Seat 5: Ehrewind ($2 in chips) 
Seat 6: AleksSiri ($1.10 in chips) 
estelionat171: posts small blind $0.01
Hejpåre: posts big blind $0.02
*** HOLE CARDS ***
Dealt to Scaaalll [Ah 9d]
Scaaalll: folds 
Ehrewind: folds 
AleksSiri: folds 
Mad_Clock: folds 
estelionat171: folds 
Uncalled bet ($0.01) returned to Hejpåre
Hejpåre collected $0.02 from pot
Hejpåre: doesn't show hand 
*** SUMMARY ***
Total pot $0.02 | Rake $0 
Seat 1: Mad_Clock (button) folded before Flop (didn't bet)
Seat 2: estelionat171 (small blind) folded before Flop
Seat 3: Hejpåre (big blind) collected ($0.02)
Seat 4: Scaaalll folded before Flop (didn't bet)
Seat 5: Ehrewind folded before Flop (didn't bet)
Seat 6: AleksSiri folded before Flop (didn't bet)



PokerStars Zoom Hand #229232567334:  Hold'em No Limit ($0.01/$0.02) - 2021/08/21 22:55:49 CET [2021/08/21 16:55:49 ET]
Table 'Halley' 6-max Seat #1 is the button
Seat 1: VovaU164 ($1.91 in chips) 
Seat 2: AlexGTPS ($3.37 in chips) 
Seat 3: The-End-snglr ($2.30 in chips) 
Seat 4: HubertFroh ($2 in chips) 
Seat 5: Scaaalll ($2.56 in chips) 
Seat 6: rabbitmeat73 ($2.82 in chips) 
AlexGTPS: posts small blind $0.01
The-End-snglr: posts big blind $0.02
*** HOLE CARDS ***
Dealt to Scaaalll [4d Ts]
HubertFroh: folds 
Scaaalll: folds 
rabbitmeat73: folds 
VovaU164: raises $0.04 to $0.06
AlexGTPS: folds 
The-End-snglr: folds 
Uncalled bet ($0.04) returned to VovaU164
VovaU164 collected $0.05 from pot
VovaU164: doesn't show hand 
*** SUMMARY ***
Total pot $0.05 | Rake $0 
Seat 1: VovaU164 (button) collected ($0.05)
Seat 2: AlexGTPS (small blind) folded before Flop
Seat 3: The-End-snglr (big blind) folded before Flop
Seat 4: HubertFroh folded before Flop (didn't bet)
Seat 5: Scaaalll folded before Flop (didn't bet)
Seat 6: rabbitmeat73 folded before Flop (didn't bet)



PokerStars Zoom Hand #229232570926:  Hold'em No Limit ($0.01/$0.02) - 2021/08/21 22:56:00 CET [2021/08/21 16:56:00 ET]
Table 'Halley' 6-max Seat #1 is the button
Seat 1: ISBman ($3.77 in chips) 
Seat 2: Ck@tih@ ($1.86 in chips) 
Seat 3: Scaaalll ($2.56 in chips) 
Seat 4: tazar34_777 ($5.04 in chips) 
Seat 5: Map4ik ($1.67 in chips) 
Seat 6: znak312 ($2 in chips) 
Ck@tih@: posts small blind $0.01
Scaaalll: posts big blind $0.02
*** HOLE CARDS ***
Dealt to Scaaalll [8h 7c]
tazar34_777: folds 
Map4ik: calls $0.02
znak312: folds 
ISBman: folds 
Ck@tih@: folds 
Scaaalll: checks 
*** FLOP *** [9d 3h 3s]
Scaaalll: checks 
Map4ik: checks 
*** TURN *** [9d 3h 3s] [Jd]
Scaaalll: checks 
Map4ik: bets $0.02
Scaaalll: folds 
Uncalled bet ($0.02) returned to Map4ik
Map4ik collected $0.05 from pot
Map4ik: doesn't show hand 
*** SUMMARY ***
Total pot $0.05 | Rake $0 
Board [9d 3h 3s Jd]
Seat 1: ISBman (button) folded before Flop (didn't bet)
Seat 2: Ck@tih@ (small blind) folded before Flop
Seat 3: Scaaalll (big blind) folded on the Turn
Seat 4: tazar34_777 folded before Flop (didn't bet)
Seat 5: Map4ik collected ($0.05)
Seat 6: znak312 folded before Flop (didn't bet)



PokerStars Zoom Hand #229232592092:  Hold'em No Limit ($0.01/$0.02) - 2021/08/21 22:56:27 CET [2021/08/21 16:56:27 ET]
Table 'Halley' 6-max Seat #1 is the button
Seat 1: diamonminer1976 ($2.05 in chips) 
Seat 2: pavlo8855 ($2.12 in chips) 
Seat 3: causavera ($1.93 in chips) 
Seat 4: Scaaalll ($2.54 in chips) 
Seat 5: alphabeta1d ($2.48 in chips) 
Seat 6: MrTarpey ($0.87 in chips) 
pavlo8855: posts small blind $0.01
causavera: posts big blind $0.02
*** HOLE CARDS ***
Dealt to Scaaalll [3h Kh]
Scaaalll: folds 
MrTarpey is disconnected 
alphabeta1d: folds 
MrTarpey: folds 
diamonminer1976: folds 
pavlo8855: folds 
Uncalled bet ($0.01) returned to causavera
causavera collected $0.02 from pot
causavera: doesn't show hand 
*** SUMMARY ***
Total pot $0.02 | Rake $0 
Seat 1: diamonminer1976 (button) folded before Flop (didn't bet)
Seat 2: pavlo8855 (small blind) folded before Flop
Seat 3: causavera (big blind) collected ($0.02)
Seat 4: Scaaalll folded before Flop (didn't bet)
Seat 5: alphabeta1d folded before Flop (didn't bet)
Seat 6: MrTarpey folded before Flop (didn't bet)



PokerStars Zoom Hand #229232598896:  Hold'em No Limit ($0.01/$0.02) - 2021/08/21 22:56:48 CET [2021/08/21 16:56:48 ET]
Table 'Halley' 6-max Seat #1 is the button
Seat 1: Scaaalll ($2.53 in chips) 
Seat 2: lackymad ($1.04 in chips) 
Seat 3: boa juice ($1.92 in chips) 
Seat 4: anes.v. ($2.61 in chips) 
Seat 5: fishh_play ($3.65 in chips) 
Seat 6: RomiSex ($2.06 in chips) 
lackymad: posts small blind $0.01
boa juice: posts big blind $0.02
*** HOLE CARDS ***
Dealt to Scaaalll [3h Jd]
anes.v.: raises $0.02 to $0.04
boa juice is disconnected 
fishh_play: folds 
RomiSex: folds 
Scaaalll: folds 
lackymad: folds 
boa juice: folds 
Uncalled bet ($0.02) returned to anes.v.
anes.v. collected $0.05 from pot
anes.v.: doesn't show hand 
*** SUMMARY ***
Total pot $0.05 | Rake $0 
Seat 1: Scaaalll (button) folded before Flop (didn't bet)
Seat 2: lackymad (small blind) folded before Flop
Seat 3: boa juice (big blind) folded before Flop
Seat 4: anes.v. collected ($0.05)
Seat 5: fishh_play folded before Flop (didn't bet)
Seat 6: RomiSex folded before Flop (didn't bet)



PokerStars Zoom Hand #229232593336:  Hold'em No Limit ($0.01/$0.02) - 2021/08/21 22:56:31 CET [2021/08/21 16:56:31 ET]
Table 'Halley' 6-max Seat #1 is the button
Seat 1: Santa.Sangr3 ($1.85 in chips) 
Seat 2: Scaaalll ($2.54 in chips) 
Seat 3: T-saitama ($2.08 in chips) 
Seat 4: Gofman A ($1.57 in chips) 
Seat 5: Koldun 2636 ($4 in chips) 
Seat 6: kahzura ($2.20 in chips) 
Scaaalll: posts small blind $0.01
T-saitama: posts big blind $0.02
*** HOLE CARDS ***
Dealt to Scaaalll [5h 6c]
Gofman A: raises $0.03 to $0.05
Koldun 2636: folds 
kahzura: folds 
Santa.Sangr3: calls $0.05
Scaaalll: folds 
T-saitama: folds 
*** FLOP *** [Qc 4c 5d]
Gofman A: bets $0.02
Santa.Sangr3: folds 
Uncalled bet ($0.02) returned to Gofman A
Gofman A collected $0.13 from pot
Gofman A: doesn't show hand 
*** SUMMARY ***
Total pot $0.13 | Rake $0 
Board [Qc 4c 5d]
Seat 1: Santa.Sangr3 (button) folded on the Flop
Seat 2: Scaaalll (small blind) folded before Flop
Seat 3: T-saitama (big blind) folded before Flop
Seat 4: Gofman A collected ($0.13)
Seat 5: Koldun 2636 folded before Flop (didn't bet)
Seat 6: kahzura folded before Flop (didn't bet)



PokerStars Zoom Hand #229232610006:  Hold'em No Limit ($0.01/$0.02) - 2021/08/21 22:57:22 CET [2021/08/21 16:57:22 ET]
Table 'Halley' 6-max Seat #1 is the button
Seat 1: rodrigoasor ($4.68 in chips) 
Seat 2: Rin97 ($2.09 in chips) 
Seat 3: Yangyang1407 ($2.03 in chips) 
Seat 4: Scaaalll ($2.50 in chips) 
Seat 5: Pechorin.G ($2.03 in chips) 
Seat 6: Coldact ($2.02 in chips) 
Rin97: posts small blind $0.01
Yangyang1407: posts big blind $0.02
*** HOLE CARDS ***
Dealt to Scaaalll [7h Ts]
Scaaalll: folds 
Pechorin.G: folds 
Coldact: folds 
rodrigoasor: folds 
Rin97: raises $0.05 to $0.07
Yangyang1407: folds 
Uncalled bet ($0.05) returned to Rin97
Rin97 collected $0.04 from pot
Rin97: doesn't show hand 
*** SUMMARY ***
Total pot $0.04 | Rake $0 
Seat 1: rodrigoasor (button) folded before Flop (didn't bet)
Seat 2: Rin97 (small blind) collected ($0.04)
Seat 3: Yangyang1407 (big blind) folded before Flop
Seat 4: Scaaalll folded before Flop (didn't bet)
Seat 5: Pechorin.G folded before Flop (didn't bet)
Seat 6: Coldact folded before Flop (didn't bet)



PokerStars Zoom Hand #229232611645:  Hold'em No Limit ($0.01/$0.02) - 2021/08/21 22:57:27 CET [2021/08/21 16:57:27 ET]
Table 'Halley' 6-max Seat #1 is the button
Seat 1: Scaaalll ($2.50 in chips) 
Seat 2: PapiMik3 ($6.13 in chips) 
Seat 3: Jackb9908 ($2.18 in chips) 
Seat 4: A.luckebeggr ($5.76 in chips) 
Seat 5: gilberto98 ($2.48 in chips) 
Seat 6: Bufre ($2.61 in chips) 
PapiMik3: posts small blind $0.01
Jackb9908: posts big blind $0.02
*** HOLE CARDS ***
Dealt to Scaaalll [7d 4d]
A.luckebeggr: folds 
gilberto98: folds 
Bufre: folds 
Scaaalll: folds 
PapiMik3: folds 
Uncalled bet ($0.01) returned to Jackb9908
Jackb9908 collected $0.02 from pot
Jackb9908: doesn't show hand 
*** SUMMARY ***
Total pot $0.02 | Rake $0 
Seat 1: Scaaalll (button) folded before Flop (didn't bet)
Seat 2: PapiMik3 (small blind) folded before Flop
Seat 3: Jackb9908 (big blind) collected ($0.02)
Seat 4: A.luckebeggr folded before Flop (didn't bet)
Seat 5: gilberto98 folded before Flop (didn't bet)
Seat 6: Bufre folded before Flop (didn't bet)



PokerStars Zoom Hand #229232603472:  Hold'em No Limit ($0.01/$0.02) - 2021/08/21 22:57:02 CET [2021/08/21 16:57:02 ET]
Table 'Halley' 6-max Seat #1 is the button
Seat 1: saul_good246 ($2.54 in chips) 
Seat 2: Demidov V.S. ($2.74 in chips) 
Seat 3: Scaaalll ($2.53 in chips) 
Seat 4: Ne0net ($2 in chips) 
Seat 5: z3317111711 ($2.01 in chips) 
Seat 6: Herr.Hikke ($2.62 in chips) 
Demidov V.S.: posts small blind $0.01
Scaaalll: posts big blind $0.02
*** HOLE CARDS ***
Dealt to Scaaalll [4h 5c]
Ne0net: folds 
z3317111711: folds 
Herr.Hikke: folds 
saul_good246: raises $0.03 to $0.05
Demidov V.S.: folds 
Scaaalll: folds 
Uncalled bet ($0.03) returned to saul_good246
Demidov V.S. is disconnected 
saul_good246 collected $0.05 from pot
saul_good246: doesn't show hand 
*** SUMMARY ***
Total pot $0.05 | Rake $0 
Seat 1: saul_good246 (button) collected ($0.05)
Seat 2: Demidov V.S. (small blind) folded before Flop
Seat 3: Scaaalll (big blind) folded before Flop
Seat 4: Ne0net folded before Flop (didn't bet)
Seat 5: z3317111711 folded before Flop (didn't bet)
Seat 6: Herr.Hikke folded before Flop (didn't bet)



PokerStars Zoom Hand #229232613637:  Hold'em No Limit ($0.01/$0.02) - 2021/08/21 22:57:33 CET [2021/08/21 16:57:33 ET]
Table 'Halley' 6-max Seat #1 is the button
Seat 1: Ck@tih@ ($0.67 in chips) 
Seat 2: golfffffer ($0.95 in chips) 
Seat 3: S3XY_PADRE ($0.97 in chips) 
Seat 4: maressen ($2.02 in chips) 
Seat 5: Scaaalll ($2.50 in chips) 
Seat 6: Ehrewind ($2.15 in chips) 
golfffffer: posts small blind $0.01
S3XY_PADRE: posts big blind $0.02
*** HOLE CARDS ***
Dealt to Scaaalll [7d 2s]
maressen: folds 
Scaaalll: folds 
Ehrewind: raises $0.03 to $0.05
Ck@tih@: folds 
golfffffer: folds 
S3XY_PADRE: folds 
Uncalled bet ($0.03) returned to Ehrewind
golfffffer is disconnected 
Ehrewind collected $0.05 from pot
Ehrewind: doesn't show hand 
*** SUMMARY ***
Total pot $0.05 | Rake $0 
Seat 1: Ck@tih@ (button) folded before Flop (didn't bet)
Seat 2: golfffffer (small blind) folded before Flop
Seat 3: S3XY_PADRE (big blind) folded before Flop
Seat 4: maressen folded before Flop (didn't bet)
Seat 5: Scaaalll folded before Flop (didn't bet)
Seat 6: Ehrewind collected ($0.05)



PokerStars Zoom Hand #229232616264:  Hold'em No Limit ($0.01/$0.02) - 2021/08/21 22:57:41 CET [2021/08/21 16:57:41 ET]
Table 'Halley' 6-max Seat #1 is the button
Seat 1: WITKOW_AV ($2.61 in chips) 
Seat 2: AleksSiri ($0.87 in chips) 
Seat 3: martoniv ($2.84 in chips) 
Seat 4: rabbitmeat73 ($2.82 in chips) 
Seat 5: cubanhippy ($1.35 in chips) 
Seat 6: Scaaalll ($2.50 in chips) 
AleksSiri: posts small blind $0.01
martoniv: posts big blind $0.02
*** HOLE CARDS ***
Dealt to Scaaalll [3d Qs]
rabbitmeat73: folds 
cubanhippy: calls $0.02
Scaaalll: folds 
WITKOW_AV: folds 
AleksSiri: folds 
martoniv: checks 
*** FLOP *** [Ad As 9s]
martoniv: checks 
cubanhippy: bets $0.02
martoniv: folds 
Uncalled bet ($0.02) returned to cubanhippy
cubanhippy collected $0.05 from pot
cubanhippy: doesn't show hand 
*** SUMMARY ***
Total pot $0.05 | Rake $0 
Board [Ad As 9s]
Seat 1: WITKOW_AV (button) folded before Flop (didn't bet)
Seat 2: AleksSiri (small blind) folded before Flop
Seat 3: martoniv (big blind) folded on the Flop
Seat 4: rabbitmeat73 folded before Flop (didn't bet)
Seat 5: cubanhippy collected ($0.05)
Seat 6: Scaaalll folded before Flop (didn't bet)



PokerStars Zoom Hand #229232601817:  Hold'em No Limit ($0.01/$0.02) - 2021/08/21 22:56:57 CET [2021/08/21 16:56:57 ET]
Table 'Halley' 6-max Seat #1 is the button
Seat 1: bananAAbandit ($4.15 in chips) 
Seat 2: estelionat171 ($0.94 in chips) 
Seat 3: Lidion12 ($1.06 in chips) 
Seat 4: Herr.Hikke ($2.62 in chips) 
Seat 5: WithMyWalker ($6.49 in chips) 
Seat 6: Scaaalll ($2.53 in chips) 
estelionat171: posts small blind $0.01
Lidion12: posts big blind $0.02
*** HOLE CARDS ***
Dealt to Scaaalll [Qd 6c]
Herr.Hikke: folds 
WithMyWalker: raises $0.02 to $0.04
Scaaalll: folds 
bananAAbandit: raises $0.17 to $0.21
estelionat171: folds 
Lidion12: folds 
Lidion12 is disconnected 
WithMyWalker: calls $0.17
*** FLOP *** [Kc 4d 4c]
WithMyWalker: checks 
bananAAbandit: checks 
*** TURN *** [Kc 4d 4c] [Tc]
WithMyWalker: bets $0.18
bananAAbandit: calls $0.18
*** RIVER *** [Kc 4d 4c Tc] [Ks]
WithMyWalker: checks 
bananAAbandit: checks 
*** SHOW DOWN ***
WithMyWalker: shows [2c Ac] (a flush, Ace high)
bananAAbandit: mucks hand 
WithMyWalker collected $0.78 from pot
*** SUMMARY ***
Total pot $0.81 | Rake $0.03 
Board [Kc 4d 4c Tc Ks]
Seat 1: bananAAbandit (button) mucked [As Ad]
Seat 2: estelionat171 (small blind) folded before Flop
Seat 3: Lidion12 (big blind) folded before Flop
Seat 4: Herr.Hikke folded before Flop (didn't bet)
Seat 5: WithMyWalker showed [2c Ac] and won ($0.78) with a flush, Ace high
Seat 6: Scaaalll folded before Flop (didn't bet)



PokerStars Zoom Hand #229232619520:  Hold'em No Limit ($0.01/$0.02) - 2021/08/21 22:57:51 CET [2021/08/21 16:57:51 ET]
Table 'Halley' 6-max Seat #1 is the button
Seat 1: Yangyang1407 ($2.04 in chips) 
Seat 2: simensgh ($4.65 in chips) 
Seat 3: jordanzepp ($1 in chips) 
Seat 4: Aces_Pik_58 ($1.45 in chips) 
Seat 5: Scaaalll ($2.50 in chips) 
Seat 6: XaMpLEr ($2 in chips) 
simensgh: posts small blind $0.01
jordanzepp: posts big blind $0.02
*** HOLE CARDS ***
Dealt to Scaaalll [7c 3h]
Aces_Pik_58: folds 
Scaaalll: folds 
Aces_Pik_58 is disconnected 
XaMpLEr: folds 
Yangyang1407: folds 
simensgh: raises $0.02 to $0.04
jordanzepp: calls $0.02
*** FLOP *** [Js 2s Ad]
simensgh: bets $0.04
jordanzepp: folds 
Uncalled bet ($0.04) returned to simensgh
simensgh collected $0.08 from pot
simensgh: doesn't show hand 
jordanzepp is disconnected 
*** SUMMARY ***
Total pot $0.08 | Rake $0 
Board [Js 2s Ad]
Seat 1: Yangyang1407 (button) folded before Flop (didn't bet)
Seat 2: simensgh (small blind) collected ($0.08)
Seat 3: jordanzepp (big blind) folded on the Flop
Seat 4: Aces_Pik_58 folded before Flop (didn't bet)
Seat 5: Scaaalll folded before Flop (didn't bet)
Seat 6: XaMpLEr folded before Flop (didn't bet)



PokerStars Zoom Hand #229232608659:  Hold'em No Limit ($0.01/$0.02) - 2021/08/21 22:57:18 CET [2021/08/21 16:57:18 ET]
Table 'Halley' 6-max Seat #1 is the button
Seat 1: maliniak75 ($1.83 in chips) 
Seat 2: Scaaalll ($2.51 in chips) 
Seat 3: znak312 ($2 in chips) 
Seat 4: causavera ($1.88 in chips) 
Seat 5: tassy237 ($0.96 in chips) 
Seat 6: Tsopan77 ($0.96 in chips) 
Scaaalll: posts small blind $0.01
znak312: posts big blind $0.02
*** HOLE CARDS ***
Dealt to Scaaalll [4s Jc]
causavera: raises $0.02 to $0.04
tassy237: folds 
tassy237 is disconnected 
Tsopan77: folds 
maliniak75: raises $0.14 to $0.18
Scaaalll: folds 
znak312: folds 
causavera: calls $0.14
*** FLOP *** [3d Td 7h]
causavera: checks 
maliniak75: checks 
*** TURN *** [3d Td 7h] [4d]
causavera: checks 
maliniak75: checks 
*** RIVER *** [3d Td 7h 4d] [Ac]
causavera: checks 
maliniak75: bets $0.19
causavera: folds 
Uncalled bet ($0.19) returned to maliniak75
maliniak75 collected $0.38 from pot
maliniak75: doesn't show hand 
*** SUMMARY ***
Total pot $0.39 | Rake $0.01 
Board [3d Td 7h 4d Ac]
Seat 1: maliniak75 (button) collected ($0.38)
Seat 2: Scaaalll (small blind) folded before Flop
Seat 3: znak312 (big blind) folded before Flop
Seat 4: causavera folded on the River
Seat 5: tassy237 folded before Flop (didn't bet)
Seat 6: Tsopan77 folded before Flop (didn't bet)



PokerStars Zoom Hand #229232621162:  Hold'em No Limit ($0.01/$0.02) - 2021/08/21 22:57:56 CET [2021/08/21 16:57:56 ET]
Table 'Halley' 6-max Seat #1 is the button
Seat 1: polymorhp ($2.47 in chips) 
Seat 2: Jellllys ($2.01 in chips) 
Seat 3: Scaaalll ($2.50 in chips) 
Seat 4: FabOliveira9 ($2.05 in chips) 
Seat 5: AlexGTPS ($4.50 in chips) 
Seat 6: CrazyyParis ($2 in chips) 
Jellllys: posts small blind $0.01
Scaaalll: posts big blind $0.02
*** HOLE CARDS ***
Dealt to Scaaalll [4h 8d]
FabOliveira9: folds 
AlexGTPS: folds 
CrazyyParis: folds 
polymorhp: raises $0.03 to $0.05
Jellllys: calls $0.04
Jellllys is disconnected 
Scaaalll: folds 
*** FLOP *** [5s Ad 5h]
Jellllys: checks 
polymorhp: bets $0.05
Jellllys: folds 
Uncalled bet ($0.05) returned to polymorhp
polymorhp collected $0.12 from pot
polymorhp: doesn't show hand 
Jellllys is disconnected 
*** SUMMARY ***
Total pot $0.12 | Rake $0 
Board [5s Ad 5h]
Seat 1: polymorhp (button) collected ($0.12)
Seat 2: Jellllys (small blind) folded on the Flop
Seat 3: Scaaalll (big blind) folded before Flop
Seat 4: FabOliveira9 folded before Flop (didn't bet)
Seat 5: AlexGTPS folded before Flop (didn't bet)
Seat 6: CrazyyParis folded before Flop (didn't bet)



PokerStars Zoom Hand #229232628628:  Hold'em No Limit ($0.01/$0.02) - 2021/08/21 22:58:19 CET [2021/08/21 16:58:19 ET]
Table 'Halley' 6-max Seat #1 is the button
Seat 1: Scaaalll ($2.48 in chips) 
Seat 2: Healthys07 ($3.70 in chips) 
Seat 3: Nolimit.208 ($3.26 in chips) 
Seat 4: S3XY_PADRE ($0.94 in chips) 
Seat 5: Feliciano16 ($3.58 in chips) 
Seat 6: kukulagosleep ($2 in chips) 
Healthys07: posts small blind $0.01
Nolimit.208: posts big blind $0.02
*** HOLE CARDS ***
Dealt to Scaaalll [8d Jd]
S3XY_PADRE: folds 
Feliciano16: folds 
kukulagosleep: folds 
Scaaalll: raises $0.02 to $0.04
Nolimit.208 is disconnected 
Healthys07: folds 
Nolimit.208: folds 
Uncalled bet ($0.02) returned to Scaaalll
Scaaalll collected $0.05 from pot
Scaaalll: doesn't show hand 
*** SUMMARY ***
Total pot $0.05 | Rake $0 
Seat 1: Scaaalll (button) collected ($0.05)
Seat 2: Healthys07 (small blind) folded before Flop
Seat 3: Nolimit.208 (big blind) folded before Flop
Seat 4: S3XY_PADRE folded before Flop (didn't bet)
Seat 5: Feliciano16 folded before Flop (didn't bet)
Seat 6: kukulagosleep folded before Flop (didn't bet)



PokerStars Zoom Hand #229232627340:  Hold'em No Limit ($0.01/$0.02) - 2021/08/21 22:58:15 CET [2021/08/21 16:58:15 ET]
Table 'Halley' 6-max Seat #1 is the button
Seat 1: SKV_1985 ($2.25 in chips) 
Seat 2: Xlavariable ($2.34 in chips) 
Seat 3: ziggystarpoker ($0.50 in chips) 
Seat 4: Gek77 ($5.25 in chips) 
Seat 5: Scaaalll ($2.48 in chips) 
Seat 6: AtZ3899 ($2 in chips) 
Xlavariable: posts small blind $0.01
ziggystarpoker: posts big blind $0.02
*** HOLE CARDS ***
Dealt to Scaaalll [3d 9d]
Gek77: raises $0.04 to $0.06
Scaaalll: folds 
AtZ3899: raises $0.15 to $0.21
SKV_1985: folds 
Xlavariable: folds 
ziggystarpoker: folds 
Gek77: folds 
Uncalled bet ($0.15) returned to AtZ3899
ziggystarpoker is disconnected 
AtZ3899 collected $0.15 from pot
AtZ3899: doesn't show hand 
*** SUMMARY ***
Total pot $0.15 | Rake $0 
Seat 1: SKV_1985 (button) folded before Flop (didn't bet)
Seat 2: Xlavariable (small blind) folded before Flop
Seat 3: ziggystarpoker (big blind) folded before Flop
Seat 4: Gek77 folded before Flop
Seat 5: Scaaalll folded before Flop (didn't bet)
Seat 6: AtZ3899 collected ($0.15)



PokerStars Zoom Hand #229232633448:  Hold'em No Limit ($0.01/$0.02) - 2021/08/21 22:58:34 CET [2021/08/21 16:58:34 ET]
Table 'Halley' 6-max Seat #1 is the button
Seat 1: maliniak75 ($1.56 in chips) 
Seat 2: Scaaalll ($2.51 in chips) 
Seat 3: z3317111711 ($1.90 in chips) 
Seat 4: jens 305 ($1.24 in chips) 
Seat 5: Pulp Hands ($1.75 in chips) 
Seat 6: Espartacus5222 ($2.37 in chips) 
Scaaalll: posts small blind $0.01
z3317111711: posts big blind $0.02
*** HOLE CARDS ***
Dealt to Scaaalll [7h Qc]
jens 305: folds 
Pulp Hands: folds 
Espartacus5222: folds 
maliniak75: folds 
Scaaalll: folds 
Uncalled bet ($0.01) returned to z3317111711
z3317111711 collected $0.02 from pot
z3317111711: doesn't show hand 
*** SUMMARY ***
Total pot $0.02 | Rake $0 
Seat 1: maliniak75 (button) folded before Flop (didn't bet)
Seat 2: Scaaalll (small blind) folded before Flop
Seat 3: z3317111711 (big blind) collected ($0.02)
Seat 4: jens 305 folded before Flop (didn't bet)
Seat 5: Pulp Hands folded before Flop (didn't bet)
Seat 6: Espartacus5222 folded before Flop (didn't bet)



PokerStars Zoom Hand #229232636034:  Hold'em No Limit ($0.01/$0.02) - 2021/08/21 22:58:42 CET [2021/08/21 16:58:42 ET]
Table 'Halley' 6-max Seat #1 is the button
Seat 1: Hallyson_23 ($4.94 in chips) 
Seat 2: fishh_play ($2.83 in chips) 
Seat 3: Scaaalll ($2.50 in chips) 
Seat 4: ISBman ($3.86 in chips) 
Seat 5: ash1448 ($3.83 in chips) 
Seat 6: vikasatinova ($1.32 in chips) 
fishh_play: posts small blind $0.01
Scaaalll: posts big blind $0.02
*** HOLE CARDS ***
Dealt to Scaaalll [3h 6d]
vikasatinova is disconnected 
ISBman: folds 
ash1448: folds 
vikasatinova: folds 
Hallyson_23: folds 
fishh_play: folds 
Uncalled bet ($0.01) returned to Scaaalll
Scaaalll collected $0.02 from pot
Scaaalll: doesn't show hand 
*** SUMMARY ***
Total pot $0.02 | Rake $0 
Seat 1: Hallyson_23 (button) folded before Flop (didn't bet)
Seat 2: fishh_play (small blind) folded before Flop
Seat 3: Scaaalll (big blind) collected ($0.02)
Seat 4: ISBman folded before Flop (didn't bet)
Seat 5: ash1448 folded before Flop (didn't bet)
Seat 6: vikasatinova folded before Flop (didn't bet)



PokerStars Zoom Hand #229232639604:  Hold'em No Limit ($0.01/$0.02) - 2021/08/21 22:58:53 CET [2021/08/21 16:58:53 ET]
Table 'Halley' 6-max Seat #1 is the button
Seat 1: WITKOW_AV ($2.56 in chips) 
Seat 2: porkie23 ($1.20 in chips) 
Seat 3: lucksuckdonk ($6.76 in chips) 
Seat 4: Scaaalll ($2.51 in chips) 
Seat 5: MATIdf365 ($2.32 in chips) 
Seat 6: Espartacus5222 ($5.46 in chips) 
porkie23: posts small blind $0.01
lucksuckdonk: posts big blind $0.02
*** HOLE CARDS ***
Dealt to Scaaalll [3h 5s]
Scaaalll: folds 
MATIdf365: folds 
Espartacus5222: folds 
WITKOW_AV: raises $0.03 to $0.05
porkie23: folds 
lucksuckdonk: folds 
Uncalled bet ($0.03) returned to WITKOW_AV
WITKOW_AV collected $0.05 from pot
WITKOW_AV: doesn't show hand 
*** SUMMARY ***
Total pot $0.05 | Rake $0 
Seat 1: WITKOW_AV (button) collected ($0.05)
Seat 2: porkie23 (small blind) folded before Flop
Seat 3: lucksuckdonk (big blind) folded before Flop
Seat 4: Scaaalll folded before Flop (didn't bet)
Seat 5: MATIdf365 folded before Flop (didn't bet)
Seat 6: Espartacus5222 folded before Flop (didn't bet)



PokerStars Zoom Hand #229232634748:  Hold'em No Limit ($0.01/$0.02) - 2021/08/21 22:58:38 CET [2021/08/21 16:58:38 ET]
Table 'Halley' 6-max Seat #1 is the button
Seat 1: Boris_Garich ($2 in chips) 
Seat 2: rekopo203 ($6.51 in chips) 
Seat 3: znak312 ($2 in chips) 
Seat 4: SirBatish ($3.97 in chips) 
Seat 5: SaRCh_Ale ($3.43 in chips) 
Seat 6: Scaaalll ($2.50 in chips) 
rekopo203: posts small blind $0.01
znak312: posts big blind $0.02
*** HOLE CARDS ***
Dealt to Scaaalll [2s 9d]
SirBatish: folds 
SaRCh_Ale: folds 
Scaaalll: folds 
Boris_Garich: raises $0.04 to $0.06
rekopo203: folds 
znak312: calls $0.04
*** FLOP *** [Kh 6d Js]
znak312: checks 
Boris_Garich: checks 
*** TURN *** [Kh 6d Js] [5c]
znak312: checks 
Boris_Garich: bets $0.10
znak312: folds 
Uncalled bet ($0.10) returned to Boris_Garich
Boris_Garich collected $0.13 from pot
Boris_Garich: doesn't show hand 
*** SUMMARY ***
Total pot $0.13 | Rake $0 
Board [Kh 6d Js 5c]
Seat 1: Boris_Garich (button) collected ($0.13)
Seat 2: rekopo203 (small blind) folded before Flop
Seat 3: znak312 (big blind) folded on the Turn
Seat 4: SirBatish folded before Flop (didn't bet)
Seat 5: SaRCh_Ale folded before Flop (didn't bet)
Seat 6: Scaaalll folded before Flop (didn't bet)



PokerStars Zoom Hand #229232641229:  Hold'em No Limit ($0.01/$0.02) - 2021/08/21 22:58:58 CET [2021/08/21 16:58:58 ET]
Table 'Halley' 6-max Seat #1 is the button
Seat 1: Scaaalll ($2.51 in chips) 
Seat 2: Ne0net ($2.06 in chips) 
Seat 3: rekopo203 ($6.50 in chips) 
Seat 4: KonopDima ($2.37 in chips) 
Seat 5: MattieBOZ ($2.01 in chips) 
Seat 6: astapowitsch ($2.19 in chips) 
Ne0net: posts small blind $0.01
rekopo203: posts big blind $0.02
*** HOLE CARDS ***
Dealt to Scaaalll [7c 8s]
KonopDima: folds 
MattieBOZ: raises $0.04 to $0.06
astapowitsch: folds 
Scaaalll: folds 
Ne0net: folds 
rekopo203: folds 
Uncalled bet ($0.04) returned to MattieBOZ
MattieBOZ collected $0.05 from pot
MattieBOZ: doesn't show hand 
*** SUMMARY ***
Total pot $0.05 | Rake $0 
Seat 1: Scaaalll (button) folded before Flop (didn't bet)
Seat 2: Ne0net (small blind) folded before Flop
Seat 3: rekopo203 (big blind) folded before Flop
Seat 4: KonopDima folded before Flop (didn't bet)
Seat 5: MattieBOZ collected ($0.05)
Seat 6: astapowitsch folded before Flop (didn't bet)



PokerStars Zoom Hand #229232644740:  Hold'em No Limit ($0.01/$0.02) - 2021/08/21 22:59:09 CET [2021/08/21 16:59:09 ET]
Table 'Halley' 6-max Seat #1 is the button
Seat 1: Espartacus5222 ($5.46 in chips) 
Seat 2: tisadaisy ($2.26 in chips) 
Seat 3: FabOliveira9 ($2.63 in chips) 
Seat 4: zaharoff74 ($2.17 in chips) 
Seat 5: Scaaalll ($2.51 in chips) 
Seat 6: le_vlimeux ($2.13 in chips) 
tisadaisy: posts small blind $0.01
FabOliveira9: posts big blind $0.02
*** HOLE CARDS ***
Dealt to Scaaalll [4h 2s]
zaharoff74: folds 
Scaaalll: folds 
le_vlimeux: raises $0.02 to $0.04
Espartacus5222: folds 
tisadaisy: folds 
FabOliveira9: folds 
Uncalled bet ($0.02) returned to le_vlimeux
le_vlimeux collected $0.05 from pot
le_vlimeux: doesn't show hand 
*** SUMMARY ***
Total pot $0.05 | Rake $0 
Seat 1: Espartacus5222 (button) folded before Flop (didn't bet)
Seat 2: tisadaisy (small blind) folded before Flop
Seat 3: FabOliveira9 (big blind) folded before Flop
Seat 4: zaharoff74 folded before Flop (didn't bet)
Seat 5: Scaaalll folded before Flop (didn't bet)
Seat 6: le_vlimeux collected ($0.05)



PokerStars Zoom Hand #229232646392:  Hold'em No Limit ($0.01/$0.02) - 2021/08/21 22:59:14 CET [2021/08/21 16:59:14 ET]
Table 'Halley' 6-max Seat #1 is the button
Seat 1: innexplus ($4.32 in chips) 
Seat 2: Scaaalll ($2.51 in chips) 
Seat 3: causavera ($1.63 in chips) 
Seat 4: Attention1909 ($2.09 in chips) 
Seat 5: CordiPS ($5.27 in chips) 
Seat 6: felipeciji ($2.03 in chips) 
Scaaalll: posts small blind $0.01
causavera: posts big blind $0.02
*** HOLE CARDS ***
Dealt to Scaaalll [Kh Ks]
Attention1909: folds 
CordiPS: folds 
Attention1909 is disconnected 
felipeciji: folds 
innexplus: folds 
Scaaalll: raises $0.04 to $0.06
causavera: calls $0.04
*** FLOP *** [4d Th 8h]
Scaaalll: bets $0.08
causavera: calls $0.08
*** TURN *** [4d Th 8h] [Kd]
Scaaalll: bets $0.18
causavera: folds 
Uncalled bet ($0.18) returned to Scaaalll
Scaaalll collected $0.27 from pot
Scaaalll: doesn't show hand 
*** SUMMARY ***
Total pot $0.28 | Rake $0.01 
Board [4d Th 8h Kd]
Seat 1: innexplus (button) folded before Flop (didn't bet)
Seat 2: Scaaalll (small blind) collected ($0.27)
Seat 3: causavera (big blind) folded on the Turn
Seat 4: Attention1909 folded before Flop (didn't bet)
Seat 5: CordiPS folded before Flop (didn't bet)
Seat 6: felipeciji folded before Flop (didn't bet)



PokerStars Zoom Hand #229232655746:  Hold'em No Limit ($0.01/$0.02) - 2021/08/21 22:59:43 CET [2021/08/21 16:59:43 ET]
Table 'Halley' 6-max Seat #1 is the button
Seat 1: MEZz828 ($1.92 in chips) 
Seat 2: Koldun 2636 ($2.87 in chips) 
Seat 3: NoEff0rt2w1n ($2.26 in chips) 
Seat 4: Andnet ($2.59 in chips) 
Seat 5: i.m.bluffing002 ($2.20 in chips) 
Seat 6: Scaaalll ($2.64 in chips) 
Koldun 2636: posts small blind $0.01
NoEff0rt2w1n: posts big blind $0.02
*** HOLE CARDS ***
Dealt to Scaaalll [As 5s]
Andnet: folds 
i.m.bluffing002: raises $0.04 to $0.06
Scaaalll: calls $0.06
MEZz828: folds 
Koldun 2636: folds 
NoEff0rt2w1n: calls $0.04
*** FLOP *** [8c 9h Kd]
NoEff0rt2w1n: checks 
i.m.bluffing002: checks 
Scaaalll: checks 
*** TURN *** [8c 9h Kd] [Ad]
NoEff0rt2w1n: checks 
i.m.bluffing002: checks 
Scaaalll: bets $0.07
NoEff0rt2w1n: calls $0.07
i.m.bluffing002: calls $0.07
*** RIVER *** [8c 9h Kd Ad] [6d]
NoEff0rt2w1n: checks 
i.m.bluffing002: checks 
Scaaalll: checks 
*** SHOW DOWN ***
NoEff0rt2w1n: shows [4d 2d] (a flush, Ace high)
i.m.bluffing002: mucks hand 
Scaaalll: mucks hand 
NoEff0rt2w1n collected $0.39 from pot
*** SUMMARY ***
Total pot $0.40 | Rake $0.01 
Board [8c 9h Kd Ad 6d]
Seat 1: MEZz828 (button) folded before Flop (didn't bet)
Seat 2: Koldun 2636 (small blind) folded before Flop
Seat 3: NoEff0rt2w1n (big blind) showed [4d 2d] and won ($0.39) with a flush, Ace high
Seat 4: Andnet folded before Flop (didn't bet)
Seat 5: i.m.bluffing002 mucked [Ac Th]
Seat 6: Scaaalll mucked [As 5s]



PokerStars Zoom Hand #229232672586:  Hold'em No Limit ($0.01/$0.02) - 2021/08/21 23:00:33 CET [2021/08/21 17:00:33 ET]
Table 'Halley' 6-max Seat #1 is the button
Seat 1: fishh_play ($4.99 in chips) 
Seat 2: NoEff0rt2w1n ($2.52 in chips) 
Seat 3: orlovac1995 ($4.27 in chips) 
Seat 4: znak312 ($2.10 in chips) 
Seat 5: Scaaalll ($2.51 in chips) 
Seat 6: TTGemi ($2 in chips) 
NoEff0rt2w1n: posts small blind $0.01
orlovac1995: posts big blind $0.02
*** HOLE CARDS ***
Dealt to Scaaalll [Ks Ah]
znak312: folds 
Scaaalll: raises $0.04 to $0.06
TTGemi: folds 
fishh_play: calls $0.06
NoEff0rt2w1n: folds 
orlovac1995: calls $0.04
*** FLOP *** [8s 3s 3d]
orlovac1995: checks 
Scaaalll: bets $0.11
fishh_play: calls $0.11
orlovac1995: calls $0.11
*** TURN *** [8s 3s 3d] [Tc]
orlovac1995: checks 
Scaaalll: checks 
fishh_play: checks 
*** RIVER *** [8s 3s 3d Tc] [8d]
orlovac1995: checks 
Scaaalll: checks 
fishh_play: bets $0.42
orlovac1995: folds 
Scaaalll: folds 
Uncalled bet ($0.42) returned to fishh_play
fishh_play collected $0.50 from pot
fishh_play: doesn't show hand 
*** SUMMARY ***
Total pot $0.52 | Rake $0.02 
Board [8s 3s 3d Tc 8d]
Seat 1: fishh_play (button) collected ($0.50)
Seat 2: NoEff0rt2w1n (small blind) folded before Flop
Seat 3: orlovac1995 (big blind) folded on the River
Seat 4: znak312 folded before Flop (didn't bet)
Seat 5: Scaaalll folded on the River
Seat 6: TTGemi folded before Flop (didn't bet)



PokerStars Zoom Hand #229232694074:  Hold'em No Limit ($0.01/$0.02) - 2021/08/21 23:01:28 CET [2021/08/21 17:01:28 ET]
Table 'Halley' 6-max Seat #1 is the button
Seat 1: anes.v. ($2.69 in chips) 
Seat 2: AXXILLES ($3.88 in chips) 
Seat 3: CrazyyParis ($2 in chips) 
Seat 4: Scaaalll ($2.34 in chips) 
Seat 5: Mr.Kurier ($1.96 in chips) 
Seat 6: 48159348 ($5.81 in chips) 
AXXILLES: posts small blind $0.01
CrazyyParis: posts big blind $0.02
*** HOLE CARDS ***
Dealt to Scaaalll [Jd 3s]
Scaaalll: folds 
Mr.Kurier: folds 
48159348: folds 
anes.v.: folds 
AXXILLES: folds 
Uncalled bet ($0.01) returned to CrazyyParis
CrazyyParis collected $0.02 from pot
CrazyyParis: doesn't show hand 
*** SUMMARY ***
Total pot $0.02 | Rake $0 
Seat 1: anes.v. (button) folded before Flop (didn't bet)
Seat 2: AXXILLES (small blind) folded before Flop
Seat 3: CrazyyParis (big blind) collected ($0.02)
Seat 4: Scaaalll folded before Flop (didn't bet)
Seat 5: Mr.Kurier folded before Flop (didn't bet)
Seat 6: 48159348 folded before Flop (didn't bet)



PokerStars Zoom Hand #229232695682:  Hold'em No Limit ($0.01/$0.02) - 2021/08/21 23:01:32 CET [2021/08/21 17:01:32 ET]
Table 'Halley' 6-max Seat #1 is the button
Seat 1: maliniak75 ($2.45 in chips) 
Seat 2: lucksuckdonk ($4.51 in chips) 
Seat 3: Scaaalll ($2.34 in chips) 
Seat 4: schrumpeI_ ($1.61 in chips) 
Seat 5: oleg12312441 ($0.80 in chips) 
Seat 6: Herr.Hikke ($2.82 in chips) 
lucksuckdonk: posts small blind $0.01
Scaaalll: posts big blind $0.02
*** HOLE CARDS ***
Dealt to Scaaalll [4h 8s]
oleg12312441 is disconnected 
schrumpeI_: folds 
oleg12312441: folds 
schrumpeI_ is disconnected 
Herr.Hikke: folds 
maliniak75: folds 
lucksuckdonk: folds 
Uncalled bet ($0.01) returned to Scaaalll
Scaaalll collected $0.02 from pot
Scaaalll: doesn't show hand 
*** SUMMARY ***
Total pot $0.02 | Rake $0 
Seat 1: maliniak75 (button) folded before Flop (didn't bet)
Seat 2: lucksuckdonk (small blind) folded before Flop
Seat 3: Scaaalll (big blind) collected ($0.02)
Seat 4: schrumpeI_ folded before Flop (didn't bet)
Seat 5: oleg12312441 folded before Flop (didn't bet)
Seat 6: Herr.Hikke folded before Flop (didn't bet)



PokerStars Zoom Hand #229232704498:  Hold'em No Limit ($0.01/$0.02) - 2021/08/21 23:01:53 CET [2021/08/21 17:01:53 ET]
Table 'Halley' 6-max Seat #1 is the button
Seat 1: Scaaalll ($2.34 in chips) 
Seat 2: newen83 ($2.32 in chips) 
Seat 3: HubertFroh ($2.01 in chips) 
Seat 4: bugib1 ($2.12 in chips) 
Seat 5: nitzed12 ($2.17 in chips) 
Seat 6: Gamer577 ($3.55 in chips) 
newen83: posts small blind $0.01
HubertFroh: posts big blind $0.02
*** HOLE CARDS ***
Dealt to Scaaalll [Ts 5h]
bugib1: folds 
newen83 is disconnected 
nitzed12: folds 
Gamer577: folds 
Scaaalll: folds 
newen83: folds 
Uncalled bet ($0.01) returned to HubertFroh
HubertFroh collected $0.02 from pot
HubertFroh: doesn't show hand 
*** SUMMARY ***
Total pot $0.02 | Rake $0 
Seat 1: Scaaalll (button) folded before Flop (didn't bet)
Seat 2: newen83 (small blind) folded before Flop
Seat 3: HubertFroh (big blind) collected ($0.02)
Seat 4: bugib1 folded before Flop (didn't bet)
Seat 5: nitzed12 folded before Flop (didn't bet)
Seat 6: Gamer577 folded before Flop (didn't bet)



PokerStars Zoom Hand #229232706350:  Hold'em No Limit ($0.01/$0.02) - 2021/08/21 23:01:57 CET [2021/08/21 17:01:57 ET]
Table 'Halley' 6-max Seat #1 is the button
Seat 1: Gamer577 ($3.55 in chips) 
Seat 2: guciogks64 ($3.09 in chips) 
Seat 3: CordiPS ($5.01 in chips) 
Seat 4: Scaaalll ($2.34 in chips) 
Seat 5: AtZ3899 ($0.82 in chips) 
Seat 6: kumanotiger ($1.70 in chips) 
guciogks64: posts small blind $0.01
CordiPS: posts big blind $0.02
*** HOLE CARDS ***
Dealt to Scaaalll [Qh Td]
Scaaalll: folds 
AtZ3899: raises $0.04 to $0.06
kumanotiger: folds 
Gamer577: folds 
guciogks64: folds 
CordiPS: folds 
Uncalled bet ($0.04) returned to AtZ3899
AtZ3899 collected $0.05 from pot
AtZ3899: doesn't show hand 
*** SUMMARY ***
Total pot $0.05 | Rake $0 
Seat 1: Gamer577 (button) folded before Flop (didn't bet)
Seat 2: guciogks64 (small blind) folded before Flop
Seat 3: CordiPS (big blind) folded before Flop
Seat 4: Scaaalll folded before Flop (didn't bet)
Seat 5: AtZ3899 collected ($0.05)
Seat 6: kumanotiger folded before Flop (didn't bet)



PokerStars Zoom Hand #229232707942:  Hold'em No Limit ($0.01/$0.02) - 2021/08/21 23:02:01 CET [2021/08/21 17:02:01 ET]
Table 'Halley' 6-max Seat #1 is the button
Seat 1: F_oksi(BLR) ($4.32 in chips) 
Seat 2: Mac9Monty2 ($2 in chips) 
Seat 3: Gamer577 ($2.11 in chips) 
Seat 4: EevAA190 ($2.04 in chips) 
Seat 5: Scaaalll ($2.34 in chips) 
Seat 6: vovan100157 ($2.40 in chips) 
Mac9Monty2: posts small blind $0.01
Gamer577: posts big blind $0.02
*** HOLE CARDS ***
Dealt to Scaaalll [3h Td]
EevAA190: folds 
Scaaalll: folds 
vovan100157: folds 
F_oksi(BLR): folds 
Mac9Monty2: folds 
Uncalled bet ($0.01) returned to Gamer577
Gamer577 collected $0.02 from pot
Gamer577: doesn't show hand 
*** SUMMARY ***
Total pot $0.02 | Rake $0 
Seat 1: F_oksi(BLR) (button) folded before Flop (didn't bet)
Seat 2: Mac9Monty2 (small blind) folded before Flop
Seat 3: Gamer577 (big blind) collected ($0.02)
Seat 4: EevAA190 folded before Flop (didn't bet)
Seat 5: Scaaalll folded before Flop (didn't bet)
Seat 6: vovan100157 folded before Flop (didn't bet)



PokerStars Zoom Hand #229232701204:  Hold'em No Limit ($0.01/$0.02) - 2021/08/21 23:01:45 CET [2021/08/21 17:01:45 ET]
Table 'Halley' 6-max Seat #1 is the button
Seat 1: abbadol ($0.76 in chips) 
Seat 2: Scaaalll ($2.35 in chips) 
Seat 3: Leonpy92 ($2.58 in chips) 
Seat 4: AlexGTPS ($4.31 in chips) 
Seat 5: derry,me ($3.75 in chips) 
Seat 6: Ramirres ($2.17 in chips) 
Scaaalll: posts small blind $0.01
Leonpy92: posts big blind $0.02
*** HOLE CARDS ***
Dealt to Scaaalll [Qh 6c]
AlexGTPS: folds 
derry,me: folds 
derry,me is disconnected 
Ramirres: folds 
abbadol: calls $0.02
Scaaalll: folds 
Leonpy92: checks 
*** FLOP *** [8c 2h 7s]
Leonpy92: checks 
abbadol: checks 
*** TURN *** [8c 2h 7s] [Tc]
Leonpy92: bets $0.03
abbadol: calls $0.03
*** RIVER *** [8c 2h 7s Tc] [Kc]
Leonpy92: checks 
abbadol: checks 
*** SHOW DOWN ***
Leonpy92: shows [5s Jh] (high card King)
abbadol: shows [Ad Qd] (high card Ace)
abbadol collected $0.11 from pot
*** SUMMARY ***
Total pot $0.11 | Rake $0 
Board [8c 2h 7s Tc Kc]
Seat 1: abbadol (button) showed [Ad Qd] and won ($0.11) with high card Ace
Seat 2: Scaaalll (small blind) folded before Flop
Seat 3: Leonpy92 (big blind) showed [5s Jh] and lost with high card King
Seat 4: AlexGTPS folded before Flop (didn't bet)
Seat 5: derry,me folded before Flop (didn't bet)
Seat 6: Ramirres folded before Flop (didn't bet)



PokerStars Zoom Hand #229232711752:  Hold'em No Limit ($0.01/$0.02) - 2021/08/21 23:02:10 CET [2021/08/21 17:02:10 ET]
Table 'Halley' 6-max Seat #1 is the button
Seat 1: maressen ($2.09 in chips) 
Seat 2: Billy Beane1 ($2.23 in chips) 
Seat 3: Scaaalll ($2.34 in chips) 
Seat 4: Gamer577 ($5.65 in chips) 
Seat 5: T-saitama ($2.10 in chips) 
Seat 6: castrosis ($1.97 in chips) 
Billy Beane1: posts small blind $0.01
Scaaalll: posts big blind $0.02
*** HOLE CARDS ***
Dealt to Scaaalll [Jd 6c]
Gamer577: folds 
T-saitama: folds 
castrosis: folds 
maressen has timed out
maressen: folds 
Billy Beane1: raises $0.03 to $0.05
Scaaalll: folds 
Uncalled bet ($0.03) returned to Billy Beane1
Billy Beane1 collected $0.04 from pot
Billy Beane1: doesn't show hand 
*** SUMMARY ***
Total pot $0.04 | Rake $0 
Seat 1: maressen (button) folded before Flop (didn't bet)
Seat 2: Billy Beane1 (small blind) collected ($0.04)
Seat 3: Scaaalll (big blind) folded before Flop
Seat 4: Gamer577 folded before Flop (didn't bet)
Seat 5: T-saitama folded before Flop (didn't bet)
Seat 6: castrosis folded before Flop (didn't bet)



PokerStars Zoom Hand #229232702924:  Hold'em No Limit ($0.01/$0.02) - 2021/08/21 23:01:49 CET [2021/08/21 17:01:49 ET]
Table 'Halley' 6-max Seat #1 is the button
Seat 1: Thaleshs ($3.78 in chips) 
Seat 2: AlexGTPS ($4.31 in chips) 
Seat 3: KonopDima ($2.50 in chips) 
Seat 4: lackymad ($0.97 in chips) 
Seat 5: MsSuffolk ($2.47 in chips) 
Seat 6: Scaaalll ($2.34 in chips) 
AlexGTPS: posts small blind $0.01
KonopDima: posts big blind $0.02
*** HOLE CARDS ***
Dealt to Scaaalll [8s 4c]
lackymad: raises $0.02 to $0.04
MsSuffolk: folds 
Scaaalll: folds 
Thaleshs: raises $0.08 to $0.12
AlexGTPS: folds 
KonopDima: calls $0.10
lackymad: raises $0.37 to $0.49
Thaleshs: raises $3.29 to $3.78 and is all-in
KonopDima: folds 
lackymad: calls $0.48 and is all-in
Uncalled bet ($2.81) returned to Thaleshs
*** FLOP *** [3d Qc 4h]
*** TURN *** [3d Qc 4h] [4s]
*** RIVER *** [3d Qc 4h 4s] [5s]
*** SHOW DOWN ***
lackymad: shows [Th As] (a pair of Fours)
Thaleshs: shows [Ad Ac] (two pair, Aces and Fours)
Thaleshs collected $2 from pot
*** SUMMARY ***
Total pot $2.07 | Rake $0.07 
Board [3d Qc 4h 4s 5s]
Seat 1: Thaleshs (button) showed [Ad Ac] and won ($2) with two pair, Aces and Fours
Seat 2: AlexGTPS (small blind) folded before Flop
Seat 3: KonopDima (big blind) folded before Flop
Seat 4: lackymad showed [Th As] and lost with a pair of Fours
Seat 5: MsSuffolk folded before Flop (didn't bet)
Seat 6: Scaaalll folded before Flop (didn't bet)



PokerStars Zoom Hand #229232725045:  Hold'em No Limit ($0.01/$0.02) - 2021/08/21 23:02:40 CET [2021/08/21 17:02:40 ET]
Table 'Halley' 6-max Seat #1 is the button
Seat 1: CordiPS ($3.11 in chips) 
Seat 2: Scaaalll ($2.32 in chips) 
Seat 3: keb1981 ($2.04 in chips) 
Seat 4: Apollonnn_13 ($1.71 in chips) 
Seat 5: alphabeta1d ($2.01 in chips) 
Seat 6: GrindToGlory ($2.02 in chips) 
Scaaalll: posts small blind $0.01
keb1981: posts big blind $0.02
*** HOLE CARDS ***
Dealt to Scaaalll [8c 2c]
Apollonnn_13: raises $0.04 to $0.06
alphabeta1d: folds 
GrindToGlory: folds 
CordiPS: folds 
Scaaalll: folds 
keb1981: folds 
Uncalled bet ($0.04) returned to Apollonnn_13
Apollonnn_13 collected $0.05 from pot
Apollonnn_13: doesn't show hand 
*** SUMMARY ***
Total pot $0.05 | Rake $0 
Seat 1: CordiPS (button) folded before Flop (didn't bet)
Seat 2: Scaaalll (small blind) folded before Flop
Seat 3: keb1981 (big blind) folded before Flop
Seat 4: Apollonnn_13 collected ($0.05)
Seat 5: alphabeta1d folded before Flop (didn't bet)
Seat 6: GrindToGlory folded before Flop (didn't bet)



PokerStars Zoom Hand #229232723347:  Hold'em No Limit ($0.01/$0.02) - 2021/08/21 23:02:36 CET [2021/08/21 17:02:36 ET]
Table 'Halley' 6-max Seat #1 is the button
Seat 1: Scaaalll ($2.32 in chips) 
Seat 2: STE1NBERG ($2.13 in chips) 
Seat 3: Gamer577 ($2.11 in chips) 
Seat 4: Ruben-M. PY ($1.21 in chips) 
Seat 5: KonopDima ($2.55 in chips) 
Seat 6: CrazyyParis ($2 in chips) 
STE1NBERG: posts small blind $0.01
Gamer577: posts big blind $0.02
*** HOLE CARDS ***
Dealt to Scaaalll [2d 7c]
Ruben-M. PY: folds 
KonopDima: folds 
CrazyyParis: raises $0.03 to $0.05
Scaaalll: folds 
STE1NBERG: folds 
Gamer577: folds 
Uncalled bet ($0.03) returned to CrazyyParis
CrazyyParis collected $0.05 from pot
CrazyyParis: doesn't show hand 
*** SUMMARY ***
Total pot $0.05 | Rake $0 
Seat 1: Scaaalll (button) folded before Flop (didn't bet)
Seat 2: STE1NBERG (small blind) folded before Flop
Seat 3: Gamer577 (big blind) folded before Flop
Seat 4: Ruben-M. PY folded before Flop (didn't bet)
Seat 5: KonopDima folded before Flop (didn't bet)
Seat 6: CrazyyParis collected ($0.05)



PokerStars Zoom Hand #229232726819:  Hold'em No Limit ($0.01/$0.02) - 2021/08/21 23:02:44 CET [2021/08/21 17:02:44 ET]
Table 'Halley' 6-max Seat #1 is the button
Seat 1: Wegezin ($2.20 in chips) 
Seat 2: Posaunengodi ($2.97 in chips) 
Seat 3: yal.AnToJKe ($1.21 in chips) 
Seat 4: Sv1ch ($1.87 in chips) 
Seat 5: causavera ($1.27 in chips) 
Seat 6: Scaaalll ($2.31 in chips) 
Posaunengodi: posts small blind $0.01
yal.AnToJKe: posts big blind $0.02
*** HOLE CARDS ***
Dealt to Scaaalll [Kc Js]
Sv1ch: folds 
causavera: folds 
Scaaalll: raises $0.04 to $0.06
Wegezin: folds 
Posaunengodi: folds 
yal.AnToJKe: calls $0.04
*** FLOP *** [8h 8c 2s]
yal.AnToJKe: checks 
Scaaalll: checks 
*** TURN *** [8h 8c 2s] [7s]
yal.AnToJKe: checks 
Scaaalll: checks 
*** RIVER *** [8h 8c 2s 7s] [Ks]
yal.AnToJKe: checks 
Scaaalll: bets $0.09
yal.AnToJKe: folds 
Uncalled bet ($0.09) returned to Scaaalll
Scaaalll collected $0.13 from pot
Scaaalll: doesn't show hand 
*** SUMMARY ***
Total pot $0.13 | Rake $0 
Board [8h 8c 2s 7s Ks]
Seat 1: Wegezin (button) folded before Flop (didn't bet)
Seat 2: Posaunengodi (small blind) folded before Flop
Seat 3: yal.AnToJKe (big blind) folded on the River
Seat 4: Sv1ch folded before Flop (didn't bet)
Seat 5: causavera folded before Flop (didn't bet)
Seat 6: Scaaalll collected ($0.13)



PokerStars Zoom Hand #229232741622:  Hold'em No Limit ($0.01/$0.02) - 2021/08/21 23:03:18 CET [2021/08/21 17:03:18 ET]
Table 'Halley' 6-max Seat #1 is the button
Seat 1: Scaaalll ($2.38 in chips) 
Seat 2: Taran0001 ($0.68 in chips) 
Seat 3: abbadol ($0.82 in chips) 
Seat 4: PapiMik3 ($5.84 in chips) 
Seat 5: Yangyang1407 ($2.22 in chips) 
Seat 6: Revairo ($3.62 in chips) 
Taran0001: posts small blind $0.01
abbadol: posts big blind $0.02
*** HOLE CARDS ***
Dealt to Scaaalll [9s 6s]
PapiMik3: folds 
Yangyang1407: folds 
Revairo: calls $0.02
Scaaalll: raises $0.07 to $0.09
Taran0001: calls $0.08
abbadol: folds 
Revairo: calls $0.07
*** FLOP *** [Kd Qs 3s]
Taran0001: checks 
Revairo: bets $0.10
Scaaalll: calls $0.10
Taran0001: calls $0.10
*** TURN *** [Kd Qs 3s] [4s]
Taran0001: checks 
Revairo: bets $0.10
Scaaalll: calls $0.10
Taran0001: folds 
*** RIVER *** [Kd Qs 3s 4s] [5c]
Revairo: checks 
Scaaalll: bets $0.58
Revairo: calls $0.58
*** SHOW DOWN ***
Scaaalll: shows [9s 6s] (a flush, Queen high)
Revairo: mucks hand 
Scaaalll collected $1.86 from pot
*** SUMMARY ***
Total pot $1.95 | Rake $0.09 
Board [Kd Qs 3s 4s 5c]
Seat 1: Scaaalll (button) showed [9s 6s] and won ($1.86) with a flush, Queen high
Seat 2: Taran0001 (small blind) folded on the Turn
Seat 3: abbadol (big blind) folded before Flop
Seat 4: PapiMik3 folded before Flop (didn't bet)
Seat 5: Yangyang1407 folded before Flop (didn't bet)
Seat 6: Revairo mucked [Th Qh]



PokerStars Zoom Hand #229232772885:  Hold'em No Limit ($0.01/$0.02) - 2021/08/21 23:04:29 CET [2021/08/21 17:04:29 ET]
Table 'Halley' 6-max Seat #1 is the button
Seat 1: yu-guncasi ($2.87 in chips) 
Seat 2: Apollonnn_13 ($1.78 in chips) 
Seat 3: GVMELLO ($2 in chips) 
Seat 4: rpycmbEM ($3.43 in chips) 
Seat 5: Scaaalll ($3.37 in chips) 
Seat 6: Feliciano16 ($7.71 in chips) 
Apollonnn_13: posts small blind $0.01
GVMELLO: posts big blind $0.02
*** HOLE CARDS ***
Dealt to Scaaalll [Td 4d]
rpycmbEM: folds 
Scaaalll: folds 
Feliciano16: folds 
yu-guncasi: folds 
Apollonnn_13: folds 
Uncalled bet ($0.01) returned to GVMELLO
yu-guncasi is disconnected 
GVMELLO collected $0.02 from pot
GVMELLO: doesn't show hand 
*** SUMMARY ***
Total pot $0.02 | Rake $0 
Seat 1: yu-guncasi (button) folded before Flop (didn't bet)
Seat 2: Apollonnn_13 (small blind) folded before Flop
Seat 3: GVMELLO (big blind) collected ($0.02)
Seat 4: rpycmbEM folded before Flop (didn't bet)
Seat 5: Scaaalll folded before Flop (didn't bet)
Seat 6: Feliciano16 folded before Flop (didn't bet)



PokerStars Zoom Hand #229232775052:  Hold'em No Limit ($0.01/$0.02) - 2021/08/21 23:04:34 CET [2021/08/21 17:04:34 ET]
Table 'Halley' 6-max Seat #1 is the button
Seat 1: rekopo203 ($6.41 in chips) 
Seat 2: fishh_play ($4.08 in chips) 
Seat 3: Scaaalll ($3.37 in chips) 
Seat 4: Fanatspartak ($1.51 in chips) 
Seat 5: Colby1771 ($3.74 in chips) 
Seat 6: Pulp Hands ($1.55 in chips) 
fishh_play: posts small blind $0.01
Scaaalll: posts big blind $0.02
*** HOLE CARDS ***
Dealt to Scaaalll [8c 8h]
Fanatspartak: folds 
Colby1771: folds 
Pulp Hands: folds 
rekopo203: folds 
fishh_play: raises $0.05 to $0.07
Scaaalll: calls $0.05
*** FLOP *** [9s 3c Kc]
fishh_play: bets $0.08
Scaaalll: calls $0.08
*** TURN *** [9s 3c Kc] [7d]
fishh_play: bets $0.17
Scaaalll: calls $0.17
*** RIVER *** [9s 3c Kc 7d] [Qs]
fishh_play: checks 
Scaaalll: checks 
*** SHOW DOWN ***
fishh_play: shows [Ac 3s] (a pair of Threes)
Scaaalll: shows [8c 8h] (a pair of Eights)
Scaaalll collected $0.62 from pot
*** SUMMARY ***
Total pot $0.64 | Rake $0.02 
Board [9s 3c Kc 7d Qs]
Seat 1: rekopo203 (button) folded before Flop (didn't bet)
Seat 2: fishh_play (small blind) showed [Ac 3s] and lost with a pair of Threes
Seat 3: Scaaalll (big blind) showed [8c 8h] and won ($0.62) with a pair of Eights
Seat 4: Fanatspartak folded before Flop (didn't bet)
Seat 5: Colby1771 folded before Flop (didn't bet)
Seat 6: Pulp Hands folded before Flop (didn't bet)



PokerStars Zoom Hand #229232792632:  Hold'em No Limit ($0.01/$0.02) - 2021/08/21 23:05:14 CET [2021/08/21 17:05:14 ET]
Table 'Halley' 6-max Seat #1 is the button
Seat 1: Daiting1 ($1.89 in chips) 
Seat 2: xxVanquishxx ($15.01 in chips) 
Seat 3: z3317111711 ($1.99 in chips) 
Seat 4: Scaaalll ($3.67 in chips) 
Seat 5: _TsarukV_12 ($7.29 in chips) 
Seat 6: nitzed12 ($2.51 in chips) 
xxVanquishxx: posts small blind $0.01
z3317111711: posts big blind $0.02
*** HOLE CARDS ***
Dealt to Scaaalll [5c 8d]
_TsarukV_12 is disconnected 
Scaaalll: folds 
_TsarukV_12: folds 
nitzed12: folds 
Daiting1: folds 
xxVanquishxx: folds 
Uncalled bet ($0.01) returned to z3317111711
z3317111711 collected $0.02 from pot
z3317111711: doesn't show hand 
*** SUMMARY ***
Total pot $0.02 | Rake $0 
Seat 1: Daiting1 (button) folded before Flop (didn't bet)
Seat 2: xxVanquishxx (small blind) folded before Flop
Seat 3: z3317111711 (big blind) collected ($0.02)
Seat 4: Scaaalll folded before Flop (didn't bet)
Seat 5: _TsarukV_12 folded before Flop (didn't bet)
Seat 6: nitzed12 folded before Flop (didn't bet)



PokerStars Zoom Hand #229232794804:  Hold'em No Limit ($0.01/$0.02) - 2021/08/21 23:05:19 CET [2021/08/21 17:05:19 ET]
Table 'Halley' 6-max Seat #1 is the button
Seat 1: le_vlimeux ($2.35 in chips) 
Seat 2: Scaaalll ($3.67 in chips) 
Seat 3: polymorhp ($3.79 in chips) 
Seat 4: AXXILLES ($3.29 in chips) 
Seat 5: ASAjr ($2.79 in chips) 
Seat 6: Ck@tih@ ($1.76 in chips) 
Scaaalll: posts small blind $0.01
polymorhp: posts big blind $0.02
*** HOLE CARDS ***
Dealt to Scaaalll [Kc Tc]
AXXILLES: folds 
ASAjr: folds 
Ck@tih@ has timed out
Ck@tih@: folds 
le_vlimeux: raises $0.02 to $0.04
Scaaalll: calls $0.03
polymorhp: folds 
*** FLOP *** [5d Th 7s]
Scaaalll: checks 
le_vlimeux: bets $0.04
Scaaalll: calls $0.04
*** TURN *** [5d Th 7s] [7c]
Scaaalll: checks 
le_vlimeux: bets $0.10
Scaaalll: calls $0.10
*** RIVER *** [5d Th 7s 7c] [6s]
Scaaalll: checks 
le_vlimeux: checks 
*** SHOW DOWN ***
Scaaalll: shows [Kc Tc] (two pair, Tens and Sevens)
le_vlimeux: mucks hand 
Scaaalll collected $0.37 from pot
*** SUMMARY ***
Total pot $0.38 | Rake $0.01 
Board [5d Th 7s 7c 6s]
Seat 1: le_vlimeux (button) mucked [Ks Qh]
Seat 2: Scaaalll (small blind) showed [Kc Tc] and won ($0.37) with two pair, Tens and Sevens
Seat 3: polymorhp (big blind) folded before Flop
Seat 4: AXXILLES folded before Flop (didn't bet)
Seat 5: ASAjr folded before Flop (didn't bet)
Seat 6: Ck@tih@ folded before Flop (didn't bet)



PokerStars Zoom Hand #229232822032:  Hold'em No Limit ($0.01/$0.02) - 2021/08/21 23:06:21 CET [2021/08/21 17:06:21 ET]
Table 'Halley' 6-max Seat #1 is the button
Seat 1: znak312 ($2 in chips) 
Seat 2: RaulacateFolds ($2.76 in chips) 
Seat 3: squidy4 ($3.37 in chips) 
Seat 4: Scaaalll ($3.86 in chips) 
Seat 5: olga3021221 ($2.29 in chips) 
Seat 6: auxy89 ($3.47 in chips) 
RaulacateFolds: posts small blind $0.01
squidy4: posts big blind $0.02
*** HOLE CARDS ***
Dealt to Scaaalll [8c Td]
Scaaalll: folds 
olga3021221: folds 
auxy89: raises $0.04 to $0.06
znak312: folds 
RaulacateFolds: folds 
squidy4: folds 
Uncalled bet ($0.04) returned to auxy89
auxy89 collected $0.05 from pot
auxy89: doesn't show hand 
squidy4 is disconnected 
*** SUMMARY ***
Total pot $0.05 | Rake $0 
Seat 1: znak312 (button) folded before Flop (didn't bet)
Seat 2: RaulacateFolds (small blind) folded before Flop
Seat 3: squidy4 (big blind) folded before Flop
Seat 4: Scaaalll folded before Flop (didn't bet)
Seat 5: olga3021221 folded before Flop (didn't bet)
Seat 6: auxy89 collected ($0.05)



PokerStars Zoom Hand #229232823800:  Hold'em No Limit ($0.01/$0.02) - 2021/08/21 23:06:25 CET [2021/08/21 17:06:25 ET]
Table 'Halley' 6-max Seat #1 is the button
Seat 1: Axel201388 ($1.28 in chips) 
Seat 2: OFSHOR ($3.26 in chips) 
Seat 3: Scaaalll ($3.86 in chips) 
Seat 4: GregHarrison ($0.98 in chips) 
Seat 5: Meskalita ($2 in chips) 
Seat 6: juan24655 ($1.28 in chips) 
OFSHOR: posts small blind $0.01
Scaaalll: posts big blind $0.02
*** HOLE CARDS ***
Dealt to Scaaalll [2h 6c]
GregHarrison: folds 
Meskalita: folds 
juan24655: folds 
GregHarrison is disconnected 
Axel201388: raises $0.04 to $0.06
OFSHOR: folds 
Scaaalll: folds 
Uncalled bet ($0.04) returned to Axel201388
Axel201388 collected $0.05 from pot
Axel201388: doesn't show hand 
*** SUMMARY ***
Total pot $0.05 | Rake $0 
Seat 1: Axel201388 (button) collected ($0.05)
Seat 2: OFSHOR (small blind) folded before Flop
Seat 3: Scaaalll (big blind) folded before Flop
Seat 4: GregHarrison folded before Flop (didn't bet)
Seat 5: Meskalita folded before Flop (didn't bet)
Seat 6: juan24655 folded before Flop (didn't bet)



PokerStars Zoom Hand #229232818590:  Hold'em No Limit ($0.01/$0.02) - 2021/08/21 23:06:13 CET [2021/08/21 17:06:13 ET]
Table 'Halley' 6-max Seat #1 is the button
Seat 1: EevAA190 ($2 in chips) 
Seat 2: PapiMik3 ($6.21 in chips) 
Seat 3: Fanatspartak ($1.09 in chips) 
Seat 4: xxRoseIloveu ($9.22 in chips) 
Seat 5: bananAAbandit ($7.64 in chips) 
Seat 6: Scaaalll ($3.86 in chips) 
PapiMik3: posts small blind $0.01
Fanatspartak: posts big blind $0.02
*** HOLE CARDS ***
Dealt to Scaaalll [7s 8h]
xxRoseIloveu: raises $0.04 to $0.06
bananAAbandit: folds 
Scaaalll: folds 
EevAA190: folds 
PapiMik3: raises $0.14 to $0.20
Fanatspartak: folds 
xxRoseIloveu: calls $0.14
*** FLOP *** [Kc 5s 3s]
PapiMik3: bets $0.21
xxRoseIloveu: calls $0.21
*** TURN *** [Kc 5s 3s] [3c]
PapiMik3: bets $0.81
xxRoseIloveu: folds 
Uncalled bet ($0.81) returned to PapiMik3
PapiMik3 collected $0.81 from pot
PapiMik3: doesn't show hand 
*** SUMMARY ***
Total pot $0.84 | Rake $0.03 
Board [Kc 5s 3s 3c]
Seat 1: EevAA190 (button) folded before Flop (didn't bet)
Seat 2: PapiMik3 (small blind) collected ($0.81)
Seat 3: Fanatspartak (big blind) folded before Flop
Seat 4: xxRoseIloveu folded on the Turn
Seat 5: bananAAbandit folded before Flop (didn't bet)
Seat 6: Scaaalll folded before Flop (didn't bet)



PokerStars Zoom Hand #229232830784:  Hold'em No Limit ($0.01/$0.02) - 2021/08/21 23:06:41 CET [2021/08/21 17:06:41 ET]
Table 'Halley' 6-max Seat #1 is the button
Seat 1: Scaaalll ($3.84 in chips) 
Seat 2: tazar34_777 ($4.32 in chips) 
Seat 3: PapiMik3 ($3.04 in chips) 
Seat 4: jordanzepp ($2.34 in chips) 
Seat 5: WITKOW_AV ($2 in chips) 
Seat 6: Dakosm ($2.14 in chips) 
tazar34_777: posts small blind $0.01
PapiMik3: posts big blind $0.02
*** HOLE CARDS ***
Dealt to Scaaalll [3c Qc]
jordanzepp: folds 
WITKOW_AV: folds 
jordanzepp is disconnected 
Dakosm: raises $0.02 to $0.04
Scaaalll: folds 
tazar34_777: folds 
PapiMik3: folds 
Uncalled bet ($0.02) returned to Dakosm
Dakosm collected $0.05 from pot
Dakosm: doesn't show hand 
*** SUMMARY ***
Total pot $0.05 | Rake $0 
Seat 1: Scaaalll (button) folded before Flop (didn't bet)
Seat 2: tazar34_777 (small blind) folded before Flop
Seat 3: PapiMik3 (big blind) folded before Flop
Seat 4: jordanzepp folded before Flop (didn't bet)
Seat 5: WITKOW_AV folded before Flop (didn't bet)
Seat 6: Dakosm collected ($0.05)



PokerStars Zoom Hand #229232838170:  Hold'em No Limit ($0.01/$0.02) - 2021/08/21 23:06:58 CET [2021/08/21 17:06:58 ET]
Table 'Halley' 6-max Seat #1 is the button
Seat 1: Soko 1381 ($2.12 in chips) 
Seat 2: Scaaalll ($3.84 in chips) 
Seat 3: kumanotiger ($1.62 in chips) 
Seat 4: twiti174 ($1.97 in chips) 
Seat 5: gasmar_29 ($2 in chips) 
Seat 6: bt710 ($4.72 in chips) 
Scaaalll: posts small blind $0.01
kumanotiger: posts big blind $0.02
*** HOLE CARDS ***
Dealt to Scaaalll [Kc 8d]
twiti174: raises $0.05 to $0.07
gasmar_29: folds 
bt710: folds 
Soko 1381: folds 
Scaaalll: folds 
kumanotiger: folds 
Uncalled bet ($0.05) returned to twiti174
twiti174 collected $0.05 from pot
twiti174: doesn't show hand 
*** SUMMARY ***
Total pot $0.05 | Rake $0 
Seat 1: Soko 1381 (button) folded before Flop (didn't bet)
Seat 2: Scaaalll (small blind) folded before Flop
Seat 3: kumanotiger (big blind) folded before Flop
Seat 4: twiti174 collected ($0.05)
Seat 5: gasmar_29 folded before Flop (didn't bet)
Seat 6: bt710 folded before Flop (didn't bet)



PokerStars Zoom Hand #229232839897:  Hold'em No Limit ($0.01/$0.02) - 2021/08/21 23:07:02 CET [2021/08/21 17:07:02 ET]
Table 'Halley' 6-max Seat #1 is the button
Seat 1: Kojak34 ($5.89 in chips) 
Seat 2: Mustang01373 ($1.38 in chips) 
Seat 3: Scaaalll ($3.83 in chips) 
Seat 4: Peimievvt ($2.44 in chips) 
Seat 5: WITKOW_AV ($2.11 in chips) 
Seat 6: stUPolak ($2.18 in chips) 
Mustang01373: posts small blind $0.01
Scaaalll: posts big blind $0.02
*** HOLE CARDS ***
Dealt to Scaaalll [5h 8c]
Peimievvt: folds 
WITKOW_AV: folds 
stUPolak: folds 
Kojak34: folds 
Mustang01373: calls $0.01
Scaaalll: checks 
*** FLOP *** [Kc 9d Jd]
Mustang01373: checks 
Scaaalll: checks 
*** TURN *** [Kc 9d Jd] [5d]
Mustang01373: checks 
Scaaalll: checks 
*** RIVER *** [Kc 9d Jd 5d] [4c]
Mustang01373: checks 
Scaaalll: checks 
*** SHOW DOWN ***
Mustang01373: shows [As Ts] (high card Ace)
Scaaalll: shows [5h 8c] (a pair of Fives)
Scaaalll collected $0.04 from pot
*** SUMMARY ***
Total pot $0.04 | Rake $0 
Board [Kc 9d Jd 5d 4c]
Seat 1: Kojak34 (button) folded before Flop (didn't bet)
Seat 2: Mustang01373 (small blind) showed [As Ts] and lost with high card Ace
Seat 3: Scaaalll (big blind) showed [5h 8c] and won ($0.04) with a pair of Fives
Seat 4: Peimievvt folded before Flop (didn't bet)
Seat 5: WITKOW_AV folded before Flop (didn't bet)
Seat 6: stUPolak folded before Flop (didn't bet)



PokerStars Zoom Hand #229232834668:  Hold'em No Limit ($0.01/$0.02) - 2021/08/21 23:06:50 CET [2021/08/21 17:06:50 ET]
Table 'Halley' 6-max Seat #1 is the button
Seat 1: WITKOW_AV ($2 in chips) 
Seat 2: Takkeee ($1.98 in chips) 
Seat 3: Ck@tih@ ($3.69 in chips) 
Seat 4: maressen ($2.22 in chips) 
Seat 5: Scaaalll ($3.84 in chips) 
Seat 6: volt_by ($1.73 in chips) 
Takkeee: posts small blind $0.01
Ck@tih@: posts big blind $0.02
*** HOLE CARDS ***
Dealt to Scaaalll [Ah 3d]
maressen: folds 
Scaaalll: folds 
volt_by: folds 
WITKOW_AV: raises $0.03 to $0.05
Takkeee: raises $0.07 to $0.12
Ck@tih@: raises $0.24 to $0.36
WITKOW_AV: folds 
Takkeee: raises $1.62 to $1.98 and is all-in
Ck@tih@: calls $1.62
*** FLOP *** [7s Jh As]
*** TURN *** [7s Jh As] [Js]
*** RIVER *** [7s Jh As Js] [Tc]
*** SHOW DOWN ***
Takkeee: shows [Qs Qc] (two pair, Queens and Jacks)
Ck@tih@: shows [Ac Ad] (a full house, Aces full of Jacks)
Ck@tih@ collected $3.87 from pot
*** SUMMARY ***
Total pot $4.01 | Rake $0.14 
Board [7s Jh As Js Tc]
Seat 1: WITKOW_AV (button) folded before Flop
Seat 2: Takkeee (small blind) showed [Qs Qc] and lost with two pair, Queens and Jacks
Seat 3: Ck@tih@ (big blind) showed [Ac Ad] and won ($3.87) with a full house, Aces full of Jacks
Seat 4: maressen folded before Flop (didn't bet)
Seat 5: Scaaalll folded before Flop (didn't bet)
Seat 6: volt_by folded before Flop (didn't bet)



PokerStars Zoom Hand #229232858568:  Hold'em No Limit ($0.01/$0.02) - 2021/08/21 23:07:45 CET [2021/08/21 17:07:45 ET]
Table 'Halley' 6-max Seat #1 is the button
Seat 1: giselerebelo ($3.72 in chips) 
Seat 2: Scaaalll ($3.85 in chips) 
Seat 3: Ck@tih@ ($1.75 in chips) 
Seat 4: gerhavfc ($1.03 in chips) 
Seat 5: dr_tolob ($0.80 in chips) 
Seat 6: STE1NBERG ($5.95 in chips) 
Scaaalll: posts small blind $0.01
Ck@tih@: posts big blind $0.02
*** HOLE CARDS ***
Dealt to Scaaalll [8d 6s]
gerhavfc: folds 
gerhavfc is disconnected 
dr_tolob: folds 
STE1NBERG: folds 
giselerebelo: folds 
Scaaalll: folds 
Uncalled bet ($0.01) returned to Ck@tih@
Ck@tih@ collected $0.02 from pot
Ck@tih@: doesn't show hand 
*** SUMMARY ***
Total pot $0.02 | Rake $0 
Seat 1: giselerebelo (button) folded before Flop (didn't bet)
Seat 2: Scaaalll (small blind) folded before Flop
Seat 3: Ck@tih@ (big blind) collected ($0.02)
Seat 4: gerhavfc folded before Flop (didn't bet)
Seat 5: dr_tolob folded before Flop (didn't bet)
Seat 6: STE1NBERG folded before Flop (didn't bet)



PokerStars Zoom Hand #229232854308:  Hold'em No Limit ($0.01/$0.02) - 2021/08/21 23:07:35 CET [2021/08/21 17:07:35 ET]
Table 'Halley' 6-max Seat #1 is the button
Seat 1: Alegry-Babay ($2.15 in chips) 
Seat 2: Bluff2WlN ($2.59 in chips) 
Seat 3: znak312 ($2.05 in chips) 
Seat 4: renansoumarques ($0.89 in chips) 
Seat 5: OFSHOR ($3.22 in chips) 
Seat 6: Scaaalll ($3.85 in chips) 
Bluff2WlN: posts small blind $0.01
znak312: posts big blind $0.02
*** HOLE CARDS ***
Dealt to Scaaalll [Qh 2c]
renansoumarques: calls $0.02
OFSHOR: folds 
Scaaalll: folds 
Alegry-Babay: folds 
Bluff2WlN: folds 
znak312: checks 
*** FLOP *** [Ad 5c 8c]
znak312: checks 
renansoumarques: checks 
*** TURN *** [Ad 5c 8c] [8s]
znak312: checks 
renansoumarques: checks 
*** RIVER *** [Ad 5c 8c 8s] [Kd]
znak312: checks 
renansoumarques: bets $0.87 and is all-in
znak312: folds 
Uncalled bet ($0.87) returned to renansoumarques
renansoumarques collected $0.05 from pot
renansoumarques: doesn't show hand 
*** SUMMARY ***
Total pot $0.05 | Rake $0 
Board [Ad 5c 8c 8s Kd]
Seat 1: Alegry-Babay (button) folded before Flop (didn't bet)
Seat 2: Bluff2WlN (small blind) folded before Flop
Seat 3: znak312 (big blind) folded on the River
Seat 4: renansoumarques collected ($0.05)
Seat 5: OFSHOR folded before Flop (didn't bet)
Seat 6: Scaaalll folded before Flop (didn't bet)



PokerStars Zoom Hand #229232874631:  Hold'em No Limit ($0.01/$0.02) - 2021/08/21 23:08:22 CET [2021/08/21 17:08:22 ET]
Table 'Halley' 6-max Seat #1 is the button
Seat 1: bRt 85 ($2.43 in chips) 
Seat 2: Apollonnn_13 ($2.27 in chips) 
Seat 3: Jellycube ($4.51 in chips) 
Seat 4: Feliciano16 ($7.52 in chips) 
Seat 5: Scaaalll ($3.84 in chips) 
Seat 6: maria west side ($1.96 in chips) 
Apollonnn_13: posts small blind $0.01
Jellycube: posts big blind $0.02
*** HOLE CARDS ***
Dealt to Scaaalll [2c 6h]
Feliciano16: folds 
Scaaalll: folds 
maria west side: folds 
maria west side is disconnected 
bRt 85: raises $0.04 to $0.06
Apollonnn_13: folds 
Jellycube: calls $0.04
*** FLOP *** [Td Qs 5h]
Jellycube: checks 
bRt 85: bets $0.07
Jellycube: folds 
Uncalled bet ($0.07) returned to bRt 85
bRt 85 collected $0.13 from pot
bRt 85: doesn't show hand 
*** SUMMARY ***
Total pot $0.13 | Rake $0 
Board [Td Qs 5h]
Seat 1: bRt 85 (button) collected ($0.13)
Seat 2: Apollonnn_13 (small blind) folded before Flop
Seat 3: Jellycube (big blind) folded on the Flop
Seat 4: Feliciano16 folded before Flop (didn't bet)
Seat 5: Scaaalll folded before Flop (didn't bet)
Seat 6: maria west side folded before Flop (didn't bet)



PokerStars Zoom Hand #229232867656:  Hold'em No Limit ($0.01/$0.02) - 2021/08/21 23:08:06 CET [2021/08/21 17:08:06 ET]
Table 'Halley' 6-max Seat #1 is the button
Seat 1: Scaaalll ($3.84 in chips) 
Seat 2: cr@sh test ($2 in chips) 
Seat 3: pipecmolodec ($2 in chips) 
Seat 4: polymorhp ($3.11 in chips) 
Seat 5: PEDACIT0 ($2.86 in chips) 
Seat 6: HDYD18 ($7.84 in chips) 
cr@sh test: posts small blind $0.01
pipecmolodec: posts big blind $0.02
*** HOLE CARDS ***
Dealt to Scaaalll [7d 5c]
polymorhp: folds 
PEDACIT0: folds 
HDYD18: folds 
Scaaalll: folds 
cr@sh test: raises $0.04 to $0.06
pipecmolodec: raises $0.12 to $0.18
cr@sh test: calls $0.12
*** FLOP *** [2d 3h 8h]
cr@sh test: checks 
pipecmolodec: bets $0.12
cr@sh test: raises $0.12 to $0.24
pipecmolodec: calls $0.12
*** TURN *** [2d 3h 8h] [Qc]
cr@sh test: bets $0.42
pipecmolodec: calls $0.42
*** RIVER *** [2d 3h 8h Qc] [9c]
cr@sh test: checks 
pipecmolodec: checks 
*** SHOW DOWN ***
cr@sh test: shows [Ks Ad] (high card Ace)
pipecmolodec: shows [9h 4h] (a pair of Nines)
pipecmolodec collected $1.62 from pot
*** SUMMARY ***
Total pot $1.68 | Rake $0.06 
Board [2d 3h 8h Qc 9c]
Seat 1: Scaaalll (button) folded before Flop (didn't bet)
Seat 2: cr@sh test (small blind) showed [Ks Ad] and lost with high card Ace
Seat 3: pipecmolodec (big blind) showed [9h 4h] and won ($1.62) with a pair of Nines
Seat 4: polymorhp folded before Flop (didn't bet)
Seat 5: PEDACIT0 folded before Flop (didn't bet)
Seat 6: HDYD18 folded before Flop (didn't bet)



PokerStars Zoom Hand #229232883801:  Hold'em No Limit ($0.01/$0.02) - 2021/08/21 23:08:43 CET [2021/08/21 17:08:43 ET]
Table 'Halley' 6-max Seat #1 is the button
Seat 1: Scaaalll ($3.82 in chips) 
Seat 2: Fabi151312 ($1.98 in chips) 
Seat 3: HubertFroh ($2.13 in chips) 
Seat 4: Meskalita ($2 in chips) 
Seat 5: RomiSex ($4.66 in chips) 
Seat 6: Chapaev136 ($6.29 in chips) 
Fabi151312: posts small blind $0.01
HubertFroh: posts big blind $0.02
*** HOLE CARDS ***
Dealt to Scaaalll [9h Th]
Meskalita: folds 
RomiSex: folds 
Chapaev136: folds 
Scaaalll: raises $0.02 to $0.04
Fabi151312: folds 
HubertFroh: folds 
Uncalled bet ($0.02) returned to Scaaalll
Scaaalll collected $0.05 from pot
Scaaalll: doesn't show hand 
*** SUMMARY ***
Total pot $0.05 | Rake $0 
Seat 1: Scaaalll (button) collected ($0.05)
Seat 2: Fabi151312 (small blind) folded before Flop
Seat 3: HubertFroh (big blind) folded before Flop
Seat 4: Meskalita folded before Flop (didn't bet)
Seat 5: RomiSex folded before Flop (didn't bet)
Seat 6: Chapaev136 folded before Flop (didn't bet)



PokerStars Zoom Hand #229232871600:  Hold'em No Limit ($0.01/$0.02) - 2021/08/21 23:08:15 CET [2021/08/21 17:08:15 ET]
Table 'Halley' 6-max Seat #1 is the button
Seat 1: Reipinguimm ($2 in chips) 
Seat 2: Gamer577 ($2.82 in chips) 
Seat 3: pipecmolodec ($2.19 in chips) 
Seat 4: gilberto98 ($2.76 in chips) 
Seat 5: Scaaalll ($3.84 in chips) 
Seat 6: dinoVIEIRA ($2.46 in chips) 
Gamer577: posts small blind $0.01
pipecmolodec: posts big blind $0.02
*** HOLE CARDS ***
Dealt to Scaaalll [8s Jc]
gilberto98: raises $0.04 to $0.06
Scaaalll: folds 
dinoVIEIRA: folds 
Reipinguimm: calls $0.06
Gamer577: folds 
pipecmolodec: folds 
*** FLOP *** [7s 5d 4c]
gilberto98: checks 
Reipinguimm: checks 
*** TURN *** [7s 5d 4c] [7c]
gilberto98: checks 
Reipinguimm: checks 
*** RIVER *** [7s 5d 4c 7c] [5c]
gilberto98: checks 
Reipinguimm: bets $0.12
gilberto98: calls $0.12
*** SHOW DOWN ***
Reipinguimm: shows [Ts Ah] (two pair, Sevens and Fives)
gilberto98: mucks hand 
Reipinguimm collected $0.38 from pot
*** SUMMARY ***
Total pot $0.39 | Rake $0.01 
Board [7s 5d 4c 7c 5c]
Seat 1: Reipinguimm (button) showed [Ts Ah] and won ($0.38) with two pair, Sevens and Fives
Seat 2: Gamer577 (small blind) folded before Flop
Seat 3: pipecmolodec (big blind) folded before Flop
Seat 4: gilberto98 mucked [Qh Kh]
Seat 5: Scaaalll folded before Flop (didn't bet)
Seat 6: dinoVIEIRA folded before Flop (didn't bet)



PokerStars Zoom Hand #229232878161:  Hold'em No Limit ($0.01/$0.02) - 2021/08/21 23:08:30 CET [2021/08/21 17:08:30 ET]
Table 'Halley' 6-max Seat #1 is the button
Seat 1: yal.AnToJKe ($0.63 in chips) 
Seat 2: Phoenixxxxxxxx ($2 in chips) 
Seat 3: Scaaalll ($3.84 in chips) 
Seat 4: BriceDo1917 ($4.10 in chips) 
Seat 5: stUPolak ($2.11 in chips) 
Seat 6: JaguarAndy17 ($2.09 in chips) 
Phoenixxxxxxxx: posts small blind $0.01
Scaaalll: posts big blind $0.02
*** HOLE CARDS ***
Dealt to Scaaalll [2c 4d]
BriceDo1917: folds 
BriceDo1917 is disconnected 
stUPolak: raises $0.04 to $0.06
JaguarAndy17: calls $0.06
yal.AnToJKe: folds 
Phoenixxxxxxxx: folds 
Scaaalll: folds 
*** FLOP *** [8h 7c Qc]
stUPolak: bets $0.07
JaguarAndy17: folds 
Uncalled bet ($0.07) returned to stUPolak
stUPolak collected $0.14 from pot
stUPolak: doesn't show hand 
JaguarAndy17 is disconnected 
*** SUMMARY ***
Total pot $0.15 | Rake $0.01 
Board [8h 7c Qc]
Seat 1: yal.AnToJKe (button) folded before Flop (didn't bet)
Seat 2: Phoenixxxxxxxx (small blind) folded before Flop
Seat 3: Scaaalll (big blind) folded before Flop
Seat 4: BriceDo1917 folded before Flop (didn't bet)
Seat 5: stUPolak collected ($0.14)
Seat 6: JaguarAndy17 folded on the Flop



PokerStars Zoom Hand #229232876470:  Hold'em No Limit ($0.01/$0.02) - 2021/08/21 23:08:26 CET [2021/08/21 17:08:26 ET]
Table 'Halley' 6-max Seat #1 is the button
Seat 1: ISBman ($3.22 in chips) 
Seat 2: BlackhawKK's ($2.87 in chips) 
Seat 3: AleksSiri ($1.35 in chips) 
Seat 4: _TsarukV_12 ($7.65 in chips) 
Seat 5: CrazyyParis ($2 in chips) 
Seat 6: Scaaalll ($3.84 in chips) 
BlackhawKK's: posts small blind $0.01
AleksSiri: posts big blind $0.02
*** HOLE CARDS ***
Dealt to Scaaalll [Td 2d]
_TsarukV_12: folds 
_TsarukV_12 is disconnected 
CrazyyParis: folds 
Scaaalll: folds 
ISBman: raises $0.03 to $0.05
BlackhawKK's: folds 
AleksSiri: calls $0.03
*** FLOP *** [6s Jh 3d]
AleksSiri: checks 
ISBman: checks 
*** TURN *** [6s Jh 3d] [2h]
AleksSiri: bets $0.06
ISBman: calls $0.06
*** RIVER *** [6s Jh 3d 2h] [7s]
AleksSiri: checks 
ISBman: bets $0.17
AleksSiri: calls $0.17
*** SHOW DOWN ***
ISBman: shows [Qh 9h] (high card Queen)
AleksSiri: shows [3c Ad] (a pair of Threes)
AleksSiri collected $0.55 from pot
*** SUMMARY ***
Total pot $0.57 | Rake $0.02 
Board [6s Jh 3d 2h 7s]
Seat 1: ISBman (button) showed [Qh 9h] and lost with high card Queen
Seat 2: BlackhawKK's (small blind) folded before Flop
Seat 3: AleksSiri (big blind) showed [3c Ad] and won ($0.55) with a pair of Threes
Seat 4: _TsarukV_12 folded before Flop (didn't bet)
Seat 5: CrazyyParis folded before Flop (didn't bet)
Seat 6: Scaaalll folded before Flop (didn't bet)



PokerStars Zoom Hand #229232865912:  Hold'em No Limit ($0.01/$0.02) - 2021/08/21 23:08:02 CET [2021/08/21 17:08:02 ET]
Table 'Halley' 6-max Seat #1 is the button
Seat 1: OFSHOR ($3.20 in chips) 
Seat 2: RChinenov ($2.02 in chips) 
Seat 3: castrosis ($2.54 in chips) 
Seat 4: Scaaalll ($3.84 in chips) 
Seat 5: VadimSaratov ($1.04 in chips) 
Seat 6: Vanekakqj ($2.74 in chips) 
RChinenov: posts small blind $0.01
castrosis: posts big blind $0.02
*** HOLE CARDS ***
Dealt to Scaaalll [Jc Th]
Scaaalll: folds 
VadimSaratov: folds 
Vanekakqj: folds 
OFSHOR: raises $0.04 to $0.06
RChinenov: folds 
castrosis: calls $0.04
*** FLOP *** [9s 6h 3d]
castrosis: checks 
OFSHOR: bets $0.09
castrosis: raises $0.09 to $0.18
OFSHOR: calls $0.09
*** TURN *** [9s 6h 3d] [6d]
castrosis: bets $2.30 and is all-in
OFSHOR: folds 
Uncalled bet ($2.30) returned to castrosis
castrosis collected $0.47 from pot
castrosis: doesn't show hand 
*** SUMMARY ***
Total pot $0.49 | Rake $0.02 
Board [9s 6h 3d 6d]
Seat 1: OFSHOR (button) folded on the Turn
Seat 2: RChinenov (small blind) folded before Flop
Seat 3: castrosis (big blind) collected ($0.47)
Seat 4: Scaaalll folded before Flop (didn't bet)
Seat 5: VadimSaratov folded before Flop (didn't bet)
Seat 6: Vanekakqj folded before Flop (didn't bet)



PokerStars Zoom Hand #229232889509:  Hold'em No Limit ($0.01/$0.02) - 2021/08/21 23:08:56 CET [2021/08/21 17:08:56 ET]
Table 'Halley' 6-max Seat #1 is the button
Seat 1: Roachy 92 ($3 in chips) 
Seat 2: Scaaalll ($3.85 in chips) 
Seat 3: Keltu :D ($2.03 in chips) 
Seat 4: tisadaisy ($2.87 in chips) 
Seat 5: ctaceo ($2 in chips) 
Seat 6: MATIdf365 ($4.53 in chips) 
Scaaalll: posts small blind $0.01
Keltu :D: posts big blind $0.02
*** HOLE CARDS ***
Dealt to Scaaalll [Kc Ts]
tisadaisy: raises $0.02 to $0.04
ctaceo: calls $0.04
MATIdf365: folds 
Roachy 92: folds 
Scaaalll: calls $0.03
Keltu :D: calls $0.02
*** FLOP *** [Ad Jc 2s]
Scaaalll: checks 
Keltu :D: checks 
tisadaisy: bets $0.08
ctaceo: calls $0.08
Scaaalll: folds 
Keltu :D: folds 
*** TURN *** [Ad Jc 2s] [6s]
tisadaisy: checks 
ctaceo: bets $0.23
tisadaisy: folds 
Uncalled bet ($0.23) returned to ctaceo
ctaceo collected $0.31 from pot
ctaceo: doesn't show hand 
*** SUMMARY ***
Total pot $0.32 | Rake $0.01 
Board [Ad Jc 2s 6s]
Seat 1: Roachy 92 (button) folded before Flop (didn't bet)
Seat 2: Scaaalll (small blind) folded on the Flop
Seat 3: Keltu :D (big blind) folded on the Flop
Seat 4: tisadaisy folded on the Turn
Seat 5: ctaceo collected ($0.31)
Seat 6: MATIdf365 folded before Flop (didn't bet)



PokerStars Zoom Hand #229232904690:  Hold'em No Limit ($0.01/$0.02) - 2021/08/21 23:09:31 CET [2021/08/21 17:09:31 ET]
Table 'Halley' 6-max Seat #1 is the button
Seat 1: MATIdf365 ($2.07 in chips) 
Seat 2: BriceDo1917 ($4.11 in chips) 
Seat 3: vipan2011 ($0.70 in chips) 
Seat 4: Dr.stromg ($4 in chips) 
Seat 5: kumanotiger ($1.61 in chips) 
Seat 6: Scaaalll ($3.81 in chips) 
BriceDo1917: posts small blind $0.01
vipan2011: posts big blind $0.02
*** HOLE CARDS ***
Dealt to Scaaalll [4h 5h]
Dr.stromg: folds 
kumanotiger: folds 
Scaaalll: raises $0.04 to $0.06
MATIdf365: folds 
BriceDo1917: raises $0.14 to $0.20
vipan2011: folds 
vipan2011 is disconnected 
Scaaalll: calls $0.14
*** FLOP *** [6d Jd 8h]
BriceDo1917: bets $0.22
Scaaalll: folds 
Uncalled bet ($0.22) returned to BriceDo1917
BriceDo1917 collected $0.41 from pot
BriceDo1917: doesn't show hand 
*** SUMMARY ***
Total pot $0.42 | Rake $0.01 
Board [6d Jd 8h]
Seat 1: MATIdf365 (button) folded before Flop (didn't bet)
Seat 2: BriceDo1917 (small blind) collected ($0.41)
Seat 3: vipan2011 (big blind) folded before Flop
Seat 4: Dr.stromg folded before Flop (didn't bet)
Seat 5: kumanotiger folded before Flop (didn't bet)
Seat 6: Scaaalll folded on the Flop



PokerStars Zoom Hand #229232925498:  Hold'em No Limit ($0.01/$0.02) - 2021/08/21 23:10:19 CET [2021/08/21 17:10:19 ET]
Table 'Halley' 6-max Seat #1 is the button
Seat 1: Kb013497 ($2.55 in chips) 
Seat 2: ASAjr ($2.08 in chips) 
Seat 3: Scaaalll ($3.61 in chips) 
Seat 4: F_oksi(BLR) ($4.41 in chips) 
Seat 5: Trembon ($0.91 in chips) 
Seat 6: AlexGTPS ($2.17 in chips) 
ASAjr: posts small blind $0.01
Scaaalll: posts big blind $0.02
*** HOLE CARDS ***
Dealt to Scaaalll [8d 5d]
F_oksi(BLR): folds 
Trembon: folds 
AlexGTPS: folds 
Kb013497: folds 
ASAjr: folds 
Uncalled bet ($0.01) returned to Scaaalll
Scaaalll collected $0.02 from pot
Scaaalll: doesn't show hand 
*** SUMMARY ***
Total pot $0.02 | Rake $0 
Seat 1: Kb013497 (button) folded before Flop (didn't bet)
Seat 2: ASAjr (small blind) folded before Flop
Seat 3: Scaaalll (big blind) collected ($0.02)
Seat 4: F_oksi(BLR) folded before Flop (didn't bet)
Seat 5: Trembon folded before Flop (didn't bet)
Seat 6: AlexGTPS folded before Flop (didn't bet)



PokerStars Zoom Hand #229232931502:  Hold'em No Limit ($0.01/$0.02) - 2021/08/21 23:10:33 CET [2021/08/21 17:10:33 ET]
Table 'Halley' 6-max Seat #1 is the button
Seat 1: newen83 ($2.99 in chips) 
Seat 2: Scaaalll ($3.62 in chips) 
Seat 3: OFSHOR ($2.15 in chips) 
Seat 4: yal.AnToJKe ($0.78 in chips) 
Seat 5: igara tigara ($3.52 in chips) 
Seat 6: Boris_Garich ($2.39 in chips) 
Scaaalll: posts small blind $0.01
OFSHOR: posts big blind $0.02
*** HOLE CARDS ***
Dealt to Scaaalll [9d 8h]
yal.AnToJKe: folds 
igara tigara: folds 
Boris_Garich: folds 
newen83: folds 
newen83 is disconnected 
Scaaalll: folds 
Uncalled bet ($0.01) returned to OFSHOR
OFSHOR collected $0.02 from pot
OFSHOR: doesn't show hand 
*** SUMMARY ***
Total pot $0.02 | Rake $0 
Seat 1: newen83 (button) folded before Flop (didn't bet)
Seat 2: Scaaalll (small blind) folded before Flop
Seat 3: OFSHOR (big blind) collected ($0.02)
Seat 4: yal.AnToJKe folded before Flop (didn't bet)
Seat 5: igara tigara folded before Flop (didn't bet)
Seat 6: Boris_Garich folded before Flop (didn't bet)



PokerStars Zoom Hand #229232929330:  Hold'em No Limit ($0.01/$0.02) - 2021/08/21 23:10:28 CET [2021/08/21 17:10:28 ET]
Table 'Halley' 6-max Seat #1 is the button
Seat 1: Astel88 ($3.25 in chips) 
Seat 2: tisadaisy ($2.63 in chips) 
Seat 3: MattieBOZ ($2.06 in chips) 
Seat 4: Scaaalll ($3.62 in chips) 
Seat 5: pavlo8855 ($2.34 in chips) 
Seat 6: new face onl ($2.24 in chips) 
tisadaisy: posts small blind $0.01
MattieBOZ: posts big blind $0.02
*** HOLE CARDS ***
Dealt to Scaaalll [Th 2h]
Scaaalll: folds 
pavlo8855: folds 
new face onl: raises $0.02 to $0.04
Astel88: folds 
Astel88 is disconnected 
MattieBOZ is disconnected 
tisadaisy: folds 
MattieBOZ: folds 
Uncalled bet ($0.02) returned to new face onl
new face onl collected $0.05 from pot
new face onl: doesn't show hand 
*** SUMMARY ***
Total pot $0.05 | Rake $0 
Seat 1: Astel88 (button) folded before Flop (didn't bet)
Seat 2: tisadaisy (small blind) folded before Flop
Seat 3: MattieBOZ (big blind) folded before Flop
Seat 4: Scaaalll folded before Flop (didn't bet)
Seat 5: pavlo8855 folded before Flop (didn't bet)
Seat 6: new face onl collected ($0.05)



PokerStars Zoom Hand #229232918457:  Hold'em No Limit ($0.01/$0.02) - 2021/08/21 23:10:03 CET [2021/08/21 17:10:03 ET]
Table 'Halley' 6-max Seat #1 is the button
Seat 1: Smaill174 ($2.24 in chips) 
Seat 2: kahzura ($2 in chips) 
Seat 3: Ogni ($5.19 in chips) 
Seat 4: Scaaalll ($3.61 in chips) 
Seat 5: Dr.stromg ($5.80 in chips) 
Seat 6: HDYD18 ($2.02 in chips) 
kahzura: posts small blind $0.01
Ogni: posts big blind $0.02
*** HOLE CARDS ***
Dealt to Scaaalll [2s Th]
Scaaalll: folds 
Dr.stromg: raises $0.03 to $0.05
HDYD18: folds 
Smaill174: calls $0.05
kahzura: folds 
Ogni: folds 
*** FLOP *** [6s Ks Kh]
Dr.stromg: bets $0.04
Smaill174: calls $0.04
*** TURN *** [6s Ks Kh] [Td]
Dr.stromg: checks 
Smaill174: checks 
*** RIVER *** [6s Ks Kh Td] [2d]
Dr.stromg: checks 
Smaill174: bets $0.10
Dr.stromg: folds 
Uncalled bet ($0.10) returned to Smaill174
Smaill174 collected $0.20 from pot
Smaill174: doesn't show hand 
*** SUMMARY ***
Total pot $0.21 | Rake $0.01 
Board [6s Ks Kh Td 2d]
Seat 1: Smaill174 (button) collected ($0.20)
Seat 2: kahzura (small blind) folded before Flop
Seat 3: Ogni (big blind) folded before Flop
Seat 4: Scaaalll folded before Flop (didn't bet)
Seat 5: Dr.stromg folded on the River
Seat 6: HDYD18 folded before Flop (didn't bet)



PokerStars Zoom Hand #229232920685:  Hold'em No Limit ($0.01/$0.02) - 2021/08/21 23:10:08 CET [2021/08/21 17:10:08 ET]
Table 'Halley' 6-max Seat #1 is the button
Seat 1: VadimSaratov ($1.14 in chips) 
Seat 2: didiclavi777 ($1.90 in chips) 
Seat 3: Stormzilla ($2.10 in chips) 
Seat 4: egroj1700 ($2.08 in chips) 
Seat 5: Scaaalll ($3.61 in chips) 
Seat 6: CrazyyParis ($2 in chips) 
didiclavi777: posts small blind $0.01
Stormzilla: posts big blind $0.02
*** HOLE CARDS ***
Dealt to Scaaalll [Kd 8h]
egroj1700: folds 
Scaaalll: folds 
CrazyyParis: raises $0.03 to $0.05
VadimSaratov: calls $0.05
didiclavi777: calls $0.04
Stormzilla: folds 
*** FLOP *** [Jc 7d Ac]
didiclavi777: checks 
CrazyyParis: checks 
VadimSaratov: checks 
*** TURN *** [Jc 7d Ac] [9h]
didiclavi777: checks 
CrazyyParis: checks 
VadimSaratov: bets $0.06
didiclavi777: calls $0.06
CrazyyParis: folds 
*** RIVER *** [Jc 7d Ac 9h] [5s]
didiclavi777: checks 
VadimSaratov: checks 
*** SHOW DOWN ***
didiclavi777: shows [Kc 9s] (a pair of Nines)
VadimSaratov: shows [Jh Kh] (a pair of Jacks)
VadimSaratov collected $0.28 from pot
*** SUMMARY ***
Total pot $0.29 | Rake $0.01 
Board [Jc 7d Ac 9h 5s]
Seat 1: VadimSaratov (button) showed [Jh Kh] and won ($0.28) with a pair of Jacks
Seat 2: didiclavi777 (small blind) showed [Kc 9s] and lost with a pair of Nines
Seat 3: Stormzilla (big blind) folded before Flop
Seat 4: egroj1700 folded before Flop (didn't bet)
Seat 5: Scaaalll folded before Flop (didn't bet)
Seat 6: CrazyyParis folded on the Turn



PokerStars Zoom Hand #229232937140:  Hold'em No Limit ($0.01/$0.02) - 2021/08/21 23:10:46 CET [2021/08/21 17:10:46 ET]
Table 'Halley' 6-max Seat #1 is the button
Seat 1: XaMpLEr ($2.06 in chips) 
Seat 2: Axel201388 ($0.99 in chips) 
Seat 3: dinoVIEIRA ($2.21 in chips) 
Seat 4: Scaaalll ($3.61 in chips) 
Seat 5: AleksSiri ($1.11 in chips) 
Seat 6: pipecmolodec ($2.14 in chips) 
Axel201388: posts small blind $0.01
dinoVIEIRA: posts big blind $0.02
*** HOLE CARDS ***
Dealt to Scaaalll [Ad 2h]
Scaaalll: folds 
AleksSiri: folds 
pipecmolodec: folds 
XaMpLEr: folds 
Axel201388: folds 
Uncalled bet ($0.01) returned to dinoVIEIRA
dinoVIEIRA collected $0.02 from pot
dinoVIEIRA: doesn't show hand 
*** SUMMARY ***
Total pot $0.02 | Rake $0 
Seat 1: XaMpLEr (button) folded before Flop (didn't bet)
Seat 2: Axel201388 (small blind) folded before Flop
Seat 3: dinoVIEIRA (big blind) collected ($0.02)
Seat 4: Scaaalll folded before Flop (didn't bet)
Seat 5: AleksSiri folded before Flop (didn't bet)
Seat 6: pipecmolodec folded before Flop (didn't bet)



PokerStars Zoom Hand #229232923732:  Hold'em No Limit ($0.01/$0.02) - 2021/08/21 23:10:15 CET [2021/08/21 17:10:15 ET]
Table 'Halley' 6-max Seat #1 is the button
Seat 1: Scaaalll ($3.61 in chips) 
Seat 2: XaMpLEr ($2.09 in chips) 
Seat 3: Bol'tazar111 ($5.21 in chips) 
Seat 4: OFSHOR ($2.16 in chips) 
Seat 5: i.m.bluffing002 ($2.45 in chips) 
Seat 6: RaulacateFolds ($2.32 in chips) 
XaMpLEr: posts small blind $0.01
Bol'tazar111: posts big blind $0.02
*** HOLE CARDS ***
Dealt to Scaaalll [2c 3d]
OFSHOR: folds 
i.m.bluffing002: raises $0.04 to $0.06
RaulacateFolds: folds 
Scaaalll: folds 
XaMpLEr: folds 
Bol'tazar111: calls $0.04
*** FLOP *** [Tc 9s 7h]
Bol'tazar111: checks 
i.m.bluffing002: bets $0.08
Bol'tazar111: calls $0.08
*** TURN *** [Tc 9s 7h] [4h]
Bol'tazar111: checks 
i.m.bluffing002: bets $0.18
Bol'tazar111: folds 
Uncalled bet ($0.18) returned to i.m.bluffing002
i.m.bluffing002 collected $0.28 from pot
i.m.bluffing002: doesn't show hand 
*** SUMMARY ***
Total pot $0.29 | Rake $0.01 
Board [Tc 9s 7h 4h]
Seat 1: Scaaalll (button) folded before Flop (didn't bet)
Seat 2: XaMpLEr (small blind) folded before Flop
Seat 3: Bol'tazar111 (big blind) folded on the Turn
Seat 4: OFSHOR folded before Flop (didn't bet)
Seat 5: i.m.bluffing002 collected ($0.28)
Seat 6: RaulacateFolds folded before Flop (didn't bet)



PokerStars Zoom Hand #229232939260:  Hold'em No Limit ($0.01/$0.02) - 2021/08/21 23:10:51 CET [2021/08/21 17:10:51 ET]
Table 'Halley' 6-max Seat #1 is the button
Seat 1: NecromiconP ($8.14 in chips) 
Seat 2: AleksSiri ($1.11 in chips) 
Seat 3: SIGREX ($2.93 in chips) 
Seat 4: ctaceo ($2 in chips) 
Seat 5: Ne0net ($6.42 in chips) 
Seat 6: Scaaalll ($3.61 in chips) 
AleksSiri: posts small blind $0.01
SIGREX: posts big blind $0.02
*** HOLE CARDS ***
Dealt to Scaaalll [4d Jd]
ctaceo: raises $0.03 to $0.05
Ne0net: folds 
Scaaalll: folds 
NecromiconP: folds 
AleksSiri: folds 
SIGREX: folds 
Uncalled bet ($0.03) returned to ctaceo
ctaceo collected $0.05 from pot
ctaceo: doesn't show hand 
*** SUMMARY ***
Total pot $0.05 | Rake $0 
Seat 1: NecromiconP (button) folded before Flop (didn't bet)
Seat 2: AleksSiri (small blind) folded before Flop
Seat 3: SIGREX (big blind) folded before Flop
Seat 4: ctaceo collected ($0.05)
Seat 5: Ne0net folded before Flop (didn't bet)
Seat 6: Scaaalll folded before Flop (didn't bet)



PokerStars Zoom Hand #229232941013:  Hold'em No Limit ($0.01/$0.02) - 2021/08/21 23:10:55 CET [2021/08/21 17:10:55 ET]
Table 'Halley' 6-max Seat #1 is the button
Seat 1: RaulacateFolds ($2.32 in chips) 
Seat 2: ISBman ($2.89 in chips) 
Seat 3: Scaaalll ($3.61 in chips) 
Seat 4: alphabeta1d ($2 in chips) 
Seat 5: CrazyyParis ($2.01 in chips) 
Seat 6: jaamonra ($2.06 in chips) 
ISBman: posts small blind $0.01
Scaaalll: posts big blind $0.02
*** HOLE CARDS ***
Dealt to Scaaalll [8d 8h]
alphabeta1d: folds 
CrazyyParis: raises $0.03 to $0.05
jaamonra: folds 
RaulacateFolds: folds 
ISBman: raises $0.15 to $0.20
Scaaalll: folds 
CrazyyParis: folds 
Uncalled bet ($0.15) returned to ISBman
ISBman collected $0.12 from pot
ISBman: doesn't show hand 
*** SUMMARY ***
Total pot $0.12 | Rake $0 
Seat 1: RaulacateFolds (button) folded before Flop (didn't bet)
Seat 2: ISBman (small blind) collected ($0.12)
Seat 3: Scaaalll (big blind) folded before Flop
Seat 4: alphabeta1d folded before Flop (didn't bet)
Seat 5: CrazyyParis folded before Flop
Seat 6: jaamonra folded before Flop (didn't bet)



PokerStars Zoom Hand #229232950147:  Hold'em No Limit ($0.01/$0.02) - 2021/08/21 23:11:16 CET [2021/08/21 17:11:16 ET]
Table 'Halley' 6-max Seat #1 is the button
Seat 1: Scaaalll ($3.59 in chips) 
Seat 2: chigilaci ($5.30 in chips) 
Seat 3: Taran0001 ($1.94 in chips) 
Seat 4: 888lifeIS ($2 in chips) 
Seat 5: Kb013497 ($1.96 in chips) 
Seat 6: giselerebelo ($3.53 in chips) 
chigilaci: posts small blind $0.01
Taran0001: posts big blind $0.02
*** HOLE CARDS ***
Dealt to Scaaalll [Kd Jd]
888lifeIS: raises $0.02 to $0.04
Kb013497: folds 
giselerebelo: folds 
Scaaalll: calls $0.04
chigilaci: folds 
Taran0001: raises $0.13 to $0.17
888lifeIS: calls $0.13
Scaaalll: calls $0.13
*** FLOP *** [9h 9s 6d]
Taran0001: checks 
888lifeIS: checks 
Scaaalll: checks 
*** TURN *** [9h 9s 6d] [Jh]
Taran0001: bets $0.25
888lifeIS: folds 
Scaaalll: calls $0.25
*** RIVER *** [9h 9s 6d Jh] [4h]
Taran0001: checks 
Scaaalll: bets $0.23
Taran0001: calls $0.23
*** SHOW DOWN ***
Scaaalll: shows [Kd Jd] (two pair, Jacks and Nines)
Taran0001: mucks hand 
Scaaalll collected $1.42 from pot
*** SUMMARY ***
Total pot $1.48 | Rake $0.06 
Board [9h 9s 6d Jh 4h]
Seat 1: Scaaalll (button) showed [Kd Jd] and won ($1.42) with two pair, Jacks and Nines
Seat 2: chigilaci (small blind) folded before Flop
Seat 3: Taran0001 (big blind) mucked [Qd Ac]
Seat 4: 888lifeIS folded on the Turn
Seat 5: Kb013497 folded before Flop (didn't bet)
Seat 6: giselerebelo folded before Flop (didn't bet)



PokerStars Zoom Hand #229232981563:  Hold'em No Limit ($0.01/$0.02) - 2021/08/21 23:12:29 CET [2021/08/21 17:12:29 ET]
Table 'Halley' 6-max Seat #1 is the button
Seat 1: Smaill174 ($2.19 in chips) 
Seat 2: Scaaalll ($4.36 in chips) 
Seat 3: RChinenov ($2.35 in chips) 
Seat 4: BlackhawKK's ($2 in chips) 
Seat 5: Kadkoy ($3.56 in chips) 
Seat 6: Canoinhas37 ($6.79 in chips) 
Scaaalll: posts small blind $0.01
RChinenov: posts big blind $0.02
*** HOLE CARDS ***
Dealt to Scaaalll [5d 7d]
BlackhawKK's: folds 
Kadkoy: folds 
Kadkoy is disconnected 
Canoinhas37: raises $0.02 to $0.04
Smaill174: folds 
Scaaalll: folds 
RChinenov: folds 
Uncalled bet ($0.02) returned to Canoinhas37
Canoinhas37 collected $0.05 from pot
Canoinhas37: doesn't show hand 
*** SUMMARY ***
Total pot $0.05 | Rake $0 
Seat 1: Smaill174 (button) folded before Flop (didn't bet)
Seat 2: Scaaalll (small blind) folded before Flop
Seat 3: RChinenov (big blind) folded before Flop
Seat 4: BlackhawKK's folded before Flop (didn't bet)
Seat 5: Kadkoy folded before Flop (didn't bet)
Seat 6: Canoinhas37 collected ($0.05)



PokerStars Zoom Hand #229232979370:  Hold'em No Limit ($0.01/$0.02) - 2021/08/21 23:12:24 CET [2021/08/21 17:12:24 ET]
Table 'Halley' 6-max Seat #1 is the button
Seat 1: johnpa89 ($2.62 in chips) 
Seat 2: MATIdf365 ($4.21 in chips) 
Seat 3: sg.32rus ($1.52 in chips) 
Seat 4: BIITRU ($2 in chips) 
Seat 5: Meskalita ($2.03 in chips) 
Seat 6: Scaaalll ($4.36 in chips) 
MATIdf365: posts small blind $0.01
sg.32rus: posts big blind $0.02
*** HOLE CARDS ***
Dealt to Scaaalll [4h 2c]
BIITRU: folds 
Meskalita: folds 
Scaaalll: folds 
johnpa89: folds 
MATIdf365: raises $0.02 to $0.04
sg.32rus: folds 
Uncalled bet ($0.02) returned to MATIdf365
MATIdf365 collected $0.04 from pot
MATIdf365: doesn't show hand 
*** SUMMARY ***
Total pot $0.04 | Rake $0 
Seat 1: johnpa89 (button) folded before Flop (didn't bet)
Seat 2: MATIdf365 (small blind) collected ($0.04)
Seat 3: sg.32rus (big blind) folded before Flop
Seat 4: BIITRU folded before Flop (didn't bet)
Seat 5: Meskalita folded before Flop (didn't bet)
Seat 6: Scaaalll folded before Flop (didn't bet)



PokerStars Zoom Hand #229232991882:  Hold'em No Limit ($0.01/$0.02) - 2021/08/21 23:12:53 CET [2021/08/21 17:12:53 ET]
Table 'Halley' 6-max Seat #1 is the button
Seat 1: RrriotGrrrl ($7.31 in chips) 
Seat 2: NecromiconP ($2.71 in chips) 
Seat 3: Dr.stromg ($3.95 in chips) 
Seat 4: Espartacus5222 ($4.14 in chips) 
Seat 5: Scaaalll ($4.33 in chips) 
Seat 6: CrazyyParis ($2.04 in chips) 
NecromiconP: posts small blind $0.01
Dr.stromg: posts big blind $0.02
*** HOLE CARDS ***
Dealt to Scaaalll [7s Qc]
Espartacus5222: folds 
Scaaalll: folds 
CrazyyParis: folds 
RrriotGrrrl: raises $0.02 to $0.04
NecromiconP: folds 
Dr.stromg: folds 
Uncalled bet ($0.02) returned to RrriotGrrrl
RrriotGrrrl collected $0.05 from pot
RrriotGrrrl: doesn't show hand 
*** SUMMARY ***
Total pot $0.05 | Rake $0 
Seat 1: RrriotGrrrl (button) collected ($0.05)
Seat 2: NecromiconP (small blind) folded before Flop
Seat 3: Dr.stromg (big blind) folded before Flop
Seat 4: Espartacus5222 folded before Flop (didn't bet)
Seat 5: Scaaalll folded before Flop (didn't bet)
Seat 6: CrazyyParis folded before Flop (didn't bet)



PokerStars Zoom Hand #229232985894:  Hold'em No Limit ($0.01/$0.02) - 2021/08/21 23:12:39 CET [2021/08/21 17:12:39 ET]
Table 'Halley' 6-max Seat #1 is the button
Seat 1: snowpepsi ($4.30 in chips) 
Seat 2: Kuni_Ma ($2.26 in chips) 
Seat 3: Scaaalll ($4.35 in chips) 
Seat 4: selinus007 ($0.87 in chips) 
Seat 5: trickywizard64 ($1.70 in chips) 
Seat 6: WaiT4U ($2.12 in chips) 
Kuni_Ma: posts small blind $0.01
Scaaalll: posts big blind $0.02
*** HOLE CARDS ***
Dealt to Scaaalll [8s 7c]
selinus007: calls $0.02
trickywizard64: folds 
WaiT4U: raises $0.06 to $0.08
snowpepsi: folds 
selinus007 is disconnected 
Kuni_Ma: calls $0.07
Scaaalll: folds 
selinus007: folds 
*** FLOP *** [3d Qc 2h]
Kuni_Ma: checks 
WaiT4U: checks 
*** TURN *** [3d Qc 2h] [4s]
Kuni_Ma: checks 
WaiT4U: checks 
*** RIVER *** [3d Qc 2h 4s] [Ad]
Kuni_Ma: checks 
WaiT4U: bets $0.10
Kuni_Ma: folds 
Uncalled bet ($0.10) returned to WaiT4U
WaiT4U collected $0.19 from pot
WaiT4U: doesn't show hand 
*** SUMMARY ***
Total pot $0.20 | Rake $0.01 
Board [3d Qc 2h 4s Ad]
Seat 1: snowpepsi (button) folded before Flop (didn't bet)
Seat 2: Kuni_Ma (small blind) folded on the River
Seat 3: Scaaalll (big blind) folded before Flop
Seat 4: selinus007 folded before Flop
Seat 5: trickywizard64 folded before Flop (didn't bet)
Seat 6: WaiT4U collected ($0.19)



PokerStars Zoom Hand #229232994975:  Hold'em No Limit ($0.01/$0.02) - 2021/08/21 23:13:00 CET [2021/08/21 17:13:00 ET]
Table 'Halley' 6-max Seat #1 is the button
Seat 1: Scaaalll ($4.33 in chips) 
Seat 2: Tibelloni ($5.36 in chips) 
Seat 3: apadis ($1 in chips) 
Seat 4: Roachy 92 ($3.24 in chips) 
Seat 5: Sv1ch ($1.40 in chips) 
Seat 6: simensgh ($2 in chips) 
Tibelloni: posts small blind $0.01
apadis: posts big blind $0.02
*** HOLE CARDS ***
Dealt to Scaaalll [7s 8h]
Roachy 92: folds 
Sv1ch: folds 
simensgh: folds 
Scaaalll: folds 
Tibelloni: raises $0.04 to $0.06
apadis: calls $0.04
*** FLOP *** [8c 4s Th]
Tibelloni: checks 
apadis: bets $0.06
Tibelloni: folds 
Uncalled bet ($0.06) returned to apadis
apadis collected $0.12 from pot
apadis: doesn't show hand 
Tibelloni is disconnected 
*** SUMMARY ***
Total pot $0.12 | Rake $0 
Board [8c 4s Th]
Seat 1: Scaaalll (button) folded before Flop (didn't bet)
Seat 2: Tibelloni (small blind) folded on the Flop
Seat 3: apadis (big blind) collected ($0.12)
Seat 4: Roachy 92 folded before Flop (didn't bet)
Seat 5: Sv1ch folded before Flop (didn't bet)
Seat 6: simensgh folded before Flop (didn't bet)



PokerStars Zoom Hand #229233009000:  Hold'em No Limit ($0.01/$0.02) - 2021/08/21 23:13:33 CET [2021/08/21 17:13:33 ET]
Table 'Halley' 6-max Seat #1 is the button
Seat 1: dominik7315 ($1.91 in chips) 
Seat 2: pipecmolodec ($2 in chips) 
Seat 3: olga3021221 ($2.27 in chips) 
Seat 4: BlackhawKK's ($3.75 in chips) 
Seat 5: Scaaalll ($4.32 in chips) 
Seat 6: GrindToGlory ($4.15 in chips) 
pipecmolodec: posts small blind $0.01
olga3021221: posts big blind $0.02
*** HOLE CARDS ***
Dealt to Scaaalll [5s 8c]
dominik7315 is disconnected 
BlackhawKK's: folds 
Scaaalll: folds 
GrindToGlory: folds 
dominik7315: folds 
pipecmolodec: folds 
Uncalled bet ($0.01) returned to olga3021221
olga3021221 collected $0.02 from pot
olga3021221: doesn't show hand 
*** SUMMARY ***
Total pot $0.02 | Rake $0 
Seat 1: dominik7315 (button) folded before Flop (didn't bet)
Seat 2: pipecmolodec (small blind) folded before Flop
Seat 3: olga3021221 (big blind) collected ($0.02)
Seat 4: BlackhawKK's folded before Flop (didn't bet)
Seat 5: Scaaalll folded before Flop (didn't bet)
Seat 6: GrindToGlory folded before Flop (didn't bet)



PokerStars Zoom Hand #229233000507:  Hold'em No Limit ($0.01/$0.02) - 2021/08/21 23:13:13 CET [2021/08/21 17:13:13 ET]
Table 'Halley' 6-max Seat #1 is the button
Seat 1: Stillmare ($0.73 in chips) 
Seat 2: Colby1771 ($4.15 in chips) 
Seat 3: pipecmolodec ($2.08 in chips) 
Seat 4: Meskalita ($2.54 in chips) 
Seat 5: Scaaalll ($4.33 in chips) 
Seat 6: Xlavariable ($2.05 in chips) 
Colby1771: posts small blind $0.01
pipecmolodec: posts big blind $0.02
*** HOLE CARDS ***
Dealt to Scaaalll [3d 4d]
Meskalita: folds 
Scaaalll: folds 
Xlavariable: folds 
Stillmare: calls $0.02
Colby1771: folds 
pipecmolodec: raises $0.06 to $0.08
Stillmare: calls $0.06
*** FLOP *** [9d 6s 2c]
pipecmolodec: bets $0.05
Stillmare: calls $0.05
*** TURN *** [9d 6s 2c] [Td]
pipecmolodec: checks 
Stillmare: bets $0.08
pipecmolodec: folds 
Uncalled bet ($0.08) returned to Stillmare
Stillmare collected $0.26 from pot
Stillmare: doesn't show hand 
*** SUMMARY ***
Total pot $0.27 | Rake $0.01 
Board [9d 6s 2c Td]
Seat 1: Stillmare (button) collected ($0.26)
Seat 2: Colby1771 (small blind) folded before Flop
Seat 3: pipecmolodec (big blind) folded on the Turn
Seat 4: Meskalita folded before Flop (didn't bet)
Seat 5: Scaaalll folded before Flop (didn't bet)
Seat 6: Xlavariable folded before Flop (didn't bet)



PokerStars Zoom Hand #229233006792:  Hold'em No Limit ($0.01/$0.02) - 2021/08/21 23:13:28 CET [2021/08/21 17:13:28 ET]
Table 'Halley' 6-max Seat #1 is the button
Seat 1: trickywizard64 ($1.68 in chips) 
Seat 2: Billy Beane1 ($1.98 in chips) 
Seat 3: jaamonra ($2.14 in chips) 
Seat 4: HDYD18 ($2.05 in chips) 
Seat 5: NoEff0rt2w1n ($6.95 in chips) 
Seat 6: Scaaalll ($4.32 in chips) 
Billy Beane1: posts small blind $0.01
jaamonra: posts big blind $0.02
*** HOLE CARDS ***
Dealt to Scaaalll [4d 9c]
HDYD18: folds 
NoEff0rt2w1n: folds 
Scaaalll: folds 
trickywizard64: calls $0.02
Billy Beane1: folds 
jaamonra: checks 
*** FLOP *** [Ks 6d Th]
jaamonra: checks 
trickywizard64: bets $0.02
jaamonra: folds 
Uncalled bet ($0.02) returned to trickywizard64
trickywizard64 collected $0.05 from pot
trickywizard64: doesn't show hand 
*** SUMMARY ***
Total pot $0.05 | Rake $0 
Board [Ks 6d Th]
Seat 1: trickywizard64 (button) collected ($0.05)
Seat 2: Billy Beane1 (small blind) folded before Flop
Seat 3: jaamonra (big blind) folded on the Flop
Seat 4: HDYD18 folded before Flop (didn't bet)
Seat 5: NoEff0rt2w1n folded before Flop (didn't bet)
Seat 6: Scaaalll folded before Flop (didn't bet)



PokerStars Zoom Hand #229233005114:  Hold'em No Limit ($0.01/$0.02) - 2021/08/21 23:13:24 CET [2021/08/21 17:13:24 ET]
Table 'Halley' 6-max Seat #1 is the button
Seat 1: Apollonnn_13 ($2.32 in chips) 
Seat 2: Scaaalll ($4.33 in chips) 
Seat 3: Yangyang1407 ($2.21 in chips) 
Seat 4: jnbjnb1010 ($1.99 in chips) 
Seat 5: The-End-snglr ($1.38 in chips) 
Seat 6: KKARMELO ($2.19 in chips) 
Scaaalll: posts small blind $0.01
Yangyang1407: posts big blind $0.02
*** HOLE CARDS ***
Dealt to Scaaalll [2h Jh]
jnbjnb1010: folds 
jnbjnb1010 is disconnected 
The-End-snglr: raises $0.02 to $0.04
KKARMELO: folds 
Apollonnn_13: calls $0.04
Scaaalll: folds 
Yangyang1407: folds 
*** FLOP *** [Ks 4d As]
The-End-snglr: bets $0.06
Apollonnn_13: calls $0.06
*** TURN *** [Ks 4d As] [6h]
The-End-snglr: bets $0.06
Apollonnn_13: calls $0.06
*** RIVER *** [Ks 4d As 6h] [Qs]
The-End-snglr: bets $0.08
Apollonnn_13: folds 
Uncalled bet ($0.08) returned to The-End-snglr
The-End-snglr collected $0.34 from pot
The-End-snglr: doesn't show hand 
*** SUMMARY ***
Total pot $0.35 | Rake $0.01 
Board [Ks 4d As 6h Qs]
Seat 1: Apollonnn_13 (button) folded on the River
Seat 2: Scaaalll (small blind) folded before Flop
Seat 3: Yangyang1407 (big blind) folded before Flop
Seat 4: jnbjnb1010 folded before Flop (didn't bet)
Seat 5: The-End-snglr collected ($0.34)
Seat 6: KKARMELO folded before Flop (didn't bet)



PokerStars Zoom Hand #229233011211:  Hold'em No Limit ($0.01/$0.02) - 2021/08/21 23:13:38 CET [2021/08/21 17:13:38 ET]
Table 'Halley' 6-max Seat #1 is the button
Seat 1: Scaaalll ($4.32 in chips) 
Seat 2: babiloniaxxx ($2.42 in chips) 
Seat 3: RaulacateFolds ($2.12 in chips) 
Seat 4: NIK1973 23 ($2 in chips) 
Seat 5: jribeiros ($1 in chips) 
Seat 6: amario89 ($2.21 in chips) 
babiloniaxxx: posts small blind $0.01
RaulacateFolds: posts big blind $0.02
*** HOLE CARDS ***
Dealt to Scaaalll [Ah 6s]
NIK1973 23: raises $0.04 to $0.06
jribeiros: raises $0.14 to $0.20
amario89: folds 
Scaaalll: folds 
babiloniaxxx: folds 
RaulacateFolds: folds 
NIK1973 23: raises $1.80 to $2 and is all-in
jribeiros: calls $0.80 and is all-in
Uncalled bet ($1) returned to NIK1973 23
*** FLOP *** [7d Jh 3h]
*** TURN *** [7d Jh 3h] [7c]
*** RIVER *** [7d Jh 3h 7c] [4h]
*** SHOW DOWN ***
NIK1973 23: shows [As Ad] (two pair, Aces and Sevens)
jribeiros: shows [Qc Qd] (two pair, Queens and Sevens)
NIK1973 23 collected $1.96 from pot
*** SUMMARY ***
Total pot $2.03 | Rake $0.07 
Board [7d Jh 3h 7c 4h]
Seat 1: Scaaalll (button) folded before Flop (didn't bet)
Seat 2: babiloniaxxx (small blind) folded before Flop
Seat 3: RaulacateFolds (big blind) folded before Flop
Seat 4: NIK1973 23 showed [As Ad] and won ($1.96) with two pair, Aces and Sevens
Seat 5: jribeiros showed [Qc Qd] and lost with two pair, Queens and Sevens
Seat 6: amario89 folded before Flop (didn't bet)



PokerStars Zoom Hand #229233018897:  Hold'em No Limit ($0.01/$0.02) - 2021/08/21 23:13:56 CET [2021/08/21 17:13:56 ET]
Table 'Halley' 6-max Seat #1 is the button
Seat 1: BMRB1991 ($1 in chips) 
Seat 2: new face onl ($2.06 in chips) 
Seat 3: cbbbka ($3.95 in chips) 
Seat 4: Scaaalll ($4.32 in chips) 
Seat 5: Sv1ch ($1.74 in chips) 
Seat 6: Apollonnn_13 ($1.82 in chips) 
new face onl: posts small blind $0.01
cbbbka: posts big blind $0.02
*** HOLE CARDS ***
Dealt to Scaaalll [7c Ks]
Scaaalll: folds 
Sv1ch: folds 
Apollonnn_13: folds 
BMRB1991: folds 
new face onl: raises $0.05 to $0.07
cbbbka: calls $0.05
*** FLOP *** [9c 4s 7h]
new face onl: checks 
cbbbka: checks 
*** TURN *** [9c 4s 7h] [3c]
new face onl: bets $0.07
cbbbka: calls $0.07
*** RIVER *** [9c 4s 7h 3c] [7d]
new face onl: bets $0.14
cbbbka: raises $0.18 to $0.32
new face onl: folds 
Uncalled bet ($0.18) returned to cbbbka
cbbbka collected $0.54 from pot
cbbbka: doesn't show hand 
*** SUMMARY ***
Total pot $0.56 | Rake $0.02 
Board [9c 4s 7h 3c 7d]
Seat 1: BMRB1991 (button) folded before Flop (didn't bet)
Seat 2: new face onl (small blind) folded on the River
Seat 3: cbbbka (big blind) collected ($0.54)
Seat 4: Scaaalll folded before Flop (didn't bet)
Seat 5: Sv1ch folded before Flop (didn't bet)
Seat 6: Apollonnn_13 folded before Flop (didn't bet)



PokerStars Zoom Hand #229233104059:  Hold'em No Limit ($0.01/$0.02) - 2021/08/21 23:17:14 CET [2021/08/21 17:17:14 ET]
Table 'Halley' 6-max Seat #1 is the button
Seat 1: trasi1e ($1.07 in chips) 
Seat 2: Scaaalll ($4.30 in chips) 
Seat 3: ukesco ($1.01 in chips) 
Seat 4: Healthys07 ($3.01 in chips) 
Seat 5: sg.32rus ($1.97 in chips) 
Seat 6: Gamer577 ($4.38 in chips) 
Scaaalll: posts small blind $0.01
ukesco: posts big blind $0.02
*** HOLE CARDS ***
Dealt to Scaaalll [5h Jh]
Healthys07: folds 
trasi1e is disconnected 
sg.32rus: raises $0.04 to $0.06
Gamer577: folds 
trasi1e: folds 
Scaaalll: folds 
ukesco: folds 
Uncalled bet ($0.04) returned to sg.32rus
sg.32rus collected $0.05 from pot
sg.32rus: doesn't show hand 
*** SUMMARY ***
Total pot $0.05 | Rake $0 
Seat 1: trasi1e (button) folded before Flop (didn't bet)
Seat 2: Scaaalll (small blind) folded before Flop
Seat 3: ukesco (big blind) folded before Flop
Seat 4: Healthys07 folded before Flop (didn't bet)
Seat 5: sg.32rus collected ($0.05)
Seat 6: Gamer577 folded before Flop (didn't bet)



PokerStars Zoom Hand #229233097180:  Hold'em No Limit ($0.01/$0.02) - 2021/08/21 23:16:58 CET [2021/08/21 17:16:58 ET]
Table 'Halley' 6-max Seat #1 is the button
Seat 1: kidninja888 ($2.15 in chips) 
Seat 2: Knutzers ($2 in chips) 
Seat 3: Scaaalll ($4.32 in chips) 
Seat 4: Ryan Colls ($2.08 in chips) 
Seat 5: GrindToGlory ($2.31 in chips) 
Seat 6: Valansen ($2.03 in chips) 
Knutzers: posts small blind $0.01
Scaaalll: posts big blind $0.02
*** HOLE CARDS ***
Dealt to Scaaalll [6s Kc]
Ryan Colls: folds 
Ryan Colls is disconnected 
GrindToGlory: raises $0.03 to $0.05
Valansen: folds 
kidninja888: raises $0.13 to $0.18
Knutzers: folds 
Scaaalll: folds 
GrindToGlory: calls $0.13
*** FLOP *** [2s Ks 7d]
GrindToGlory: checks 
kidninja888: bets $0.23
GrindToGlory: calls $0.23
*** TURN *** [2s Ks 7d] [2c]
GrindToGlory: checks 
kidninja888: bets $0.49
GrindToGlory: calls $0.49
*** RIVER *** [2s Ks 7d 2c] [Jd]
GrindToGlory: checks 
kidninja888: checks 
*** SHOW DOWN ***
GrindToGlory: shows [Qs Qd] (two pair, Queens and Deuces)
kidninja888: mucks hand 
GrindToGlory collected $1.75 from pot
*** SUMMARY ***
Total pot $1.83 | Rake $0.08 
Board [2s Ks 7d 2c Jd]
Seat 1: kidninja888 (button) mucked [9h 7h]
Seat 2: Knutzers (small blind) folded before Flop
Seat 3: Scaaalll (big blind) folded before Flop
Seat 4: Ryan Colls folded before Flop (didn't bet)
Seat 5: GrindToGlory showed [Qs Qd] and won ($1.75) with two pair, Queens and Deuces
Seat 6: Valansen folded before Flop (didn't bet)



PokerStars Zoom Hand #229233112174:  Hold'em No Limit ($0.01/$0.02) - 2021/08/21 23:17:33 CET [2021/08/21 17:17:33 ET]
Table 'Halley' 6-max Seat #1 is the button
Seat 1: Scaaalll ($4.29 in chips) 
Seat 2: EzukoChan ($3.29 in chips) 
Seat 3: selinus007 ($1.12 in chips) 
Seat 4: Wegezin ($3.10 in chips) 
Seat 5: Bol'tazar111 ($2.62 in chips) 
Seat 6: pavlo8855 ($2.16 in chips) 
EzukoChan: posts small blind $0.01
selinus007: posts big blind $0.02
*** HOLE CARDS ***
Dealt to Scaaalll [5c Qs]
Wegezin: folds 
Bol'tazar111: folds 
pavlo8855: folds 
Scaaalll: folds 
EzukoChan: raises $0.04 to $0.06
selinus007: folds 
Uncalled bet ($0.04) returned to EzukoChan
EzukoChan collected $0.04 from pot
EzukoChan: doesn't show hand 
selinus007 is disconnected 
*** SUMMARY ***
Total pot $0.04 | Rake $0 
Seat 1: Scaaalll (button) folded before Flop (didn't bet)
Seat 2: EzukoChan (small blind) collected ($0.04)
Seat 3: selinus007 (big blind) folded before Flop
Seat 4: Wegezin folded before Flop (didn't bet)
Seat 5: Bol'tazar111 folded before Flop (didn't bet)
Seat 6: pavlo8855 folded before Flop (didn't bet)



PokerStars Zoom Hand #229233106175:  Hold'em No Limit ($0.01/$0.02) - 2021/08/21 23:17:19 CET [2021/08/21 17:17:19 ET]
Table 'Halley' 6-max Seat #1 is the button
Seat 1: d11dozer ($1.74 in chips) 
Seat 2: Pechorin.G ($2.07 in chips) 
Seat 3: orlovac1995 ($3.97 in chips) 
Seat 4: ctaceo ($2.08 in chips) 
Seat 5: Scaaalll ($4.29 in chips) 
Seat 6: alphabeta1d ($2 in chips) 
Pechorin.G: posts small blind $0.01
orlovac1995: posts big blind $0.02
*** HOLE CARDS ***
Dealt to Scaaalll [Tc 9d]
ctaceo: folds 
Scaaalll: folds 
alphabeta1d: raises $0.05 to $0.07
d11dozer: folds 
Pechorin.G: folds 
orlovac1995: calls $0.05
*** FLOP *** [2s 3h 6h]
orlovac1995: checks 
alphabeta1d: bets $0.11
orlovac1995: folds 
Uncalled bet ($0.11) returned to alphabeta1d
alphabeta1d collected $0.14 from pot
alphabeta1d: doesn't show hand 
*** SUMMARY ***
Total pot $0.15 | Rake $0.01 
Board [2s 3h 6h]
Seat 1: d11dozer (button) folded before Flop (didn't bet)
Seat 2: Pechorin.G (small blind) folded before Flop
Seat 3: orlovac1995 (big blind) folded on the Flop
Seat 4: ctaceo folded before Flop (didn't bet)
Seat 5: Scaaalll folded before Flop (didn't bet)
Seat 6: alphabeta1d collected ($0.14)



PokerStars Zoom Hand #229233116409:  Hold'em No Limit ($0.01/$0.02) - 2021/08/21 23:17:43 CET [2021/08/21 17:17:43 ET]
Table 'Halley' 6-max Seat #1 is the button
Seat 1: Taran0001 ($1.58 in chips) 
Seat 2: NeckCarp ($1.15 in chips) 
Seat 3: amario89 ($2.05 in chips) 
Seat 4: OFSHOR ($3.90 in chips) 
Seat 5: polymorhp ($3.34 in chips) 
Seat 6: Scaaalll ($4.29 in chips) 
NeckCarp: posts small blind $0.01
amario89: posts big blind $0.02
*** HOLE CARDS ***
Dealt to Scaaalll [Ks 4c]
OFSHOR: folds 
polymorhp: folds 
NeckCarp is disconnected 
Scaaalll: folds 
Taran0001: raises $0.02 to $0.04
NeckCarp: folds 
amario89: folds 
Uncalled bet ($0.02) returned to Taran0001
Taran0001 collected $0.05 from pot
Taran0001: doesn't show hand 
*** SUMMARY ***
Total pot $0.05 | Rake $0 
Seat 1: Taran0001 (button) collected ($0.05)
Seat 2: NeckCarp (small blind) folded before Flop
Seat 3: amario89 (big blind) folded before Flop
Seat 4: OFSHOR folded before Flop (didn't bet)
Seat 5: polymorhp folded before Flop (didn't bet)
Seat 6: Scaaalll folded before Flop (didn't bet)



PokerStars Zoom Hand #229233121926:  Hold'em No Limit ($0.01/$0.02) - 2021/08/21 23:17:56 CET [2021/08/21 17:17:56 ET]
Table 'Halley' 6-max Seat #1 is the button
Seat 1: diamonds410 ($0.97 in chips) 
Seat 2: Attention1909 ($1.92 in chips) 
Seat 3: Astel88 ($2.41 in chips) 
Seat 4: San4oWV ($2.22 in chips) 
Seat 5: Scaaalll ($4.29 in chips) 
Seat 6: Wegezin ($2 in chips) 
Attention1909: posts small blind $0.01
Astel88: posts big blind $0.02
*** HOLE CARDS ***
Dealt to Scaaalll [5h 4s]
diamonds410 is disconnected 
San4oWV: folds 
Scaaalll: folds 
Wegezin: folds 
diamonds410: folds 
Attention1909: raises $1.90 to $1.92 and is all-in
Astel88: folds 
Uncalled bet ($1.90) returned to Attention1909
Attention1909 collected $0.04 from pot
Attention1909: doesn't show hand 
Astel88 is disconnected 
*** SUMMARY ***
Total pot $0.04 | Rake $0 
Seat 1: diamonds410 (button) folded before Flop (didn't bet)
Seat 2: Attention1909 (small blind) collected ($0.04)
Seat 3: Astel88 (big blind) folded before Flop
Seat 4: San4oWV folded before Flop (didn't bet)
Seat 5: Scaaalll folded before Flop (didn't bet)
Seat 6: Wegezin folded before Flop (didn't bet)



PokerStars Zoom Hand #229233129952:  Hold'em No Limit ($0.01/$0.02) - 2021/08/21 23:18:15 CET [2021/08/21 17:18:15 ET]
Table 'Halley' 6-max Seat #1 is the button
Seat 1: Pulp Hands ($2 in chips) 
Seat 2: zergmiky ($2 in chips) 
Seat 3: Scaaalll ($4.28 in chips) 
Seat 4: Boris_Garich ($2.13 in chips) 
Seat 5: Mac9Monty2 ($2.44 in chips) 
Seat 6: so0love ($2.18 in chips) 
zergmiky: posts small blind $0.01
Scaaalll: posts big blind $0.02
*** HOLE CARDS ***
Dealt to Scaaalll [3c Ts]
Boris_Garich: raises $0.04 to $0.06
Mac9Monty2: folds 
so0love: folds 
Pulp Hands: folds 
zergmiky: folds 
Scaaalll: folds 
Uncalled bet ($0.04) returned to Boris_Garich
Boris_Garich collected $0.05 from pot
Boris_Garich: doesn't show hand 
*** SUMMARY ***
Total pot $0.05 | Rake $0 
Seat 1: Pulp Hands (button) folded before Flop (didn't bet)
Seat 2: zergmiky (small blind) folded before Flop
Seat 3: Scaaalll (big blind) folded before Flop
Seat 4: Boris_Garich collected ($0.05)
Seat 5: Mac9Monty2 folded before Flop (didn't bet)
Seat 6: so0love folded before Flop (didn't bet)



PokerStars Zoom Hand #229233127458:  Hold'em No Limit ($0.01/$0.02) - 2021/08/21 23:18:09 CET [2021/08/21 17:18:09 ET]
Table 'Halley' 6-max Seat #1 is the button
Seat 1: Scaaalll ($4.28 in chips) 
Seat 2: Alegry-Babay ($2.05 in chips) 
Seat 3: Shoxuzb ($2 in chips) 
Seat 4: obnoman ($3.43 in chips) 
Seat 5: alexan00 ($2.03 in chips) 
Seat 6: Tzunnamy ($1.56 in chips) 
Alegry-Babay: posts small blind $0.01
Shoxuzb: posts big blind $0.02
*** HOLE CARDS ***
Dealt to Scaaalll [7c 9d]
Tzunnamy is disconnected 
obnoman: folds 
alexan00: folds 
Tzunnamy: folds 
Scaaalll: folds 
obnoman is disconnected 
Alegry-Babay: calls $0.01
Shoxuzb: checks 
*** FLOP *** [Kc 9c 5c]
Alegry-Babay: bets $0.02
Shoxuzb: calls $0.02
*** TURN *** [Kc 9c 5c] [3c]
Alegry-Babay: checks 
Shoxuzb: bets $0.02
Alegry-Babay: folds 
Uncalled bet ($0.02) returned to Shoxuzb
Shoxuzb collected $0.08 from pot
Shoxuzb: doesn't show hand 
*** SUMMARY ***
Total pot $0.08 | Rake $0 
Board [Kc 9c 5c 3c]
Seat 1: Scaaalll (button) folded before Flop (didn't bet)
Seat 2: Alegry-Babay (small blind) folded on the Turn
Seat 3: Shoxuzb (big blind) collected ($0.08)
Seat 4: obnoman folded before Flop (didn't bet)
Seat 5: alexan00 folded before Flop (didn't bet)
Seat 6: Tzunnamy folded before Flop (didn't bet)



PokerStars Zoom Hand #229233139582:  Hold'em No Limit ($0.01/$0.02) - 2021/08/21 23:18:38 CET [2021/08/21 17:18:38 ET]
Table 'Halley' 6-max Seat #1 is the button
Seat 1: CrazyyParis ($2.01 in chips) 
Seat 2: osantos401 ($8.07 in chips) 
Seat 3: Scaaalll ($4.26 in chips) 
Seat 4: Mac9Monty2 ($2.13 in chips) 
Seat 5: Reipinguimm ($2.27 in chips) 
Seat 6: estelionat171 ($0.89 in chips) 
osantos401: posts small blind $0.01
Scaaalll: posts big blind $0.02
*** HOLE CARDS ***
Dealt to Scaaalll [Jd 8d]
Mac9Monty2: folds 
Reipinguimm: folds 
estelionat171: folds 
CrazyyParis: raises $0.03 to $0.05
osantos401: folds 
Scaaalll: folds 
Uncalled bet ($0.03) returned to CrazyyParis
CrazyyParis collected $0.05 from pot
CrazyyParis: doesn't show hand 
*** SUMMARY ***
Total pot $0.05 | Rake $0 
Seat 1: CrazyyParis (button) collected ($0.05)
Seat 2: osantos401 (small blind) folded before Flop
Seat 3: Scaaalll (big blind) folded before Flop
Seat 4: Mac9Monty2 folded before Flop (didn't bet)
Seat 5: Reipinguimm folded before Flop (didn't bet)
Seat 6: estelionat171 folded before Flop (didn't bet)



PokerStars Zoom Hand #229233136249:  Hold'em No Limit ($0.01/$0.02) - 2021/08/21 23:18:30 CET [2021/08/21 17:18:30 ET]
Table 'Halley' 6-max Seat #1 is the button
Seat 1: gordoatlantico ($3.11 in chips) 
Seat 2: blubfishi Òó ($1.98 in chips) 
Seat 3: alexmpokes ($2.15 in chips) 
Seat 4: alphabeta1d ($2 in chips) 
Seat 5: zergmiky ($2.14 in chips) 
Seat 6: Scaaalll ($4.26 in chips) 
blubfishi Òó: posts small blind $0.01
alexmpokes: posts big blind $0.02
*** HOLE CARDS ***
Dealt to Scaaalll [Kc 9s]
alphabeta1d: folds 
zergmiky: folds 
Scaaalll: folds 
gordoatlantico: folds 
blubfishi Òó: folds 
Uncalled bet ($0.01) returned to alexmpokes
alexmpokes collected $0.02 from pot
alexmpokes: doesn't show hand 
*** SUMMARY ***
Total pot $0.02 | Rake $0 
Seat 1: gordoatlantico (button) folded before Flop (didn't bet)
Seat 2: blubfishi Òó (small blind) folded before Flop
Seat 3: alexmpokes (big blind) collected ($0.02)
Seat 4: alphabeta1d folded before Flop (didn't bet)
Seat 5: zergmiky folded before Flop (didn't bet)
Seat 6: Scaaalll folded before Flop (didn't bet)



PokerStars Zoom Hand #229233150076:  Hold'em No Limit ($0.01/$0.02) - 2021/08/21 23:18:53 CET [2021/08/21 17:18:53 ET]
Table 'Halley' 6-max Seat #1 is the button
Seat 1: fishh_play ($2.24 in chips) 
Seat 2: martinob11 ($1.90 in chips) 
Seat 3: Billy Beane1 ($2.21 in chips) 
Seat 4: samyr1111 ($2.35 in chips) 
Seat 5: Scaaalll ($4.24 in chips) 
Seat 6: bioern ($3.78 in chips) 
martinob11: posts small blind $0.01
Billy Beane1: posts big blind $0.02
*** HOLE CARDS ***
Dealt to Scaaalll [Qh 4c]
samyr1111: folds 
Scaaalll: folds 
bioern: folds 
samyr1111 is disconnected 
fishh_play: raises $0.03 to $0.05
martinob11: folds 
Billy Beane1: folds 
Uncalled bet ($0.03) returned to fishh_play
fishh_play collected $0.05 from pot
fishh_play: doesn't show hand 
*** SUMMARY ***
Total pot $0.05 | Rake $0 
Seat 1: fishh_play (button) collected ($0.05)
Seat 2: martinob11 (small blind) folded before Flop
Seat 3: Billy Beane1 (big blind) folded before Flop
Seat 4: samyr1111 folded before Flop (didn't bet)
Seat 5: Scaaalll folded before Flop (didn't bet)
Seat 6: bioern folded before Flop (didn't bet)



PokerStars Zoom Hand #229233124062:  Hold'em No Limit ($0.01/$0.02) - 2021/08/21 23:18:01 CET [2021/08/21 17:18:01 ET]
Table 'Halley' 6-max Seat #1 is the button
Seat 1: Espartacus5222 ($2.10 in chips) 
Seat 2: Scaaalll ($4.29 in chips) 
Seat 3: ASAjr ($2.56 in chips) 
Seat 4: CrazyyParis ($2.03 in chips) 
Seat 5: KonopDima ($2.03 in chips) 
Seat 6: Cid s2 ($2.32 in chips) 
Scaaalll: posts small blind $0.01
ASAjr: posts big blind $0.02
*** HOLE CARDS ***
Dealt to Scaaalll [5c Qd]
CrazyyParis: folds 
KonopDima: folds 
Cid s2: calls $0.02
Espartacus5222: raises $0.06 to $0.08
Scaaalll: folds 
ASAjr: folds 
Cid s2: calls $0.06
*** FLOP *** [Jh 3s Qh]
Cid s2: checks 
Espartacus5222: bets $0.06
Cid s2: calls $0.06
*** TURN *** [Jh 3s Qh] [7s]
Cid s2: checks 
Espartacus5222: bets $0.30
Cid s2: folds 
Uncalled bet ($0.30) returned to Espartacus5222
Espartacus5222 collected $0.30 from pot
Espartacus5222: doesn't show hand 
*** SUMMARY ***
Total pot $0.31 | Rake $0.01 
Board [Jh 3s Qh 7s]
Seat 1: Espartacus5222 (button) collected ($0.30)
Seat 2: Scaaalll (small blind) folded before Flop
Seat 3: ASAjr (big blind) folded before Flop
Seat 4: CrazyyParis folded before Flop (didn't bet)
Seat 5: KonopDima folded before Flop (didn't bet)
Seat 6: Cid s2 folded on the Turn



PokerStars Zoom Hand #229233151724:  Hold'em No Limit ($0.01/$0.02) - 2021/08/21 23:18:57 CET [2021/08/21 17:18:57 ET]
Table 'Halley' 6-max Seat #1 is the button
Seat 1: isurusa ($1.94 in chips) 
Seat 2: Scaaalll ($4.24 in chips) 
Seat 3: auxy89 ($3.62 in chips) 
Seat 4: kukulagosleep ($3.57 in chips) 
Seat 5: Thaleshs ($3.77 in chips) 
Seat 6: Xlavariable ($2.26 in chips) 
Scaaalll: posts small blind $0.01
auxy89: posts big blind $0.02
*** HOLE CARDS ***
Dealt to Scaaalll [9d Ad]
kukulagosleep: folds 
Thaleshs: folds 
Xlavariable: raises $0.04 to $0.06
isurusa: folds 
Scaaalll: raises $0.14 to $0.20
auxy89: calls $0.18
Xlavariable: folds 
*** FLOP *** [9s Jh 3h]
Scaaalll: checks 
auxy89: checks 
*** TURN *** [9s Jh 3h] [As]
Scaaalll: bets $0.28
auxy89: calls $0.28
*** RIVER *** [9s Jh 3h As] [Kd]
Scaaalll: bets $0.42
auxy89: folds 
Uncalled bet ($0.42) returned to Scaaalll
Scaaalll collected $0.97 from pot
Scaaalll: doesn't show hand 
auxy89 is disconnected 
*** SUMMARY ***
Total pot $1.02 | Rake $0.05 
Board [9s Jh 3h As Kd]
Seat 1: isurusa (button) folded before Flop (didn't bet)
Seat 2: Scaaalll (small blind) collected ($0.97)
Seat 3: auxy89 (big blind) folded on the River
Seat 4: kukulagosleep folded before Flop (didn't bet)
Seat 5: Thaleshs folded before Flop (didn't bet)
Seat 6: Xlavariable folded before Flop



PokerStars Zoom Hand #229233179866:  Hold'em No Limit ($0.01/$0.02) - 2021/08/21 23:20:03 CET [2021/08/21 17:20:03 ET]
Table 'Halley' 6-max Seat #1 is the button
Seat 1: Scaaalll ($4.73 in chips) 
Seat 2: Cineva81 ($2 in chips) 
Seat 3: HubertFroh ($4.84 in chips) 
Seat 4: Den198443 ($2.53 in chips) 
Seat 5: Mac9Monty2 ($2.56 in chips) 
Seat 6: ernmic ($2.24 in chips) 
Cineva81: posts small blind $0.01
HubertFroh: posts big blind $0.02
*** HOLE CARDS ***
Dealt to Scaaalll [5c 8h]
Den198443: folds 
Mac9Monty2: folds 
ernmic: folds 
Scaaalll: folds 
Cineva81: folds 
Uncalled bet ($0.01) returned to HubertFroh
HubertFroh collected $0.02 from pot
HubertFroh: doesn't show hand 
*** SUMMARY ***
Total pot $0.02 | Rake $0 
Seat 1: Scaaalll (button) folded before Flop (didn't bet)
Seat 2: Cineva81 (small blind) folded before Flop
Seat 3: HubertFroh (big blind) collected ($0.02)
Seat 4: Den198443 folded before Flop (didn't bet)
Seat 5: Mac9Monty2 folded before Flop (didn't bet)
Seat 6: ernmic folded before Flop (didn't bet)



PokerStars Zoom Hand #229233182481:  Hold'em No Limit ($0.01/$0.02) - 2021/08/21 23:20:09 CET [2021/08/21 17:20:09 ET]
Table 'Halley' 6-max Seat #1 is the button
Seat 1: babiloniaxxx ($2.70 in chips) 
Seat 2: OFSHOR ($3.92 in chips) 
Seat 3: ASAjr ($2.33 in chips) 
Seat 4: Scaaalll ($4.73 in chips) 
Seat 5: MattieBOZ ($2.99 in chips) 
Seat 6: Thaleshs ($2.24 in chips) 
OFSHOR: posts small blind $0.01
ASAjr: posts big blind $0.02
*** HOLE CARDS ***
Dealt to Scaaalll [2s 9d]
Scaaalll: folds 
MattieBOZ: folds 
MattieBOZ is disconnected 
Thaleshs: folds 
babiloniaxxx: raises $0.03 to $0.05
OFSHOR: folds 
ASAjr: folds 
Uncalled bet ($0.03) returned to babiloniaxxx
babiloniaxxx collected $0.05 from pot
babiloniaxxx: doesn't show hand 
*** SUMMARY ***
Total pot $0.05 | Rake $0 
Seat 1: babiloniaxxx (button) collected ($0.05)
Seat 2: OFSHOR (small blind) folded before Flop
Seat 3: ASAjr (big blind) folded before Flop
Seat 4: Scaaalll folded before Flop (didn't bet)
Seat 5: MattieBOZ folded before Flop (didn't bet)
Seat 6: Thaleshs folded before Flop (didn't bet)



PokerStars Zoom Hand #229233184144:  Hold'em No Limit ($0.01/$0.02) - 2021/08/21 23:20:13 CET [2021/08/21 17:20:13 ET]
Table 'Halley' 6-max Seat #1 is the button
Seat 1: *88VIC88* ($0.51 in chips) 
Seat 2: rabbitmeat73 ($1.82 in chips) 
Seat 3: TTGemi ($3.12 in chips) 
Seat 4: Jellycube ($4.05 in chips) 
Seat 5: Scaaalll ($4.73 in chips) 
Seat 6: dkno77 ($1.84 in chips) 
rabbitmeat73: posts small blind $0.01
TTGemi: posts big blind $0.02
*** HOLE CARDS ***
Dealt to Scaaalll [Qc As]
*88VIC88* is disconnected 
Jellycube: raises $0.04 to $0.06
Scaaalll: calls $0.06
dkno77: folds 
*88VIC88*: folds 
rabbitmeat73: folds 
TTGemi: folds 
*** FLOP *** [9s 7s 4s]
Jellycube: bets $0.11
Scaaalll: calls $0.11
*** TURN *** [9s 7s 4s] [Td]
Jellycube: bets $0.30
Scaaalll: folds 
Uncalled bet ($0.30) returned to Jellycube
Jellycube collected $0.36 from pot
Jellycube: doesn't show hand 
*** SUMMARY ***
Total pot $0.37 | Rake $0.01 
Board [9s 7s 4s Td]
Seat 1: *88VIC88* (button) folded before Flop (didn't bet)
Seat 2: rabbitmeat73 (small blind) folded before Flop
Seat 3: TTGemi (big blind) folded before Flop
Seat 4: Jellycube collected ($0.36)
Seat 5: Scaaalll folded on the Turn
Seat 6: dkno77 folded before Flop (didn't bet)



PokerStars Zoom Hand #229233198915:  Hold'em No Limit ($0.01/$0.02) - 2021/08/21 23:20:48 CET [2021/08/21 17:20:48 ET]
Table 'Halley' 6-max Seat #1 is the button
Seat 1: lucksuckdonk ($3.62 in chips) 
Seat 2: Taran0001 ($1.78 in chips) 
Seat 3: Mr.Kurier ($4.78 in chips) 
Seat 4: HubertFroh ($4.84 in chips) 
Seat 5: Tibeau21 ($0.89 in chips) 
Seat 6: Scaaalll ($4.56 in chips) 
Taran0001: posts small blind $0.01
Mr.Kurier: posts big blind $0.02
*** HOLE CARDS ***
Dealt to Scaaalll [Qd Ac]
HubertFroh: folds 
Tibeau21: folds 
Tibeau21 is disconnected 
Scaaalll: raises $0.04 to $0.06
lucksuckdonk: raises $0.14 to $0.20
Taran0001: folds 
Mr.Kurier: folds 
Scaaalll: folds 
Uncalled bet ($0.14) returned to lucksuckdonk
lucksuckdonk collected $0.15 from pot
lucksuckdonk: doesn't show hand 
*** SUMMARY ***
Total pot $0.15 | Rake $0 
Seat 1: lucksuckdonk (button) collected ($0.15)
Seat 2: Taran0001 (small blind) folded before Flop
Seat 3: Mr.Kurier (big blind) folded before Flop
Seat 4: HubertFroh folded before Flop (didn't bet)
Seat 5: Tibeau21 folded before Flop (didn't bet)
Seat 6: Scaaalll folded before Flop



PokerStars Zoom Hand #229233209085:  Hold'em No Limit ($0.01/$0.02) - 2021/08/21 23:21:12 CET [2021/08/21 17:21:12 ET]
Table 'Halley' 6-max Seat #1 is the button
Seat 1: blubfishi Òó ($1.91 in chips) 
Seat 2: BeastBoy18 ($2 in chips) 
Seat 3: Scaaalll ($4.50 in chips) 
Seat 4: kukulagosleep ($3.48 in chips) 
Seat 5: TTGemi ($2.62 in chips) 
Seat 6: djovex ($0.41 in chips) 
BeastBoy18: posts small blind $0.01
Scaaalll: posts big blind $0.02
*** HOLE CARDS ***
Dealt to Scaaalll [Jc 9c]
djovex is disconnected 
kukulagosleep: folds 
TTGemi: folds 
djovex: folds 
blubfishi Òó: folds 
BeastBoy18: raises $0.04 to $0.06
Scaaalll: calls $0.04
*** FLOP *** [6c Th Ad]
BeastBoy18: bets $0.04
Scaaalll: folds 
Uncalled bet ($0.04) returned to BeastBoy18
BeastBoy18 collected $0.12 from pot
BeastBoy18: doesn't show hand 
*** SUMMARY ***
Total pot $0.12 | Rake $0 
Board [6c Th Ad]
Seat 1: blubfishi Òó (button) folded before Flop (didn't bet)
Seat 2: BeastBoy18 (small blind) collected ($0.12)
Seat 3: Scaaalll (big blind) folded on the Flop
Seat 4: kukulagosleep folded before Flop (didn't bet)
Seat 5: TTGemi folded before Flop (didn't bet)
Seat 6: djovex folded before Flop (didn't bet)



PokerStars Zoom Hand #229233207277:  Hold'em No Limit ($0.01/$0.02) - 2021/08/21 23:21:08 CET [2021/08/21 17:21:08 ET]
Table 'Halley' 6-max Seat #1 is the button
Seat 1: Posaunengodi ($2.71 in chips) 
Seat 2: Hejpåre ($3.32 in chips) 
Seat 3: Earl_greyPL ($1.67 in chips) 
Seat 4: Scaaalll ($4.50 in chips) 
Seat 5: Richaud ($3.82 in chips) 
Seat 6: ivorypiano ($5.98 in chips) 
Hejpåre: posts small blind $0.01
Earl_greyPL: posts big blind $0.02
*** HOLE CARDS ***
Dealt to Scaaalll [Ts 9c]
Scaaalll: folds 
Richaud: raises $0.04 to $0.06
ivorypiano: raises $0.04 to $0.10
Posaunengodi: folds 
Hejpåre: folds 
Earl_greyPL: folds 
Richaud: calls $0.04
*** FLOP *** [Kc 7c Kh]
Richaud: checks 
ivorypiano: bets $0.11
Richaud: calls $0.11
*** TURN *** [Kc 7c Kh] [As]
Richaud: checks 
ivorypiano: checks 
*** RIVER *** [Kc 7c Kh As] [3s]
Richaud: bets $0.46
ivorypiano: calls $0.46
*** SHOW DOWN ***
Richaud: shows [Kd Ad] (a full house, Kings full of Aces)
ivorypiano: mucks hand 
Richaud collected $1.32 from pot
*** SUMMARY ***
Total pot $1.37 | Rake $0.05 
Board [Kc 7c Kh As 3s]
Seat 1: Posaunengodi (button) folded before Flop (didn't bet)
Seat 2: Hejpåre (small blind) folded before Flop
Seat 3: Earl_greyPL (big blind) folded before Flop
Seat 4: Scaaalll folded before Flop (didn't bet)
Seat 5: Richaud showed [Kd Ad] and won ($1.32) with a full house, Kings full of Aces
Seat 6: ivorypiano mucked [Jh Jc]



PokerStars Zoom Hand #229233221038:  Hold'em No Limit ($0.01/$0.02) - 2021/08/21 23:21:40 CET [2021/08/21 17:21:40 ET]
Table 'Halley' 6-max Seat #1 is the button
Seat 1: Feliciano16 ($7.27 in chips) 
Seat 2: Scaaalll ($4.44 in chips) 
Seat 3: Yangyang1407 ($2.49 in chips) 
Seat 4: Pizotifen ($2 in chips) 
Seat 5: Mustang01373 ($1.35 in chips) 
Seat 6: PapiMik3 ($7.50 in chips) 
Scaaalll: posts small blind $0.01
Yangyang1407: posts big blind $0.02
*** HOLE CARDS ***
Dealt to Scaaalll [Tc Jd]
Pizotifen: folds 
Mustang01373: folds 
PapiMik3: raises $0.04 to $0.06
Feliciano16: folds 
Scaaalll: folds 
Yangyang1407: folds 
Uncalled bet ($0.04) returned to PapiMik3
PapiMik3 collected $0.05 from pot
PapiMik3: doesn't show hand 
*** SUMMARY ***
Total pot $0.05 | Rake $0 
Seat 1: Feliciano16 (button) folded before Flop (didn't bet)
Seat 2: Scaaalll (small blind) folded before Flop
Seat 3: Yangyang1407 (big blind) folded before Flop
Seat 4: Pizotifen folded before Flop (didn't bet)
Seat 5: Mustang01373 folded before Flop (didn't bet)
Seat 6: PapiMik3 collected ($0.05)



PokerStars Zoom Hand #229233227358:  Hold'em No Limit ($0.01/$0.02) - 2021/08/21 23:21:55 CET [2021/08/21 17:21:55 ET]
Table 'Halley' 6-max Seat #1 is the button
Seat 1: Scaaalll ($4.43 in chips) 
Seat 2: Craitastrophe ($2.09 in chips) 
Seat 3: bossquaid ($2.04 in chips) 
Seat 4: didiclavi777 ($2.93 in chips) 
Seat 5: Hejpåre ($2.05 in chips) 
Seat 6: lucksuckdonk ($7.95 in chips) 
Craitastrophe: posts small blind $0.01
bossquaid: posts big blind $0.02
*** HOLE CARDS ***
Dealt to Scaaalll [Ad Td]
didiclavi777: folds 
Hejpåre: folds 
lucksuckdonk: folds 
Craitastrophe is disconnected 
Scaaalll: raises $0.02 to $0.04
Craitastrophe: folds 
bossquaid: folds 
Uncalled bet ($0.02) returned to Scaaalll
Scaaalll collected $0.05 from pot
Scaaalll: doesn't show hand 
*** SUMMARY ***
Total pot $0.05 | Rake $0 
Seat 1: Scaaalll (button) collected ($0.05)
Seat 2: Craitastrophe (small blind) folded before Flop
Seat 3: bossquaid (big blind) folded before Flop
Seat 4: didiclavi777 folded before Flop (didn't bet)
Seat 5: Hejpåre folded before Flop (didn't bet)
Seat 6: lucksuckdonk folded before Flop (didn't bet)



PokerStars Zoom Hand #229233225686:  Hold'em No Limit ($0.01/$0.02) - 2021/08/21 23:21:51 CET [2021/08/21 17:21:51 ET]
Table 'Halley' 6-max Seat #1 is the button
Seat 1: Vahenta ($2.83 in chips) 
Seat 2: dkno77 ($2.51 in chips) 
Seat 3: Earl_greyPL ($1.35 in chips) 
Seat 4: Scaaalll ($4.43 in chips) 
Seat 5: Red Sky 15 ($11.53 in chips) 
Seat 6: barton1007 ($1.18 in chips) 
dkno77: posts small blind $0.01
Earl_greyPL: posts big blind $0.02
*** HOLE CARDS ***
Dealt to Scaaalll [4h Ah]
Scaaalll: folds 
barton1007 is disconnected 
Red Sky 15: folds 
barton1007: folds 
Red Sky 15 is disconnected 
Vahenta: raises $0.04 to $0.06
dkno77: folds 
Earl_greyPL: calls $0.04
*** FLOP *** [3d 7d 5c]
Earl_greyPL: checks 
Vahenta: checks 
*** TURN *** [3d 7d 5c] [7s]
Earl_greyPL: checks 
Vahenta: bets $0.04
Earl_greyPL: folds 
Uncalled bet ($0.04) returned to Vahenta
Vahenta collected $0.13 from pot
Vahenta: doesn't show hand 
*** SUMMARY ***
Total pot $0.13 | Rake $0 
Board [3d 7d 5c 7s]
Seat 1: Vahenta (button) collected ($0.13)
Seat 2: dkno77 (small blind) folded before Flop
Seat 3: Earl_greyPL (big blind) folded on the Turn
Seat 4: Scaaalll folded before Flop (didn't bet)
Seat 5: Red Sky 15 folded before Flop (didn't bet)
Seat 6: barton1007 folded before Flop (didn't bet)



PokerStars Zoom Hand #229233237929:  Hold'em No Limit ($0.01/$0.02) - 2021/08/21 23:22:20 CET [2021/08/21 17:22:20 ET]
Table 'Halley' 6-max Seat #1 is the button
Seat 1: jaamonra ($2.24 in chips) 
Seat 2: Merlin_Arg ($2.03 in chips) 
Seat 3: Koldun 2636 ($3.33 in chips) 
Seat 4: timatrue ($1.79 in chips) 
Seat 5: Earl_greyPL ($2.11 in chips) 
Seat 6: Scaaalll ($4.46 in chips) 
Merlin_Arg: posts small blind $0.01
Koldun 2636: posts big blind $0.02
*** HOLE CARDS ***
Dealt to Scaaalll [8s Ad]
timatrue: folds 
timatrue is disconnected 
Earl_greyPL: folds 
Scaaalll: folds 
jaamonra: folds 
Merlin_Arg: folds 
Uncalled bet ($0.01) returned to Koldun 2636
Koldun 2636 collected $0.02 from pot
Koldun 2636: doesn't show hand 
*** SUMMARY ***
Total pot $0.02 | Rake $0 
Seat 1: jaamonra (button) folded before Flop (didn't bet)
Seat 2: Merlin_Arg (small blind) folded before Flop
Seat 3: Koldun 2636 (big blind) collected ($0.02)
Seat 4: timatrue folded before Flop (didn't bet)
Seat 5: Earl_greyPL folded before Flop (didn't bet)
Seat 6: Scaaalll folded before Flop (didn't bet)



PokerStars Zoom Hand #229233241333:  Hold'em No Limit ($0.01/$0.02) - 2021/08/21 23:22:28 CET [2021/08/21 17:22:28 ET]
Table 'Halley' 6-max Seat #1 is the button
Seat 1: estelionat171 ($0.44 in chips) 
Seat 2: 888lifeIS ($2.02 in chips) 
Seat 3: rabbitmeat73 ($0.87 in chips) 
Seat 4: Hejpåre ($2.08 in chips) 
Seat 5: Scaaalll ($4.46 in chips) 
Seat 6: Vanekakqj ($2.09 in chips) 
888lifeIS: posts small blind $0.01
rabbitmeat73: posts big blind $0.02
*** HOLE CARDS ***
Dealt to Scaaalll [7d 2c]
Hejpåre: folds 
Scaaalll: folds 
Vanekakqj: folds 
estelionat171: folds 
888lifeIS: raises $0.02 to $0.04
rabbitmeat73: folds 
Uncalled bet ($0.02) returned to 888lifeIS
888lifeIS collected $0.04 from pot
888lifeIS: doesn't show hand 
*** SUMMARY ***
Total pot $0.04 | Rake $0 
Seat 1: estelionat171 (button) folded before Flop (didn't bet)
Seat 2: 888lifeIS (small blind) collected ($0.04)
Seat 3: rabbitmeat73 (big blind) folded before Flop
Seat 4: Hejpåre folded before Flop (didn't bet)
Seat 5: Scaaalll folded before Flop (didn't bet)
Seat 6: Vanekakqj folded before Flop (didn't bet)



PokerStars Zoom Hand #229233243874:  Hold'em No Limit ($0.01/$0.02) - 2021/08/21 23:22:34 CET [2021/08/21 17:22:34 ET]
Table 'Halley' 6-max Seat #1 is the button
Seat 1: obnoman ($3.15 in chips) 
Seat 2: gilberto98 ($4.27 in chips) 
Seat 3: Scaaalll ($4.46 in chips) 
Seat 4: Habarovs18 ($5.23 in chips) 
Seat 5: NoEff0rt2w1n ($7.29 in chips) 
Seat 6: Earl_greyPL ($1.31 in chips) 
gilberto98: posts small blind $0.01
Scaaalll: posts big blind $0.02
*** HOLE CARDS ***
Dealt to Scaaalll [2c Tc]
obnoman is disconnected 
Habarovs18: raises $0.07 to $0.09
NoEff0rt2w1n: folds 
Earl_greyPL: folds 
obnoman: folds 
gilberto98: folds 
Scaaalll: folds 
Uncalled bet ($0.07) returned to Habarovs18
Habarovs18 collected $0.05 from pot
Habarovs18: doesn't show hand 
*** SUMMARY ***
Total pot $0.05 | Rake $0 
Seat 1: obnoman (button) folded before Flop (didn't bet)
Seat 2: gilberto98 (small blind) folded before Flop
Seat 3: Scaaalll (big blind) folded before Flop
Seat 4: Habarovs18 collected ($0.05)
Seat 5: NoEff0rt2w1n folded before Flop (didn't bet)
Seat 6: Earl_greyPL folded before Flop (didn't bet)



PokerStars Zoom Hand #229233260219:  Hold'em No Limit ($0.01/$0.02) - 2021/08/21 23:23:13 CET [2021/08/21 17:23:13 ET]
Table 'Halley' 6-max Seat #1 is the button
Seat 1: ChowMangao ($3.07 in chips) 
Seat 2: Pechorin.G ($2 in chips) 
Seat 3: auxy89 ($2.69 in chips) 
Seat 4: Scaaalll ($4.42 in chips) 
Seat 5: zergmiky ($2.12 in chips) 
Seat 6: nagiloR ($1.92 in chips) 
Pechorin.G: posts small blind $0.01
auxy89: posts big blind $0.02
*** HOLE CARDS ***
Dealt to Scaaalll [Kc Tc]
Scaaalll: raises $0.04 to $0.06
auxy89 is disconnected 
zergmiky: folds 
nagiloR: folds 
ChowMangao: folds 
Pechorin.G: raises $0.18 to $0.24
auxy89: folds 
Scaaalll: folds 
Uncalled bet ($0.18) returned to Pechorin.G
Pechorin.G collected $0.14 from pot
Pechorin.G: doesn't show hand 
*** SUMMARY ***
Total pot $0.14 | Rake $0 
Seat 1: ChowMangao (button) folded before Flop (didn't bet)
Seat 2: Pechorin.G (small blind) collected ($0.14)
Seat 3: auxy89 (big blind) folded before Flop
Seat 4: Scaaalll folded before Flop
Seat 5: zergmiky folded before Flop (didn't bet)
Seat 6: nagiloR folded before Flop (didn't bet)



PokerStars Zoom Hand #229233249314:  Hold'em No Limit ($0.01/$0.02) - 2021/08/21 23:22:47 CET [2021/08/21 17:22:47 ET]
Table 'Halley' 6-max Seat #1 is the button
Seat 1: Xpokerfreak ($1.92 in chips) 
Seat 2: Scaaalll ($4.44 in chips) 
Seat 3: Gamer577 ($3.58 in chips) 
Seat 4: Posaunengodi ($2.46 in chips) 
Seat 5: SRobinson1 ($1.78 in chips) 
Seat 6: Phoenixxxxxxxx ($2 in chips) 
Scaaalll: posts small blind $0.01
Gamer577: posts big blind $0.02
*** HOLE CARDS ***
Dealt to Scaaalll [4h Ah]
Posaunengodi: folds 
SRobinson1: folds 
SRobinson1 is disconnected 
Phoenixxxxxxxx: folds 
Xpokerfreak: calls $0.02
Scaaalll: calls $0.01
Gamer577: checks 
*** FLOP *** [Jd 7h Tc]
Scaaalll: checks 
Gamer577: bets $0.06
Xpokerfreak: calls $0.06
Scaaalll: folds 
*** TURN *** [Jd 7h Tc] [4s]
Gamer577: bets $0.17
Xpokerfreak: calls $0.17
*** RIVER *** [Jd 7h Tc 4s] [2c]
Gamer577: bets $0.42
Xpokerfreak: calls $0.42
*** SHOW DOWN ***
Gamer577: shows [Ts Jc] (two pair, Jacks and Tens)
Xpokerfreak: mucks hand 
Gamer577 collected $1.31 from pot
*** SUMMARY ***
Total pot $1.36 | Rake $0.05 
Board [Jd 7h Tc 4s 2c]
Seat 1: Xpokerfreak (button) mucked [As Jh]
Seat 2: Scaaalll (small blind) folded on the Flop
Seat 3: Gamer577 (big blind) showed [Ts Jc] and won ($1.31) with two pair, Jacks and Tens
Seat 4: Posaunengodi folded before Flop (didn't bet)
Seat 5: SRobinson1 folded before Flop (didn't bet)
Seat 6: Phoenixxxxxxxx folded before Flop (didn't bet)



PokerStars Zoom Hand #229233267722:  Hold'em No Limit ($0.01/$0.02) - 2021/08/21 23:23:31 CET [2021/08/21 17:23:31 ET]
Table 'Halley' 6-max Seat #1 is the button
Seat 1: znak312 ($2 in chips) 
Seat 2: Scaaalll ($4.36 in chips) 
Seat 3: johnpa89 ($2 in chips) 
Seat 4: PapiMik3 ($8.17 in chips) 
Seat 5: BexleyBoy ($1.81 in chips) 
Seat 6: TTGemi ($3.56 in chips) 
Scaaalll: posts small blind $0.01
johnpa89: posts big blind $0.02
*** HOLE CARDS ***
Dealt to Scaaalll [Qc Qs]
PapiMik3: folds 
BexleyBoy: folds 
TTGemi: raises $0.04 to $0.06
znak312: folds 
Scaaalll: raises $0.14 to $0.20
johnpa89: folds 
TTGemi: calls $0.14
*** FLOP *** [4d Jd 8d]
Scaaalll: bets $0.23
TTGemi: calls $0.23
*** TURN *** [4d Jd 8d] [6c]
Scaaalll: checks 
TTGemi: checks 
*** RIVER *** [4d Jd 8d 6c] [Jh]
Scaaalll: checks 
TTGemi: bets $0.56
Scaaalll: calls $0.56
*** SHOW DOWN ***
TTGemi: shows [Ah Qd] (a pair of Jacks)
Scaaalll: shows [Qc Qs] (two pair, Queens and Jacks)
Scaaalll collected $1.91 from pot
*** SUMMARY ***
Total pot $2 | Rake $0.09 
Board [4d Jd 8d 6c Jh]
Seat 1: znak312 (button) folded before Flop (didn't bet)
Seat 2: Scaaalll (small blind) showed [Qc Qs] and won ($1.91) with two pair, Queens and Jacks
Seat 3: johnpa89 (big blind) folded before Flop
Seat 4: PapiMik3 folded before Flop (didn't bet)
Seat 5: BexleyBoy folded before Flop (didn't bet)
Seat 6: TTGemi showed [Ah Qd] and lost with a pair of Jacks



PokerStars Zoom Hand #229233287859:  Hold'em No Limit ($0.01/$0.02) - 2021/08/21 23:24:19 CET [2021/08/21 17:24:19 ET]
Table 'Halley' 6-max Seat #1 is the button
Seat 1: Scaaalll ($5.28 in chips) 
Seat 2: timatrue ($2 in chips) 
Seat 3: Bol'tazar111 ($1.48 in chips) 
Seat 4: Kb013497 ($1.90 in chips) 
Seat 5: ronald1982 ($1.61 in chips) 
Seat 6: KKARMELO ($2.94 in chips) 
timatrue: posts small blind $0.01
Bol'tazar111: posts big blind $0.02
*** HOLE CARDS ***
Dealt to Scaaalll [9s 9c]
Kb013497: folds 
ronald1982: raises $0.02 to $0.04
KKARMELO: folds 
Scaaalll: calls $0.04
timatrue: calls $0.03
Bol'tazar111: folds 
*** FLOP *** [2s 6c 2c]
timatrue: checks 
ronald1982: checks 
Scaaalll: bets $0.08
timatrue: folds 
timatrue is disconnected 
ronald1982: folds 
Uncalled bet ($0.08) returned to Scaaalll
Scaaalll collected $0.14 from pot
Scaaalll: doesn't show hand 
*** SUMMARY ***
Total pot $0.14 | Rake $0 
Board [2s 6c 2c]
Seat 1: Scaaalll (button) collected ($0.14)
Seat 2: timatrue (small blind) folded on the Flop
Seat 3: Bol'tazar111 (big blind) folded before Flop
Seat 4: Kb013497 folded before Flop (didn't bet)
Seat 5: ronald1982 folded on the Flop
Seat 6: KKARMELO folded before Flop (didn't bet)



PokerStars Zoom Hand #229233311091:  Hold'em No Limit ($0.01/$0.02) - 2021/08/21 23:25:01 CET [2021/08/21 17:25:01 ET]
Table 'Halley' 6-max Seat #1 is the button
Seat 1: MEZz828 ($2.31 in chips) 
Seat 2: Tabitaji ($2.19 in chips) 
Seat 3: WITKOW_AV ($2.02 in chips) 
Seat 4: LeoZ77755 ($2.09 in chips) 
Seat 5: tarogame ($2.31 in chips) 
Seat 6: Scaaalll ($5.38 in chips) 
Tabitaji: posts small blind $0.01
WITKOW_AV: posts big blind $0.02
*** HOLE CARDS ***
Dealt to Scaaalll [2c 5h]
LeoZ77755: folds 
LeoZ77755 is disconnected 
tarogame: raises $0.03 to $0.05
Scaaalll: folds 
MEZz828: folds 
Tabitaji: folds 
WITKOW_AV: folds 
Uncalled bet ($0.03) returned to tarogame
tarogame collected $0.05 from pot
tarogame: doesn't show hand 
*** SUMMARY ***
Total pot $0.05 | Rake $0 
Seat 1: MEZz828 (button) folded before Flop (didn't bet)
Seat 2: Tabitaji (small blind) folded before Flop
Seat 3: WITKOW_AV (big blind) folded before Flop
Seat 4: LeoZ77755 folded before Flop (didn't bet)
Seat 5: tarogame collected ($0.05)
Seat 6: Scaaalll folded before Flop (didn't bet)



PokerStars Zoom Hand #229233313937:  Hold'em No Limit ($0.01/$0.02) - 2021/08/21 23:25:08 CET [2021/08/21 17:25:08 ET]
Table 'Halley' 6-max Seat #1 is the button
Seat 1: Cineva81 ($2.22 in chips) 
Seat 2: tarogame ($2 in chips) 
Seat 3: KKARMELO ($2 in chips) 
Seat 4: polymorhp ($2.75 in chips) 
Seat 5: Scaaalll ($5.38 in chips) 
Seat 6: Gamer577 ($2.39 in chips) 
tarogame: posts small blind $0.01
KKARMELO: posts big blind $0.02
*** HOLE CARDS ***
Dealt to Scaaalll [7c 7d]
polymorhp: folds 
Scaaalll: raises $0.04 to $0.06
Gamer577: folds 
Cineva81: folds 
tarogame: folds 
KKARMELO: folds 
Uncalled bet ($0.04) returned to Scaaalll
Scaaalll collected $0.05 from pot
Scaaalll: doesn't show hand 
*** SUMMARY ***
Total pot $0.05 | Rake $0 
Seat 1: Cineva81 (button) folded before Flop (didn't bet)
Seat 2: tarogame (small blind) folded before Flop
Seat 3: KKARMELO (big blind) folded before Flop
Seat 4: polymorhp folded before Flop (didn't bet)
Seat 5: Scaaalll collected ($0.05)
Seat 6: Gamer577 folded before Flop (didn't bet)



PokerStars Zoom Hand #229233324136:  Hold'em No Limit ($0.01/$0.02) - 2021/08/21 23:25:32 CET [2021/08/21 17:25:32 ET]
Table 'Halley' 6-max Seat #1 is the button
Seat 1: OneFaw ($2.10 in chips) 
Seat 2: rancing87 ($2.14 in chips) 
Seat 3: Scaaalll ($5.41 in chips) 
Seat 4: SIGREX ($2.82 in chips) 
Seat 5: Gremlipoo ($2.76 in chips) 
Seat 6: Habarovs18 ($7.08 in chips) 
rancing87: posts small blind $0.01
Scaaalll: posts big blind $0.02
*** HOLE CARDS ***
Dealt to Scaaalll [5h 3c]
SIGREX: folds 
Habarovs18 is disconnected 
Gremlipoo: raises $0.04 to $0.06
Habarovs18: folds 
OneFaw: raises $0.04 to $0.10
rancing87: folds 
Scaaalll: folds 
Gremlipoo: calls $0.04
*** FLOP *** [Ad Jd 5c]
Gremlipoo: checks 
OneFaw: bets $0.11
Gremlipoo: folds 
Uncalled bet ($0.11) returned to OneFaw
OneFaw collected $0.22 from pot
OneFaw: doesn't show hand 
Gremlipoo is disconnected 
*** SUMMARY ***
Total pot $0.23 | Rake $0.01 
Board [Ad Jd 5c]
Seat 1: OneFaw (button) collected ($0.22)
Seat 2: rancing87 (small blind) folded before Flop
Seat 3: Scaaalll (big blind) folded before Flop
Seat 4: SIGREX folded before Flop (didn't bet)
Seat 5: Gremlipoo folded on the Flop
Seat 6: Habarovs18 folded before Flop (didn't bet)



PokerStars Zoom Hand #229233330290:  Hold'em No Limit ($0.01/$0.02) - 2021/08/21 23:25:47 CET [2021/08/21 17:25:47 ET]
Table 'Halley' 6-max Seat #1 is the button
Seat 1: Carlos_glaza ($2.05 in chips) 
Seat 2: Valansen ($2.10 in chips) 
Seat 3: REZAKOV72 ($3.29 in chips) 
Seat 4: Scaaalll ($5.39 in chips) 
Seat 5: Cineva81 ($2.22 in chips) 
Seat 6: KonopDima ($2.08 in chips) 
Valansen: posts small blind $0.01
REZAKOV72: posts big blind $0.02
*** HOLE CARDS ***
Dealt to Scaaalll [2s 2c]
Scaaalll: raises $0.04 to $0.06
Cineva81: folds 
KonopDima: folds 
Carlos_glaza: folds 
Valansen: folds 
REZAKOV72: calls $0.04
*** FLOP *** [Ks 6d 4c]
REZAKOV72: checks 
Scaaalll: checks 
*** TURN *** [Ks 6d 4c] [5c]
REZAKOV72: checks 
Scaaalll: bets $0.07
REZAKOV72: folds 
Uncalled bet ($0.07) returned to Scaaalll
Scaaalll collected $0.13 from pot
Scaaalll: doesn't show hand 
*** SUMMARY ***
Total pot $0.13 | Rake $0 
Board [Ks 6d 4c 5c]
Seat 1: Carlos_glaza (button) folded before Flop (didn't bet)
Seat 2: Valansen (small blind) folded before Flop
Seat 3: REZAKOV72 (big blind) folded on the Turn
Seat 4: Scaaalll collected ($0.13)
Seat 5: Cineva81 folded before Flop (didn't bet)
Seat 6: KonopDima folded before Flop (didn't bet)



PokerStars Zoom Hand #229233339527:  Hold'em No Limit ($0.01/$0.02) - 2021/08/21 23:26:09 CET [2021/08/21 17:26:09 ET]
Table 'Halley' 6-max Seat #1 is the button
Seat 1: Scaaalll ($5.46 in chips) 
Seat 2: Red Sky 15 ($11.57 in chips) 
Seat 3: nodtress ($2.21 in chips) 
Seat 4: baksu12 ($2.07 in chips) 
Seat 5: PapiMik3 ($7.24 in chips) 
Seat 6: kukulagosleep ($3.72 in chips) 
Red Sky 15: posts small blind $0.01
nodtress: posts big blind $0.02
*** HOLE CARDS ***
Dealt to Scaaalll [6h Kc]
baksu12: raises $0.04 to $0.06
PapiMik3: folds 
kukulagosleep: folds 
Scaaalll: folds 
Red Sky 15: folds 
nodtress: folds 
Uncalled bet ($0.04) returned to baksu12
Red Sky 15 is disconnected 
baksu12 collected $0.05 from pot
baksu12: doesn't show hand 
*** SUMMARY ***
Total pot $0.05 | Rake $0 
Seat 1: Scaaalll (button) folded before Flop (didn't bet)
Seat 2: Red Sky 15 (small blind) folded before Flop
Seat 3: nodtress (big blind) folded before Flop
Seat 4: baksu12 collected ($0.05)
Seat 5: PapiMik3 folded before Flop (didn't bet)
Seat 6: kukulagosleep folded before Flop (didn't bet)



PokerStars Zoom Hand #229233344628:  Hold'em No Limit ($0.01/$0.02) - 2021/08/21 23:26:21 CET [2021/08/21 17:26:21 ET]
Table 'Halley' 6-max Seat #1 is the button
Seat 1: rekopo203 ($7.29 in chips) 
Seat 2: Gamer577 ($6.08 in chips) 
Seat 3: Kojak34 ($6.10 in chips) 
Seat 4: Smirandal ($4.01 in chips) 
Seat 5: isaeg ($2.12 in chips) 
Seat 6: Scaaalll ($5.45 in chips) 
Gamer577: posts small blind $0.01
Kojak34: posts big blind $0.02
*** HOLE CARDS ***
Dealt to Scaaalll [5s 9h]
isaeg is disconnected 
Smirandal: folds 
isaeg: folds 
Scaaalll: folds 
rekopo203: folds 
Gamer577: folds 
Uncalled bet ($0.01) returned to Kojak34
Kojak34 collected $0.02 from pot
Kojak34: doesn't show hand 
*** SUMMARY ***
Total pot $0.02 | Rake $0 
Seat 1: rekopo203 (button) folded before Flop (didn't bet)
Seat 2: Gamer577 (small blind) folded before Flop
Seat 3: Kojak34 (big blind) collected ($0.02)
Seat 4: Smirandal folded before Flop (didn't bet)
Seat 5: isaeg folded before Flop (didn't bet)
Seat 6: Scaaalll folded before Flop (didn't bet)



PokerStars Zoom Hand #229233342905:  Hold'em No Limit ($0.01/$0.02) - 2021/08/21 23:26:17 CET [2021/08/21 17:26:17 ET]
Table 'Halley' 6-max Seat #1 is the button
Seat 1: rodrigoasor ($4.45 in chips) 
Seat 2: Scaaalll ($5.46 in chips) 
Seat 3: Valansen ($2.09 in chips) 
Seat 4: tassy237 ($0.79 in chips) 
Seat 5: gasmar_29 ($2 in chips) 
Seat 6: orlovac1995 ($4.36 in chips) 
Scaaalll: posts small blind $0.01
Valansen: posts big blind $0.02
*** HOLE CARDS ***
Dealt to Scaaalll [8s Jh]
tassy237: raises $0.04 to $0.06
gasmar_29: folds 
orlovac1995: folds 
rodrigoasor: calls $0.06
Scaaalll: folds 
Valansen: folds 
*** FLOP *** [Ac Ts 3s]
tassy237: bets $0.07
rodrigoasor: calls $0.07
*** TURN *** [Ac Ts 3s] [6d]
tassy237: bets $0.28
rodrigoasor: calls $0.28
*** RIVER *** [Ac Ts 3s 6d] [4c]
tassy237: bets $0.38 and is all-in
rodrigoasor: calls $0.38
*** SHOW DOWN ***
tassy237: shows [Kh Ad] (a pair of Aces)
rodrigoasor: shows [Td As] (two pair, Aces and Tens)
rodrigoasor collected $1.55 from pot
*** SUMMARY ***
Total pot $1.61 | Rake $0.06 
Board [Ac Ts 3s 6d 4c]
Seat 1: rodrigoasor (button) showed [Td As] and won ($1.55) with two pair, Aces and Tens
Seat 2: Scaaalll (small blind) folded before Flop
Seat 3: Valansen (big blind) folded before Flop
Seat 4: tassy237 showed [Kh Ad] and lost with a pair of Aces
Seat 5: gasmar_29 folded before Flop (didn't bet)
Seat 6: orlovac1995 folded before Flop (didn't bet)



PokerStars Zoom Hand #229233348447:  Hold'em No Limit ($0.01/$0.02) - 2021/08/21 23:26:30 CET [2021/08/21 17:26:30 ET]
Table 'Halley' 6-max Seat #1 is the button
Seat 1: Scaaalll ($5.45 in chips) 
Seat 2: gasmar_29 ($2.40 in chips) 
Seat 3: BeastBoy18 ($2 in chips) 
Seat 4: Yangyang1407 ($2.10 in chips) 
Seat 5: egroj1700 ($2 in chips) 
Seat 6: elmex886 ($2 in chips) 
gasmar_29: posts small blind $0.01
BeastBoy18: posts big blind $0.02
*** HOLE CARDS ***
Dealt to Scaaalll [Ks Ts]
Yangyang1407: folds 
egroj1700: raises $0.04 to $0.06
elmex886: folds 
Scaaalll: calls $0.06
gasmar_29: folds 
BeastBoy18: folds 
*** FLOP *** [6h 5c Jc]
egroj1700: bets $0.05
Scaaalll: folds 
Uncalled bet ($0.05) returned to egroj1700
egroj1700 collected $0.14 from pot
egroj1700: doesn't show hand 
*** SUMMARY ***
Total pot $0.15 | Rake $0.01 
Board [6h 5c Jc]
Seat 1: Scaaalll (button) folded on the Flop
Seat 2: gasmar_29 (small blind) folded before Flop
Seat 3: BeastBoy18 (big blind) folded before Flop
Seat 4: Yangyang1407 folded before Flop (didn't bet)
Seat 5: egroj1700 collected ($0.14)
Seat 6: elmex886 folded before Flop (didn't bet)



PokerStars Zoom Hand #229233363235:  Hold'em No Limit ($0.01/$0.02) - 2021/08/21 23:27:05 CET [2021/08/21 17:27:05 ET]
Table 'Halley' 6-max Seat #1 is the button
Seat 1: Mustang01373 ($1.11 in chips) 
Seat 2: BeastBoy18 ($2.75 in chips) 
Seat 3: Scaaalll ($5.39 in chips) 
Seat 4: gizum17 ($2.02 in chips) 
Seat 5: Sinad1302 ($2.54 in chips) 
Seat 6: NickAlex18 ($2 in chips) 
BeastBoy18: posts small blind $0.01
Scaaalll: posts big blind $0.02
*** HOLE CARDS ***
Dealt to Scaaalll [4c Kd]
gizum17: folds 
Sinad1302: folds 
Sinad1302 is disconnected 
NickAlex18: folds 
Mustang01373: folds 
BeastBoy18: folds 
Uncalled bet ($0.01) returned to Scaaalll
Scaaalll collected $0.02 from pot
Scaaalll: doesn't show hand 
*** SUMMARY ***
Total pot $0.02 | Rake $0 
Seat 1: Mustang01373 (button) folded before Flop (didn't bet)
Seat 2: BeastBoy18 (small blind) folded before Flop
Seat 3: Scaaalll (big blind) collected ($0.02)
Seat 4: gizum17 folded before Flop (didn't bet)
Seat 5: Sinad1302 folded before Flop (didn't bet)
Seat 6: NickAlex18 folded before Flop (didn't bet)



PokerStars Zoom Hand #229233369902:  Hold'em No Limit ($0.01/$0.02) - 2021/08/21 23:27:21 CET [2021/08/21 17:27:21 ET]
Table 'Halley' 6-max Seat #1 is the button
Seat 1: znak312 ($2 in chips) 
Seat 2: gilberto98 ($2.12 in chips) 
Seat 3: Fabi151312 ($2 in chips) 
Seat 4: keldh ($5.16 in chips) 
Seat 5: Scaaalll ($5.40 in chips) 
Seat 6: Xlavariable ($2 in chips) 
gilberto98: posts small blind $0.01
Fabi151312: posts big blind $0.02
*** HOLE CARDS ***
Dealt to Scaaalll [Jd Qs]
keldh: raises $0.03 to $0.05
Scaaalll: folds 
Xlavariable: folds 
znak312: folds 
gilberto98: folds 
Fabi151312: folds 
Uncalled bet ($0.03) returned to keldh
keldh collected $0.05 from pot
keldh: doesn't show hand 
*** SUMMARY ***
Total pot $0.05 | Rake $0 
Seat 1: znak312 (button) folded before Flop (didn't bet)
Seat 2: gilberto98 (small blind) folded before Flop
Seat 3: Fabi151312 (big blind) folded before Flop
Seat 4: keldh collected ($0.05)
Seat 5: Scaaalll folded before Flop (didn't bet)
Seat 6: Xlavariable folded before Flop (didn't bet)



PokerStars Zoom Hand #229233372413:  Hold'em No Limit ($0.01/$0.02) - 2021/08/21 23:27:27 CET [2021/08/21 17:27:27 ET]
Table 'Halley' 6-max Seat #1 is the button
Seat 1: ibstah ($3.93 in chips) 
Seat 2: Scaaalll ($5.40 in chips) 
Seat 3: Pizotifen ($2.03 in chips) 
Seat 4: Mac9Monty2 ($2.84 in chips) 
Seat 5: sg.32rus ($1 in chips) 
Seat 6: KonopDima ($2.57 in chips) 
Scaaalll: posts small blind $0.01
Pizotifen: posts big blind $0.02
*** HOLE CARDS ***
Dealt to Scaaalll [Qs Ts]
Mac9Monty2: folds 
sg.32rus: calls $0.02
KonopDima: folds 
ibstah: folds 
Scaaalll: raises $0.06 to $0.08
Pizotifen: folds 
sg.32rus: calls $0.06
*** FLOP *** [3d As Jc]
Scaaalll: bets $0.11
sg.32rus: folds 
Uncalled bet ($0.11) returned to Scaaalll
Scaaalll collected $0.17 from pot
Scaaalll: doesn't show hand 
*** SUMMARY ***
Total pot $0.18 | Rake $0.01 
Board [3d As Jc]
Seat 1: ibstah (button) folded before Flop (didn't bet)
Seat 2: Scaaalll (small blind) collected ($0.17)
Seat 3: Pizotifen (big blind) folded before Flop
Seat 4: Mac9Monty2 folded before Flop (didn't bet)
Seat 5: sg.32rus folded on the Flop
Seat 6: KonopDima folded before Flop (didn't bet)



PokerStars Zoom Hand #229233383733:  Hold'em No Limit ($0.01/$0.02) - 2021/08/21 23:27:54 CET [2021/08/21 17:27:54 ET]
Table 'Halley' 6-max Seat #1 is the button
Seat 1: bioern ($2.98 in chips) 
Seat 2: jancsi321 ($1.84 in chips) 
Seat 3: estelionat171 ($0.52 in chips) 
Seat 4: Scaaalll ($5.49 in chips) 
Seat 5: osantos401 ($9.41 in chips) 
Seat 6: keldh ($5.19 in chips) 
jancsi321: posts small blind $0.01
estelionat171: posts big blind $0.02
*** HOLE CARDS ***
Dealt to Scaaalll [Ac Qs]
Scaaalll: raises $0.04 to $0.06
osantos401: folds 
keldh: folds 
bioern: folds 
jancsi321 has timed out
jancsi321: folds 
estelionat171: folds 
Uncalled bet ($0.04) returned to Scaaalll
Scaaalll collected $0.05 from pot
Scaaalll: doesn't show hand 
*** SUMMARY ***
Total pot $0.05 | Rake $0 
Seat 1: bioern (button) folded before Flop (didn't bet)
Seat 2: jancsi321 (small blind) folded before Flop
Seat 3: estelionat171 (big blind) folded before Flop
Seat 4: Scaaalll collected ($0.05)
Seat 5: osantos401 folded before Flop (didn't bet)
Seat 6: keldh folded before Flop (didn't bet)



PokerStars Zoom Hand #229233398067:  Hold'em No Limit ($0.01/$0.02) - 2021/08/21 23:28:28 CET [2021/08/21 17:28:28 ET]
Table 'Halley' 6-max Seat #1 is the button
Seat 1: Pechorin.G ($2.01 in chips) 
Seat 2: gizum17 ($2.23 in chips) 
Seat 3: Scaaalll ($5.52 in chips) 
Seat 4: FabOliveira9 ($2.06 in chips) 
Seat 5: RrriotGrrrl ($2.39 in chips) 
Seat 6: kahzura ($2.20 in chips) 
gizum17: posts small blind $0.01
Scaaalll: posts big blind $0.02
*** HOLE CARDS ***
Dealt to Scaaalll [6d 9h]
FabOliveira9: folds 
RrriotGrrrl: folds 
kahzura: folds 
Pechorin.G: raises $0.03 to $0.05
gizum17: folds 
Scaaalll: folds 
Uncalled bet ($0.03) returned to Pechorin.G
Pechorin.G collected $0.05 from pot
Pechorin.G: doesn't show hand 
*** SUMMARY ***
Total pot $0.05 | Rake $0 
Seat 1: Pechorin.G (button) collected ($0.05)
Seat 2: gizum17 (small blind) folded before Flop
Seat 3: Scaaalll (big blind) folded before Flop
Seat 4: FabOliveira9 folded before Flop (didn't bet)
Seat 5: RrriotGrrrl folded before Flop (didn't bet)
Seat 6: kahzura folded before Flop (didn't bet)



PokerStars Zoom Hand #229233405760:  Hold'em No Limit ($0.01/$0.02) - 2021/08/21 23:28:46 CET [2021/08/21 17:28:46 ET]
Table 'Halley' 6-max Seat #1 is the button
Seat 1: Kb013497 ($1.60 in chips) 
Seat 2: MetalCrüe ($1.85 in chips) 
Seat 3: altubehernan ($2.44 in chips) 
Seat 4: Scaaalll ($5.50 in chips) 
Seat 5: prosto lili ($0.86 in chips) 
Seat 6: johnpa89 ($2.07 in chips) 
MetalCrüe: posts small blind $0.01
altubehernan: posts big blind $0.02
*** HOLE CARDS ***
Dealt to Scaaalll [8d Qs]
Scaaalll: folds 
prosto lili: folds 
johnpa89: folds 
Kb013497: folds 
MetalCrüe: folds 
Uncalled bet ($0.01) returned to altubehernan
altubehernan collected $0.02 from pot
altubehernan: doesn't show hand 
*** SUMMARY ***
Total pot $0.02 | Rake $0 
Seat 1: Kb013497 (button) folded before Flop (didn't bet)
Seat 2: MetalCrüe (small blind) folded before Flop
Seat 3: altubehernan (big blind) collected ($0.02)
Seat 4: Scaaalll folded before Flop (didn't bet)
Seat 5: prosto lili folded before Flop (didn't bet)
Seat 6: johnpa89 folded before Flop (didn't bet)



PokerStars Zoom Hand #229233396384:  Hold'em No Limit ($0.01/$0.02) - 2021/08/21 23:28:24 CET [2021/08/21 17:28:24 ET]
Table 'Halley' 6-max Seat #1 is the button
Seat 1: polymorhp ($8.99 in chips) 
Seat 2: maliniak75 ($2.31 in chips) 
Seat 3: Iv3rson18 ($2.45 in chips) 
Seat 4: auxy89 ($2.99 in chips) 
Seat 5: Dr.stromg ($5.50 in chips) 
Seat 6: Scaaalll ($5.52 in chips) 
maliniak75: posts small blind $0.01
Iv3rson18: posts big blind $0.02
*** HOLE CARDS ***
Dealt to Scaaalll [2d 4c]
auxy89: folds 
auxy89 is disconnected 
Dr.stromg: folds 
Scaaalll: folds 
polymorhp: raises $0.03 to $0.05
maliniak75: folds 
Iv3rson18: calls $0.03
*** FLOP *** [As Qc Js]
Iv3rson18: checks 
polymorhp: checks 
*** TURN *** [As Qc Js] [5h]
Iv3rson18: bets $0.06
polymorhp: calls $0.06
*** RIVER *** [As Qc Js 5h] [Jh]
Iv3rson18: checks 
polymorhp: checks 
*** SHOW DOWN ***
Iv3rson18: shows [Qs 3s] (two pair, Queens and Jacks)
polymorhp: shows [6d Ah] (two pair, Aces and Jacks)
polymorhp collected $0.22 from pot
*** SUMMARY ***
Total pot $0.23 | Rake $0.01 
Board [As Qc Js 5h Jh]
Seat 1: polymorhp (button) showed [6d Ah] and won ($0.22) with two pair, Aces and Jacks
Seat 2: maliniak75 (small blind) folded before Flop
Seat 3: Iv3rson18 (big blind) showed [Qs 3s] and lost with two pair, Queens and Jacks
Seat 4: auxy89 folded before Flop (didn't bet)
Seat 5: Dr.stromg folded before Flop (didn't bet)
Seat 6: Scaaalll folded before Flop (didn't bet)



PokerStars Zoom Hand #229233407901:  Hold'em No Limit ($0.01/$0.02) - 2021/08/21 23:28:51 CET [2021/08/21 17:28:51 ET]
Table 'Halley' 6-max Seat #1 is the button
Seat 1: Merlin_Arg ($2.17 in chips) 
Seat 2: Scaaalll ($5.50 in chips) 
Seat 3: pavlo8855 ($2.16 in chips) 
Seat 4: ciucibaby ($2 in chips) 
Seat 5: Mikmaq Caper ($1.38 in chips) 
Seat 6: NeckCarp ($2.09 in chips) 
Scaaalll: posts small blind $0.01
pavlo8855: posts big blind $0.02
*** HOLE CARDS ***
Dealt to Scaaalll [As Ac]
ciucibaby: folds 
NeckCarp is disconnected 
Mikmaq Caper: calls $0.02
NeckCarp: folds 
Merlin_Arg: folds 
Scaaalll: raises $0.07 to $0.09
pavlo8855: folds 
Mikmaq Caper: folds 
Uncalled bet ($0.07) returned to Scaaalll
Scaaalll collected $0.06 from pot
Scaaalll: doesn't show hand 
Mikmaq Caper is disconnected 
*** SUMMARY ***
Total pot $0.06 | Rake $0 
Seat 1: Merlin_Arg (button) folded before Flop (didn't bet)
Seat 2: Scaaalll (small blind) collected ($0.06)
Seat 3: pavlo8855 (big blind) folded before Flop
Seat 4: ciucibaby folded before Flop (didn't bet)
Seat 5: Mikmaq Caper folded before Flop
Seat 6: NeckCarp folded before Flop (didn't bet)



PokerStars Zoom Hand #229233417573:  Hold'em No Limit ($0.01/$0.02) - 2021/08/21 23:29:14 CET [2021/08/21 17:29:14 ET]
Table 'Halley' 6-max Seat #1 is the button
Seat 1: Scaaalll ($5.54 in chips) 
Seat 2: 888lifeIS ($2 in chips) 
Seat 3: Reipinguimm ($3.52 in chips) 
Seat 4: Ruben-M. PY ($2.30 in chips) 
Seat 5: WithMyWalker ($2 in chips) 
Seat 6: Brigistul ($2.73 in chips) 
888lifeIS: posts small blind $0.01
Reipinguimm: posts big blind $0.02
*** HOLE CARDS ***
Dealt to Scaaalll [4c 5d]
Ruben-M. PY: folds 
WithMyWalker: folds 
Brigistul: raises $0.16 to $0.18
Scaaalll: folds 
888lifeIS: folds 
Reipinguimm: folds 
Uncalled bet ($0.16) returned to Brigistul
Brigistul collected $0.05 from pot
Brigistul: doesn't show hand 
*** SUMMARY ***
Total pot $0.05 | Rake $0 
Seat 1: Scaaalll (button) folded before Flop (didn't bet)
Seat 2: 888lifeIS (small blind) folded before Flop
Seat 3: Reipinguimm (big blind) folded before Flop
Seat 4: Ruben-M. PY folded before Flop (didn't bet)
Seat 5: WithMyWalker folded before Flop (didn't bet)
Seat 6: Brigistul collected ($0.05)



PokerStars Zoom Hand #229233420154:  Hold'em No Limit ($0.01/$0.02) - 2021/08/21 23:29:20 CET [2021/08/21 17:29:20 ET]
Table 'Halley' 6-max Seat #1 is the button
Seat 1: Feyqdoi ($2.01 in chips) 
Seat 2: nightwacher ($2.01 in chips) 
Seat 3: juelz_ua ($1.65 in chips) 
Seat 4: Feliciano16 ($7.40 in chips) 
Seat 5: Cineva81 ($2 in chips) 
Seat 6: Scaaalll ($5.54 in chips) 
nightwacher: posts small blind $0.01
juelz_ua: posts big blind $0.02
*** HOLE CARDS ***
Dealt to Scaaalll [Ks 4h]
Feliciano16: folds 
Cineva81: folds 
Scaaalll: folds 
Feyqdoi: folds 
nightwacher: folds 
Uncalled bet ($0.01) returned to juelz_ua
juelz_ua collected $0.02 from pot
juelz_ua: doesn't show hand 
*** SUMMARY ***
Total pot $0.02 | Rake $0 
Seat 1: Feyqdoi (button) folded before Flop (didn't bet)
Seat 2: nightwacher (small blind) folded before Flop
Seat 3: juelz_ua (big blind) collected ($0.02)
Seat 4: Feliciano16 folded before Flop (didn't bet)
Seat 5: Cineva81 folded before Flop (didn't bet)
Seat 6: Scaaalll folded before Flop (didn't bet)



PokerStars Zoom Hand #229233431397:  Hold'em No Limit ($0.01/$0.02) - 2021/08/21 23:29:47 CET [2021/08/21 17:29:47 ET]
Table 'Halley' 6-max Seat #1 is the button
Seat 1: StayFunky ($1.95 in chips) 
Seat 2: josealfredonino ($1.72 in chips) 
Seat 3: Scaaalll ($5.54 in chips) 
Seat 4: MetalCrüe ($1.77 in chips) 
Seat 5: ulisessoria ($2 in chips) 
Seat 6: Yangyang1407 ($2 in chips) 
josealfredonino: posts small blind $0.01
Scaaalll: posts big blind $0.02
*** HOLE CARDS ***
Dealt to Scaaalll [Ah Qh]
MetalCrüe: folds 
ulisessoria: folds 
Yangyang1407: folds 
StayFunky: folds 
josealfredonino: folds 
Uncalled bet ($0.01) returned to Scaaalll
Scaaalll collected $0.02 from pot
Scaaalll: doesn't show hand 
*** SUMMARY ***
Total pot $0.02 | Rake $0 
Seat 1: StayFunky (button) folded before Flop (didn't bet)
Seat 2: josealfredonino (small blind) folded before Flop
Seat 3: Scaaalll (big blind) collected ($0.02)
Seat 4: MetalCrüe folded before Flop (didn't bet)
Seat 5: ulisessoria folded before Flop (didn't bet)
Seat 6: Yangyang1407 folded before Flop (didn't bet)



PokerStars Zoom Hand #229233426093:  Hold'em No Limit ($0.01/$0.02) - 2021/08/21 23:29:34 CET [2021/08/21 17:29:34 ET]
Table 'Halley' 6-max Seat #1 is the button
Seat 1: shingo594 ($4.38 in chips) 
Seat 2: ulisessoria ($2.20 in chips) 
Seat 3: LucasLMdS ($3.10 in chips) 
Seat 4: romul795 ($0.27 in chips) 
Seat 5: Scaaalll ($5.54 in chips) 
Seat 6: sg.32rus ($1.75 in chips) 
ulisessoria: posts small blind $0.01
LucasLMdS: posts big blind $0.02
*** HOLE CARDS ***
Dealt to Scaaalll [7s 2s]
romul795: folds 
Scaaalll: folds 
sg.32rus: folds 
romul795 is disconnected 
shingo594: raises $0.04 to $0.06
ulisessoria: folds 
LucasLMdS: folds 
Uncalled bet ($0.04) returned to shingo594
shingo594 collected $0.05 from pot
shingo594: doesn't show hand 
*** SUMMARY ***
Total pot $0.05 | Rake $0 
Seat 1: shingo594 (button) collected ($0.05)
Seat 2: ulisessoria (small blind) folded before Flop
Seat 3: LucasLMdS (big blind) folded before Flop
Seat 4: romul795 folded before Flop (didn't bet)
Seat 5: Scaaalll folded before Flop (didn't bet)
Seat 6: sg.32rus folded before Flop (didn't bet)



PokerStars Zoom Hand #229233436000:  Hold'em No Limit ($0.01/$0.02) - 2021/08/21 23:29:58 CET [2021/08/21 17:29:58 ET]
Table 'Halley' 6-max Seat #1 is the button
Seat 1: gizum17 ($1.08 in chips) 
Seat 2: LucasLMdS ($3.08 in chips) 
Seat 3: hairy navel ($2 in chips) 
Seat 4: Scaaalll ($5.55 in chips) 
Seat 5: BIITRU ($2 in chips) 
Seat 6: Cineva81 ($2 in chips) 
LucasLMdS: posts small blind $0.01
hairy navel: posts big blind $0.02
*** HOLE CARDS ***
Dealt to Scaaalll [7c 3s]
Scaaalll: folds 
BIITRU: folds 
Cineva81: folds 
gizum17: folds 
LucasLMdS: folds 
Uncalled bet ($0.01) returned to hairy navel
hairy navel collected $0.02 from pot
hairy navel: doesn't show hand 
*** SUMMARY ***
Total pot $0.02 | Rake $0 
Seat 1: gizum17 (button) folded before Flop (didn't bet)
Seat 2: LucasLMdS (small blind) folded before Flop
Seat 3: hairy navel (big blind) collected ($0.02)
Seat 4: Scaaalll folded before Flop (didn't bet)
Seat 5: BIITRU folded before Flop (didn't bet)
Seat 6: Cineva81 folded before Flop (didn't bet)



PokerStars Zoom Hand #229233437558:  Hold'em No Limit ($0.01/$0.02) - 2021/08/21 23:30:02 CET [2021/08/21 17:30:02 ET]
Table 'Halley' 6-max Seat #1 is the button
Seat 1: yorkoss ($2.94 in chips) 
Seat 2: Scaaalll ($5.55 in chips) 
Seat 3: NoEff0rt2w1n ($7.74 in chips) 
Seat 4: nightwacher ($1.94 in chips) 
Seat 5: WaiT4U ($2.29 in chips) 
Seat 6: Colby1771 ($2.09 in chips) 
Scaaalll: posts small blind $0.01
NoEff0rt2w1n: posts big blind $0.02
*** HOLE CARDS ***
Dealt to Scaaalll [4c 8c]
nightwacher: folds 
WaiT4U: folds 
Colby1771: folds 
yorkoss: raises $0.02 to $0.04
Scaaalll: folds 
NoEff0rt2w1n: calls $0.02
*** FLOP *** [Jc Kc Ad]
NoEff0rt2w1n: checks 
yorkoss: bets $0.02
NoEff0rt2w1n: folds 
Uncalled bet ($0.02) returned to yorkoss
yorkoss collected $0.09 from pot
yorkoss: doesn't show hand 
*** SUMMARY ***
Total pot $0.09 | Rake $0 
Board [Jc Kc Ad]
Seat 1: yorkoss (button) collected ($0.09)
Seat 2: Scaaalll (small blind) folded before Flop
Seat 3: NoEff0rt2w1n (big blind) folded on the Flop
Seat 4: nightwacher folded before Flop (didn't bet)
Seat 5: WaiT4U folded before Flop (didn't bet)
Seat 6: Colby1771 folded before Flop (didn't bet)



PokerStars Zoom Hand #229233427714:  Hold'em No Limit ($0.01/$0.02) - 2021/08/21 23:29:38 CET [2021/08/21 17:29:38 ET]
Table 'Halley' 6-max Seat #1 is the button
Seat 1: Scaaalll ($5.54 in chips) 
Seat 2: bart8612 ($2.25 in chips) 
Seat 3: Bol'tazar111 ($2.05 in chips) 
Seat 4: fabor1303 ($2.09 in chips) 
Seat 5: ash1448 ($11.16 in chips) 
Seat 6: 888lifeIS ($2.08 in chips) 
bart8612: posts small blind $0.01
Bol'tazar111: posts big blind $0.02
*** HOLE CARDS ***
Dealt to Scaaalll [Kc Td]
fabor1303: raises $0.03 to $0.05
ash1448: folds 
888lifeIS: folds 
Scaaalll: folds 
bart8612: calls $0.04
Bol'tazar111: calls $0.03
*** FLOP *** [8d 9s 4d]
bart8612: checks 
Bol'tazar111: checks 
fabor1303: bets $0.07
bart8612: folds 
Bol'tazar111: calls $0.07
*** TURN *** [8d 9s 4d] [7d]
Bol'tazar111: checks 
fabor1303: bets $0.14
Bol'tazar111: folds 
Uncalled bet ($0.14) returned to fabor1303
fabor1303 collected $0.28 from pot
fabor1303: doesn't show hand 
*** SUMMARY ***
Total pot $0.29 | Rake $0.01 
Board [8d 9s 4d 7d]
Seat 1: Scaaalll (button) folded before Flop (didn't bet)
Seat 2: bart8612 (small blind) folded on the Flop
Seat 3: Bol'tazar111 (big blind) folded on the Turn
Seat 4: fabor1303 collected ($0.28)
Seat 5: ash1448 folded before Flop (didn't bet)
Seat 6: 888lifeIS folded before Flop (didn't bet)



PokerStars Zoom Hand #229233447043:  Hold'em No Limit ($0.01/$0.02) - 2021/08/21 23:30:24 CET [2021/08/21 17:30:24 ET]
Table 'Halley' 6-max Seat #1 is the button
Seat 1: Scaaalll ($5.54 in chips) 
Seat 2: maressen ($2.02 in chips) 
Seat 3: Posaunengodi ($2.73 in chips) 
Seat 4: Rin97 ($2 in chips) 
Seat 5: kahzura ($2 in chips) 
Seat 6: vovan100157 ($5.11 in chips) 
maressen: posts small blind $0.01
Posaunengodi: posts big blind $0.02
*** HOLE CARDS ***
Dealt to Scaaalll [Ts 3c]
Rin97: folds 
kahzura: folds 
vovan100157: folds 
Scaaalll: folds 
maressen: folds 
Uncalled bet ($0.01) returned to Posaunengodi
Posaunengodi collected $0.02 from pot
Posaunengodi: doesn't show hand 
*** SUMMARY ***
Total pot $0.02 | Rake $0 
Seat 1: Scaaalll (button) folded before Flop (didn't bet)
Seat 2: maressen (small blind) folded before Flop
Seat 3: Posaunengodi (big blind) collected ($0.02)
Seat 4: Rin97 folded before Flop (didn't bet)
Seat 5: kahzura folded before Flop (didn't bet)
Seat 6: vovan100157 folded before Flop (didn't bet)



PokerStars Zoom Hand #229233443166:  Hold'em No Limit ($0.01/$0.02) - 2021/08/21 23:30:15 CET [2021/08/21 17:30:15 ET]
Table 'Halley' 6-max Seat #1 is the button
Seat 1: SIGREX ($2.04 in chips) 
Seat 2: GVMELLO ($2.05 in chips) 
Seat 3: HubertFroh ($2.58 in chips) 
Seat 4: Recasia ($1.26 in chips) 
Seat 5: Scaaalll ($5.54 in chips) 
Seat 6: QuienEsDezzed ($2.01 in chips) 
GVMELLO: posts small blind $0.01
HubertFroh: posts big blind $0.02
*** HOLE CARDS ***
Dealt to Scaaalll [7c Th]
Recasia: calls $0.02
Scaaalll: folds 
QuienEsDezzed: folds 
SIGREX: folds 
GVMELLO: raises $0.10 to $0.12
HubertFroh: folds 
Recasia: folds 
Uncalled bet ($0.10) returned to GVMELLO
GVMELLO collected $0.06 from pot
GVMELLO: doesn't show hand 
*** SUMMARY ***
Total pot $0.06 | Rake $0 
Seat 1: SIGREX (button) folded before Flop (didn't bet)
Seat 2: GVMELLO (small blind) collected ($0.06)
Seat 3: HubertFroh (big blind) folded before Flop
Seat 4: Recasia folded before Flop
Seat 5: Scaaalll folded before Flop (didn't bet)
Seat 6: QuienEsDezzed folded before Flop (didn't bet)



PokerStars Zoom Hand #229233441555:  Hold'em No Limit ($0.01/$0.02) - 2021/08/21 23:30:11 CET [2021/08/21 17:30:11 ET]
Table 'Halley' 6-max Seat #1 is the button
Seat 1: Umnik_M ($2.02 in chips) 
Seat 2: Treadero ($2.25 in chips) 
Seat 3: TTGemi ($2.57 in chips) 
Seat 4: karkal1990 ($1.46 in chips) 
Seat 5: Canoinhas37 ($6.70 in chips) 
Seat 6: Scaaalll ($5.54 in chips) 
Treadero: posts small blind $0.01
TTGemi: posts big blind $0.02
*** HOLE CARDS ***
Dealt to Scaaalll [2c 8s]
karkal1990: folds 
Canoinhas37: folds 
Scaaalll: folds 
Umnik_M: folds 
karkal1990 is disconnected 
Treadero: raises $0.02 to $0.04
TTGemi: calls $0.02
*** FLOP *** [5d 5c 8d]
Treadero: bets $0.04
TTGemi: calls $0.04
*** TURN *** [5d 5c 8d] [9d]
Treadero: bets $0.08
TTGemi: calls $0.08
*** RIVER *** [5d 5c 8d 9d] [Jh]
Treadero: checks 
TTGemi: bets $0.20
Treadero: folds 
Uncalled bet ($0.20) returned to TTGemi
TTGemi collected $0.31 from pot
TTGemi: doesn't show hand 
*** SUMMARY ***
Total pot $0.32 | Rake $0.01 
Board [5d 5c 8d 9d Jh]
Seat 1: Umnik_M (button) folded before Flop (didn't bet)
Seat 2: Treadero (small blind) folded on the River
Seat 3: TTGemi (big blind) collected ($0.31)
Seat 4: karkal1990 folded before Flop (didn't bet)
Seat 5: Canoinhas37 folded before Flop (didn't bet)
Seat 6: Scaaalll folded before Flop (didn't bet)



PokerStars Zoom Hand #229233452032:  Hold'em No Limit ($0.01/$0.02) - 2021/08/21 23:30:36 CET [2021/08/21 17:30:36 ET]
Table 'Halley' 6-max Seat #1 is the button
Seat 1: ctaceo ($2 in chips) 
Seat 2: kboskov123 ($2.38 in chips) 
Seat 3: Scaaalll ($5.54 in chips) 
Seat 4: Xlavariable ($2 in chips) 
Seat 5: romul795 ($0.18 in chips) 
Seat 6: gilberto98 ($1.73 in chips) 
kboskov123: posts small blind $0.01
Scaaalll: posts big blind $0.02
*** HOLE CARDS ***
Dealt to Scaaalll [Ks 6s]
Xlavariable: folds 
romul795: folds 
romul795 is disconnected 
gilberto98: raises $0.04 to $0.06
ctaceo: folds 
kboskov123: folds 
Scaaalll: folds 
Uncalled bet ($0.04) returned to gilberto98
gilberto98 collected $0.05 from pot
gilberto98: doesn't show hand 
*** SUMMARY ***
Total pot $0.05 | Rake $0 
Seat 1: ctaceo (button) folded before Flop (didn't bet)
Seat 2: kboskov123 (small blind) folded before Flop
Seat 3: Scaaalll (big blind) folded before Flop
Seat 4: Xlavariable folded before Flop (didn't bet)
Seat 5: romul795 folded before Flop (didn't bet)
Seat 6: gilberto98 collected ($0.05)



PokerStars Zoom Hand #229233459971:  Hold'em No Limit ($0.01/$0.02) - 2021/08/21 23:30:55 CET [2021/08/21 17:30:55 ET]
Table 'Halley' 6-max Seat #1 is the button
Seat 1: dannyluijten ($2.38 in chips) 
Seat 2: Cineva81 ($2 in chips) 
Seat 3: nightwacher ($1.89 in chips) 
Seat 4: Scaaalll ($5.52 in chips) 
Seat 5: lucky1529 ($1.15 in chips) 
Seat 6: Jackb9908 ($1.70 in chips) 
Cineva81: posts small blind $0.01
nightwacher: posts big blind $0.02
*** HOLE CARDS ***
Dealt to Scaaalll [6c 9s]
Scaaalll: folds 
lucky1529: folds 
Jackb9908: folds 
dannyluijten: raises $0.04 to $0.06
Cineva81: folds 
nightwacher: calls $0.04
*** FLOP *** [5c Kd Jc]
nightwacher: checks 
dannyluijten: bets $0.07
nightwacher: folds 
Uncalled bet ($0.07) returned to dannyluijten
dannyluijten collected $0.13 from pot
dannyluijten: doesn't show hand 
*** SUMMARY ***
Total pot $0.13 | Rake $0 
Board [5c Kd Jc]
Seat 1: dannyluijten (button) collected ($0.13)
Seat 2: Cineva81 (small blind) folded before Flop
Seat 3: nightwacher (big blind) folded on the Flop
Seat 4: Scaaalll folded before Flop (didn't bet)
Seat 5: lucky1529 folded before Flop (didn't bet)
Seat 6: Jackb9908 folded before Flop (didn't bet)



PokerStars Zoom Hand #229233467978:  Hold'em No Limit ($0.01/$0.02) - 2021/08/21 23:31:14 CET [2021/08/21 17:31:14 ET]
Table 'Halley' 6-max Seat #1 is the button
Seat 1: xxVanquishxx ($15.60 in chips) 
Seat 2: nightwacher ($1.67 in chips) 
Seat 3: alphabeta1d ($2 in chips) 
Seat 4: znak312 ($2 in chips) 
Seat 5: Nihility77 ($3.88 in chips) 
Seat 6: Scaaalll ($5.51 in chips) 
nightwacher: posts small blind $0.01
alphabeta1d: posts big blind $0.02
*** HOLE CARDS ***
Dealt to Scaaalll [2s Th]
znak312: folds 
Nihility77: folds 
Scaaalll: folds 
xxVanquishxx: folds 
nightwacher: folds 
Uncalled bet ($0.01) returned to alphabeta1d
alphabeta1d collected $0.02 from pot
alphabeta1d: doesn't show hand 
*** SUMMARY ***
Total pot $0.02 | Rake $0 
Seat 1: xxVanquishxx (button) folded before Flop (didn't bet)
Seat 2: nightwacher (small blind) folded before Flop
Seat 3: alphabeta1d (big blind) collected ($0.02)
Seat 4: znak312 folded before Flop (didn't bet)
Seat 5: Nihility77 folded before Flop (didn't bet)
Seat 6: Scaaalll folded before Flop (didn't bet)



PokerStars Zoom Hand #229233470064:  Hold'em No Limit ($0.01/$0.02) - 2021/08/21 23:31:19 CET [2021/08/21 17:31:19 ET]
Table 'Halley' 6-max Seat #1 is the button
Seat 1: Taran0001 ($4.02 in chips) 
Seat 2: samn102 ($2.23 in chips) 
Seat 3: Scaaalll ($5.51 in chips) 
Seat 4: jnbjnb1010 ($2.99 in chips) 
Seat 5: pavlo8855 ($2.13 in chips) 
Seat 6: Cineva81 ($2 in chips) 
samn102: posts small blind $0.01
Scaaalll: posts big blind $0.02
*** HOLE CARDS ***
Dealt to Scaaalll [7h 4c]
jnbjnb1010: raises $0.02 to $0.04
pavlo8855: folds 
Cineva81: folds 
Taran0001: folds 
samn102: folds 
Scaaalll: folds 
Uncalled bet ($0.02) returned to jnbjnb1010
jnbjnb1010 collected $0.05 from pot
jnbjnb1010: doesn't show hand 
*** SUMMARY ***
Total pot $0.05 | Rake $0 
Seat 1: Taran0001 (button) folded before Flop (didn't bet)
Seat 2: samn102 (small blind) folded before Flop
Seat 3: Scaaalll (big blind) folded before Flop
Seat 4: jnbjnb1010 collected ($0.05)
Seat 5: pavlo8855 folded before Flop (didn't bet)
Seat 6: Cineva81 folded before Flop (didn't bet)



PokerStars Zoom Hand #229233473814:  Hold'em No Limit ($0.01/$0.02) - 2021/08/21 23:31:28 CET [2021/08/21 17:31:28 ET]
Table 'Halley' 6-max Seat #1 is the button
Seat 1: Sadikson ($2.19 in chips) 
Seat 2: Scaaalll ($5.49 in chips) 
Seat 3: Posaunengodi ($2.79 in chips) 
Seat 4: FabOliveira9 ($2 in chips) 
Seat 5: adrianh2002 ($2.08 in chips) 
Seat 6: alexan00 ($3.37 in chips) 
Scaaalll: posts small blind $0.01
Posaunengodi: posts big blind $0.02
*** HOLE CARDS ***
Dealt to Scaaalll [5d 2d]
Sadikson is disconnected 
FabOliveira9: folds 
adrianh2002: raises $0.03 to $0.05
alexan00: folds 
Sadikson: folds 
Scaaalll: folds 
Posaunengodi: folds 
Uncalled bet ($0.03) returned to adrianh2002
adrianh2002 collected $0.05 from pot
adrianh2002: doesn't show hand 
*** SUMMARY ***
Total pot $0.05 | Rake $0 
Seat 1: Sadikson (button) folded before Flop (didn't bet)
Seat 2: Scaaalll (small blind) folded before Flop
Seat 3: Posaunengodi (big blind) folded before Flop
Seat 4: FabOliveira9 folded before Flop (didn't bet)
Seat 5: adrianh2002 collected ($0.05)
Seat 6: alexan00 folded before Flop (didn't bet)



PokerStars Zoom Hand #229233462659:  Hold'em No Limit ($0.01/$0.02) - 2021/08/21 23:31:01 CET [2021/08/21 17:31:01 ET]
Table 'Halley' 6-max Seat #1 is the button
Seat 1: Shoxuzb ($1.75 in chips) 
Seat 2: Scaaalll ($5.52 in chips) 
Seat 3: Umnik_M ($2.02 in chips) 
Seat 4: Solarios ($1.19 in chips) 
Seat 5: lucky1529 ($0.99 in chips) 
Seat 6: altubehernan ($2.32 in chips) 
Scaaalll: posts small blind $0.01
Umnik_M: posts big blind $0.02
*** HOLE CARDS ***
Dealt to Scaaalll [5h Kc]
Solarios: folds 
lucky1529: folds 
altubehernan: raises $0.04 to $0.06
Shoxuzb: raises $0.15 to $0.21
Scaaalll: folds 
Umnik_M: folds 
altubehernan: calls $0.15
*** FLOP *** [Ks 2c Jc]
altubehernan: checks 
Shoxuzb: bets $0.41
altubehernan: raises $1.70 to $2.11 and is all-in
Shoxuzb: calls $1.13 and is all-in
Uncalled bet ($0.57) returned to altubehernan
*** TURN *** [Ks 2c Jc] [Ad]
*** RIVER *** [Ks 2c Jc Ad] [9d]
*** SHOW DOWN ***
altubehernan: shows [Qd Kh] (a pair of Kings)
Shoxuzb: shows [Ah Tc] (a pair of Aces)
Shoxuzb collected $3.41 from pot
*** SUMMARY ***
Total pot $3.53 | Rake $0.12 
Board [Ks 2c Jc Ad 9d]
Seat 1: Shoxuzb (button) showed [Ah Tc] and won ($3.41) with a pair of Aces
Seat 2: Scaaalll (small blind) folded before Flop
Seat 3: Umnik_M (big blind) folded before Flop
Seat 4: Solarios folded before Flop (didn't bet)
Seat 5: lucky1529 folded before Flop (didn't bet)
Seat 6: altubehernan showed [Qd Kh] and lost with a pair of Kings



PokerStars Zoom Hand #229233464280:  Hold'em No Limit ($0.01/$0.02) - 2021/08/21 23:31:05 CET [2021/08/21 17:31:05 ET]
Table 'Halley' 6-max Seat #1 is the button
Seat 1: elmex886 ($2.02 in chips) 
Seat 2: Feyqdoi ($2 in chips) 
Seat 3: auxy89 ($2.95 in chips) 
Seat 4: ash1448 ($6.82 in chips) 
Seat 5: Scaaalll ($5.51 in chips) 
Seat 6: RzkPoker ($2.11 in chips) 
Feyqdoi: posts small blind $0.01
auxy89: posts big blind $0.02
*** HOLE CARDS ***
Dealt to Scaaalll [3s 5c]
ash1448: folds 
Scaaalll: folds 
RzkPoker: folds 
elmex886: folds 
Feyqdoi: raises $0.04 to $0.06
auxy89: raises $0.04 to $0.10
Feyqdoi: calls $0.04
*** FLOP *** [2c Jd 4d]
Feyqdoi: checks 
auxy89: bets $0.19
Feyqdoi: folds 
Uncalled bet ($0.19) returned to auxy89
auxy89 collected $0.19 from pot
auxy89: doesn't show hand 
*** SUMMARY ***
Total pot $0.20 | Rake $0.01 
Board [2c Jd 4d]
Seat 1: elmex886 (button) folded before Flop (didn't bet)
Seat 2: Feyqdoi (small blind) folded on the Flop
Seat 3: auxy89 (big blind) collected ($0.19)
Seat 4: ash1448 folded before Flop (didn't bet)
Seat 5: Scaaalll folded before Flop (didn't bet)
Seat 6: RzkPoker folded before Flop (didn't bet)



PokerStars Zoom Hand #229233479704:  Hold'em No Limit ($0.01/$0.02) - 2021/08/21 23:31:42 CET [2021/08/21 17:31:42 ET]
Table 'Halley' 6-max Seat #1 is the button
Seat 1: TM 69 UIE ($2.48 in chips) 
Seat 2: Treadero ($2.22 in chips) 
Seat 3: kidninja888 ($2 in chips) 
Seat 4: Scaaalll ($5.48 in chips) 
Seat 5: cutter2468 ($2.36 in chips) 
Seat 6: ulisessoria ($2 in chips) 
Treadero: posts small blind $0.01
kidninja888: posts big blind $0.02
*** HOLE CARDS ***
Dealt to Scaaalll [4s 9c]
TM 69 UIE is disconnected 
Scaaalll: folds 
cutter2468: folds 
ulisessoria: raises $0.02 to $0.04
TM 69 UIE: folds 
Treadero: raises $0.08 to $0.12
kidninja888: folds 
ulisessoria: folds 
Uncalled bet ($0.08) returned to Treadero
Treadero collected $0.10 from pot
Treadero: doesn't show hand 
*** SUMMARY ***
Total pot $0.10 | Rake $0 
Seat 1: TM 69 UIE (button) folded before Flop (didn't bet)
Seat 2: Treadero (small blind) collected ($0.10)
Seat 3: kidninja888 (big blind) folded before Flop
Seat 4: Scaaalll folded before Flop (didn't bet)
Seat 5: cutter2468 folded before Flop (didn't bet)
Seat 6: ulisessoria folded before Flop



PokerStars Zoom Hand #229233482305:  Hold'em No Limit ($0.01/$0.02) - 2021/08/21 23:31:48 CET [2021/08/21 17:31:48 ET]
Table 'Halley' 6-max Seat #1 is the button
Seat 1: Scaaalll ($5.48 in chips) 
Seat 2: Vladimir1954 ($2.24 in chips) 
Seat 3: KissingTheSun ($2 in chips) 
Seat 4: Hope2706 ($4.75 in chips) 
Seat 5: Carlos_glaza ($2.30 in chips) 
Seat 6: szapintosz ($1.61 in chips) 
Vladimir1954: posts small blind $0.01
KissingTheSun: posts big blind $0.02
*** HOLE CARDS ***
Dealt to Scaaalll [Th Td]
szapintosz is disconnected 
Hope2706: folds 
Carlos_glaza: folds 
szapintosz: folds 
Hope2706 is disconnected 
Scaaalll: raises $0.03 to $0.05
Vladimir1954: folds 
KissingTheSun: calls $0.03
*** FLOP *** [2s 5h Tc]
KissingTheSun: checks 
Scaaalll: bets $0.07
KissingTheSun: folds 
Uncalled bet ($0.07) returned to Scaaalll
Scaaalll collected $0.11 from pot
Scaaalll: doesn't show hand 
*** SUMMARY ***
Total pot $0.11 | Rake $0 
Board [2s 5h Tc]
Seat 1: Scaaalll (button) collected ($0.11)
Seat 2: Vladimir1954 (small blind) folded before Flop
Seat 3: KissingTheSun (big blind) folded on the Flop
Seat 4: Hope2706 folded before Flop (didn't bet)
Seat 5: Carlos_glaza folded before Flop (didn't bet)
Seat 6: szapintosz folded before Flop (didn't bet)



PokerStars Zoom Hand #229233496196:  Hold'em No Limit ($0.01/$0.02) - 2021/08/21 23:32:21 CET [2021/08/21 17:32:21 ET]
Table 'Halley' 6-max Seat #1 is the button
Seat 1: bart8612 ($2.52 in chips) 
Seat 2: CitizenOfSky ($2.94 in chips) 
Seat 3: kboskov123 ($2.29 in chips) 
Seat 4: Boris_Garich ($3.86 in chips) 
Seat 5: Xlavariable ($2 in chips) 
Seat 6: Scaaalll ($5.54 in chips) 
CitizenOfSky: posts small blind $0.01
kboskov123: posts big blind $0.02
*** HOLE CARDS ***
Dealt to Scaaalll [4d Qc]
Boris_Garich: folds 
Xlavariable: raises $0.04 to $0.06
Scaaalll: folds 
bart8612: folds 
CitizenOfSky: folds 
kboskov123: folds 
Uncalled bet ($0.04) returned to Xlavariable
Xlavariable collected $0.05 from pot
Xlavariable: doesn't show hand 
*** SUMMARY ***
Total pot $0.05 | Rake $0 
Seat 1: bart8612 (button) folded before Flop (didn't bet)
Seat 2: CitizenOfSky (small blind) folded before Flop
Seat 3: kboskov123 (big blind) folded before Flop
Seat 4: Boris_Garich folded before Flop (didn't bet)
Seat 5: Xlavariable collected ($0.05)
Seat 6: Scaaalll folded before Flop (didn't bet)



PokerStars Zoom Hand #229233497753:  Hold'em No Limit ($0.01/$0.02) - 2021/08/21 23:32:25 CET [2021/08/21 17:32:25 ET]
Table 'Halley' 6-max Seat #1 is the button
Seat 1: BexleyBoy ($2.86 in chips) 
Seat 2: Hope2706 ($4.73 in chips) 
Seat 3: h3cTics ($1.12 in chips) 
Seat 4: Hejpåre ($3.61 in chips) 
Seat 5: Scaaalll ($5.54 in chips) 
Seat 6: Busya777 ($3.69 in chips) 
Hope2706: posts small blind $0.01
h3cTics: posts big blind $0.02
*** HOLE CARDS ***
Dealt to Scaaalll [3d 6h]
Busya777 is disconnected 
Hejpåre: folds 
Scaaalll: folds 
Busya777: folds 
BexleyBoy: folds 
Hope2706: folds 
Uncalled bet ($0.01) returned to h3cTics
h3cTics collected $0.02 from pot
h3cTics: doesn't show hand 
Hope2706 is disconnected 
*** SUMMARY ***
Total pot $0.02 | Rake $0 
Seat 1: BexleyBoy (button) folded before Flop (didn't bet)
Seat 2: Hope2706 (small blind) folded before Flop
Seat 3: h3cTics (big blind) collected ($0.02)
Seat 4: Hejpåre folded before Flop (didn't bet)
Seat 5: Scaaalll folded before Flop (didn't bet)
Seat 6: Busya777 folded before Flop (didn't bet)



PokerStars Zoom Hand #229233505293:  Hold'em No Limit ($0.01/$0.02) - 2021/08/21 23:32:43 CET [2021/08/21 17:32:43 ET]
Table 'Halley' 6-max Seat #1 is the button
Seat 1: Scaaalll ($5.52 in chips) 
Seat 2: SaLoMaN4iK ($1.95 in chips) 
Seat 3: Jones278 ($2.33 in chips) 
Seat 4: KKARMELO ($3.17 in chips) 
Seat 5: BeastBoy18 ($2.03 in chips) 
Seat 6: Koldun 2636 ($4.15 in chips) 
SaLoMaN4iK: posts small blind $0.01
Jones278: posts big blind $0.02
*** HOLE CARDS ***
Dealt to Scaaalll [2c Ad]
KKARMELO: folds 
BeastBoy18: folds 
Koldun 2636: folds 
Scaaalll: folds 
SaLoMaN4iK: raises $0.04 to $0.06
Jones278: folds 
Uncalled bet ($0.04) returned to SaLoMaN4iK
SaLoMaN4iK collected $0.04 from pot
SaLoMaN4iK: doesn't show hand 
*** SUMMARY ***
Total pot $0.04 | Rake $0 
Seat 1: Scaaalll (button) folded before Flop (didn't bet)
Seat 2: SaLoMaN4iK (small blind) collected ($0.04)
Seat 3: Jones278 (big blind) folded before Flop
Seat 4: KKARMELO folded before Flop (didn't bet)
Seat 5: BeastBoy18 folded before Flop (didn't bet)
Seat 6: Koldun 2636 folded before Flop (didn't bet)



PokerStars Zoom Hand #229233510193:  Hold'em No Limit ($0.01/$0.02) - 2021/08/21 23:32:55 CET [2021/08/21 17:32:55 ET]
Table 'Halley' 6-max Seat #1 is the button
Seat 1: juelz_ua ($1.85 in chips) 
Seat 2: DrewRich420 ($3.81 in chips) 
Seat 3: Mikeloko182 ($6.34 in chips) 
Seat 4: pipecmolodec ($2.14 in chips) 
Seat 5: Scaaalll ($5.52 in chips) 
Seat 6: udav26 ($2.38 in chips) 
DrewRich420: posts small blind $0.01
Mikeloko182: posts big blind $0.02
*** HOLE CARDS ***
Dealt to Scaaalll [Qd 2d]
pipecmolodec: folds 
Scaaalll: folds 
udav26: folds 
juelz_ua: raises $0.04 to $0.06
DrewRich420: folds 
DrewRich420 is disconnected 
Mikeloko182: folds 
Uncalled bet ($0.04) returned to juelz_ua
juelz_ua collected $0.05 from pot
juelz_ua: doesn't show hand 
*** SUMMARY ***
Total pot $0.05 | Rake $0 
Seat 1: juelz_ua (button) collected ($0.05)
Seat 2: DrewRich420 (small blind) folded before Flop
Seat 3: Mikeloko182 (big blind) folded before Flop
Seat 4: pipecmolodec folded before Flop (didn't bet)
Seat 5: Scaaalll folded before Flop (didn't bet)
Seat 6: udav26 folded before Flop (didn't bet)



PokerStars Zoom Hand #229233499433:  Hold'em No Limit ($0.01/$0.02) - 2021/08/21 23:32:29 CET [2021/08/21 17:32:29 ET]
Table 'Halley' 6-max Seat #1 is the button
Seat 1: MKIronCrAAzy ($5.89 in chips) 
Seat 2: NickAlex18 ($2.22 in chips) 
Seat 3: Scaaalll ($5.54 in chips) 
Seat 4: ctaceo ($2 in chips) 
Seat 5: sg.32rus ($2.01 in chips) 
Seat 6: Colby1771 ($2.21 in chips) 
NickAlex18: posts small blind $0.01
Scaaalll: posts big blind $0.02
*** HOLE CARDS ***
Dealt to Scaaalll [7h 2s]
ctaceo: raises $0.03 to $0.05
sg.32rus: calls $0.05
Colby1771: raises $0.15 to $0.20
MKIronCrAAzy: folds 
NickAlex18: folds 
Scaaalll: folds 
ctaceo: folds 
sg.32rus: calls $0.15
*** FLOP *** [Qs Js 9s]
sg.32rus: bets $0.02
Colby1771: raises $0.20 to $0.22
sg.32rus: raises $1.59 to $1.81 and is all-in
Colby1771: folds 
Uncalled bet ($1.59) returned to sg.32rus
sg.32rus collected $0.89 from pot
sg.32rus: doesn't show hand 
*** SUMMARY ***
Total pot $0.92 | Rake $0.03 
Board [Qs Js 9s]
Seat 1: MKIronCrAAzy (button) folded before Flop (didn't bet)
Seat 2: NickAlex18 (small blind) folded before Flop
Seat 3: Scaaalll (big blind) folded before Flop
Seat 4: ctaceo folded before Flop
Seat 5: sg.32rus collected ($0.89)
Seat 6: Colby1771 folded on the Flop



PokerStars Zoom Hand #229233511854:  Hold'em No Limit ($0.01/$0.02) - 2021/08/21 23:32:59 CET [2021/08/21 17:32:59 ET]
Table 'Halley' 6-max Seat #1 is the button
Seat 1: so0love ($6.92 in chips) 
Seat 2: Scaaalll ($5.52 in chips) 
Seat 3: Hejpåre ($2.09 in chips) 
Seat 4: Ape$apiens ($2.02 in chips) 
Seat 5: Mustang01373 ($1.27 in chips) 
Seat 6: nodtress ($4.26 in chips) 
Scaaalll: posts small blind $0.01
Hejpåre: posts big blind $0.02
*** HOLE CARDS ***
Dealt to Scaaalll [5s 7s]
Ape$apiens: folds 
Ape$apiens is disconnected 
Mustang01373: calls $0.02
nodtress: folds 
so0love: folds 
Scaaalll: calls $0.01
Hejpåre: checks 
*** FLOP *** [7d 9h 6h]
Scaaalll: checks 
Hejpåre: checks 
Mustang01373: checks 
*** TURN *** [7d 9h 6h] [Kd]
Scaaalll: checks 
Hejpåre: checks 
Mustang01373: checks 
*** RIVER *** [7d 9h 6h Kd] [5d]
Scaaalll: bets $0.03
Hejpåre: folds 
Mustang01373: folds 
Uncalled bet ($0.03) returned to Scaaalll
Scaaalll collected $0.06 from pot
Scaaalll: doesn't show hand 
*** SUMMARY ***
Total pot $0.06 | Rake $0 
Board [7d 9h 6h Kd 5d]
Seat 1: so0love (button) folded before Flop (didn't bet)
Seat 2: Scaaalll (small blind) collected ($0.06)
Seat 3: Hejpåre (big blind) folded on the River
Seat 4: Ape$apiens folded before Flop (didn't bet)
Seat 5: Mustang01373 folded on the River
Seat 6: nodtress folded before Flop (didn't bet)



PokerStars Zoom Hand #229233533387:  Hold'em No Limit ($0.01/$0.02) - 2021/08/21 23:33:51 CET [2021/08/21 17:33:51 ET]
Table 'Halley' 6-max Seat #1 is the button
Seat 1: Treadero ($2.44 in chips) 
Seat 2: YgovAndrey ($2.28 in chips) 
Seat 3: Pizotifen ($2.66 in chips) 
Seat 4: Scaaalll ($5.56 in chips) 
Seat 5: deldanlee ($0.90 in chips) 
Seat 6: BexleyBoy ($2.80 in chips) 
YgovAndrey: posts small blind $0.01
Pizotifen: posts big blind $0.02
*** HOLE CARDS ***
Dealt to Scaaalll [4d Jd]
Scaaalll: folds 
deldanlee: calls $0.02
BexleyBoy: folds 
Treadero: raises $0.04 to $0.06
YgovAndrey: folds 
Pizotifen: folds 
deldanlee: calls $0.04
*** FLOP *** [5h 6c 2s]
deldanlee: checks 
Treadero: bets $0.07
deldanlee: calls $0.07
*** TURN *** [5h 6c 2s] [6h]
deldanlee: checks 
Treadero: bets $0.14
deldanlee: folds 
Uncalled bet ($0.14) returned to Treadero
Treadero collected $0.28 from pot
Treadero: doesn't show hand 
*** SUMMARY ***
Total pot $0.29 | Rake $0.01 
Board [5h 6c 2s 6h]
Seat 1: Treadero (button) collected ($0.28)
Seat 2: YgovAndrey (small blind) folded before Flop
Seat 3: Pizotifen (big blind) folded before Flop
Seat 4: Scaaalll folded before Flop (didn't bet)
Seat 5: deldanlee folded on the Turn
Seat 6: BexleyBoy folded before Flop (didn't bet)



PokerStars Zoom Hand #229233539208:  Hold'em No Limit ($0.01/$0.02) - 2021/08/21 23:34:05 CET [2021/08/21 17:34:05 ET]
Table 'Halley' 6-max Seat #1 is the button
Seat 1: olga3021221 ($2.75 in chips) 
Seat 2: kahzura ($2.92 in chips) 
Seat 3: Scaaalll ($5.56 in chips) 
Seat 4: estelionat171 ($1.05 in chips) 
Seat 5: 365p2eva ($2.09 in chips) 
Seat 6: Vladimir1954 ($2.25 in chips) 
kahzura: posts small blind $0.01
Scaaalll: posts big blind $0.02
*** HOLE CARDS ***
Dealt to Scaaalll [Ah Ad]
estelionat171: folds 
365p2eva: raises $0.04 to $0.06
Vladimir1954: folds 
olga3021221: folds 
kahzura: folds 
Scaaalll: raises $0.14 to $0.20
365p2eva: calls $0.14
*** FLOP *** [As 6h 5c]
Scaaalll: bets $0.22
365p2eva: folds 
Uncalled bet ($0.22) returned to Scaaalll
Scaaalll collected $0.40 from pot
Scaaalll: doesn't show hand 
*** SUMMARY ***
Total pot $0.41 | Rake $0.01 
Board [As 6h 5c]
Seat 1: olga3021221 (button) folded before Flop (didn't bet)
Seat 2: kahzura (small blind) folded before Flop
Seat 3: Scaaalll (big blind) collected ($0.40)
Seat 4: estelionat171 folded before Flop (didn't bet)
Seat 5: 365p2eva folded on the Flop
Seat 6: Vladimir1954 folded before Flop (didn't bet)



PokerStars Zoom Hand #229233535461:  Hold'em No Limit ($0.01/$0.02) - 2021/08/21 23:33:56 CET [2021/08/21 17:33:56 ET]
Table 'Halley' 6-max Seat #1 is the button
Seat 1: Pechorin.G ($2.25 in chips) 
Seat 2: altubehernan ($1.21 in chips) 
Seat 3: pokerfan3999 ($2 in chips) 
Seat 4: nitzed12 ($2 in chips) 
Seat 5: Vanekakqj ($4.21 in chips) 
Seat 6: Scaaalll ($5.56 in chips) 
altubehernan: posts small blind $0.01
pokerfan3999: posts big blind $0.02
*** HOLE CARDS ***
Dealt to Scaaalll [Js 2c]
nitzed12: folds 
Vanekakqj: folds 
Scaaalll: folds 
Pechorin.G: raises $0.03 to $0.05
altubehernan: folds 
pokerfan3999: calls $0.03
*** FLOP *** [As 4s 8d]
pokerfan3999: checks 
Pechorin.G: checks 
*** TURN *** [As 4s 8d] [9h]
pokerfan3999: checks 
Pechorin.G: bets $0.06
pokerfan3999: folds 
Uncalled bet ($0.06) returned to Pechorin.G
Pechorin.G collected $0.11 from pot
Pechorin.G: doesn't show hand 
*** SUMMARY ***
Total pot $0.11 | Rake $0 
Board [As 4s 8d 9h]
Seat 1: Pechorin.G (button) collected ($0.11)
Seat 2: altubehernan (small blind) folded before Flop
Seat 3: pokerfan3999 (big blind) folded on the Turn
Seat 4: nitzed12 folded before Flop (didn't bet)
Seat 5: Vanekakqj folded before Flop (didn't bet)
Seat 6: Scaaalll folded before Flop (didn't bet)



PokerStars Zoom Hand #229233537144:  Hold'em No Limit ($0.01/$0.02) - 2021/08/21 23:34:00 CET [2021/08/21 17:34:00 ET]
Table 'Halley' 6-max Seat #1 is the button
Seat 1: Busya777 ($4.83 in chips) 
Seat 2: GVMELLO ($2 in chips) 
Seat 3: I.P.BAYANOV ($3.86 in chips) 
Seat 4: Doktor Yes ($2.15 in chips) 
Seat 5: Scaaalll ($5.56 in chips) 
Seat 6: znak312 ($2.10 in chips) 
GVMELLO: posts small blind $0.01
I.P.BAYANOV: posts big blind $0.02
*** HOLE CARDS ***
Dealt to Scaaalll [7c Jc]
Doktor Yes: folds 
Scaaalll: folds 
znak312: raises $0.03 to $0.05
Busya777: folds 
GVMELLO: folds 
Busya777 is disconnected 
I.P.BAYANOV: calls $0.03
*** FLOP *** [4c Qd 8s]
I.P.BAYANOV: checks 
znak312: bets $0.06
I.P.BAYANOV: calls $0.06
*** TURN *** [4c Qd 8s] [4s]
I.P.BAYANOV: checks 
znak312: checks 
*** RIVER *** [4c Qd 8s 4s] [7d]
I.P.BAYANOV: checks 
znak312: checks 
*** SHOW DOWN ***
I.P.BAYANOV: shows [Jh Ac] (a pair of Fours)
znak312: mucks hand 
I.P.BAYANOV collected $0.22 from pot
*** SUMMARY ***
Total pot $0.23 | Rake $0.01 
Board [4c Qd 8s 4s 7d]
Seat 1: Busya777 (button) folded before Flop (didn't bet)
Seat 2: GVMELLO (small blind) folded before Flop
Seat 3: I.P.BAYANOV (big blind) showed [Jh Ac] and won ($0.22) with a pair of Fours
Seat 4: Doktor Yes folded before Flop (didn't bet)
Seat 5: Scaaalll folded before Flop (didn't bet)
Seat 6: znak312 mucked [Ah Ts]



PokerStars Zoom Hand #229233556283:  Hold'em No Limit ($0.01/$0.02) - 2021/08/21 23:34:31 CET [2021/08/21 17:34:31 ET]
Table 'Halley' 6-max Seat #1 is the button
Seat 1: Scaaalll ($5.76 in chips) 
Seat 2: 888lifeIS ($2.45 in chips) 
Seat 3: Lekcey05 ($2.07 in chips) 
Seat 4: Doktor Yes ($2.01 in chips) 
Seat 5: Hope2706 ($5.09 in chips) 
Seat 6: Feliciano16 ($3.20 in chips) 
888lifeIS: posts small blind $0.01
Lekcey05: posts big blind $0.02
*** HOLE CARDS ***
Dealt to Scaaalll [5d 4d]
Doktor Yes: folds 
Hope2706: folds 
Feliciano16: folds 
Hope2706 is disconnected 
Scaaalll: raises $0.02 to $0.04
888lifeIS: folds 
Lekcey05: raises $0.14 to $0.18
Scaaalll: folds 
Uncalled bet ($0.14) returned to Lekcey05
Lekcey05 collected $0.09 from pot
Lekcey05: doesn't show hand 
*** SUMMARY ***
Total pot $0.09 | Rake $0 
Seat 1: Scaaalll (button) folded before Flop
Seat 2: 888lifeIS (small blind) folded before Flop
Seat 3: Lekcey05 (big blind) collected ($0.09)
Seat 4: Doktor Yes folded before Flop (didn't bet)
Seat 5: Hope2706 folded before Flop (didn't bet)
Seat 6: Feliciano16 folded before Flop (didn't bet)



PokerStars Zoom Hand #229233571925:  Hold'em No Limit ($0.01/$0.02) - 2021/08/21 23:35:09 CET [2021/08/21 17:35:09 ET]
Table 'Halley' 6-max Seat #1 is the button
Seat 1: Feliciano16 ($3.35 in chips) 
Seat 2: Scaaalll ($5.72 in chips) 
Seat 3: afreak93 ($2.63 in chips) 
Seat 4: PapiMik3 ($2.97 in chips) 
Seat 5: MinorityRule ($1.16 in chips) 
Seat 6: vovan100157 ($2.21 in chips) 
Scaaalll: posts small blind $0.01
afreak93: posts big blind $0.02
*** HOLE CARDS ***
Dealt to Scaaalll [9h 7h]
PapiMik3: raises $0.04 to $0.06
MinorityRule: folds 
MinorityRule is disconnected 
vovan100157: folds 
Feliciano16: folds 
Scaaalll: folds 
afreak93: folds 
Uncalled bet ($0.04) returned to PapiMik3
PapiMik3 collected $0.05 from pot
PapiMik3: doesn't show hand 
*** SUMMARY ***
Total pot $0.05 | Rake $0 
Seat 1: Feliciano16 (button) folded before Flop (didn't bet)
Seat 2: Scaaalll (small blind) folded before Flop
Seat 3: afreak93 (big blind) folded before Flop
Seat 4: PapiMik3 collected ($0.05)
Seat 5: MinorityRule folded before Flop (didn't bet)
Seat 6: vovan100157 folded before Flop (didn't bet)



PokerStars Zoom Hand #229233578973:  Hold'em No Limit ($0.01/$0.02) - 2021/08/21 23:35:26 CET [2021/08/21 17:35:26 ET]
Table 'Halley' 6-max Seat #1 is the button
Seat 1: Scaaalll ($5.71 in chips) 
Seat 2: HubertFroh ($4.34 in chips) 
Seat 3: MinorityRule ($1.16 in chips) 
Seat 4: martuska88 ($2.02 in chips) 
Seat 5: estelionat171 ($1.44 in chips) 
Seat 6: Yangyang1407 ($2.03 in chips) 
HubertFroh: posts small blind $0.01
MinorityRule: posts big blind $0.02
*** HOLE CARDS ***
Dealt to Scaaalll [2s 8h]
martuska88: folds 
estelionat171: folds 
Yangyang1407: folds 
Scaaalll: folds 
HubertFroh: folds 
Uncalled bet ($0.01) returned to MinorityRule
MinorityRule collected $0.02 from pot
MinorityRule: doesn't show hand 
*** SUMMARY ***
Total pot $0.02 | Rake $0 
Seat 1: Scaaalll (button) folded before Flop (didn't bet)
Seat 2: HubertFroh (small blind) folded before Flop
Seat 3: MinorityRule (big blind) collected ($0.02)
Seat 4: martuska88 folded before Flop (didn't bet)
Seat 5: estelionat171 folded before Flop (didn't bet)
Seat 6: Yangyang1407 folded before Flop (didn't bet)



PokerStars Zoom Hand #229233577216:  Hold'em No Limit ($0.01/$0.02) - 2021/08/21 23:35:22 CET [2021/08/21 17:35:22 ET]
Table 'Halley' 6-max Seat #1 is the button
Seat 1: pavlo8855 ($2.02 in chips) 
Seat 2: Doktor Yes ($2.02 in chips) 
Seat 3: kahzura ($2.86 in chips) 
Seat 4: Scaaalll ($5.71 in chips) 
Seat 5: AbusiveLion ($1.52 in chips) 
Seat 6: hairy navel ($2.02 in chips) 
Doktor Yes: posts small blind $0.01
kahzura: posts big blind $0.02
*** HOLE CARDS ***
Dealt to Scaaalll [9h 8d]
Scaaalll: folds 
AbusiveLion: raises $0.02 to $0.04
hairy navel: folds 
pavlo8855: folds 
Doktor Yes: folds 
kahzura: calls $0.02
*** FLOP *** [3d 2h Kh]
kahzura: checks 
AbusiveLion: bets $0.04
kahzura: folds 
Uncalled bet ($0.04) returned to AbusiveLion
AbusiveLion collected $0.09 from pot
AbusiveLion: doesn't show hand 
*** SUMMARY ***
Total pot $0.09 | Rake $0 
Board [3d 2h Kh]
Seat 1: pavlo8855 (button) folded before Flop (didn't bet)
Seat 2: Doktor Yes (small blind) folded before Flop
Seat 3: kahzura (big blind) folded on the Flop
Seat 4: Scaaalll folded before Flop (didn't bet)
Seat 5: AbusiveLion collected ($0.09)
Seat 6: hairy navel folded before Flop (didn't bet)



PokerStars Zoom Hand #229233575559:  Hold'em No Limit ($0.01/$0.02) - 2021/08/21 23:35:18 CET [2021/08/21 17:35:18 ET]
Table 'Halley' 6-max Seat #1 is the button
Seat 1: A.Khodyakov ($1.86 in chips) 
Seat 2: Rafa13brr ($0.94 in chips) 
Seat 3: kumka8812 ($1.47 in chips) 
Seat 4: Scaaalll ($5.71 in chips) 
Seat 5: Hallyson_23 ($4.61 in chips) 
Seat 6: Yangyang1407 ($2 in chips) 
Rafa13brr: posts small blind $0.01
kumka8812: posts big blind $0.02
*** HOLE CARDS ***
Dealt to Scaaalll [6s 7c]
Scaaalll: folds 
Hallyson_23: folds 
Yangyang1407: folds 
A.Khodyakov: folds 
Rafa13brr: raises $0.02 to $0.04
kumka8812: calls $0.02
*** FLOP *** [Qs 7d Js]
Rafa13brr: checks 
kumka8812: checks 
*** TURN *** [Qs 7d Js] [Ts]
Rafa13brr: bets $0.04
kumka8812: calls $0.04
*** RIVER *** [Qs 7d Js Ts] [Qh]
Rafa13brr: bets $0.08
kumka8812: calls $0.08
*** SHOW DOWN ***
Rafa13brr: shows [Ac 3d] (a pair of Queens)
kumka8812: shows [6d Td] (two pair, Queens and Tens)
kumka8812 collected $0.31 from pot
*** SUMMARY ***
Total pot $0.32 | Rake $0.01 
Board [Qs 7d Js Ts Qh]
Seat 1: A.Khodyakov (button) folded before Flop (didn't bet)
Seat 2: Rafa13brr (small blind) showed [Ac 3d] and lost with a pair of Queens
Seat 3: kumka8812 (big blind) showed [6d Td] and won ($0.31) with two pair, Queens and Tens
Seat 4: Scaaalll folded before Flop (didn't bet)
Seat 5: Hallyson_23 folded before Flop (didn't bet)
Seat 6: Yangyang1407 folded before Flop (didn't bet)



PokerStars Zoom Hand #229233568269:  Hold'em No Limit ($0.01/$0.02) - 2021/08/21 23:35:00 CET [2021/08/21 17:35:00 ET]
Table 'Halley' 6-max Seat #1 is the button
Seat 1: Jacon2905 ($2.21 in chips) 
Seat 2: znak312 ($2.14 in chips) 
Seat 3: medyza111 ($2 in chips) 
Seat 4: phlopit ($2.03 in chips) 
Seat 5: RrriotGrrrl ($3.38 in chips) 
Seat 6: Scaaalll ($5.72 in chips) 
znak312: posts small blind $0.01
medyza111: posts big blind $0.02
*** HOLE CARDS ***
Dealt to Scaaalll [9d 7s]
phlopit: folds 
RrriotGrrrl: raises $0.04 to $0.06
Scaaalll: folds 
Jacon2905: folds 
znak312: folds 
medyza111: calls $0.04
*** FLOP *** [Th 3s 7h]
medyza111: checks 
RrriotGrrrl: bets $0.08
medyza111: raises $0.08 to $0.16
RrriotGrrrl: calls $0.08
*** TURN *** [Th 3s 7h] [8h]
medyza111: checks 
RrriotGrrrl: checks 
*** RIVER *** [Th 3s 7h 8h] [9h]
medyza111: bets $0.22
RrriotGrrrl: folds 
Uncalled bet ($0.22) returned to medyza111
medyza111 collected $0.43 from pot
medyza111: doesn't show hand 
*** SUMMARY ***
Total pot $0.45 | Rake $0.02 
Board [Th 3s 7h 8h 9h]
Seat 1: Jacon2905 (button) folded before Flop (didn't bet)
Seat 2: znak312 (small blind) folded before Flop
Seat 3: medyza111 (big blind) collected ($0.43)
Seat 4: phlopit folded before Flop (didn't bet)
Seat 5: RrriotGrrrl folded on the River
Seat 6: Scaaalll folded before Flop (didn't bet)



PokerStars Zoom Hand #229233580528:  Hold'em No Limit ($0.01/$0.02) - 2021/08/21 23:35:30 CET [2021/08/21 17:35:30 ET]
Table 'Halley' 6-max Seat #1 is the button
Seat 1: zergmiky ($3.14 in chips) 
Seat 2: JTbukowski ($2.83 in chips) 
Seat 3: Scaaalll ($5.71 in chips) 
Seat 4: Fenix888888 ($1.01 in chips) 
Seat 5: kidninja888 ($2.17 in chips) 
Seat 6: SaLoMaN4iK ($1.87 in chips) 
JTbukowski: posts small blind $0.01
Scaaalll: posts big blind $0.02
*** HOLE CARDS ***
Dealt to Scaaalll [Td Ts]
Fenix888888: folds 
kidninja888: folds 
SaLoMaN4iK: raises $0.04 to $0.06
zergmiky: folds 
JTbukowski: folds 
Scaaalll: calls $0.04
*** FLOP *** [7s Kh Jh]
Scaaalll: checks 
SaLoMaN4iK: bets $0.04
Scaaalll: calls $0.04
*** TURN *** [7s Kh Jh] [9d]
Scaaalll: checks 
SaLoMaN4iK: checks 
*** RIVER *** [7s Kh Jh 9d] [7c]
Scaaalll: bets $0.06
SaLoMaN4iK: folds 
Uncalled bet ($0.06) returned to Scaaalll
Scaaalll collected $0.20 from pot
Scaaalll: doesn't show hand 
SaLoMaN4iK is disconnected 
*** SUMMARY ***
Total pot $0.21 | Rake $0.01 
Board [7s Kh Jh 9d 7c]
Seat 1: zergmiky (button) folded before Flop (didn't bet)
Seat 2: JTbukowski (small blind) folded before Flop
Seat 3: Scaaalll (big blind) collected ($0.20)
Seat 4: Fenix888888 folded before Flop (didn't bet)
Seat 5: kidninja888 folded before Flop (didn't bet)
Seat 6: SaLoMaN4iK folded on the River



PokerStars Zoom Hand #229233599055:  Hold'em No Limit ($0.01/$0.02) - 2021/08/21 23:36:15 CET [2021/08/21 17:36:15 ET]
Table 'Halley' 6-max Seat #1 is the button
Seat 1: rabbitmeat73 ($0.65 in chips) 
Seat 2: Pizotifen ($2.01 in chips) 
Seat 3: kingdieter1 ($2.06 in chips) 
Seat 4: BeastBoy18 ($2.13 in chips) 
Seat 5: maliniak75 ($1.61 in chips) 
Seat 6: Scaaalll ($5.81 in chips) 
Pizotifen: posts small blind $0.01
kingdieter1: posts big blind $0.02
*** HOLE CARDS ***
Dealt to Scaaalll [6c 7c]
BeastBoy18: folds 
maliniak75: folds 
Scaaalll: raises $0.04 to $0.06
rabbitmeat73: folds 
kingdieter1 is disconnected 
Pizotifen: folds 
kingdieter1: folds 
Uncalled bet ($0.04) returned to Scaaalll
Scaaalll collected $0.05 from pot
Scaaalll: doesn't show hand 
*** SUMMARY ***
Total pot $0.05 | Rake $0 
Seat 1: rabbitmeat73 (button) folded before Flop (didn't bet)
Seat 2: Pizotifen (small blind) folded before Flop
Seat 3: kingdieter1 (big blind) folded before Flop
Seat 4: BeastBoy18 folded before Flop (didn't bet)
Seat 5: maliniak75 folded before Flop (didn't bet)
Seat 6: Scaaalll collected ($0.05)



PokerStars Zoom Hand #229233596218:  Hold'em No Limit ($0.01/$0.02) - 2021/08/21 23:36:08 CET [2021/08/21 17:36:08 ET]
Table 'Halley' 6-max Seat #1 is the button
Seat 1: owtwilldo ($2.69 in chips) 
Seat 2: SHALOMandKAT ($1.27 in chips) 
Seat 3: KonopDima ($2.03 in chips) 
Seat 4: Scaaalll ($5.81 in chips) 
Seat 5: cutter2468 ($7.04 in chips) 
Seat 6: Carlos_glaza ($2.70 in chips) 
SHALOMandKAT: posts small blind $0.01
KonopDima: posts big blind $0.02
*** HOLE CARDS ***
Dealt to Scaaalll [Jc 5c]
Scaaalll: folds 
cutter2468: raises $0.03 to $0.05
Carlos_glaza: folds 
owtwilldo: folds 
SHALOMandKAT: calls $0.04
KonopDima: folds 
*** FLOP *** [Jh 3d Qd]
SHALOMandKAT: checks 
cutter2468: bets $0.04
SHALOMandKAT: calls $0.04
*** TURN *** [Jh 3d Qd] [9c]
SHALOMandKAT: bets $0.10
cutter2468: folds 
Uncalled bet ($0.10) returned to SHALOMandKAT
SHALOMandKAT collected $0.19 from pot
SHALOMandKAT: doesn't show hand 
*** SUMMARY ***
Total pot $0.20 | Rake $0.01 
Board [Jh 3d Qd 9c]
Seat 1: owtwilldo (button) folded before Flop (didn't bet)
Seat 2: SHALOMandKAT (small blind) collected ($0.19)
Seat 3: KonopDima (big blind) folded before Flop
Seat 4: Scaaalll folded before Flop (didn't bet)
Seat 5: cutter2468 folded on the Turn
Seat 6: Carlos_glaza folded before Flop (didn't bet)



PokerStars Zoom Hand #229233607980:  Hold'em No Limit ($0.01/$0.02) - 2021/08/21 23:36:37 CET [2021/08/21 17:36:37 ET]
Table 'Halley' 6-max Seat #1 is the button
Seat 1: BIITRU ($2.02 in chips) 
Seat 2: Scaaalll ($5.84 in chips) 
Seat 3: NoEff0rt2w1n ($6.87 in chips) 
Seat 4: GVMELLO ($2 in chips) 
Seat 5: heynckes18 ($5.43 in chips) 
Seat 6: 47911728 ($1.74 in chips) 
Scaaalll: posts small blind $0.01
NoEff0rt2w1n: posts big blind $0.02
*** HOLE CARDS ***
Dealt to Scaaalll [6d Tc]
GVMELLO: raises $0.03 to $0.05
heynckes18: folds 
47911728: folds 
BIITRU: folds 
Scaaalll: folds 
NoEff0rt2w1n: calls $0.03
*** FLOP *** [Ks Kd As]
NoEff0rt2w1n: checks 
GVMELLO: bets $0.04
NoEff0rt2w1n: folds 
Uncalled bet ($0.04) returned to GVMELLO
GVMELLO collected $0.11 from pot
GVMELLO: doesn't show hand 
*** SUMMARY ***
Total pot $0.11 | Rake $0 
Board [Ks Kd As]
Seat 1: BIITRU (button) folded before Flop (didn't bet)
Seat 2: Scaaalll (small blind) folded before Flop
Seat 3: NoEff0rt2w1n (big blind) folded on the Flop
Seat 4: GVMELLO collected ($0.11)
Seat 5: heynckes18 folded before Flop (didn't bet)
Seat 6: 47911728 folded before Flop (didn't bet)



PokerStars Zoom Hand #229233609691:  Hold'em No Limit ($0.01/$0.02) - 2021/08/21 23:36:41 CET [2021/08/21 17:36:41 ET]
Table 'Halley' 6-max Seat #1 is the button
Seat 1: elmex886 ($2 in chips) 
Seat 2: 47911728 ($1.74 in chips) 
Seat 3: zergmiky ($2 in chips) 
Seat 4: Scaaalll ($5.83 in chips) 
Seat 5: YgovAndrey ($1.97 in chips) 
Seat 6: 1984gonzo33 ($3.48 in chips) 
47911728: posts small blind $0.01
zergmiky: posts big blind $0.02
*** HOLE CARDS ***
Dealt to Scaaalll [Kd Qc]
Scaaalll: raises $0.04 to $0.06
YgovAndrey: folds 
1984gonzo33: folds 
1984gonzo33 is disconnected 
elmex886: folds 
47911728: folds 
zergmiky: folds 
Uncalled bet ($0.04) returned to Scaaalll
Scaaalll collected $0.05 from pot
Scaaalll: doesn't show hand 
*** SUMMARY ***
Total pot $0.05 | Rake $0 
Seat 1: elmex886 (button) folded before Flop (didn't bet)
Seat 2: 47911728 (small blind) folded before Flop
Seat 3: zergmiky (big blind) folded before Flop
Seat 4: Scaaalll collected ($0.05)
Seat 5: YgovAndrey folded before Flop (didn't bet)
Seat 6: 1984gonzo33 folded before Flop (didn't bet)



PokerStars Zoom Hand #229233616200:  Hold'em No Limit ($0.01/$0.02) - 2021/08/21 23:36:57 CET [2021/08/21 17:36:57 ET]
Table 'Halley' 6-max Seat #1 is the button
Seat 1: Scaaalll ($5.86 in chips) 
Seat 2: A.Khodyakov ($1.72 in chips) 
Seat 3: xoen ($2 in chips) 
Seat 4: gasmar_29 ($2.56 in chips) 
Seat 5: Sidnei_ps ($2.08 in chips) 
Seat 6: Mr.Kurier ($4.26 in chips) 
A.Khodyakov: posts small blind $0.01
xoen: posts big blind $0.02
*** HOLE CARDS ***
Dealt to Scaaalll [2c Th]
gasmar_29: folds 
Sidnei_ps: raises $2.06 to $2.08 and is all-in
Mr.Kurier: folds 
Scaaalll: folds 
A.Khodyakov: folds 
xoen: folds 
Uncalled bet ($2.06) returned to Sidnei_ps
Sidnei_ps collected $0.05 from pot
Sidnei_ps: doesn't show hand 
*** SUMMARY ***
Total pot $0.05 | Rake $0 
Seat 1: Scaaalll (button) folded before Flop (didn't bet)
Seat 2: A.Khodyakov (small blind) folded before Flop
Seat 3: xoen (big blind) folded before Flop
Seat 4: gasmar_29 folded before Flop (didn't bet)
Seat 5: Sidnei_ps collected ($0.05)
Seat 6: Mr.Kurier folded before Flop (didn't bet)



PokerStars Zoom Hand #229233619822:  Hold'em No Limit ($0.01/$0.02) - 2021/08/21 23:37:06 CET [2021/08/21 17:37:06 ET]
Table 'Halley' 6-max Seat #1 is the button
Seat 1: Pechorin.G ($2.56 in chips) 
Seat 2: San4oWV ($2.47 in chips) 
Seat 3: nikof420 ($2.37 in chips) 
Seat 4: vovan100157 ($5.26 in chips) 
Seat 5: Scaaalll ($5.86 in chips) 
Seat 6: owtwilldo ($2 in chips) 
San4oWV: posts small blind $0.01
nikof420: posts big blind $0.02
*** HOLE CARDS ***
Dealt to Scaaalll [Qd Th]
vovan100157: folds 
Scaaalll has timed out
Scaaalll: folds 
owtwilldo: folds 
Pechorin.G: folds 
San4oWV: raises $0.04 to $0.06
nikof420: raises $0.12 to $0.18
San4oWV: folds 
Uncalled bet ($0.12) returned to nikof420
nikof420 collected $0.12 from pot
nikof420: doesn't show hand 
*** SUMMARY ***
Total pot $0.12 | Rake $0 
Seat 1: Pechorin.G (button) folded before Flop (didn't bet)
Seat 2: San4oWV (small blind) folded before Flop
Seat 3: nikof420 (big blind) collected ($0.12)
Seat 4: vovan100157 folded before Flop (didn't bet)
Seat 5: Scaaalll folded before Flop (didn't bet)
Seat 6: owtwilldo folded before Flop (didn't bet)



PokerStars Zoom Hand #229233628359:  Hold'em No Limit ($0.01/$0.02) - 2021/08/21 23:37:27 CET [2021/08/21 17:37:27 ET]
Table 'Halley' 6-max Seat #1 is the button
Seat 1: gaturamard ($3.05 in chips) 
Seat 2: kidninja888 ($2.02 in chips) 
Seat 3: Scaaalll ($5.86 in chips) 
Seat 4: olga3021221 ($2.05 in chips) 
Seat 5: Cineva81 ($2.28 in chips) 
Seat 6: altubehernan ($2.05 in chips) 
kidninja888: posts small blind $0.01
Scaaalll: posts big blind $0.02
*** HOLE CARDS ***
Dealt to Scaaalll [5c Qh]
olga3021221: folds 
Cineva81: folds 
altubehernan: folds 
gaturamard: folds 
kidninja888: raises $0.03 to $0.05
Scaaalll: folds 
Uncalled bet ($0.03) returned to kidninja888
kidninja888 collected $0.04 from pot
kidninja888: doesn't show hand 
*** SUMMARY ***
Total pot $0.04 | Rake $0 
Seat 1: gaturamard (button) folded before Flop (didn't bet)
Seat 2: kidninja888 (small blind) collected ($0.04)
Seat 3: Scaaalll (big blind) folded before Flop
Seat 4: olga3021221 folded before Flop (didn't bet)
Seat 5: Cineva81 folded before Flop (didn't bet)
Seat 6: altubehernan folded before Flop (didn't bet)



PokerStars Zoom Hand #229233634564:  Hold'em No Limit ($0.01/$0.02) - 2021/08/21 23:37:42 CET [2021/08/21 17:37:42 ET]
Table 'Halley' 6-max Seat #1 is the button
Seat 1: Merlin_Arg ($2.55 in chips) 
Seat 2: piligrim.d83 ($1.54 in chips) 
Seat 3: Gamer577 ($2 in chips) 
Seat 4: plmanuelpl ($0.94 in chips) 
Seat 5: Scaaalll ($5.84 in chips) 
Seat 6: isaeg ($2.48 in chips) 
piligrim.d83: posts small blind $0.01
Gamer577: posts big blind $0.02
*** HOLE CARDS ***
Dealt to Scaaalll [5d 4s]
isaeg is disconnected 
plmanuelpl: folds 
Scaaalll: folds 
isaeg: folds 
plmanuelpl is disconnected 
Merlin_Arg: folds 
piligrim.d83: raises $0.04 to $0.06
Gamer577: folds 
Uncalled bet ($0.04) returned to piligrim.d83
piligrim.d83 collected $0.04 from pot
piligrim.d83: doesn't show hand 
*** SUMMARY ***
Total pot $0.04 | Rake $0 
Seat 1: Merlin_Arg (button) folded before Flop (didn't bet)
Seat 2: piligrim.d83 (small blind) collected ($0.04)
Seat 3: Gamer577 (big blind) folded before Flop
Seat 4: plmanuelpl folded before Flop (didn't bet)
Seat 5: Scaaalll folded before Flop (didn't bet)
Seat 6: isaeg folded before Flop (didn't bet)



PokerStars Zoom Hand #229233636155:  Hold'em No Limit ($0.01/$0.02) - 2021/08/21 23:37:46 CET [2021/08/21 17:37:46 ET]
Table 'Halley' 6-max Seat #1 is the button
Seat 1: Posaunengodi ($4.76 in chips) 
Seat 2: Scaaalll ($5.84 in chips) 
Seat 3: BexleyBoy ($1.72 in chips) 
Seat 4: hexi107 ($3.93 in chips) 
Seat 5: Taran0001 ($5.01 in chips) 
Seat 6: ZermeloFraenkel ($2 in chips) 
Scaaalll: posts small blind $0.01
BexleyBoy: posts big blind $0.02
*** HOLE CARDS ***
Dealt to Scaaalll [As 2h]
hexi107: folds 
Taran0001: raises $0.02 to $0.04
ZermeloFraenkel: folds 
Posaunengodi: folds 
Scaaalll: folds 
BexleyBoy: folds 
Uncalled bet ($0.02) returned to Taran0001
Taran0001 collected $0.05 from pot
Taran0001: doesn't show hand 
*** SUMMARY ***
Total pot $0.05 | Rake $0 
Seat 1: Posaunengodi (button) folded before Flop (didn't bet)
Seat 2: Scaaalll (small blind) folded before Flop
Seat 3: BexleyBoy (big blind) folded before Flop
Seat 4: hexi107 folded before Flop (didn't bet)
Seat 5: Taran0001 collected ($0.05)
Seat 6: ZermeloFraenkel folded before Flop (didn't bet)



PokerStars Zoom Hand #229233638231:  Hold'em No Limit ($0.01/$0.02) - 2021/08/21 23:37:51 CET [2021/08/21 17:37:51 ET]
Table 'Halley' 6-max Seat #1 is the button
Seat 1: STE1NBERG ($4.70 in chips) 
Seat 2: Koldun 2636 ($4.80 in chips) 
Seat 3: MetalCrüe ($1.33 in chips) 
Seat 4: bennodiem ($1.16 in chips) 
Seat 5: roukoun1984 ($1.68 in chips) 
Seat 6: Scaaalll ($5.83 in chips) 
Koldun 2636: posts small blind $0.01
MetalCrüe: posts big blind $0.02
*** HOLE CARDS ***
Dealt to Scaaalll [3h 7c]
bennodiem: folds 
roukoun1984: folds 
Scaaalll: folds 
STE1NBERG: folds 
Koldun 2636: folds 
Uncalled bet ($0.01) returned to MetalCrüe
roukoun1984 is disconnected 
MetalCrüe collected $0.02 from pot
MetalCrüe: doesn't show hand 
*** SUMMARY ***
Total pot $0.02 | Rake $0 
Seat 1: STE1NBERG (button) folded before Flop (didn't bet)
Seat 2: Koldun 2636 (small blind) folded before Flop
Seat 3: MetalCrüe (big blind) collected ($0.02)
Seat 4: bennodiem folded before Flop (didn't bet)
Seat 5: roukoun1984 folded before Flop (didn't bet)
Seat 6: Scaaalll folded before Flop (didn't bet)



PokerStars Zoom Hand #229233645512:  Hold'em No Limit ($0.01/$0.02) - 2021/08/21 23:38:09 CET [2021/08/21 17:38:09 ET]
Table 'Halley' 6-max Seat #1 is the button
Seat 1: adrianh2002 ($2.10 in chips) 
Seat 2: EzukoChan ($2.85 in chips) 
Seat 3: Scaaalll ($5.83 in chips) 
Seat 4: jaamonra ($2.68 in chips) 
Seat 5: zergmiky ($2.47 in chips) 
Seat 6: GambleNinjaEX ($4.76 in chips) 
EzukoChan: posts small blind $0.01
Scaaalll: posts big blind $0.02
*** HOLE CARDS ***
Dealt to Scaaalll [Jc 6s]
jaamonra: folds 
zergmiky: folds 
GambleNinjaEX: raises $0.03 to $0.05
adrianh2002: folds 
EzukoChan: folds 
Scaaalll: folds 
Uncalled bet ($0.03) returned to GambleNinjaEX
GambleNinjaEX collected $0.05 from pot
GambleNinjaEX: doesn't show hand 
*** SUMMARY ***
Total pot $0.05 | Rake $0 
Seat 1: adrianh2002 (button) folded before Flop (didn't bet)
Seat 2: EzukoChan (small blind) folded before Flop
Seat 3: Scaaalll (big blind) folded before Flop
Seat 4: jaamonra folded before Flop (didn't bet)
Seat 5: zergmiky folded before Flop (didn't bet)
Seat 6: GambleNinjaEX collected ($0.05)



PokerStars Zoom Hand #229233639873:  Hold'em No Limit ($0.01/$0.02) - 2021/08/21 23:37:55 CET [2021/08/21 17:37:55 ET]
Table 'Halley' 6-max Seat #1 is the button
Seat 1: Pizotifen ($2.55 in chips) 
Seat 2: MattieBOZ ($1.71 in chips) 
Seat 3: hustlehero ($2 in chips) 
Seat 4: Scaaalll ($5.83 in chips) 
Seat 5: alphabeta1d ($2.36 in chips) 
Seat 6: EzukoChan ($2.85 in chips) 
MattieBOZ: posts small blind $0.01
hustlehero: posts big blind $0.02
*** HOLE CARDS ***
Dealt to Scaaalll [9s 2h]
Scaaalll: folds 
alphabeta1d: folds 
EzukoChan: folds 
Pizotifen: raises $0.04 to $0.06
MattieBOZ: calls $0.05
hustlehero: folds 
*** FLOP *** [9d 8s Jd]
MattieBOZ: checks 
Pizotifen: checks 
*** TURN *** [9d 8s Jd] [Qc]
MattieBOZ: checks 
Pizotifen: bets $0.09
MattieBOZ: calls $0.09
*** RIVER *** [9d 8s Jd Qc] [7d]
MattieBOZ: checks 
Pizotifen: checks 
*** SHOW DOWN ***
MattieBOZ: shows [Kc Qs] (a pair of Queens)
Pizotifen: mucks hand 
MattieBOZ collected $0.31 from pot
*** SUMMARY ***
Total pot $0.32 | Rake $0.01 
Board [9d 8s Jd Qc 7d]
Seat 1: Pizotifen (button) mucked [Ac 5s]
Seat 2: MattieBOZ (small blind) showed [Kc Qs] and won ($0.31) with a pair of Queens
Seat 3: hustlehero (big blind) folded before Flop
Seat 4: Scaaalll folded before Flop (didn't bet)
Seat 5: alphabeta1d folded before Flop (didn't bet)
Seat 6: EzukoChan folded before Flop (didn't bet)



PokerStars Zoom Hand #229233653222:  Hold'em No Limit ($0.01/$0.02) - 2021/08/21 23:38:28 CET [2021/08/21 17:38:28 ET]
Table 'Halley' 6-max Seat #1 is the button
Seat 1: Dr.stromg ($2.73 in chips) 
Seat 2: AlienMdeo ($1.98 in chips) 
Seat 3: Valera Terentev ($1 in chips) 
Seat 4: Busya777 ($4.99 in chips) 
Seat 5: Carlos_glaza ($2.49 in chips) 
Seat 6: Scaaalll ($5.81 in chips) 
AlienMdeo: posts small blind $0.01
Valera Terentev: posts big blind $0.02
*** HOLE CARDS ***
Dealt to Scaaalll [6s Jc]
Busya777: folds 
Carlos_glaza: folds 
Busya777 is disconnected 
Scaaalll: folds 
Dr.stromg: folds 
AlienMdeo: folds 
Uncalled bet ($0.01) returned to Valera Terentev
Valera Terentev collected $0.02 from pot
Valera Terentev: doesn't show hand 
*** SUMMARY ***
Total pot $0.02 | Rake $0 
Seat 1: Dr.stromg (button) folded before Flop (didn't bet)
Seat 2: AlienMdeo (small blind) folded before Flop
Seat 3: Valera Terentev (big blind) collected ($0.02)
Seat 4: Busya777 folded before Flop (didn't bet)
Seat 5: Carlos_glaza folded before Flop (didn't bet)
Seat 6: Scaaalll folded before Flop (didn't bet)



PokerStars Zoom Hand #229233656554:  Hold'em No Limit ($0.01/$0.02) - 2021/08/21 23:38:36 CET [2021/08/21 17:38:36 ET]
Table 'Halley' 6-max Seat #1 is the button
Seat 1: ctaceo ($2.02 in chips) 
Seat 2: so0love ($6.14 in chips) 
Seat 3: josealfredonino ($2.05 in chips) 
Seat 4: Jimor Marlow ($2.08 in chips) 
Seat 5: Scaaalll ($5.81 in chips) 
Seat 6: xxVanquishxx ($15.68 in chips) 
so0love: posts small blind $0.01
josealfredonino: posts big blind $0.02
*** HOLE CARDS ***
Dealt to Scaaalll [4h 3s]
Jimor Marlow: folds 
Jimor Marlow is disconnected 
Scaaalll: folds 
xxVanquishxx: folds 
ctaceo: folds 
so0love: folds 
Uncalled bet ($0.01) returned to josealfredonino
josealfredonino collected $0.02 from pot
josealfredonino: doesn't show hand 
*** SUMMARY ***
Total pot $0.02 | Rake $0 
Seat 1: ctaceo (button) folded before Flop (didn't bet)
Seat 2: so0love (small blind) folded before Flop
Seat 3: josealfredonino (big blind) collected ($0.02)
Seat 4: Jimor Marlow folded before Flop (didn't bet)
Seat 5: Scaaalll folded before Flop (didn't bet)
Seat 6: xxVanquishxx folded before Flop (didn't bet)



PokerStars Zoom Hand #229233641887:  Hold'em No Limit ($0.01/$0.02) - 2021/08/21 23:38:00 CET [2021/08/21 17:38:00 ET]
Table 'Halley' 6-max Seat #1 is the button
Seat 1: Scaaalll ($5.83 in chips) 
Seat 2: LeoZ77755 ($2.58 in chips) 
Seat 3: LucasLMdS ($3.20 in chips) 
Seat 4: Luisit0_aqp ($0.96 in chips) 
Seat 5: H0mmer99 ($2.92 in chips) 
Seat 6: 888lifeIS ($2 in chips) 
LeoZ77755: posts small blind $0.01
LucasLMdS: posts big blind $0.02
*** HOLE CARDS ***
Dealt to Scaaalll [Ac 2d]
LeoZ77755 is disconnected 
Luisit0_aqp: folds 
H0mmer99: raises $0.02 to $0.04
888lifeIS: folds 
Scaaalll: folds 
LeoZ77755: folds 
LucasLMdS: calls $0.02
*** FLOP *** [2h 5s 9c]
LucasLMdS: checks 
H0mmer99: bets $0.05
LucasLMdS: calls $0.05
*** TURN *** [2h 5s 9c] [Th]
LucasLMdS: checks 
H0mmer99: bets $0.09
LucasLMdS: folds 
Uncalled bet ($0.09) returned to H0mmer99
H0mmer99 collected $0.18 from pot
H0mmer99: doesn't show hand 
*** SUMMARY ***
Total pot $0.19 | Rake $0.01 
Board [2h 5s 9c Th]
Seat 1: Scaaalll (button) folded before Flop (didn't bet)
Seat 2: LeoZ77755 (small blind) folded before Flop
Seat 3: LucasLMdS (big blind) folded on the Turn
Seat 4: Luisit0_aqp folded before Flop (didn't bet)
Seat 5: H0mmer99 collected ($0.18)
Seat 6: 888lifeIS folded before Flop (didn't bet)



PokerStars Zoom Hand #229233658585:  Hold'em No Limit ($0.01/$0.02) - 2021/08/21 23:38:41 CET [2021/08/21 17:38:41 ET]
Table 'Halley' 6-max Seat #1 is the button
Seat 1: xxVanquishxx ($15.68 in chips) 
Seat 2: Scaaalll ($5.81 in chips) 
Seat 3: HubertFroh ($2.70 in chips) 
Seat 4: A.Khodyakov ($2.04 in chips) 
Seat 5: rancing87 ($2.06 in chips) 
Seat 6: pizzaroni159 ($2 in chips) 
Scaaalll: posts small blind $0.01
HubertFroh: posts big blind $0.02
*** HOLE CARDS ***
Dealt to Scaaalll [Jd Jc]
A.Khodyakov: raises $0.03 to $0.05
rancing87: folds 
pizzaroni159: folds 
xxVanquishxx: folds 
Scaaalll: raises $0.13 to $0.18
HubertFroh: folds 
A.Khodyakov: calls $0.13
*** FLOP *** [5c 7c Ks]
Scaaalll: bets $0.22
A.Khodyakov: folds 
Uncalled bet ($0.22) returned to Scaaalll
Scaaalll collected $0.37 from pot
Scaaalll: doesn't show hand 
*** SUMMARY ***
Total pot $0.38 | Rake $0.01 
Board [5c 7c Ks]
Seat 1: xxVanquishxx (button) folded before Flop (didn't bet)
Seat 2: Scaaalll (small blind) collected ($0.37)
Seat 3: HubertFroh (big blind) folded before Flop
Seat 4: A.Khodyakov folded on the Flop
Seat 5: rancing87 folded before Flop (didn't bet)
Seat 6: pizzaroni159 folded before Flop (didn't bet)



PokerStars Zoom Hand #229233670954:  Hold'em No Limit ($0.01/$0.02) - 2021/08/21 23:39:12 CET [2021/08/21 17:39:12 ET]
Table 'Halley' 6-max Seat #1 is the button
Seat 1: WITKOW_AV ($6.03 in chips) 
Seat 2: Ck@tih@ ($1.88 in chips) 
Seat 3: Chapaev136 ($1.67 in chips) 
Seat 4: Scaaalll ($6 in chips) 
Seat 5: gasmar_29 ($2.68 in chips) 
Seat 6: A.Khodyakov ($2.53 in chips) 
Ck@tih@: posts small blind $0.01
Chapaev136: posts big blind $0.02
*** HOLE CARDS ***
Dealt to Scaaalll [Kc 4c]
Scaaalll: folds 
gasmar_29: folds 
A.Khodyakov: folds 
WITKOW_AV: raises $0.03 to $0.05
Ck@tih@: folds 
Chapaev136: folds 
Uncalled bet ($0.03) returned to WITKOW_AV
WITKOW_AV collected $0.05 from pot
WITKOW_AV: doesn't show hand 
*** SUMMARY ***
Total pot $0.05 | Rake $0 
Seat 1: WITKOW_AV (button) collected ($0.05)
Seat 2: Ck@tih@ (small blind) folded before Flop
Seat 3: Chapaev136 (big blind) folded before Flop
Seat 4: Scaaalll folded before Flop (didn't bet)
Seat 5: gasmar_29 folded before Flop (didn't bet)
Seat 6: A.Khodyakov folded before Flop (didn't bet)



PokerStars Zoom Hand #229233676307:  Hold'em No Limit ($0.01/$0.02) - 2021/08/21 23:39:25 CET [2021/08/21 17:39:25 ET]
Table 'Halley' 6-max Seat #1 is the button
Seat 1: Scaaalll ($5.98 in chips) 
Seat 2: nitzed12 ($2 in chips) 
Seat 3: KonopDima ($2 in chips) 
Seat 4: slipknot956 ($3.05 in chips) 
Seat 5: Ck@tih@ ($1.56 in chips) 
Seat 6: Gamer577 ($2.19 in chips) 
nitzed12: posts small blind $0.01
KonopDima: posts big blind $0.02
*** HOLE CARDS ***
Dealt to Scaaalll [3h 6c]
slipknot956: folds 
Ck@tih@: folds 
Gamer577: folds 
Scaaalll: folds 
nitzed12: raises $0.04 to $0.06
KonopDima: folds 
Uncalled bet ($0.04) returned to nitzed12
nitzed12 collected $0.04 from pot
nitzed12: doesn't show hand 
*** SUMMARY ***
Total pot $0.04 | Rake $0 
Seat 1: Scaaalll (button) folded before Flop (didn't bet)
Seat 2: nitzed12 (small blind) collected ($0.04)
Seat 3: KonopDima (big blind) folded before Flop
Seat 4: slipknot956 folded before Flop (didn't bet)
Seat 5: Ck@tih@ folded before Flop (didn't bet)
Seat 6: Gamer577 folded before Flop (didn't bet)



PokerStars Zoom Hand #229233672617:  Hold'em No Limit ($0.01/$0.02) - 2021/08/21 23:39:16 CET [2021/08/21 17:39:16 ET]
Table 'Halley' 6-max Seat #1 is the button
Seat 1: maliniak75 ($1.75 in chips) 
Seat 2: zzooll 9 ($3.22 in chips) 
Seat 3: Scaaalll ($6 in chips) 
Seat 4: Gumajzl ($1.99 in chips) 
Seat 5: TM 69 UIE ($2.39 in chips) 
Seat 6: m3ssy34 ($0.88 in chips) 
zzooll 9: posts small blind $0.01
Scaaalll: posts big blind $0.02
*** HOLE CARDS ***
Dealt to Scaaalll [4h 2s]
Gumajzl: folds 
TM 69 UIE: raises $0.04 to $0.06
m3ssy34: folds 
m3ssy34 is disconnected 
maliniak75: folds 
zzooll 9: calls $0.05
Scaaalll: folds 
*** FLOP *** [Js Qh 6h]
zzooll 9: bets $0.02
TM 69 UIE: raises $0.09 to $0.11
zzooll 9: calls $0.09
*** TURN *** [Js Qh 6h] [Ks]
zzooll 9: checks 
TM 69 UIE: bets $0.21
zzooll 9: calls $0.21
*** RIVER *** [Js Qh 6h Ks] [5d]
zzooll 9: checks 
TM 69 UIE: bets $0.43
zzooll 9: folds 
Uncalled bet ($0.43) returned to TM 69 UIE
TM 69 UIE collected $0.75 from pot
TM 69 UIE: doesn't show hand 
zzooll 9 is disconnected 
*** SUMMARY ***
Total pot $0.78 | Rake $0.03 
Board [Js Qh 6h Ks 5d]
Seat 1: maliniak75 (button) folded before Flop (didn't bet)
Seat 2: zzooll 9 (small blind) folded on the River
Seat 3: Scaaalll (big blind) folded before Flop
Seat 4: Gumajzl folded before Flop (didn't bet)
Seat 5: TM 69 UIE collected ($0.75)
Seat 6: m3ssy34 folded before Flop (didn't bet)



PokerStars Zoom Hand #229233682815:  Hold'em No Limit ($0.01/$0.02) - 2021/08/21 23:39:41 CET [2021/08/21 17:39:41 ET]
Table 'Halley' 6-max Seat #1 is the button
Seat 1: KKARMELO ($3.71 in chips) 
Seat 2: s1avyanin ($1.11 in chips) 
Seat 3: Scaaalll ($5.98 in chips) 
Seat 4: Luisit0_aqp ($1.01 in chips) 
Seat 5: vovan100157 ($5.31 in chips) 
Seat 6: kidninja888 ($2.77 in chips) 
s1avyanin: posts small blind $0.01
Scaaalll: posts big blind $0.02
*** HOLE CARDS ***
Dealt to Scaaalll [3d 2c]
Luisit0_aqp: folds 
vovan100157: folds 
kidninja888: folds 
KKARMELO: folds 
s1avyanin: raises $0.04 to $0.06
Scaaalll: folds 
Uncalled bet ($0.04) returned to s1avyanin
s1avyanin collected $0.04 from pot
s1avyanin: doesn't show hand 
*** SUMMARY ***
Total pot $0.04 | Rake $0 
Seat 1: KKARMELO (button) folded before Flop (didn't bet)
Seat 2: s1avyanin (small blind) collected ($0.04)
Seat 3: Scaaalll (big blind) folded before Flop
Seat 4: Luisit0_aqp folded before Flop (didn't bet)
Seat 5: vovan100157 folded before Flop (didn't bet)
Seat 6: kidninja888 folded before Flop (didn't bet)



PokerStars Zoom Hand #229233680759:  Hold'em No Limit ($0.01/$0.02) - 2021/08/21 23:39:36 CET [2021/08/21 17:39:36 ET]
Table 'Halley' 6-max Seat #1 is the button
Seat 1: GGopenBet ($1.12 in chips) 
Seat 2: lauti214 ($2.19 in chips) 
Seat 3: AbusiveLion ($1.48 in chips) 
Seat 4: Scaaalll ($5.98 in chips) 
Seat 5: Feyqdoi ($2 in chips) 
Seat 6: Nam Tsedom Tsom ($2 in chips) 
lauti214: posts small blind $0.01
AbusiveLion: posts big blind $0.02
*** HOLE CARDS ***
Dealt to Scaaalll [7c Kd]
GGopenBet is disconnected 
Scaaalll: folds 
Feyqdoi: folds 
Nam Tsedom Tsom: folds 
GGopenBet: folds 
lauti214: raises $0.02 to $0.04
AbusiveLion: calls $0.02
*** FLOP *** [7d As Td]
lauti214: checks 
AbusiveLion: bets $0.04
lauti214: calls $0.04
*** TURN *** [7d As Td] [4h]
lauti214: checks 
AbusiveLion: checks 
*** RIVER *** [7d As Td 4h] [2c]
lauti214: checks 
AbusiveLion: bets $0.07
lauti214: folds 
Uncalled bet ($0.07) returned to AbusiveLion
AbusiveLion collected $0.15 from pot
AbusiveLion: doesn't show hand 
*** SUMMARY ***
Total pot $0.16 | Rake $0.01 
Board [7d As Td 4h 2c]
Seat 1: GGopenBet (button) folded before Flop (didn't bet)
Seat 2: lauti214 (small blind) folded on the River
Seat 3: AbusiveLion (big blind) collected ($0.15)
Seat 4: Scaaalll folded before Flop (didn't bet)
Seat 5: Feyqdoi folded before Flop (didn't bet)
Seat 6: Nam Tsedom Tsom folded before Flop (didn't bet)



PokerStars Zoom Hand #229233692109:  Hold'em No Limit ($0.01/$0.02) - 2021/08/21 23:40:04 CET [2021/08/21 17:40:04 ET]
Table 'Halley' 6-max Seat #1 is the button
Seat 1: Nihility77 ($4.55 in chips) 
Seat 2: BeMyATMplz ($1.98 in chips) 
Seat 3: Mikmaq Caper ($1.02 in chips) 
Seat 4: Hallyson_23 ($3.57 in chips) 
Seat 5: Scaaalll ($5.96 in chips) 
Seat 6: SKV_1985 ($2 in chips) 
BeMyATMplz: posts small blind $0.01
Mikmaq Caper: posts big blind $0.02
*** HOLE CARDS ***
Dealt to Scaaalll [3d 4s]
Hallyson_23: folds 
Scaaalll: folds 
SKV_1985: folds 
Nihility77: folds 
BeMyATMplz: raises $0.04 to $0.06
Mikmaq Caper: folds 
Uncalled bet ($0.04) returned to BeMyATMplz
BeMyATMplz collected $0.04 from pot
BeMyATMplz: doesn't show hand 
Mikmaq Caper is disconnected 
*** SUMMARY ***
Total pot $0.04 | Rake $0 
Seat 1: Nihility77 (button) folded before Flop (didn't bet)
Seat 2: BeMyATMplz (small blind) collected ($0.04)
Seat 3: Mikmaq Caper (big blind) folded before Flop
Seat 4: Hallyson_23 folded before Flop (didn't bet)
Seat 5: Scaaalll folded before Flop (didn't bet)
Seat 6: SKV_1985 folded before Flop (didn't bet)



PokerStars Zoom Hand #229233693687:  Hold'em No Limit ($0.01/$0.02) - 2021/08/21 23:40:08 CET [2021/08/21 17:40:08 ET]
Table 'Halley' 6-max Seat #1 is the button
Seat 1: bart8612 ($3.14 in chips) 
Seat 2: Scaaalll ($5.96 in chips) 
Seat 3: i.m.bluffing002 ($2.71 in chips) 
Seat 4: Mikeloko182 ($3.13 in chips) 
Seat 5: hexi107 ($4.34 in chips) 
Seat 6: ulisessoria ($4.07 in chips) 
Scaaalll: posts small blind $0.01
i.m.bluffing002: posts big blind $0.02
*** HOLE CARDS ***
Dealt to Scaaalll [Jh 4d]
Mikeloko182: folds 
hexi107: folds 
ulisessoria: folds 
bart8612: folds 
Scaaalll: folds 
Uncalled bet ($0.01) returned to i.m.bluffing002
i.m.bluffing002 collected $0.02 from pot
i.m.bluffing002: doesn't show hand 
*** SUMMARY ***
Total pot $0.02 | Rake $0 
Seat 1: bart8612 (button) folded before Flop (didn't bet)
Seat 2: Scaaalll (small blind) folded before Flop
Seat 3: i.m.bluffing002 (big blind) collected ($0.02)
Seat 4: Mikeloko182 folded before Flop (didn't bet)
Seat 5: hexi107 folded before Flop (didn't bet)
Seat 6: ulisessoria folded before Flop (didn't bet)



PokerStars Zoom Hand #229233697275:  Hold'em No Limit ($0.01/$0.02) - 2021/08/21 23:40:17 CET [2021/08/21 17:40:17 ET]
Table 'Halley' 6-max Seat #1 is the button
Seat 1: Scaaalll ($5.95 in chips) 
Seat 2: zergmiky ($3.70 in chips) 
Seat 3: Razmenchic ($2.99 in chips) 
Seat 4: Merlin_Arg ($2.59 in chips) 
Seat 5: 3rian cARc ($2 in chips) 
Seat 6: Gerar NB ($2.24 in chips) 
zergmiky: posts small blind $0.01
Razmenchic: posts big blind $0.02
*** HOLE CARDS ***
Dealt to Scaaalll [3s 6c]
Merlin_Arg: folds 
3rian cARc: raises $0.03 to $0.05
Gerar NB: folds 
Scaaalll: folds 
zergmiky: folds 
Razmenchic: calls $0.03
*** FLOP *** [Ah 2c Ac]
Razmenchic: checks 
3rian cARc: bets $0.04
Razmenchic: calls $0.04
*** TURN *** [Ah 2c Ac] [Qh]
Razmenchic: checks 
3rian cARc: bets $0.07
Razmenchic: folds 
Uncalled bet ($0.07) returned to 3rian cARc
3rian cARc collected $0.18 from pot
3rian cARc: doesn't show hand 
*** SUMMARY ***
Total pot $0.19 | Rake $0.01 
Board [Ah 2c Ac Qh]
Seat 1: Scaaalll (button) folded before Flop (didn't bet)
Seat 2: zergmiky (small blind) folded before Flop
Seat 3: Razmenchic (big blind) folded on the Turn
Seat 4: Merlin_Arg folded before Flop (didn't bet)
Seat 5: 3rian cARc collected ($0.18)
Seat 6: Gerar NB folded before Flop (didn't bet)



PokerStars Zoom Hand #229233701263:  Hold'em No Limit ($0.01/$0.02) - 2021/08/21 23:40:27 CET [2021/08/21 17:40:27 ET]
Table 'Halley' 6-max Seat #1 is the button
Seat 1: sg.32rus ($0.94 in chips) 
Seat 2: 365p2eva ($2.01 in chips) 
Seat 3: nish1319 ($2.15 in chips) 
Seat 4: Doktor Yes ($2 in chips) 
Seat 5: Mac9Monty2 ($2.31 in chips) 
Seat 6: Scaaalll ($5.95 in chips) 
365p2eva: posts small blind $0.01
nish1319: posts big blind $0.02
*** HOLE CARDS ***
Dealt to Scaaalll [Kc 5h]
Doktor Yes: folds 
Mac9Monty2: folds 
Scaaalll: folds 
sg.32rus: folds 
365p2eva: raises $0.04 to $0.06
nish1319: calls $0.04
*** FLOP *** [5s 7d Ks]
365p2eva: bets $0.06
nish1319: folds 
Uncalled bet ($0.06) returned to 365p2eva
365p2eva collected $0.12 from pot
365p2eva: doesn't show hand 
nish1319 is disconnected 
*** SUMMARY ***
Total pot $0.12 | Rake $0 
Board [5s 7d Ks]
Seat 1: sg.32rus (button) folded before Flop (didn't bet)
Seat 2: 365p2eva (small blind) collected ($0.12)
Seat 3: nish1319 (big blind) folded on the Flop
Seat 4: Doktor Yes folded before Flop (didn't bet)
Seat 5: Mac9Monty2 folded before Flop (didn't bet)
Seat 6: Scaaalll folded before Flop (didn't bet)



PokerStars Zoom Hand #229233703763:  Hold'em No Limit ($0.01/$0.02) - 2021/08/21 23:40:33 CET [2021/08/21 17:40:33 ET]
Table 'Halley' 6-max Seat #1 is the button
Seat 1: osantos401 ($9.91 in chips) 
Seat 2: zergmiky ($2 in chips) 
Seat 3: fabor1303 ($5.38 in chips) 
Seat 4: maressen ($3.82 in chips) 
Seat 5: Scaaalll ($5.95 in chips) 
Seat 6: 888lifeIS ($2 in chips) 
zergmiky: posts small blind $0.01
fabor1303: posts big blind $0.02
*** HOLE CARDS ***
Dealt to Scaaalll [Js Kh]
maressen: folds 
Scaaalll: folds 
888lifeIS: folds 
osantos401: raises $0.02 to $0.04
zergmiky: folds 
fabor1303: calls $0.02
*** FLOP *** [Tc 9s 6d]
fabor1303: checks 
osantos401: bets $0.04
fabor1303: folds 
Uncalled bet ($0.04) returned to osantos401
osantos401 collected $0.09 from pot
osantos401: doesn't show hand 
*** SUMMARY ***
Total pot $0.09 | Rake $0 
Board [Tc 9s 6d]
Seat 1: osantos401 (button) collected ($0.09)
Seat 2: zergmiky (small blind) folded before Flop
Seat 3: fabor1303 (big blind) folded on the Flop
Seat 4: maressen folded before Flop (didn't bet)
Seat 5: Scaaalll folded before Flop (didn't bet)
Seat 6: 888lifeIS folded before Flop (didn't bet)



PokerStars Zoom Hand #229233709063:  Hold'em No Limit ($0.01/$0.02) - 2021/08/21 23:40:46 CET [2021/08/21 17:40:46 ET]
Table 'Halley' 6-max Seat #1 is the button
Seat 1: Gamer577 ($3.61 in chips) 
Seat 2: gabgordula ($2.18 in chips) 
Seat 3: Scaaalll ($5.94 in chips) 
Seat 4: zergmiky ($2 in chips) 
Seat 5: cutter2468 ($4.81 in chips) 
Seat 6: Taran0001 ($6.34 in chips) 
gabgordula: posts small blind $0.01
Scaaalll: posts big blind $0.02
*** HOLE CARDS ***
Dealt to Scaaalll [Qc Qd]
zergmiky: folds 
cutter2468: raises $0.03 to $0.05
Taran0001: folds 
Gamer577: folds 
gabgordula: folds 
Scaaalll: raises $0.13 to $0.18
cutter2468: raises $0.30 to $0.48
Scaaalll: folds 
Uncalled bet ($0.30) returned to cutter2468
cutter2468 collected $0.37 from pot
cutter2468: doesn't show hand 
*** SUMMARY ***
Total pot $0.37 | Rake $0 
Seat 1: Gamer577 (button) folded before Flop (didn't bet)
Seat 2: gabgordula (small blind) folded before Flop
Seat 3: Scaaalll (big blind) folded before Flop
Seat 4: zergmiky folded before Flop (didn't bet)
Seat 5: cutter2468 collected ($0.37)
Seat 6: Taran0001 folded before Flop (didn't bet)



PokerStars Zoom Hand #229233707448:  Hold'em No Limit ($0.01/$0.02) - 2021/08/21 23:40:42 CET [2021/08/21 17:40:42 ET]
Table 'Halley' 6-max Seat #1 is the button
Seat 1: udav26 ($2.45 in chips) 
Seat 2: Scaaalll ($5.95 in chips) 
Seat 3: giselerebelo ($1.42 in chips) 
Seat 4: BriceDo1917 ($4.21 in chips) 
Seat 5: 888lifeIS ($2.46 in chips) 
Seat 6: 365p2eva ($2 in chips) 
Scaaalll: posts small blind $0.01
giselerebelo: posts big blind $0.02
*** HOLE CARDS ***
Dealt to Scaaalll [Td 7c]
BriceDo1917: raises $0.04 to $0.06
888lifeIS: folds 
365p2eva: folds 
udav26: calls $0.06
Scaaalll: folds 
giselerebelo: folds 
*** FLOP *** [9c Jd Th]
BriceDo1917: checks 
udav26: checks 
*** TURN *** [9c Jd Th] [Kh]
BriceDo1917: bets $0.08
udav26: raises $0.15 to $0.23
BriceDo1917: calls $0.15
*** RIVER *** [9c Jd Th Kh] [Jc]
BriceDo1917: checks 
udav26: bets $0.30
BriceDo1917: calls $0.30
*** SHOW DOWN ***
udav26: shows [Qs Ks] (a straight, Nine to King)
BriceDo1917: shows [Jh Qh] (a straight, Nine to King)
BriceDo1917 collected $0.59 from pot
udav26 collected $0.58 from pot
*** SUMMARY ***
Total pot $1.21 | Rake $0.04 
Board [9c Jd Th Kh Jc]
Seat 1: udav26 (button) showed [Qs Ks] and won ($0.58) with a straight, Nine to King
Seat 2: Scaaalll (small blind) folded before Flop
Seat 3: giselerebelo (big blind) folded before Flop
Seat 4: BriceDo1917 showed [Jh Qh] and won ($0.59) with a straight, Nine to King
Seat 5: 888lifeIS folded before Flop (didn't bet)
Seat 6: 365p2eva folded before Flop (didn't bet)



PokerStars Zoom Hand #229233722838:  Hold'em No Limit ($0.01/$0.02) - 2021/08/21 23:41:20 CET [2021/08/21 17:41:20 ET]
Table 'Halley' 6-max Seat #1 is the button
Seat 1: kai_inge_mar ($0.79 in chips) 
Seat 2: Marcus579 ($2.21 in chips) 
Seat 3: Jimor Marlow ($2.17 in chips) 
Seat 4: ulisessoria ($4.04 in chips) 
Seat 5: artur9124 ($1.12 in chips) 
Seat 6: Scaaalll ($5.76 in chips) 
Marcus579: posts small blind $0.01
Jimor Marlow: posts big blind $0.02
*** HOLE CARDS ***
Dealt to Scaaalll [5s Ad]
ulisessoria: folds 
artur9124: folds 
Scaaalll: folds 
kai_inge_mar: folds 
Marcus579: folds 
Uncalled bet ($0.01) returned to Jimor Marlow
artur9124 is disconnected 
Jimor Marlow collected $0.02 from pot
Jimor Marlow: doesn't show hand 
*** SUMMARY ***
Total pot $0.02 | Rake $0 
Seat 1: kai_inge_mar (button) folded before Flop (didn't bet)
Seat 2: Marcus579 (small blind) folded before Flop
Seat 3: Jimor Marlow (big blind) collected ($0.02)
Seat 4: ulisessoria folded before Flop (didn't bet)
Seat 5: artur9124 folded before Flop (didn't bet)
Seat 6: Scaaalll folded before Flop (didn't bet)



PokerStars Zoom Hand #229233729266:  Hold'em No Limit ($0.01/$0.02) - 2021/08/21 23:41:36 CET [2021/08/21 17:41:36 ET]
Table 'Halley' 6-max Seat #1 is the button
Seat 1: Dr.stromg ($3.22 in chips) 
Seat 2: dkno77 ($3.47 in chips) 
Seat 3: Ruben-M. PY ($3.32 in chips) 
Seat 4: Scaaalll ($5.76 in chips) 
Seat 5: Bina_sweety ($2.95 in chips) 
Seat 6: NoEff0rt2w1n ($2.41 in chips) 
dkno77: posts small blind $0.01
Ruben-M. PY: posts big blind $0.02
*** HOLE CARDS ***
Dealt to Scaaalll [9h 2c]
Scaaalll: folds 
Bina_sweety: folds 
NoEff0rt2w1n: folds 
Dr.stromg: folds 
dkno77: folds 
Uncalled bet ($0.01) returned to Ruben-M. PY
Ruben-M. PY collected $0.02 from pot
Ruben-M. PY: doesn't show hand 
*** SUMMARY ***
Total pot $0.02 | Rake $0 
Seat 1: Dr.stromg (button) folded before Flop (didn't bet)
Seat 2: dkno77 (small blind) folded before Flop
Seat 3: Ruben-M. PY (big blind) collected ($0.02)
Seat 4: Scaaalll folded before Flop (didn't bet)
Seat 5: Bina_sweety folded before Flop (didn't bet)
Seat 6: NoEff0rt2w1n folded before Flop (didn't bet)



PokerStars Zoom Hand #229233730908:  Hold'em No Limit ($0.01/$0.02) - 2021/08/21 23:41:40 CET [2021/08/21 17:41:40 ET]
Table 'Halley' 6-max Seat #1 is the button
Seat 1: NoEff0rt2w1n ($2 in chips) 
Seat 2: kukulagosleep ($6.64 in chips) 
Seat 3: 0Jarek ($1.06 in chips) 
Seat 4: WithMyWalker ($3.08 in chips) 
Seat 5: Scaaalll ($5.76 in chips) 
Seat 6: rodrigoasor ($3.62 in chips) 
kukulagosleep: posts small blind $0.01
0Jarek: posts big blind $0.02
*** HOLE CARDS ***
Dealt to Scaaalll [4d 6h]
WithMyWalker has timed out
WithMyWalker: folds 
Scaaalll: folds 
rodrigoasor: folds 
NoEff0rt2w1n: folds 
kukulagosleep: folds 
Uncalled bet ($0.01) returned to 0Jarek
0Jarek collected $0.02 from pot
0Jarek: doesn't show hand 
*** SUMMARY ***
Total pot $0.02 | Rake $0 
Seat 1: NoEff0rt2w1n (button) folded before Flop (didn't bet)
Seat 2: kukulagosleep (small blind) folded before Flop
Seat 3: 0Jarek (big blind) collected ($0.02)
Seat 4: WithMyWalker folded before Flop (didn't bet)
Seat 5: Scaaalll folded before Flop (didn't bet)
Seat 6: rodrigoasor folded before Flop (didn't bet)



PokerStars Zoom Hand #229233732486:  Hold'em No Limit ($0.01/$0.02) - 2021/08/21 23:41:44 CET [2021/08/21 17:41:44 ET]
Table 'Halley' 6-max Seat #1 is the button
Seat 1: KKARMELO ($2 in chips) 
Seat 2: Scaaalll ($5.76 in chips) 
Seat 3: Enders_Monkey ($1 in chips) 
Seat 4: Fenix888888 ($1.01 in chips) 
Seat 5: BeastBoy18 ($2 in chips) 
Seat 6: bart8612 ($3.18 in chips) 
Scaaalll: posts small blind $0.01
Enders_Monkey: posts big blind $0.02
*** HOLE CARDS ***
Dealt to Scaaalll [Tc Ks]
Fenix888888: folds 
BeastBoy18: folds 
bart8612: folds 
KKARMELO: folds 
Scaaalll: raises $0.04 to $0.06
Enders_Monkey: folds 
Uncalled bet ($0.04) returned to Scaaalll
Scaaalll collected $0.04 from pot
Scaaalll: doesn't show hand 
Enders_Monkey is disconnected 
*** SUMMARY ***
Total pot $0.04 | Rake $0 
Seat 1: KKARMELO (button) folded before Flop (didn't bet)
Seat 2: Scaaalll (small blind) collected ($0.04)
Seat 3: Enders_Monkey (big blind) folded before Flop
Seat 4: Fenix888888 folded before Flop (didn't bet)
Seat 5: BeastBoy18 folded before Flop (didn't bet)
Seat 6: bart8612 folded before Flop (didn't bet)



PokerStars Zoom Hand #229233739352:  Hold'em No Limit ($0.01/$0.02) - 2021/08/21 23:42:01 CET [2021/08/21 17:42:01 ET]
Table 'Halley' 6-max Seat #1 is the button
Seat 1: Scaaalll ($5.78 in chips) 
Seat 2: Finderra ($2.87 in chips) 
Seat 3: GGopenBet ($1.09 in chips) 
Seat 4: Mrajax-Beardman ($1.26 in chips) 
Seat 5: AXXILLES ($4.73 in chips) 
Seat 6: KonopDima ($2.47 in chips) 
Finderra: posts small blind $0.01
GGopenBet: posts big blind $0.02
*** HOLE CARDS ***
Dealt to Scaaalll [Ac Qd]
Mrajax-Beardman: folds 
AXXILLES: folds 
KonopDima: folds 
Scaaalll: raises $0.02 to $0.04
Finderra: folds 
GGopenBet: folds 
Uncalled bet ($0.02) returned to Scaaalll
Scaaalll collected $0.05 from pot
Scaaalll: doesn't show hand 
GGopenBet is disconnected 
*** SUMMARY ***
Total pot $0.05 | Rake $0 
Seat 1: Scaaalll (button) collected ($0.05)
Seat 2: Finderra (small blind) folded before Flop
Seat 3: GGopenBet (big blind) folded before Flop
Seat 4: Mrajax-Beardman folded before Flop (didn't bet)
Seat 5: AXXILLES folded before Flop (didn't bet)
Seat 6: KonopDima folded before Flop (didn't bet)



PokerStars Zoom Hand #229233727948:  Hold'em No Limit ($0.01/$0.02) - 2021/08/21 23:41:33 CET [2021/08/21 17:41:33 ET]
Table 'Halley' 6-max Seat #1 is the button
Seat 1: Scaaalll ($5.76 in chips) 
Seat 2: Hejpåre ($4.23 in chips) 
Seat 3: owtwilldo ($2.63 in chips) 
Seat 4: tisadaisy ($2.85 in chips) 
Seat 5: lucky1529 ($0.93 in chips) 
Seat 6: xxVanquishxx ($15.77 in chips) 
Hejpåre: posts small blind $0.01
owtwilldo: posts big blind $0.02
*** HOLE CARDS ***
Dealt to Scaaalll [2c 7c]
tisadaisy: folds 
lucky1529: calls $0.02
xxVanquishxx: folds 
Scaaalll: folds 
Hejpåre: calls $0.01
owtwilldo: checks 
*** FLOP *** [3d As 6c]
Hejpåre: checks 
owtwilldo: checks 
lucky1529: checks 
*** TURN *** [3d As 6c] [Ad]
Hejpåre: bets $0.03
owtwilldo: folds 
lucky1529: folds 
Uncalled bet ($0.03) returned to Hejpåre
Hejpåre collected $0.06 from pot
Hejpåre: doesn't show hand 
*** SUMMARY ***
Total pot $0.06 | Rake $0 
Board [3d As 6c Ad]
Seat 1: Scaaalll (button) folded before Flop (didn't bet)
Seat 2: Hejpåre (small blind) collected ($0.06)
Seat 3: owtwilldo (big blind) folded on the Turn
Seat 4: tisadaisy folded before Flop (didn't bet)
Seat 5: lucky1529 folded on the Turn
Seat 6: xxVanquishxx folded before Flop (didn't bet)



PokerStars Zoom Hand #229233743467:  Hold'em No Limit ($0.01/$0.02) - 2021/08/21 23:42:11 CET [2021/08/21 17:42:11 ET]
Table 'Halley' 6-max Seat #1 is the button
Seat 1: 888lifeIS ($2.02 in chips) 
Seat 2: pipecmolodec ($2.01 in chips) 
Seat 3: Scaaalll ($5.81 in chips) 
Seat 4: fabor1303 ($2.93 in chips) 
Seat 5: Gumajzl ($1.86 in chips) 
Seat 6: Koldun 2636 ($3.89 in chips) 
pipecmolodec: posts small blind $0.01
Scaaalll: posts big blind $0.02
*** HOLE CARDS ***
Dealt to Scaaalll [Qh Kc]
fabor1303: folds 
Gumajzl: raises $0.04 to $0.06
Koldun 2636: folds 
888lifeIS: folds 
pipecmolodec: folds 
Scaaalll: calls $0.04
*** FLOP *** [2s Jc Ah]
Scaaalll: checks 
Gumajzl: bets $0.09
Scaaalll: folds 
Uncalled bet ($0.09) returned to Gumajzl
Gumajzl collected $0.13 from pot
Gumajzl: doesn't show hand 
*** SUMMARY ***
Total pot $0.13 | Rake $0 
Board [2s Jc Ah]
Seat 1: 888lifeIS (button) folded before Flop (didn't bet)
Seat 2: pipecmolodec (small blind) folded before Flop
Seat 3: Scaaalll (big blind) folded on the Flop
Seat 4: fabor1303 folded before Flop (didn't bet)
Seat 5: Gumajzl collected ($0.13)
Seat 6: Koldun 2636 folded before Flop (didn't bet)



PokerStars Zoom Hand #229233753526:  Hold'em No Limit ($0.01/$0.02) - 2021/08/21 23:42:36 CET [2021/08/21 17:42:36 ET]
Table 'Halley' 6-max Seat #1 is the button
Seat 1: ronald1982 ($5.44 in chips) 
Seat 2: vot-tebe888 ($3.51 in chips) 
Seat 3: nagibatorali ($0.59 in chips) 
Seat 4: FrancoOlmedo ($1.93 in chips) 
Seat 5: so0love ($4.50 in chips) 
Seat 6: Scaaalll ($5.75 in chips) 
vot-tebe888: posts small blind $0.01
nagibatorali: posts big blind $0.02
*** HOLE CARDS ***
Dealt to Scaaalll [2h Js]
FrancoOlmedo: folds 
so0love: folds 
Scaaalll: folds 
ronald1982: folds 
vot-tebe888: folds 
Uncalled bet ($0.01) returned to nagibatorali
nagibatorali collected $0.02 from pot
nagibatorali: doesn't show hand 
*** SUMMARY ***
Total pot $0.02 | Rake $0 
Seat 1: ronald1982 (button) folded before Flop (didn't bet)
Seat 2: vot-tebe888 (small blind) folded before Flop
Seat 3: nagibatorali (big blind) collected ($0.02)
Seat 4: FrancoOlmedo folded before Flop (didn't bet)
Seat 5: so0love folded before Flop (didn't bet)
Seat 6: Scaaalll folded before Flop (didn't bet)



PokerStars Zoom Hand #229233760946:  Hold'em No Limit ($0.01/$0.02) - 2021/08/21 23:42:54 CET [2021/08/21 17:42:54 ET]
Table 'Halley' 6-max Seat #1 is the button
Seat 1: Mr.Kurier ($4.65 in chips) 
Seat 2: CYBOPOB66 ($2.15 in chips) 
Seat 3: Posaunengodi ($4.01 in chips) 
Seat 4: Scaaalll ($5.75 in chips) 
Seat 5: BexleyBoy ($2.58 in chips) 
Seat 6: MKIronCrAAzy ($6.37 in chips) 
CYBOPOB66: posts small blind $0.01
Posaunengodi: posts big blind $0.02
*** HOLE CARDS ***
Dealt to Scaaalll [Ad Js]
Scaaalll: raises $0.04 to $0.06
BexleyBoy: folds 
MKIronCrAAzy: folds 
Mr.Kurier: folds 
CYBOPOB66: folds 
Posaunengodi: folds 
Uncalled bet ($0.04) returned to Scaaalll
Scaaalll collected $0.05 from pot
Scaaalll: doesn't show hand 
*** SUMMARY ***
Total pot $0.05 | Rake $0 
Seat 1: Mr.Kurier (button) folded before Flop (didn't bet)
Seat 2: CYBOPOB66 (small blind) folded before Flop
Seat 3: Posaunengodi (big blind) folded before Flop
Seat 4: Scaaalll collected ($0.05)
Seat 5: BexleyBoy folded before Flop (didn't bet)
Seat 6: MKIronCrAAzy folded before Flop (didn't bet)



PokerStars Zoom Hand #229233759270:  Hold'em No Limit ($0.01/$0.02) - 2021/08/21 23:42:50 CET [2021/08/21 17:42:50 ET]
Table 'Halley' 6-max Seat #1 is the button
Seat 1: gasmar_29 ($2.72 in chips) 
Seat 2: Merlin_Arg ($3.67 in chips) 
Seat 3: bennodiem ($2.49 in chips) 
Seat 4: Scaaalll ($5.75 in chips) 
Seat 5: fabor1303 ($10.30 in chips) 
Seat 6: REZAKOV72 ($3.13 in chips) 
Merlin_Arg: posts small blind $0.01
bennodiem: posts big blind $0.02
*** HOLE CARDS ***
Dealt to Scaaalll [7s 5h]
Scaaalll: folds 
fabor1303: folds 
REZAKOV72: folds 
gasmar_29: raises $0.03 to $0.05
Merlin_Arg: raises $0.12 to $0.17
bennodiem: folds 
gasmar_29: folds 
Uncalled bet ($0.12) returned to Merlin_Arg
Merlin_Arg collected $0.12 from pot
Merlin_Arg: doesn't show hand 
*** SUMMARY ***
Total pot $0.12 | Rake $0 
Seat 1: gasmar_29 (button) folded before Flop
Seat 2: Merlin_Arg (small blind) collected ($0.12)
Seat 3: bennodiem (big blind) folded before Flop
Seat 4: Scaaalll folded before Flop (didn't bet)
Seat 5: fabor1303 folded before Flop (didn't bet)
Seat 6: REZAKOV72 folded before Flop (didn't bet)



PokerStars Zoom Hand #229233757642:  Hold'em No Limit ($0.01/$0.02) - 2021/08/21 23:42:46 CET [2021/08/21 17:42:46 ET]
Table 'Halley' 6-max Seat #1 is the button
Seat 1: Bol'tazar111 ($2.13 in chips) 
Seat 2: didiclavi777 ($1.97 in chips) 
Seat 3: lalon22 ($2.06 in chips) 
Seat 4: 888lifeIS ($2.38 in chips) 
Seat 5: Scaaalll ($5.75 in chips) 
Seat 6: Sinad1302 ($2.91 in chips) 
didiclavi777: posts small blind $0.01
lalon22: posts big blind $0.02
*** HOLE CARDS ***
Dealt to Scaaalll [Jc 4c]
888lifeIS: folds 
Scaaalll: folds 
Sinad1302: raises $0.04 to $0.06
Bol'tazar111: calls $0.06
didiclavi777: folds 
lalon22: folds 
*** FLOP *** [6d Qh 2s]
Sinad1302: checks 
Bol'tazar111: checks 
*** TURN *** [6d Qh 2s] [9s]
Sinad1302: checks 
Bol'tazar111: checks 
*** RIVER *** [6d Qh 2s 9s] [Th]
Sinad1302: bets $0.05
Bol'tazar111: folds 
Uncalled bet ($0.05) returned to Sinad1302
Sinad1302 collected $0.14 from pot
Sinad1302: doesn't show hand 
*** SUMMARY ***
Total pot $0.15 | Rake $0.01 
Board [6d Qh 2s 9s Th]
Seat 1: Bol'tazar111 (button) folded on the River
Seat 2: didiclavi777 (small blind) folded before Flop
Seat 3: lalon22 (big blind) folded before Flop
Seat 4: 888lifeIS folded before Flop (didn't bet)
Seat 5: Scaaalll folded before Flop (didn't bet)
Seat 6: Sinad1302 collected ($0.14)



PokerStars Zoom Hand #229233770193:  Hold'em No Limit ($0.01/$0.02) - 2021/08/21 23:43:17 CET [2021/08/21 17:43:17 ET]
Table 'Halley' 6-max Seat #1 is the button
Seat 1: Bol'tazar111 ($2.18 in chips) 
Seat 2: Dr.stromg ($7.41 in chips) 
Seat 3: Scaaalll ($5.77 in chips) 
Seat 4: gasmar_29 ($2.13 in chips) 
Seat 5: WITKOW_AV ($6.19 in chips) 
Seat 6: qqqqqqqqq966 ($2.08 in chips) 
Dr.stromg: posts small blind $0.01
Scaaalll: posts big blind $0.02
*** HOLE CARDS ***
Dealt to Scaaalll [4c 2d]
gasmar_29: folds 
WITKOW_AV: raises $0.04 to $0.06
qqqqqqqqq966: folds 
Bol'tazar111: folds 
qqqqqqqqq966 is disconnected 
Dr.stromg: folds 
Scaaalll: folds 
Uncalled bet ($0.04) returned to WITKOW_AV
WITKOW_AV collected $0.05 from pot
WITKOW_AV: doesn't show hand 
*** SUMMARY ***
Total pot $0.05 | Rake $0 
Seat 1: Bol'tazar111 (button) folded before Flop (didn't bet)
Seat 2: Dr.stromg (small blind) folded before Flop
Seat 3: Scaaalll (big blind) folded before Flop
Seat 4: gasmar_29 folded before Flop (didn't bet)
Seat 5: WITKOW_AV collected ($0.05)
Seat 6: qqqqqqqqq966 folded before Flop (didn't bet)



PokerStars Zoom Hand #229233764903:  Hold'em No Limit ($0.01/$0.02) - 2021/08/21 23:43:04 CET [2021/08/21 17:43:04 ET]
Table 'Halley' 6-max Seat #1 is the button
Seat 1: nikof420 ($2.85 in chips) 
Seat 2: Scaaalll ($5.78 in chips) 
Seat 3: kidninja888 ($2.65 in chips) 
Seat 4: pizzaroni159 ($2 in chips) 
Seat 5: Enders_Monkey ($0.93 in chips) 
Seat 6: maliniak75 ($5.39 in chips) 
Scaaalll: posts small blind $0.01
kidninja888: posts big blind $0.02
*** HOLE CARDS ***
Dealt to Scaaalll [3c 2s]
nikof420 is disconnected 
pizzaroni159: calls $0.02
Enders_Monkey: calls $0.02
maliniak75: folds 
nikof420: folds 
Scaaalll: folds 
kidninja888: checks 
*** FLOP *** [8d Qs 8c]
kidninja888: checks 
pizzaroni159: bets $0.06
Enders_Monkey: calls $0.06
kidninja888: folds 
*** TURN *** [8d Qs 8c] [5d]
pizzaroni159: checks 
Enders_Monkey: bets $0.02
pizzaroni159: calls $0.02
*** RIVER *** [8d Qs 8c 5d] [Qc]
pizzaroni159: checks 
Enders_Monkey: bets $0.06
pizzaroni159: folds 
Uncalled bet ($0.06) returned to Enders_Monkey
Enders_Monkey collected $0.22 from pot
Enders_Monkey: doesn't show hand 
*** SUMMARY ***
Total pot $0.23 | Rake $0.01 
Board [8d Qs 8c 5d Qc]
Seat 1: nikof420 (button) folded before Flop (didn't bet)
Seat 2: Scaaalll (small blind) folded before Flop
Seat 3: kidninja888 (big blind) folded on the Flop
Seat 4: pizzaroni159 folded on the River
Seat 5: Enders_Monkey collected ($0.22)
Seat 6: maliniak75 folded before Flop (didn't bet)



PokerStars Zoom Hand #229233768555:  Hold'em No Limit ($0.01/$0.02) - 2021/08/21 23:43:13 CET [2021/08/21 17:43:13 ET]
Table 'Halley' 6-max Seat #1 is the button
Seat 1: Scaaalll ($5.77 in chips) 
Seat 2: NickAlex18 ($2.44 in chips) 
Seat 3: danf2012 ($1.20 in chips) 
Seat 4: ofalkeid ($1.66 in chips) 
Seat 5: 0Jarek ($1.12 in chips) 
Seat 6: GVMELLO ($2.15 in chips) 
NickAlex18: posts small blind $0.01
danf2012: posts big blind $0.02
*** HOLE CARDS ***
Dealt to Scaaalll [Kc 5d]
ofalkeid: folds 
0Jarek: calls $0.02
GVMELLO: folds 
Scaaalll: folds 
NickAlex18: folds 
danf2012: checks 
*** FLOP *** [9s 7c As]
danf2012: checks 
0Jarek: checks 
*** TURN *** [9s 7c As] [4s]
danf2012: checks 
0Jarek: checks 
*** RIVER *** [9s 7c As 4s] [Tc]
danf2012: checks 
0Jarek: bets $0.02
danf2012: calls $0.02
*** SHOW DOWN ***
0Jarek: shows [Kd Ts] (a pair of Tens)
danf2012: mucks hand 
0Jarek collected $0.09 from pot
*** SUMMARY ***
Total pot $0.09 | Rake $0 
Board [9s 7c As 4s Tc]
Seat 1: Scaaalll (button) folded before Flop (didn't bet)
Seat 2: NickAlex18 (small blind) folded before Flop
Seat 3: danf2012 (big blind) mucked [6s Qc]
Seat 4: ofalkeid folded before Flop (didn't bet)
Seat 5: 0Jarek showed [Kd Ts] and won ($0.09) with a pair of Tens
Seat 6: GVMELLO folded before Flop (didn't bet)



PokerStars Zoom Hand #229233778638:  Hold'em No Limit ($0.01/$0.02) - 2021/08/21 23:43:38 CET [2021/08/21 17:43:38 ET]
Table 'Halley' 6-max Seat #1 is the button
Seat 1: Sul07 ($0.97 in chips) 
Seat 2: ohsimoron ($2.56 in chips) 
Seat 3: prosto lili ($0.99 in chips) 
Seat 4: egroj1700 ($2.07 in chips) 
Seat 5: BlackhawKK's ($2 in chips) 
Seat 6: Scaaalll ($5.75 in chips) 
ohsimoron: posts small blind $0.01
prosto lili: posts big blind $0.02
*** HOLE CARDS ***
Dealt to Scaaalll [4d Js]
egroj1700: folds 
BlackhawKK's: folds 
Scaaalll: folds 
Sul07: folds 
ohsimoron: raises $0.04 to $0.06
prosto lili: folds 
Uncalled bet ($0.04) returned to ohsimoron
ohsimoron collected $0.04 from pot
ohsimoron: doesn't show hand 
*** SUMMARY ***
Total pot $0.04 | Rake $0 
Seat 1: Sul07 (button) folded before Flop (didn't bet)
Seat 2: ohsimoron (small blind) collected ($0.04)
Seat 3: prosto lili (big blind) folded before Flop
Seat 4: egroj1700 folded before Flop (didn't bet)
Seat 5: BlackhawKK's folded before Flop (didn't bet)
Seat 6: Scaaalll folded before Flop (didn't bet)



PokerStars Zoom Hand #229233781804:  Hold'em No Limit ($0.01/$0.02) - 2021/08/21 23:43:46 CET [2021/08/21 17:43:46 ET]
Table 'Halley' 6-max Seat #1 is the button
Seat 1: Dr.stromg ($4.99 in chips) 
Seat 2: danteesq ($2.03 in chips) 
Seat 3: BIITRU ($2.03 in chips) 
Seat 4: CYBOPOB66 ($2.40 in chips) 
Seat 5: Scaaalll ($5.75 in chips) 
Seat 6: Inside333 ($1.84 in chips) 
danteesq: posts small blind $0.01
BIITRU: posts big blind $0.02
*** HOLE CARDS ***
Dealt to Scaaalll [2c 2h]
CYBOPOB66: folds 
Inside333 is disconnected 
Scaaalll: raises $0.04 to $0.06
Inside333: folds 
Dr.stromg: raises $0.12 to $0.18
danteesq: folds 
BIITRU: folds 
Scaaalll: calls $0.12
*** FLOP *** [Qs Qh 5c]
Scaaalll: checks 
Dr.stromg: bets $0.13
Scaaalll: folds 
Uncalled bet ($0.13) returned to Dr.stromg
Dr.stromg collected $0.38 from pot
Dr.stromg: doesn't show hand 
*** SUMMARY ***
Total pot $0.39 | Rake $0.01 
Board [Qs Qh 5c]
Seat 1: Dr.stromg (button) collected ($0.38)
Seat 2: danteesq (small blind) folded before Flop
Seat 3: BIITRU (big blind) folded before Flop
Seat 4: CYBOPOB66 folded before Flop (didn't bet)
Seat 5: Scaaalll folded on the Flop
Seat 6: Inside333 folded before Flop (didn't bet)



PokerStars Zoom Hand #229233793370:  Hold'em No Limit ($0.01/$0.02) - 2021/08/21 23:44:15 CET [2021/08/21 17:44:15 ET]
Table 'Halley' 6-max Seat #1 is the button
Seat 1: Scaaalll ($5.57 in chips) 
Seat 2: vovan100157 ($1.71 in chips) 
Seat 3: pizzaroni159 ($2 in chips) 
Seat 4: didiclavi777 ($2.01 in chips) 
Seat 5: Ck@tih@ ($2.11 in chips) 
Seat 6: davidalejag ($2 in chips) 
vovan100157: posts small blind $0.01
pizzaroni159: posts big blind $0.02
*** HOLE CARDS ***
Dealt to Scaaalll [2c 7d]
didiclavi777: folds 
Ck@tih@: folds 
davidalejag: folds 
Scaaalll: folds 
vovan100157: folds 
Uncalled bet ($0.01) returned to pizzaroni159
pizzaroni159 collected $0.02 from pot
pizzaroni159: doesn't show hand 
*** SUMMARY ***
Total pot $0.02 | Rake $0 
Seat 1: Scaaalll (button) folded before Flop (didn't bet)
Seat 2: vovan100157 (small blind) folded before Flop
Seat 3: pizzaroni159 (big blind) collected ($0.02)
Seat 4: didiclavi777 folded before Flop (didn't bet)
Seat 5: Ck@tih@ folded before Flop (didn't bet)
Seat 6: davidalejag folded before Flop (didn't bet)



PokerStars Zoom Hand #229233799835:  Hold'em No Limit ($0.01/$0.02) - 2021/08/21 23:44:31 CET [2021/08/21 17:44:31 ET]
Table 'Halley' 6-max Seat #1 is the button
Seat 1: punkosk8 ($7.09 in chips) 
Seat 2: LijanaV ($5.39 in chips) 
Seat 3: owtwilldo ($2.17 in chips) 
Seat 4: Scaaalll ($5.56 in chips) 
Seat 5: Hallyson_23 ($3.27 in chips) 
Seat 6: BossTH4 ($3.91 in chips) 
LijanaV: posts small blind $0.01
owtwilldo: posts big blind $0.02
*** HOLE CARDS ***
Dealt to Scaaalll [8c 3c]
LijanaV is disconnected 
Scaaalll: folds 
Hallyson_23: folds 
BossTH4: folds 
punkosk8: folds 
LijanaV: folds 
Uncalled bet ($0.01) returned to owtwilldo
punkosk8 is disconnected 
owtwilldo collected $0.02 from pot
owtwilldo: doesn't show hand 
*** SUMMARY ***
Total pot $0.02 | Rake $0 
Seat 1: punkosk8 (button) folded before Flop (didn't bet)
Seat 2: LijanaV (small blind) folded before Flop
Seat 3: owtwilldo (big blind) collected ($0.02)
Seat 4: Scaaalll folded before Flop (didn't bet)
Seat 5: Hallyson_23 folded before Flop (didn't bet)
Seat 6: BossTH4 folded before Flop (didn't bet)



PokerStars Zoom Hand #229233794956:  Hold'em No Limit ($0.01/$0.02) - 2021/08/21 23:44:19 CET [2021/08/21 17:44:19 ET]
Table 'Halley' 6-max Seat #1 is the button
Seat 1: GVMELLO ($2.04 in chips) 
Seat 2: Scaaalll ($5.57 in chips) 
Seat 3: Xlavariable ($5.12 in chips) 
Seat 4: kcyxa ($0.54 in chips) 
Seat 5: NoEff0rt2w1n ($2.08 in chips) 
Seat 6: maliniak75 ($5.36 in chips) 
Scaaalll: posts small blind $0.01
Xlavariable: posts big blind $0.02
*** HOLE CARDS ***
Dealt to Scaaalll [Qc 3c]
kcyxa: folds 
kcyxa is disconnected 
NoEff0rt2w1n: raises $0.03 to $0.05
maliniak75: folds 
GVMELLO: folds 
Scaaalll: folds 
Xlavariable: calls $0.03
*** FLOP *** [Th 5h 8s]
Xlavariable: checks 
NoEff0rt2w1n: checks 
*** TURN *** [Th 5h 8s] [9s]
Xlavariable: bets $0.08
NoEff0rt2w1n: folds 
Uncalled bet ($0.08) returned to Xlavariable
Xlavariable collected $0.11 from pot
Xlavariable: doesn't show hand 
*** SUMMARY ***
Total pot $0.11 | Rake $0 
Board [Th 5h 8s 9s]
Seat 1: GVMELLO (button) folded before Flop (didn't bet)
Seat 2: Scaaalll (small blind) folded before Flop
Seat 3: Xlavariable (big blind) collected ($0.11)
Seat 4: kcyxa folded before Flop (didn't bet)
Seat 5: NoEff0rt2w1n folded on the Turn
Seat 6: maliniak75 folded before Flop (didn't bet)



PokerStars Zoom Hand #229233802327:  Hold'em No Limit ($0.01/$0.02) - 2021/08/21 23:44:37 CET [2021/08/21 17:44:37 ET]
Table 'Halley' 6-max Seat #1 is the button
Seat 1: Reipinguimm ($2.22 in chips) 
Seat 2: vot-tebe888 ($3.32 in chips) 
Seat 3: Xlavariable ($6.73 in chips) 
Seat 4: gabgordula ($2.19 in chips) 
Seat 5: Scaaalll ($5.56 in chips) 
Seat 6: VaanKroenen ($2.71 in chips) 
vot-tebe888: posts small blind $0.01
Xlavariable: posts big blind $0.02
*** HOLE CARDS ***
Dealt to Scaaalll [3s 3c]
gabgordula has timed out
gabgordula: folds 
Scaaalll: raises $0.04 to $0.06
VaanKroenen: folds 
Reipinguimm: folds 
vot-tebe888: calls $0.05
Xlavariable: folds 
*** FLOP *** [4h 3d 9s]
vot-tebe888: checks 
Scaaalll: bets $0.09
vot-tebe888: calls $0.09
*** TURN *** [4h 3d 9s] [9h]
vot-tebe888: checks 
Scaaalll: bets $0.20
vot-tebe888: calls $0.20
*** RIVER *** [4h 3d 9s 9h] [7c]
vot-tebe888: checks 
Scaaalll: bets $0.48
vot-tebe888: folds 
Uncalled bet ($0.48) returned to Scaaalll
Scaaalll collected $0.68 from pot
Scaaalll: doesn't show hand 
*** SUMMARY ***
Total pot $0.72 | Rake $0.04 
Board [4h 3d 9s 9h 7c]
Seat 1: Reipinguimm (button) folded before Flop (didn't bet)
Seat 2: vot-tebe888 (small blind) folded on the River
Seat 3: Xlavariable (big blind) folded before Flop
Seat 4: gabgordula folded before Flop (didn't bet)
Seat 5: Scaaalll collected ($0.68)
Seat 6: VaanKroenen folded before Flop (didn't bet)



PokerStars Zoom Hand #229233843194:  Hold'em No Limit ($0.01/$0.02) - 2021/08/21 23:46:19 CET [2021/08/21 17:46:19 ET]
Table 'Halley' 6-max Seat #1 is the button
Seat 1: le_vlimeux ($3 in chips) 
Seat 2: Erwinpkr ($1.35 in chips) 
Seat 3: QuienEsDezzed ($2.77 in chips) 
Seat 4: Scaaalll ($5.89 in chips) 
Seat 5: leeroy818 ($2.33 in chips) 
Seat 6: Doktor Yes ($2 in chips) 
Erwinpkr: posts small blind $0.01
QuienEsDezzed: posts big blind $0.02
*** HOLE CARDS ***
Dealt to Scaaalll [Jc Kc]
Erwinpkr is disconnected 
Scaaalll: raises $0.04 to $0.06
leeroy818: folds 
Doktor Yes: folds 
le_vlimeux: folds 
Erwinpkr: folds 
QuienEsDezzed: folds 
Uncalled bet ($0.04) returned to Scaaalll
Scaaalll collected $0.05 from pot
Scaaalll: doesn't show hand 
*** SUMMARY ***
Total pot $0.05 | Rake $0 
Seat 1: le_vlimeux (button) folded before Flop (didn't bet)
Seat 2: Erwinpkr (small blind) folded before Flop
Seat 3: QuienEsDezzed (big blind) folded before Flop
Seat 4: Scaaalll collected ($0.05)
Seat 5: leeroy818 folded before Flop (didn't bet)
Seat 6: Doktor Yes folded before Flop (didn't bet)



PokerStars Zoom Hand #229233853720:  Hold'em No Limit ($0.01/$0.02) - 2021/08/21 23:46:46 CET [2021/08/21 17:46:46 ET]
Table 'Halley' 6-max Seat #1 is the button
Seat 1: kcyxa ($1.64 in chips) 
Seat 2: Scaaalll ($5.90 in chips) 
Seat 3: josealfredonino ($3.06 in chips) 
Seat 4: squidy4 ($1.33 in chips) 
Seat 5: Feliciano16 ($4.83 in chips) 
Seat 6: Xpokerfreak ($1.79 in chips) 
Scaaalll: posts small blind $0.01
josealfredonino: posts big blind $0.02
*** HOLE CARDS ***
Dealt to Scaaalll [Ts 5h]
kcyxa is disconnected 
squidy4: raises $0.04 to $0.06
Feliciano16: folds 
Xpokerfreak: folds 
kcyxa: folds 
Scaaalll: folds 
josealfredonino: folds 
Uncalled bet ($0.04) returned to squidy4
squidy4 collected $0.05 from pot
squidy4: doesn't show hand 
*** SUMMARY ***
Total pot $0.05 | Rake $0 
Seat 1: kcyxa (button) folded before Flop (didn't bet)
Seat 2: Scaaalll (small blind) folded before Flop
Seat 3: josealfredonino (big blind) folded before Flop
Seat 4: squidy4 collected ($0.05)
Seat 5: Feliciano16 folded before Flop (didn't bet)
Seat 6: Xpokerfreak folded before Flop (didn't bet)



PokerStars Zoom Hand #229233846705:  Hold'em No Limit ($0.01/$0.02) - 2021/08/21 23:46:28 CET [2021/08/21 17:46:28 ET]
Table 'Halley' 6-max Seat #1 is the button
Seat 1: elmex886 ($2.36 in chips) 
Seat 2: ronald1982 ($1.14 in chips) 
Seat 3: Scaaalll ($5.92 in chips) 
Seat 4: ulisessoria ($2.11 in chips) 
Seat 5: fishh_play ($7.49 in chips) 
Seat 6: woetieman ($0.72 in chips) 
ronald1982: posts small blind $0.01
Scaaalll: posts big blind $0.02
*** HOLE CARDS ***
Dealt to Scaaalll [2h Ks]
ulisessoria: folds 
fishh_play: raises $0.03 to $0.05
woetieman: raises $0.03 to $0.08
elmex886: folds 
ronald1982: folds 
Scaaalll: folds 
fishh_play: calls $0.03
*** FLOP *** [9d 8c Ad]
fishh_play: bets $0.10
woetieman: raises $0.10 to $0.20
fishh_play: folds 
Uncalled bet ($0.10) returned to woetieman
woetieman collected $0.38 from pot
woetieman: doesn't show hand 
*** SUMMARY ***
Total pot $0.39 | Rake $0.01 
Board [9d 8c Ad]
Seat 1: elmex886 (button) folded before Flop (didn't bet)
Seat 2: ronald1982 (small blind) folded before Flop
Seat 3: Scaaalll (big blind) folded before Flop
Seat 4: ulisessoria folded before Flop (didn't bet)
Seat 5: fishh_play folded on the Flop
Seat 6: woetieman collected ($0.38)



PokerStars Zoom Hand #229233863293:  Hold'em No Limit ($0.01/$0.02) - 2021/08/21 23:47:10 CET [2021/08/21 17:47:10 ET]
Table 'Halley' 6-max Seat #1 is the button
Seat 1: pipecmolodec ($2 in chips) 
Seat 2: RrriotGrrrl ($3.30 in chips) 
Seat 3: 1nTeresT ($2.16 in chips) 
Seat 4: vovan100157 ($2.77 in chips) 
Seat 5: PaddyPoland ($2.22 in chips) 
Seat 6: Scaaalll ($5.89 in chips) 
RrriotGrrrl: posts small blind $0.01
1nTeresT: posts big blind $0.02
*** HOLE CARDS ***
Dealt to Scaaalll [7d Jc]
vovan100157: folds 
PaddyPoland: folds 
Scaaalll: folds 
pipecmolodec: folds 
RrriotGrrrl: folds 
Uncalled bet ($0.01) returned to 1nTeresT
1nTeresT collected $0.02 from pot
1nTeresT: doesn't show hand 
*** SUMMARY ***
Total pot $0.02 | Rake $0 
Seat 1: pipecmolodec (button) folded before Flop (didn't bet)
Seat 2: RrriotGrrrl (small blind) folded before Flop
Seat 3: 1nTeresT (big blind) collected ($0.02)
Seat 4: vovan100157 folded before Flop (didn't bet)
Seat 5: PaddyPoland folded before Flop (didn't bet)
Seat 6: Scaaalll folded before Flop (didn't bet)



PokerStars Zoom Hand #229233866387:  Hold'em No Limit ($0.01/$0.02) - 2021/08/21 23:47:18 CET [2021/08/21 17:47:18 ET]
Table 'Halley' 6-max Seat #1 is the button
Seat 1: HitEmUpWatz9420 ($3.30 in chips) 
Seat 2: Merlin_Arg ($3.86 in chips) 
Seat 3: Scaaalll ($5.89 in chips) 
Seat 4: SatoruGoj142 ($2.29 in chips) 
Seat 5: BeastBoy18 ($2.10 in chips) 
Seat 6: max-101219 ($2.01 in chips) 
Merlin_Arg: posts small blind $0.01
Scaaalll: posts big blind $0.02
*** HOLE CARDS ***
Dealt to Scaaalll [9s Tc]
SatoruGoj142: folds 
HitEmUpWatz9420 is disconnected 
BeastBoy18: folds 
max-101219: folds 
HitEmUpWatz9420: folds 
Merlin_Arg: folds 
Uncalled bet ($0.01) returned to Scaaalll
max-101219 is disconnected 
Scaaalll collected $0.02 from pot
Scaaalll: doesn't show hand 
*** SUMMARY ***
Total pot $0.02 | Rake $0 
Seat 1: HitEmUpWatz9420 (button) folded before Flop (didn't bet)
Seat 2: Merlin_Arg (small blind) folded before Flop
Seat 3: Scaaalll (big blind) collected ($0.02)
Seat 4: SatoruGoj142 folded before Flop (didn't bet)
Seat 5: BeastBoy18 folded before Flop (didn't bet)
Seat 6: max-101219 folded before Flop (didn't bet)



PokerStars Zoom Hand #229233859424:  Hold'em No Limit ($0.01/$0.02) - 2021/08/21 23:47:00 CET [2021/08/21 17:47:00 ET]
Table 'Halley' 6-max Seat #1 is the button
Seat 1: Scaaalll ($5.89 in chips) 
Seat 2: Iv3rson18 ($2.14 in chips) 
Seat 3: SaLoMaN4iK ($2.16 in chips) 
Seat 4: AlienMdeo ($1.74 in chips) 
Seat 5: vovan100157 ($5.13 in chips) 
Seat 6: pavlo8855 ($2 in chips) 
Iv3rson18: posts small blind $0.01
SaLoMaN4iK: posts big blind $0.02
*** HOLE CARDS ***
Dealt to Scaaalll [5c Jh]
AlienMdeo: raises $0.04 to $0.06
vovan100157: folds 
pavlo8855: folds 
Scaaalll: folds 
Iv3rson18: folds 
SaLoMaN4iK: calls $0.04
*** FLOP *** [8c 3c Kh]
SaLoMaN4iK: checks 
AlienMdeo: bets $0.07
SaLoMaN4iK: raises $0.12 to $0.19
AlienMdeo: folds 
Uncalled bet ($0.12) returned to SaLoMaN4iK
SaLoMaN4iK collected $0.26 from pot
SaLoMaN4iK: doesn't show hand 
*** SUMMARY ***
Total pot $0.27 | Rake $0.01 
Board [8c 3c Kh]
Seat 1: Scaaalll (button) folded before Flop (didn't bet)
Seat 2: Iv3rson18 (small blind) folded before Flop
Seat 3: SaLoMaN4iK (big blind) collected ($0.26)
Seat 4: AlienMdeo folded on the Flop
Seat 5: vovan100157 folded before Flop (didn't bet)
Seat 6: pavlo8855 folded before Flop (didn't bet)



PokerStars Zoom Hand #229233871173:  Hold'em No Limit ($0.01/$0.02) - 2021/08/21 23:47:30 CET [2021/08/21 17:47:30 ET]
Table 'Halley' 6-max Seat #1 is the button
Seat 1: olga3021221 ($2.20 in chips) 
Seat 2: YgovAndrey ($1.87 in chips) 
Seat 3: zergmiky ($2.24 in chips) 
Seat 4: Scaaalll ($5.90 in chips) 
Seat 5: rodrigoasor ($5.32 in chips) 
Seat 6: EdwardF95 ($2.01 in chips) 
YgovAndrey: posts small blind $0.01
zergmiky: posts big blind $0.02
*** HOLE CARDS ***
Dealt to Scaaalll [7c 3c]
Scaaalll: folds 
rodrigoasor: folds 
EdwardF95: folds 
olga3021221: folds 
YgovAndrey: folds 
Uncalled bet ($0.01) returned to zergmiky
zergmiky collected $0.02 from pot
zergmiky: doesn't show hand 
*** SUMMARY ***
Total pot $0.02 | Rake $0 
Seat 1: olga3021221 (button) folded before Flop (didn't bet)
Seat 2: YgovAndrey (small blind) folded before Flop
Seat 3: zergmiky (big blind) collected ($0.02)
Seat 4: Scaaalll folded before Flop (didn't bet)
Seat 5: rodrigoasor folded before Flop (didn't bet)
Seat 6: EdwardF95 folded before Flop (didn't bet)



PokerStars Zoom Hand #229233872708:  Hold'em No Limit ($0.01/$0.02) - 2021/08/21 23:47:34 CET [2021/08/21 17:47:34 ET]
Table 'Halley' 6-max Seat #1 is the button
Seat 1: estelionat171 ($1.49 in chips) 
Seat 2: so0love ($4.27 in chips) 
Seat 3: viktoldo ($1.88 in chips) 
Seat 4: kidninja888 ($2.72 in chips) 
Seat 5: KonopDima ($2 in chips) 
Seat 6: Scaaalll ($5.90 in chips) 
so0love: posts small blind $0.01
viktoldo: posts big blind $0.02
*** HOLE CARDS ***
Dealt to Scaaalll [Th 2c]
kidninja888: folds 
KonopDima: folds 
Scaaalll: folds 
estelionat171: folds 
so0love: folds 
Uncalled bet ($0.01) returned to viktoldo
viktoldo collected $0.02 from pot
viktoldo: doesn't show hand 
*** SUMMARY ***
Total pot $0.02 | Rake $0 
Seat 1: estelionat171 (button) folded before Flop (didn't bet)
Seat 2: so0love (small blind) folded before Flop
Seat 3: viktoldo (big blind) collected ($0.02)
Seat 4: kidninja888 folded before Flop (didn't bet)
Seat 5: KonopDima folded before Flop (didn't bet)
Seat 6: Scaaalll folded before Flop (didn't bet)



PokerStars Zoom Hand #229233877124:  Hold'em No Limit ($0.01/$0.02) - 2021/08/21 23:47:45 CET [2021/08/21 17:47:45 ET]
Table 'Halley' 6-max Seat #1 is the button
Seat 1: Scaaalll ($5.90 in chips) 
Seat 2: Ne0net ($2.01 in chips) 
Seat 3: Gerar NB ($2 in chips) 
Seat 4: fabor1303 ($5.66 in chips) 
Seat 5: kidninja888 ($2.47 in chips) 
Seat 6: ChuckGaylordIII ($2.56 in chips) 
Ne0net: posts small blind $0.01
Gerar NB: posts big blind $0.02
*** HOLE CARDS ***
Dealt to Scaaalll [2d Jc]
fabor1303: folds 
kidninja888: folds 
ChuckGaylordIII: raises $0.02 to $0.04
Scaaalll: folds 
Ne0net: folds 
Gerar NB: folds 
Uncalled bet ($0.02) returned to ChuckGaylordIII
ChuckGaylordIII collected $0.05 from pot
ChuckGaylordIII: doesn't show hand 
*** SUMMARY ***
Total pot $0.05 | Rake $0 
Seat 1: Scaaalll (button) folded before Flop (didn't bet)
Seat 2: Ne0net (small blind) folded before Flop
Seat 3: Gerar NB (big blind) folded before Flop
Seat 4: fabor1303 folded before Flop (didn't bet)
Seat 5: kidninja888 folded before Flop (didn't bet)
Seat 6: ChuckGaylordIII collected ($0.05)



PokerStars Zoom Hand #229233864810:  Hold'em No Limit ($0.01/$0.02) - 2021/08/21 23:47:14 CET [2021/08/21 17:47:14 ET]
Table 'Halley' 6-max Seat #1 is the button
Seat 1: thfc12325 ($1.57 in chips) 
Seat 2: Enders_Monkey ($0.73 in chips) 
Seat 3: 888lifeIS ($2.48 in chips) 
Seat 4: gilberto98 ($4.26 in chips) 
Seat 5: Scaaalll ($5.89 in chips) 
Seat 6: tarogame ($3.99 in chips) 
Enders_Monkey: posts small blind $0.01
888lifeIS: posts big blind $0.02
*** HOLE CARDS ***
Dealt to Scaaalll [8s Th]
gilberto98: folds 
Scaaalll: folds 
tarogame: folds 
thfc12325: raises $0.02 to $0.04
Enders_Monkey: calls $0.03
888lifeIS: raises $0.11 to $0.15
thfc12325: calls $0.11
Enders_Monkey: raises $0.11 to $0.26
888lifeIS: calls $0.11
thfc12325: calls $0.11
*** FLOP *** [6s 7d 7h]
Enders_Monkey: bets $0.37
888lifeIS: folds 
thfc12325: calls $0.37
*** TURN *** [6s 7d 7h] [6c]
Enders_Monkey: bets $0.10 and is all-in
thfc12325: calls $0.10
*** RIVER *** [6s 7d 7h 6c] [5h]
*** SHOW DOWN ***
Enders_Monkey: shows [6h 6d] (four of a kind, Sixes)
thfc12325: shows [Jh Jd] (two pair, Jacks and Sevens)
Enders_Monkey collected $1.66 from pot
*** SUMMARY ***
Total pot $1.72 | Rake $0.06 
Board [6s 7d 7h 6c 5h]
Seat 1: thfc12325 (button) showed [Jh Jd] and lost with two pair, Jacks and Sevens
Seat 2: Enders_Monkey (small blind) showed [6h 6d] and won ($1.66) with four of a kind, Sixes
Seat 3: 888lifeIS (big blind) folded on the Flop
Seat 4: gilberto98 folded before Flop (didn't bet)
Seat 5: Scaaalll folded before Flop (didn't bet)
Seat 6: tarogame folded before Flop (didn't bet)



PokerStars Zoom Hand #229233881455:  Hold'em No Limit ($0.01/$0.02) - 2021/08/21 23:47:56 CET [2021/08/21 17:47:56 ET]
Table 'Halley' 6-max Seat #1 is the button
Seat 1: Xlavariable ($6.65 in chips) 
Seat 2: NoEff0rt2w1n ($4.10 in chips) 
Seat 3: Scaaalll ($5.90 in chips) 
Seat 4: Kedziorboy ($3.98 in chips) 
Seat 5: Dr.stromg ($4.43 in chips) 
Seat 6: AlienMdeo ($1.65 in chips) 
NoEff0rt2w1n: posts small blind $0.01
Scaaalll: posts big blind $0.02
*** HOLE CARDS ***
Dealt to Scaaalll [Ac 5d]
Kedziorboy: folds 
Kedziorboy is disconnected 
Dr.stromg: folds 
AlienMdeo: raises $0.02 to $0.04
Xlavariable: folds 
NoEff0rt2w1n: folds 
Scaaalll: folds 
Uncalled bet ($0.02) returned to AlienMdeo
AlienMdeo collected $0.05 from pot
AlienMdeo: doesn't show hand 
*** SUMMARY ***
Total pot $0.05 | Rake $0 
Seat 1: Xlavariable (button) folded before Flop (didn't bet)
Seat 2: NoEff0rt2w1n (small blind) folded before Flop
Seat 3: Scaaalll (big blind) folded before Flop
Seat 4: Kedziorboy folded before Flop (didn't bet)
Seat 5: Dr.stromg folded before Flop (didn't bet)
Seat 6: AlienMdeo collected ($0.05)



PokerStars Zoom Hand #229233886932:  Hold'em No Limit ($0.01/$0.02) - 2021/08/21 23:48:10 CET [2021/08/21 17:48:10 ET]
Table 'Halley' 6-max Seat #1 is the button
Seat 1: ukesco ($1.46 in chips) 
Seat 2: Scaaalll ($5.88 in chips) 
Seat 3: LeoZ77755 ($2.47 in chips) 
Seat 4: CYBOPOB66 ($2.16 in chips) 
Seat 5: pipecmolodec ($2 in chips) 
Seat 6: Posaunengodi ($4.72 in chips) 
Scaaalll: posts small blind $0.01
LeoZ77755: posts big blind $0.02
*** HOLE CARDS ***
Dealt to Scaaalll [Ts 9h]
CYBOPOB66: folds 
pipecmolodec: folds 
Posaunengodi: folds 
ukesco: folds 
Scaaalll: folds 
Uncalled bet ($0.01) returned to LeoZ77755
LeoZ77755 collected $0.02 from pot
LeoZ77755: doesn't show hand 
*** SUMMARY ***
Total pot $0.02 | Rake $0 
Seat 1: ukesco (button) folded before Flop (didn't bet)
Seat 2: Scaaalll (small blind) folded before Flop
Seat 3: LeoZ77755 (big blind) collected ($0.02)
Seat 4: CYBOPOB66 folded before Flop (didn't bet)
Seat 5: pipecmolodec folded before Flop (didn't bet)
Seat 6: Posaunengodi folded before Flop (didn't bet)



PokerStars Zoom Hand #229233897456:  Hold'em No Limit ($0.01/$0.02) - 2021/08/21 23:48:37 CET [2021/08/21 17:48:37 ET]
Table 'Halley' 6-max Seat #1 is the button
Seat 1: pv1ch ($0.85 in chips) 
Seat 2: Scaaalll ($5.87 in chips) 
Seat 3: Ape$apiens ($1.20 in chips) 
Seat 4: new face onl ($1.96 in chips) 
Seat 5: NickAlex18 ($2 in chips) 
Seat 6: willywilson91 ($1.60 in chips) 
Scaaalll: posts small blind $0.01
Ape$apiens: posts big blind $0.02
*** HOLE CARDS ***
Dealt to Scaaalll [7c Js]
new face onl: folds 
NickAlex18: folds 
willywilson91: raises $0.04 to $0.06
Ape$apiens is disconnected 
pv1ch: folds 
Scaaalll: folds 
Ape$apiens: folds 
Uncalled bet ($0.04) returned to willywilson91
willywilson91 collected $0.05 from pot
willywilson91: doesn't show hand 
*** SUMMARY ***
Total pot $0.05 | Rake $0 
Seat 1: pv1ch (button) folded before Flop (didn't bet)
Seat 2: Scaaalll (small blind) folded before Flop
Seat 3: Ape$apiens (big blind) folded before Flop
Seat 4: new face onl folded before Flop (didn't bet)
Seat 5: NickAlex18 folded before Flop (didn't bet)
Seat 6: willywilson91 collected ($0.05)



PokerStars Zoom Hand #229233895942:  Hold'em No Limit ($0.01/$0.02) - 2021/08/21 23:48:33 CET [2021/08/21 17:48:33 ET]
Table 'Halley' 6-max Seat #1 is the button
Seat 1: A.Khodyakov ($1.57 in chips) 
Seat 2: polymorhp ($1.10 in chips) 
Seat 3: maliniak75 ($2 in chips) 
Seat 4: lalon22 ($2 in chips) 
Seat 5: Mr.Kurier ($4.72 in chips) 
Seat 6: Scaaalll ($5.87 in chips) 
polymorhp: posts small blind $0.01
maliniak75: posts big blind $0.02
*** HOLE CARDS ***
Dealt to Scaaalll [8h Ad]
lalon22: raises $0.04 to $0.06
Mr.Kurier: folds 
Scaaalll: folds 
A.Khodyakov: folds 
polymorhp: folds 
maliniak75: calls $0.04
*** FLOP *** [6h 3s 4h]
maliniak75: checks 
lalon22: checks 
*** TURN *** [6h 3s 4h] [Tc]
maliniak75: checks 
lalon22: bets $0.13
maliniak75: folds 
Uncalled bet ($0.13) returned to lalon22
lalon22 collected $0.13 from pot
lalon22: doesn't show hand 
*** SUMMARY ***
Total pot $0.13 | Rake $0 
Board [6h 3s 4h Tc]
Seat 1: A.Khodyakov (button) folded before Flop (didn't bet)
Seat 2: polymorhp (small blind) folded before Flop
Seat 3: maliniak75 (big blind) folded on the Turn
Seat 4: lalon22 collected ($0.13)
Seat 5: Mr.Kurier folded before Flop (didn't bet)
Seat 6: Scaaalll folded before Flop (didn't bet)



PokerStars Zoom Hand #229233902483:  Hold'em No Limit ($0.01/$0.02) - 2021/08/21 23:48:50 CET [2021/08/21 17:48:50 ET]
Table 'Halley' 6-max Seat #1 is the button
Seat 1: rpycmbEM ($3.01 in chips) 
Seat 2: gabgordula ($2.17 in chips) 
Seat 3: KKARMELO ($3.49 in chips) 
Seat 4: EdwardF95 ($2 in chips) 
Seat 5: Scaaalll ($5.86 in chips) 
Seat 6: REZAKOV72 ($3.06 in chips) 
gabgordula: posts small blind $0.01
KKARMELO: posts big blind $0.02
*** HOLE CARDS ***
Dealt to Scaaalll [7d Ah]
EdwardF95: raises $0.04 to $0.06
Scaaalll: folds 
REZAKOV72: calls $0.06
rpycmbEM: folds 
gabgordula: folds 
KKARMELO: calls $0.04
*** FLOP *** [5c Js 3h]
KKARMELO: checks 
EdwardF95: checks 
REZAKOV72: checks 
*** TURN *** [5c Js 3h] [8h]
KKARMELO: bets $0.07
EdwardF95: calls $0.07
REZAKOV72: folds 
*** RIVER *** [5c Js 3h 8h] [Jd]
KKARMELO: checks 
EdwardF95: checks 
*** SHOW DOWN ***
KKARMELO: shows [6d 8d] (two pair, Jacks and Eights)
EdwardF95: shows [9s 9d] (two pair, Jacks and Nines)
EdwardF95 collected $0.32 from pot
*** SUMMARY ***
Total pot $0.33 | Rake $0.01 
Board [5c Js 3h 8h Jd]
Seat 1: rpycmbEM (button) folded before Flop (didn't bet)
Seat 2: gabgordula (small blind) folded before Flop
Seat 3: KKARMELO (big blind) showed [6d 8d] and lost with two pair, Jacks and Eights
Seat 4: EdwardF95 showed [9s 9d] and won ($0.32) with two pair, Jacks and Nines
Seat 5: Scaaalll folded before Flop (didn't bet)
Seat 6: REZAKOV72 folded on the Turn



PokerStars Zoom Hand #229233912567:  Hold'em No Limit ($0.01/$0.02) - 2021/08/21 23:49:16 CET [2021/08/21 17:49:16 ET]
Table 'Halley' 6-max Seat #1 is the button
Seat 1: Iv3rson18 ($3.30 in chips) 
Seat 2: hustlehero ($3.43 in chips) 
Seat 3: Scaaalll ($5.86 in chips) 
Seat 4: kingdieter1 ($1.38 in chips) 
Seat 5: tarogame ($3.74 in chips) 
Seat 6: TM 69 UIE ($2.65 in chips) 
hustlehero: posts small blind $0.01
Scaaalll: posts big blind $0.02
*** HOLE CARDS ***
Dealt to Scaaalll [7h 3h]
TM 69 UIE is disconnected 
kingdieter1: raises $0.02 to $0.04
tarogame: folds 
TM 69 UIE: folds 
Iv3rson18: folds 
hustlehero: folds 
Scaaalll: folds 
Uncalled bet ($0.02) returned to kingdieter1
kingdieter1 collected $0.05 from pot
kingdieter1: doesn't show hand 
*** SUMMARY ***
Total pot $0.05 | Rake $0 
Seat 1: Iv3rson18 (button) folded before Flop (didn't bet)
Seat 2: hustlehero (small blind) folded before Flop
Seat 3: Scaaalll (big blind) folded before Flop
Seat 4: kingdieter1 collected ($0.05)
Seat 5: tarogame folded before Flop (didn't bet)
Seat 6: TM 69 UIE folded before Flop (didn't bet)



PokerStars Zoom Hand #229233906772:  Hold'em No Limit ($0.01/$0.02) - 2021/08/21 23:49:01 CET [2021/08/21 17:49:01 ET]
Table 'Halley' 6-max Seat #1 is the button
Seat 1: Scaaalll ($5.86 in chips) 
Seat 2: ash1448 ($8.93 in chips) 
Seat 3: giselerebelo ($1.10 in chips) 
Seat 4: Nam Tsedom Tsom ($2.17 in chips) 
Seat 5: Ruben-M. PY ($3.90 in chips) 
Seat 6: m3ssy34 ($0.96 in chips) 
ash1448: posts small blind $0.01
giselerebelo: posts big blind $0.02
*** HOLE CARDS ***
Dealt to Scaaalll [3c 2h]
Nam Tsedom Tsom: folds 
Ruben-M. PY: raises $0.03 to $0.05
m3ssy34: calls $0.05
Scaaalll: folds 
ash1448: folds 
giselerebelo: folds 
*** FLOP *** [Jc Qd 2c]
Ruben-M. PY: checks 
m3ssy34: checks 
*** TURN *** [Jc Qd 2c] [6d]
Ruben-M. PY: bets $0.04
m3ssy34: folds 
Uncalled bet ($0.04) returned to Ruben-M. PY
Ruben-M. PY collected $0.13 from pot
Ruben-M. PY: doesn't show hand 
m3ssy34 is disconnected 
*** SUMMARY ***
Total pot $0.13 | Rake $0 
Board [Jc Qd 2c 6d]
Seat 1: Scaaalll (button) folded before Flop (didn't bet)
Seat 2: ash1448 (small blind) folded before Flop
Seat 3: giselerebelo (big blind) folded before Flop
Seat 4: Nam Tsedom Tsom folded before Flop (didn't bet)
Seat 5: Ruben-M. PY collected ($0.13)
Seat 6: m3ssy34 folded on the Turn



PokerStars Zoom Hand #229233918095:  Hold'em No Limit ($0.01/$0.02) - 2021/08/21 23:49:30 CET [2021/08/21 17:49:30 ET]
Table 'Halley' 6-max Seat #1 is the button
Seat 1: Scaaalll ($5.84 in chips) 
Seat 2: MKIronCrAAzy ($5.49 in chips) 
Seat 3: Ape$apiens ($1.13 in chips) 
Seat 4: RChinenov ($2.27 in chips) 
Seat 5: AXXILLES ($5.17 in chips) 
Seat 6: kidninja888 ($2.45 in chips) 
MKIronCrAAzy: posts small blind $0.01
Ape$apiens: posts big blind $0.02
*** HOLE CARDS ***
Dealt to Scaaalll [Tc Ad]
RChinenov: raises $0.04 to $0.06
AXXILLES: folds 
kidninja888: folds 
Ape$apiens is disconnected 
Scaaalll: calls $0.06
MKIronCrAAzy: folds 
Ape$apiens: folds 
*** FLOP *** [Td 7d 7s]
RChinenov: bets $0.07
Scaaalll: calls $0.07
*** TURN *** [Td 7d 7s] [9c]
RChinenov: bets $0.21
Scaaalll: calls $0.21
*** RIVER *** [Td 7d 7s 9c] [7c]
RChinenov: checks 
Scaaalll: bets $0.37
RChinenov: folds 
Uncalled bet ($0.37) returned to Scaaalll
Scaaalll collected $0.69 from pot
Scaaalll: doesn't show hand 
*** SUMMARY ***
Total pot $0.71 | Rake $0.02 
Board [Td 7d 7s 9c 7c]
Seat 1: Scaaalll (button) collected ($0.69)
Seat 2: MKIronCrAAzy (small blind) folded before Flop
Seat 3: Ape$apiens (big blind) folded before Flop
Seat 4: RChinenov folded on the River
Seat 5: AXXILLES folded before Flop (didn't bet)
Seat 6: kidninja888 folded before Flop (didn't bet)



PokerStars Zoom Hand #229233944133:  Hold'em No Limit ($0.01/$0.02) - 2021/08/21 23:50:37 CET [2021/08/21 17:50:37 ET]
Table 'Halley' 6-max Seat #1 is the button
Seat 1: josealfredonino ($2.94 in chips) 
Seat 2: NetoFLX ($3.38 in chips) 
Seat 3: 0Jarek ($0.91 in chips) 
Seat 4: SKV_1985 ($2.94 in chips) 
Seat 5: 3@RAZZA.BLR ($2.98 in chips) 
Seat 6: Scaaalll ($6.19 in chips) 
NetoFLX: posts small blind $0.01
0Jarek: posts big blind $0.02
*** HOLE CARDS ***
Dealt to Scaaalll [3d 4h]
SKV_1985: raises $0.04 to $0.06
3@RAZZA.BLR: folds 
Scaaalll: folds 
josealfredonino: folds 
NetoFLX: folds 
0Jarek: folds 
Uncalled bet ($0.04) returned to SKV_1985
SKV_1985 collected $0.05 from pot
SKV_1985: doesn't show hand 
*** SUMMARY ***
Total pot $0.05 | Rake $0 
Seat 1: josealfredonino (button) folded before Flop (didn't bet)
Seat 2: NetoFLX (small blind) folded before Flop
Seat 3: 0Jarek (big blind) folded before Flop
Seat 4: SKV_1985 collected ($0.05)
Seat 5: 3@RAZZA.BLR folded before Flop (didn't bet)
Seat 6: Scaaalll folded before Flop (didn't bet)



PokerStars Zoom Hand #229233945632:  Hold'em No Limit ($0.01/$0.02) - 2021/08/21 23:50:41 CET [2021/08/21 17:50:41 ET]
Table 'Halley' 6-max Seat #1 is the button
Seat 1: fishh_play ($2.19 in chips) 
Seat 2: Scaaalll ($6.19 in chips) 
Seat 3: adrianh2002 ($2 in chips) 
Seat 4: Merlin_Arg ($2.19 in chips) 
Seat 5: clay070 ($1.14 in chips) 
Seat 6: Nihility77 ($6.97 in chips) 
Scaaalll: posts small blind $0.01
adrianh2002: posts big blind $0.02
*** HOLE CARDS ***
Dealt to Scaaalll [9c Kh]
Merlin_Arg: raises $0.04 to $0.06
clay070: calls $0.06
Nihility77: folds 
fishh_play: folds 
Scaaalll: folds 
adrianh2002: folds 
*** FLOP *** [5s Ks 2d]
Merlin_Arg: checks 
clay070: bets $0.14
Merlin_Arg: folds 
Uncalled bet ($0.14) returned to clay070
clay070 collected $0.14 from pot
clay070: doesn't show hand 
*** SUMMARY ***
Total pot $0.15 | Rake $0.01 
Board [5s Ks 2d]
Seat 1: fishh_play (button) folded before Flop (didn't bet)
Seat 2: Scaaalll (small blind) folded before Flop
Seat 3: adrianh2002 (big blind) folded before Flop
Seat 4: Merlin_Arg folded on the Flop
Seat 5: clay070 collected ($0.14)
Seat 6: Nihility77 folded before Flop (didn't bet)



PokerStars Zoom Hand #229233954477:  Hold'em No Limit ($0.01/$0.02) - 2021/08/21 23:50:53 CET [2021/08/21 17:50:53 ET]
Table 'Halley' 6-max Seat #1 is the button
Seat 1: Marcos130790 ($2.08 in chips) 
Seat 2: Mikeloko182 ($3.65 in chips) 
Seat 3: isaeg ($3.52 in chips) 
Seat 4: Craitastrophe ($2.91 in chips) 
Seat 5: Scaaalll ($6.18 in chips) 
Seat 6: baddbeat4fun ($2.34 in chips) 
Mikeloko182: posts small blind $0.01
isaeg: posts big blind $0.02
*** HOLE CARDS ***
Dealt to Scaaalll [9c 8c]
Craitastrophe: folds 
Scaaalll: raises $0.04 to $0.06
isaeg is disconnected 
baddbeat4fun: folds 
Marcos130790: folds 
Mikeloko182: calls $0.05
isaeg: folds 
*** FLOP *** [5h 4c 5s]
Mikeloko182: checks 
Scaaalll: bets $0.08
Mikeloko182: folds 
Uncalled bet ($0.08) returned to Scaaalll
Scaaalll collected $0.14 from pot
Scaaalll: doesn't show hand 
*** SUMMARY ***
Total pot $0.14 | Rake $0 
Board [5h 4c 5s]
Seat 1: Marcos130790 (button) folded before Flop (didn't bet)
Seat 2: Mikeloko182 (small blind) folded on the Flop
Seat 3: isaeg (big blind) folded before Flop
Seat 4: Craitastrophe folded before Flop (didn't bet)
Seat 5: Scaaalll collected ($0.14)
Seat 6: baddbeat4fun folded before Flop (didn't bet)



PokerStars Zoom Hand #229233967677:  Hold'em No Limit ($0.01/$0.02) - 2021/08/21 23:51:27 CET [2021/08/21 17:51:27 ET]
Table 'Halley' 6-max Seat #1 is the button
Seat 1: EdwardF95 ($2.07 in chips) 
Seat 2: Posaunengodi ($5.22 in chips) 
Seat 3: adrianh2002 ($2.06 in chips) 
Seat 4: Scaaalll ($6.26 in chips) 
Seat 5: pipecmolodec ($2.03 in chips) 
Seat 6: Recasia ($0.97 in chips) 
Posaunengodi: posts small blind $0.01
adrianh2002: posts big blind $0.02
*** HOLE CARDS ***
Dealt to Scaaalll [Qc Ac]
Scaaalll: raises $0.04 to $0.06
pipecmolodec: folds 
Recasia: folds 
EdwardF95: folds 
Posaunengodi: calls $0.05
adrianh2002: folds 
*** FLOP *** [6c Kd 7d]
Posaunengodi: checks 
Scaaalll: checks 
*** TURN *** [6c Kd 7d] [Th]
Posaunengodi: checks 
Scaaalll: checks 
*** RIVER *** [6c Kd 7d Th] [7c]
Posaunengodi: checks 
Scaaalll: checks 
*** SHOW DOWN ***
Posaunengodi: shows [As 5s] (a pair of Sevens)
Scaaalll: shows [Qc Ac] (a pair of Sevens - Ace+King+Queen kicker)
Scaaalll collected $0.14 from pot
*** SUMMARY ***
Total pot $0.14 | Rake $0 
Board [6c Kd 7d Th 7c]
Seat 1: EdwardF95 (button) folded before Flop (didn't bet)
Seat 2: Posaunengodi (small blind) showed [As 5s] and lost with a pair of Sevens
Seat 3: adrianh2002 (big blind) folded before Flop
Seat 4: Scaaalll showed [Qc Ac] and won ($0.14) with a pair of Sevens
Seat 5: pipecmolodec folded before Flop (didn't bet)
Seat 6: Recasia folded before Flop (didn't bet)



PokerStars Zoom Hand #229233985455:  Hold'em No Limit ($0.01/$0.02) - 2021/08/21 23:52:13 CET [2021/08/21 17:52:13 ET]
Table 'Halley' 6-max Seat #1 is the button
Seat 1: Iv3rson18 ($2.31 in chips) 
Seat 2: EstiBan18 ($2.30 in chips) 
Seat 3: Mac9Monty2 ($2.63 in chips) 
Seat 4: Scaaalll ($6.34 in chips) 
Seat 5: hallowed_0 ($2.24 in chips) 
Seat 6: Feyqdoi ($2.02 in chips) 
EstiBan18: posts small blind $0.01
Mac9Monty2: posts big blind $0.02
*** HOLE CARDS ***
Dealt to Scaaalll [Jh 8h]
Scaaalll: folds 
hallowed_0: folds 
Feyqdoi: folds 
Iv3rson18: folds 
EstiBan18: folds 
Uncalled bet ($0.01) returned to Mac9Monty2
Mac9Monty2 collected $0.02 from pot
Mac9Monty2: doesn't show hand 
*** SUMMARY ***
Total pot $0.02 | Rake $0 
Seat 1: Iv3rson18 (button) folded before Flop (didn't bet)
Seat 2: EstiBan18 (small blind) folded before Flop
Seat 3: Mac9Monty2 (big blind) collected ($0.02)
Seat 4: Scaaalll folded before Flop (didn't bet)
Seat 5: hallowed_0 folded before Flop (didn't bet)
Seat 6: Feyqdoi folded before Flop (didn't bet)



PokerStars Zoom Hand #229233987000:  Hold'em No Limit ($0.01/$0.02) - 2021/08/21 23:52:17 CET [2021/08/21 17:52:17 ET]
Table 'Halley' 6-max Seat #1 is the button
Seat 1: Xlavariable ($3.27 in chips) 
Seat 2: xmaksimus ($2.58 in chips) 
Seat 3: Xpokerfreak ($2.69 in chips) 
Seat 4: Valansen ($3.03 in chips) 
Seat 5: BautiMang ($2.23 in chips) 
Seat 6: Scaaalll ($6.34 in chips) 
xmaksimus: posts small blind $0.01
Xpokerfreak: posts big blind $0.02
*** HOLE CARDS ***
Dealt to Scaaalll [7d Kh]
Valansen: folds 
BautiMang: folds 
Scaaalll: folds 
Xlavariable has timed out
Xlavariable: folds 
xmaksimus: raises $0.04 to $0.06
Xpokerfreak: folds 
Uncalled bet ($0.04) returned to xmaksimus
xmaksimus collected $0.04 from pot
xmaksimus: doesn't show hand 
*** SUMMARY ***
Total pot $0.04 | Rake $0 
Seat 1: Xlavariable (button) folded before Flop (didn't bet)
Seat 2: xmaksimus (small blind) collected ($0.04)
Seat 3: Xpokerfreak (big blind) folded before Flop
Seat 4: Valansen folded before Flop (didn't bet)
Seat 5: BautiMang folded before Flop (didn't bet)
Seat 6: Scaaalll folded before Flop (didn't bet)



PokerStars Zoom Hand #229234000895:  Hold'em No Limit ($0.01/$0.02) - 2021/08/21 23:52:53 CET [2021/08/21 17:52:53 ET]
Table 'Halley' 6-max Seat #1 is the button
Seat 1: disanddowny ($1.45 in chips) 
Seat 2: Scaaalll ($6.32 in chips) 
Seat 3: Xlavariable ($2.02 in chips) 
Seat 4: EdwardF95 ($2.02 in chips) 
Seat 5: Ontherin ($3.31 in chips) 
Seat 6: pipecmolodec ($2.06 in chips) 
Scaaalll: posts small blind $0.01
Xlavariable: posts big blind $0.02
*** HOLE CARDS ***
Dealt to Scaaalll [Th Ah]
EdwardF95: folds 
Ontherin: folds 
pipecmolodec: folds 
disanddowny: folds 
Scaaalll: raises $0.04 to $0.06
Xlavariable: folds 
Uncalled bet ($0.04) returned to Scaaalll
Scaaalll collected $0.04 from pot
Scaaalll: doesn't show hand 
*** SUMMARY ***
Total pot $0.04 | Rake $0 
Seat 1: disanddowny (button) folded before Flop (didn't bet)
Seat 2: Scaaalll (small blind) collected ($0.04)
Seat 3: Xlavariable (big blind) folded before Flop
Seat 4: EdwardF95 folded before Flop (didn't bet)
Seat 5: Ontherin folded before Flop (didn't bet)
Seat 6: pipecmolodec folded before Flop (didn't bet)



PokerStars Zoom Hand #229233989304:  Hold'em No Limit ($0.01/$0.02) - 2021/08/21 23:52:23 CET [2021/08/21 17:52:23 ET]
Table 'Halley' 6-max Seat #1 is the button
Seat 1: manekenss ($1.02 in chips) 
Seat 2: ulisessoria ($2 in chips) 
Seat 3: Scaaalll ($6.34 in chips) 
Seat 4: Sha.Le.Ol. ($1.41 in chips) 
Seat 5: pipecmolodec ($2.10 in chips) 
Seat 6: ronald1982 ($1.20 in chips) 
ulisessoria: posts small blind $0.01
Scaaalll: posts big blind $0.02
*** HOLE CARDS ***
Dealt to Scaaalll [9d Kh]
Sha.Le.Ol.: folds 
pipecmolodec: raises $0.02 to $0.04
ronald1982: folds 
manekenss: calls $0.04
ulisessoria: folds 
Scaaalll: folds 
*** FLOP *** [3d Jc 2s]
pipecmolodec: checks 
manekenss: bets $0.11
pipecmolodec: folds 
Uncalled bet ($0.11) returned to manekenss
manekenss collected $0.11 from pot
manekenss: doesn't show hand 
*** SUMMARY ***
Total pot $0.11 | Rake $0 
Board [3d Jc 2s]
Seat 1: manekenss (button) collected ($0.11)
Seat 2: ulisessoria (small blind) folded before Flop
Seat 3: Scaaalll (big blind) folded before Flop
Seat 4: Sha.Le.Ol. folded before Flop (didn't bet)
Seat 5: pipecmolodec folded on the Flop
Seat 6: ronald1982 folded before Flop (didn't bet)



PokerStars Zoom Hand #229234007753:  Hold'em No Limit ($0.01/$0.02) - 2021/08/21 23:53:11 CET [2021/08/21 17:53:11 ET]
Table 'Halley' 6-max Seat #1 is the button
Seat 1: Scaaalll ($6.34 in chips) 
Seat 2: keldh ($6.99 in chips) 
Seat 3: fishh_play ($7.60 in chips) 
Seat 4: Feyqdoi ($2 in chips) 
Seat 5: slipknot956 ($2.82 in chips) 
Seat 6: StartGoy ($2.45 in chips) 
keldh: posts small blind $0.01
fishh_play: posts big blind $0.02
*** HOLE CARDS ***
Dealt to Scaaalll [4c 3c]
Feyqdoi: folds 
slipknot956: folds 
StartGoy: raises $0.11 to $0.13
Scaaalll: folds 
keldh: calls $0.12
fishh_play: folds 
*** FLOP *** [9s Jh Js]
keldh: checks 
StartGoy: bets $2.32 and is all-in
keldh: calls $2.32
*** TURN *** [9s Jh Js] [Qh]
*** RIVER *** [9s Jh Js Qh] [2d]
*** SHOW DOWN ***
keldh: shows [6h 6c] (two pair, Jacks and Sixes)
StartGoy: shows [2s Qd] (two pair, Queens and Jacks)
StartGoy collected $4.75 from pot
*** SUMMARY ***
Total pot $4.92 | Rake $0.17 
Board [9s Jh Js Qh 2d]
Seat 1: Scaaalll (button) folded before Flop (didn't bet)
Seat 2: keldh (small blind) showed [6h 6c] and lost with two pair, Jacks and Sixes
Seat 3: fishh_play (big blind) folded before Flop
Seat 4: Feyqdoi folded before Flop (didn't bet)
Seat 5: slipknot956 folded before Flop (didn't bet)
Seat 6: StartGoy showed [2s Qd] and won ($4.75) with two pair, Queens and Jacks



PokerStars Zoom Hand #229233997003:  Hold'em No Limit ($0.01/$0.02) - 2021/08/21 23:52:43 CET [2021/08/21 17:52:43 ET]
Table 'Halley' 6-max Seat #1 is the button
Seat 1: bennodiem ($2.10 in chips) 
Seat 2: lucky1529 ($0.87 in chips) 
Seat 3: Dr.stromg ($4.74 in chips) 
Seat 4: Scaaalll ($6.32 in chips) 
Seat 5: Marcelo17184 ($0.83 in chips) 
Seat 6: SchinkenToni ($0.88 in chips) 
lucky1529: posts small blind $0.01
Dr.stromg: posts big blind $0.02
*** HOLE CARDS ***
Dealt to Scaaalll [4s 3h]
Scaaalll: folds 
Marcelo17184: folds 
SchinkenToni: folds 
bennodiem: raises $0.02 to $0.04
lucky1529: calls $0.03
Dr.stromg: calls $0.02
*** FLOP *** [2h Ts 3c]
lucky1529: checks 
Dr.stromg: checks 
bennodiem: checks 
*** TURN *** [2h Ts 3c] [Th]
lucky1529: checks 
Dr.stromg: checks 
bennodiem: checks 
*** RIVER *** [2h Ts 3c Th] [4d]
lucky1529: checks 
Dr.stromg: bets $0.07
bennodiem: calls $0.07
lucky1529: folds 
*** SHOW DOWN ***
Dr.stromg: shows [As 5c] (a straight, Ace to Five)
bennodiem: mucks hand 
Dr.stromg collected $0.25 from pot
*** SUMMARY ***
Total pot $0.26 | Rake $0.01 
Board [2h Ts 3c Th 4d]
Seat 1: bennodiem (button) mucked [Jh 4h]
Seat 2: lucky1529 (small blind) folded on the River
Seat 3: Dr.stromg (big blind) showed [As 5c] and won ($0.25) with a straight, Ace to Five
Seat 4: Scaaalll folded before Flop (didn't bet)
Seat 5: Marcelo17184 folded before Flop (didn't bet)
Seat 6: SchinkenToni folded before Flop (didn't bet)



PokerStars Zoom Hand #229234011515:  Hold'em No Limit ($0.01/$0.02) - 2021/08/21 23:53:21 CET [2021/08/21 17:53:21 ET]
Table 'Halley' 6-max Seat #1 is the button
Seat 1: Zaarh ($3.14 in chips) 
Seat 2: Mac9Monty2 ($2.71 in chips) 
Seat 3: Scaaalll ($6.34 in chips) 
Seat 4: Treadero ($1.99 in chips) 
Seat 5: KKARMELO ($2.09 in chips) 
Seat 6: rodrigoasor ($6.03 in chips) 
Mac9Monty2: posts small blind $0.01
Scaaalll: posts big blind $0.02
*** HOLE CARDS ***
Dealt to Scaaalll [Ac 7s]
Zaarh is disconnected 
Treadero: raises $0.02 to $0.04
KKARMELO: folds 
rodrigoasor: calls $0.04
Zaarh: folds 
Mac9Monty2: folds 
Scaaalll: folds 
*** FLOP *** [3c 8h Ad]
Treadero: bets $0.06
rodrigoasor: folds 
Uncalled bet ($0.06) returned to Treadero
Treadero collected $0.11 from pot
Treadero: doesn't show hand 
*** SUMMARY ***
Total pot $0.11 | Rake $0 
Board [3c 8h Ad]
Seat 1: Zaarh (button) folded before Flop (didn't bet)
Seat 2: Mac9Monty2 (small blind) folded before Flop
Seat 3: Scaaalll (big blind) folded before Flop
Seat 4: Treadero collected ($0.11)
Seat 5: KKARMELO folded before Flop (didn't bet)
Seat 6: rodrigoasor folded on the Flop



PokerStars Zoom Hand #229234021910:  Hold'em No Limit ($0.01/$0.02) - 2021/08/21 23:53:48 CET [2021/08/21 17:53:48 ET]
Table 'Halley' 6-max Seat #1 is the button
Seat 1: new face onl ($2.48 in chips) 
Seat 2: Gumajzl ($1.63 in chips) 
Seat 3: Merlin_Arg ($3.69 in chips) 
Seat 4: pavlo8855 ($2.30 in chips) 
Seat 5: Scaaalll ($6.32 in chips) 
Seat 6: punkosk8 ($7.43 in chips) 
Gumajzl: posts small blind $0.01
Merlin_Arg: posts big blind $0.02
*** HOLE CARDS ***
Dealt to Scaaalll [Js 6d]
pavlo8855: raises $0.04 to $0.06
Scaaalll: folds 
punkosk8: folds 
new face onl: folds 
Gumajzl: folds 
Merlin_Arg: folds 
Uncalled bet ($0.04) returned to pavlo8855
punkosk8 is disconnected 
pavlo8855 collected $0.05 from pot
pavlo8855: doesn't show hand 
*** SUMMARY ***
Total pot $0.05 | Rake $0 
Seat 1: new face onl (button) folded before Flop (didn't bet)
Seat 2: Gumajzl (small blind) folded before Flop
Seat 3: Merlin_Arg (big blind) folded before Flop
Seat 4: pavlo8855 collected ($0.05)
Seat 5: Scaaalll folded before Flop (didn't bet)
Seat 6: punkosk8 folded before Flop (didn't bet)



PokerStars Zoom Hand #229234019215:  Hold'em No Limit ($0.01/$0.02) - 2021/08/21 23:53:41 CET [2021/08/21 17:53:41 ET]
Table 'Halley' 6-max Seat #1 is the button
Seat 1: xmaksimus ($2.48 in chips) 
Seat 2: 0Jarek ($0.81 in chips) 
Seat 3: Hiury5 ($3.56 in chips) 
Seat 4: elmex886 ($2 in chips) 
Seat 5: Scaaalll ($6.32 in chips) 
Seat 6: Feyqdoi ($2.02 in chips) 
0Jarek: posts small blind $0.01
Hiury5: posts big blind $0.02
*** HOLE CARDS ***
Dealt to Scaaalll [5c Th]
elmex886: folds 
Scaaalll: folds 
Feyqdoi: raises $0.04 to $0.06
xmaksimus: calls $0.06
0Jarek: folds 
Hiury5: folds 
*** FLOP *** [Qh Jc 6d]
Feyqdoi: checks 
xmaksimus: bets $0.07
Feyqdoi: calls $0.07
*** TURN *** [Qh Jc 6d] [6h]
Feyqdoi: checks 
xmaksimus: bets $0.08
Feyqdoi: calls $0.08
*** RIVER *** [Qh Jc 6d 6h] [3c]
Feyqdoi: checks 
xmaksimus: checks 
*** SHOW DOWN ***
Feyqdoi: shows [8d Qd] (two pair, Queens and Sixes)
xmaksimus: mucks hand 
Feyqdoi collected $0.43 from pot
*** SUMMARY ***
Total pot $0.45 | Rake $0.02 
Board [Qh Jc 6d 6h 3c]
Seat 1: xmaksimus (button) mucked [Js 7h]
Seat 2: 0Jarek (small blind) folded before Flop
Seat 3: Hiury5 (big blind) folded before Flop
Seat 4: elmex886 folded before Flop (didn't bet)
Seat 5: Scaaalll folded before Flop (didn't bet)
Seat 6: Feyqdoi showed [8d Qd] and won ($0.43) with two pair, Queens and Sixes



PokerStars Zoom Hand #229234029922:  Hold'em No Limit ($0.01/$0.02) - 2021/08/21 23:54:09 CET [2021/08/21 17:54:09 ET]
Table 'Halley' 6-max Seat #1 is the button
Seat 1: A.Khodyakov ($1.65 in chips) 
Seat 2: STE1NBERG ($3.03 in chips) 
Seat 3: bt710 ($5.38 in chips) 
Seat 4: CowboyNicky ($1.65 in chips) 
Seat 5: Doktor Yes ($2 in chips) 
Seat 6: Scaaalll ($6.32 in chips) 
STE1NBERG: posts small blind $0.01
bt710: posts big blind $0.02
*** HOLE CARDS ***
Dealt to Scaaalll [5h Qs]
CowboyNicky: folds 
CowboyNicky is disconnected 
Doktor Yes: raises $0.04 to $0.06
Scaaalll: folds 
A.Khodyakov: calls $0.06
STE1NBERG: folds 
bt710: folds 
*** FLOP *** [6c Js Kh]
Doktor Yes: bets $0.07
A.Khodyakov: folds 
Uncalled bet ($0.07) returned to Doktor Yes
Doktor Yes collected $0.14 from pot
Doktor Yes: doesn't show hand 
*** SUMMARY ***
Total pot $0.15 | Rake $0.01 
Board [6c Js Kh]
Seat 1: A.Khodyakov (button) folded on the Flop
Seat 2: STE1NBERG (small blind) folded before Flop
Seat 3: bt710 (big blind) folded before Flop
Seat 4: CowboyNicky folded before Flop (didn't bet)
Seat 5: Doktor Yes collected ($0.14)
Seat 6: Scaaalll folded before Flop (didn't bet)



PokerStars Zoom Hand #229234026543:  Hold'em No Limit ($0.01/$0.02) - 2021/08/21 23:54:00 CET [2021/08/21 17:54:00 ET]
Table 'Halley' 6-max Seat #1 is the button
Seat 1: Scaaalll ($6.32 in chips) 
Seat 2: Stasilo21 ($1.98 in chips) 
Seat 3: gasmar_29 ($6.08 in chips) 
Seat 4: ctaceo ($2.32 in chips) 
Seat 5: hustlehero ($3.49 in chips) 
Seat 6: STE1NBERG ($3.03 in chips) 
Stasilo21: posts small blind $0.01
gasmar_29: posts big blind $0.02
*** HOLE CARDS ***
Dealt to Scaaalll [5c 6h]
ctaceo: folds 
hustlehero: folds 
STE1NBERG: folds 
Scaaalll: folds 
Stasilo21: calls $0.01
gasmar_29: checks 
*** FLOP *** [Ks 2c 2s]
Stasilo21: checks 
gasmar_29: bets $0.03
Stasilo21: folds 
Uncalled bet ($0.03) returned to gasmar_29
gasmar_29 collected $0.04 from pot
gasmar_29: doesn't show hand 
*** SUMMARY ***
Total pot $0.04 | Rake $0 
Board [Ks 2c 2s]
Seat 1: Scaaalll (button) folded before Flop (didn't bet)
Seat 2: Stasilo21 (small blind) folded on the Flop
Seat 3: gasmar_29 (big blind) collected ($0.04)
Seat 4: ctaceo folded before Flop (didn't bet)
Seat 5: hustlehero folded before Flop (didn't bet)
Seat 6: STE1NBERG folded before Flop (didn't bet)



PokerStars Zoom Hand #229234031483:  Hold'em No Limit ($0.01/$0.02) - 2021/08/21 23:54:13 CET [2021/08/21 17:54:13 ET]
Table 'Halley' 6-max Seat #1 is the button
Seat 1: 888lifeIS ($2.40 in chips) 
Seat 2: Scaaalll ($6.32 in chips) 
Seat 3: elmex886 ($2 in chips) 
Seat 4: Carlos_glaza ($2 in chips) 
Seat 5: illya713 ($2.76 in chips) 
Seat 6: Marcos130790 ($2 in chips) 
Scaaalll: posts small blind $0.01
elmex886: posts big blind $0.02
*** HOLE CARDS ***
Dealt to Scaaalll [6s 2c]
Carlos_glaza: folds 
illya713: folds 
illya713 is disconnected 
Marcos130790: raises $0.04 to $0.06
888lifeIS: folds 
Scaaalll: folds 
elmex886: folds 
Uncalled bet ($0.04) returned to Marcos130790
Marcos130790 collected $0.05 from pot
Marcos130790: doesn't show hand 
*** SUMMARY ***
Total pot $0.05 | Rake $0 
Seat 1: 888lifeIS (button) folded before Flop (didn't bet)
Seat 2: Scaaalll (small blind) folded before Flop
Seat 3: elmex886 (big blind) folded before Flop
Seat 4: Carlos_glaza folded before Flop (didn't bet)
Seat 5: illya713 folded before Flop (didn't bet)
Seat 6: Marcos130790 collected ($0.05)



PokerStars Zoom Hand #229234039937:  Hold'em No Limit ($0.01/$0.02) - 2021/08/21 23:54:35 CET [2021/08/21 17:54:35 ET]
Table 'Halley' 6-max Seat #1 is the button
Seat 1: FreddyFlips ($1.77 in chips) 
Seat 2: thekidisnuts ($1.92 in chips) 
Seat 3: bart8612 ($2.58 in chips) 
Seat 4: 888lifeIS ($2.06 in chips) 
Seat 5: mthurner97 ($1.77 in chips) 
Seat 6: Scaaalll ($6.31 in chips) 
thekidisnuts: posts small blind $0.01
bart8612: posts big blind $0.02
*** HOLE CARDS ***
Dealt to Scaaalll [Th Qh]
888lifeIS: folds 
mthurner97: calls $0.02
Scaaalll: raises $0.06 to $0.08
FreddyFlips: calls $0.08
thekidisnuts: calls $0.07
bart8612: folds 
mthurner97: folds 
*** FLOP *** [4s Qs 8c]
mthurner97 is disconnected 
thekidisnuts: checks 
Scaaalll: bets $0.15
FreddyFlips: calls $0.15
thekidisnuts: calls $0.15
*** TURN *** [4s Qs 8c] [Tc]
thekidisnuts: checks 
Scaaalll: bets $0.43
FreddyFlips: calls $0.43
thekidisnuts: folds 
*** RIVER *** [4s Qs 8c Tc] [5h]
Scaaalll: bets $5.65 and is all-in
FreddyFlips: calls $1.11 and is all-in
Uncalled bet ($4.54) returned to Scaaalll
*** SHOW DOWN ***
Scaaalll: shows [Th Qh] (two pair, Queens and Tens)
FreddyFlips: shows [Qc Ah] (a pair of Queens)
Scaaalll collected $3.65 from pot
*** SUMMARY ***
Total pot $3.81 | Rake $0.16 
Board [4s Qs 8c Tc 5h]
Seat 1: FreddyFlips (button) showed [Qc Ah] and lost with a pair of Queens
Seat 2: thekidisnuts (small blind) folded on the Turn
Seat 3: bart8612 (big blind) folded before Flop
Seat 4: 888lifeIS folded before Flop (didn't bet)
Seat 5: mthurner97 folded before Flop
Seat 6: Scaaalll showed [Th Qh] and won ($3.65) with two pair, Queens and Tens



PokerStars Zoom Hand #229234066318:  Hold'em No Limit ($0.01/$0.02) - 2021/08/21 23:55:56 CET [2021/08/21 17:55:56 ET]
Table 'Halley' 6-max Seat #1 is the button
Seat 1: Agneobr ($1.05 in chips) 
Seat 2: OFSHOR ($5.72 in chips) 
Seat 3: Scaaalll ($8.19 in chips) 
Seat 4: fishh_play ($3.90 in chips) 
Seat 5: Blackwood567 ($1.82 in chips) 
Seat 6: vovan100157 ($3.12 in chips) 
OFSHOR: posts small blind $0.01
Scaaalll: posts big blind $0.02
*** HOLE CARDS ***
Dealt to Scaaalll [3h Th]
fishh_play: raises $0.03 to $0.05
Blackwood567: folds 
vovan100157: folds 
Blackwood567 is disconnected 
Agneobr: folds 
OFSHOR: folds 
Scaaalll: folds 
Uncalled bet ($0.03) returned to fishh_play
fishh_play collected $0.05 from pot
fishh_play: doesn't show hand 
*** SUMMARY ***
Total pot $0.05 | Rake $0 
Seat 1: Agneobr (button) folded before Flop (didn't bet)
Seat 2: OFSHOR (small blind) folded before Flop
Seat 3: Scaaalll (big blind) folded before Flop
Seat 4: fishh_play collected ($0.05)
Seat 5: Blackwood567 folded before Flop (didn't bet)
Seat 6: vovan100157 folded before Flop (didn't bet)



PokerStars Zoom Hand #229234072162:  Hold'em No Limit ($0.01/$0.02) - 2021/08/21 23:56:16 CET [2021/08/21 17:56:16 ET]
Table 'Halley' 6-max Seat #1 is the button
Seat 1: jjLG99 ($1.93 in chips) 
Seat 2: Scaaalll ($8.17 in chips) 
Seat 3: mthurner97 ($2.12 in chips) 
Seat 4: AXXILLES ($4.68 in chips) 
Seat 5: punkosk8 ($7.47 in chips) 
Seat 6: H0mmer99 ($4.44 in chips) 
Scaaalll: posts small blind $0.01
mthurner97: posts big blind $0.02
*** HOLE CARDS ***
Dealt to Scaaalll [3h Qs]
jjLG99 is disconnected 
AXXILLES: folds 
punkosk8: raises $0.04 to $0.06
H0mmer99: folds 
jjLG99: folds 
mthurner97 is disconnected 
Scaaalll: folds 
mthurner97: folds 
Uncalled bet ($0.04) returned to punkosk8
punkosk8 collected $0.05 from pot
punkosk8: doesn't show hand 
*** SUMMARY ***
Total pot $0.05 | Rake $0 
Seat 1: jjLG99 (button) folded before Flop (didn't bet)
Seat 2: Scaaalll (small blind) folded before Flop
Seat 3: mthurner97 (big blind) folded before Flop
Seat 4: AXXILLES folded before Flop (didn't bet)
Seat 5: punkosk8 collected ($0.05)
Seat 6: H0mmer99 folded before Flop (didn't bet)



PokerStars Zoom Hand #229234065136:  Hold'em No Limit ($0.01/$0.02) - 2021/08/21 23:55:52 CET [2021/08/21 17:55:52 ET]
Table 'Halley' 6-max Seat #1 is the button
Seat 1: baddbeat4fun ($2 in chips) 
Seat 2: gaturamard ($3.47 in chips) 
Seat 3: Bol'tazar111 ($2.44 in chips) 
Seat 4: Scaaalll ($8.19 in chips) 
Seat 5: downwithbdp ($0.99 in chips) 
Seat 6: Alexasha78 ($3.56 in chips) 
gaturamard: posts small blind $0.01
Bol'tazar111: posts big blind $0.02
*** HOLE CARDS ***
Dealt to Scaaalll [6h Js]
Scaaalll: folds 
Alexasha78 is disconnected 
downwithbdp: folds 
Alexasha78: folds 
baddbeat4fun: raises $0.03 to $0.05
gaturamard: calls $0.04
Bol'tazar111: calls $0.03
*** FLOP *** [3c 9c 7s]
gaturamard: checks 
Bol'tazar111: checks 
baddbeat4fun: bets $0.11
gaturamard: folds 
Bol'tazar111: folds 
Uncalled bet ($0.11) returned to baddbeat4fun
baddbeat4fun collected $0.14 from pot
baddbeat4fun: doesn't show hand 
*** SUMMARY ***
Total pot $0.15 | Rake $0.01 
Board [3c 9c 7s]
Seat 1: baddbeat4fun (button) collected ($0.14)
Seat 2: gaturamard (small blind) folded on the Flop
Seat 3: Bol'tazar111 (big blind) folded on the Flop
Seat 4: Scaaalll folded before Flop (didn't bet)
Seat 5: downwithbdp folded before Flop (didn't bet)
Seat 6: Alexasha78 folded before Flop (didn't bet)



PokerStars Zoom Hand #229234074834:  Hold'em No Limit ($0.01/$0.02) - 2021/08/21 23:56:25 CET [2021/08/21 17:56:25 ET]
Table 'Halley' 6-max Seat #1 is the button
Seat 1: Scaaalll ($8.16 in chips) 
Seat 2: Jmapih ($1.89 in chips) 
Seat 3: baddbeat4fun ($3.53 in chips) 
Seat 4: davidalejag ($2.40 in chips) 
Seat 5: kahzura ($2.32 in chips) 
Seat 6: BTEK5889 ($2.47 in chips) 
Jmapih: posts small blind $0.01
baddbeat4fun: posts big blind $0.02
*** HOLE CARDS ***
Dealt to Scaaalll [Ks 3h]
davidalejag: folds 
kahzura: folds 
BTEK5889: folds 
Scaaalll: folds 
Jmapih: raises $0.02 to $0.04
baddbeat4fun: raises $0.12 to $0.16
Jmapih: folds 
Uncalled bet ($0.12) returned to baddbeat4fun
baddbeat4fun collected $0.08 from pot
baddbeat4fun: doesn't show hand 
*** SUMMARY ***
Total pot $0.08 | Rake $0 
Seat 1: Scaaalll (button) folded before Flop (didn't bet)
Seat 2: Jmapih (small blind) folded before Flop
Seat 3: baddbeat4fun (big blind) collected ($0.08)
Seat 4: davidalejag folded before Flop (didn't bet)
Seat 5: kahzura folded before Flop (didn't bet)
Seat 6: BTEK5889 folded before Flop (didn't bet)



PokerStars Zoom Hand #229234077462:  Hold'em No Limit ($0.01/$0.02) - 2021/08/21 23:56:34 CET [2021/08/21 17:56:34 ET]
Table 'Halley' 6-max Seat #1 is the button
Seat 1: willmorel ($2 in chips) 
Seat 2: S.P.S...99 ($1.06 in chips) 
Seat 3: Posaunengodi ($5.62 in chips) 
Seat 4: Scaaalll ($8.16 in chips) 
Seat 5: Hallyson_23 ($3.85 in chips) 
Seat 6: Gerar NB ($2.62 in chips) 
S.P.S...99: posts small blind $0.01
Posaunengodi: posts big blind $0.02
*** HOLE CARDS ***
Dealt to Scaaalll [9h Tc]
S.P.S...99 is disconnected 
Scaaalll: folds 
Hallyson_23: folds 
Gerar NB: folds 
willmorel: folds 
S.P.S...99: folds 
Uncalled bet ($0.01) returned to Posaunengodi
Posaunengodi collected $0.02 from pot
Posaunengodi: doesn't show hand 
*** SUMMARY ***
Total pot $0.02 | Rake $0 
Seat 1: willmorel (button) folded before Flop (didn't bet)
Seat 2: S.P.S...99 (small blind) folded before Flop
Seat 3: Posaunengodi (big blind) collected ($0.02)
Seat 4: Scaaalll folded before Flop (didn't bet)
Seat 5: Hallyson_23 folded before Flop (didn't bet)
Seat 6: Gerar NB folded before Flop (didn't bet)



PokerStars Zoom Hand #229234080074:  Hold'em No Limit ($0.01/$0.02) - 2021/08/21 23:56:43 CET [2021/08/21 17:56:43 ET]
Table 'Halley' 6-max Seat #1 is the button
Seat 1: 3rian cARc ($2.19 in chips) 
Seat 2: 888lifeIS ($2.03 in chips) 
Seat 3: GVMELLO ($1.99 in chips) 
Seat 4: rpycmbEM ($4.19 in chips) 
Seat 5: Scaaalll ($8.16 in chips) 
Seat 6: NoEff0rt2w1n ($2.57 in chips) 
888lifeIS: posts small blind $0.01
GVMELLO: posts big blind $0.02
*** HOLE CARDS ***
Dealt to Scaaalll [9c 5c]
rpycmbEM: folds 
Scaaalll: folds 
NoEff0rt2w1n: folds 
3rian cARc: raises $0.02 to $0.04
888lifeIS: folds 
GVMELLO: folds 
Uncalled bet ($0.02) returned to 3rian cARc
3rian cARc collected $0.05 from pot
3rian cARc: doesn't show hand 
*** SUMMARY ***
Total pot $0.05 | Rake $0 
Seat 1: 3rian cARc (button) collected ($0.05)
Seat 2: 888lifeIS (small blind) folded before Flop
Seat 3: GVMELLO (big blind) folded before Flop
Seat 4: rpycmbEM folded before Flop (didn't bet)
Seat 5: Scaaalll folded before Flop (didn't bet)
Seat 6: NoEff0rt2w1n folded before Flop (didn't bet)



PokerStars Zoom Hand #229234084221:  Hold'em No Limit ($0.01/$0.02) - 2021/08/21 23:56:57 CET [2021/08/21 17:56:57 ET]
Table 'Halley' 6-max Seat #1 is the button
Seat 1: lucksuckdonk ($5.41 in chips) 
Seat 2: VisjePaktJe ($4.19 in chips) 
Seat 3: pavlo8855 ($2.28 in chips) 
Seat 4: MarioDios ($4.41 in chips) 
Seat 5: Scaaalll ($8.16 in chips) 
Seat 6: Zamin Khan ($2.50 in chips) 
VisjePaktJe: posts small blind $0.01
pavlo8855: posts big blind $0.02
*** HOLE CARDS ***
Dealt to Scaaalll [9s 6d]
MarioDios: folds 
Zamin Khan is disconnected 
Scaaalll: folds 
Zamin Khan: folds 
lucksuckdonk: raises $0.04 to $0.06
VisjePaktJe: folds 
pavlo8855: folds 
Uncalled bet ($0.04) returned to lucksuckdonk
lucksuckdonk collected $0.05 from pot
lucksuckdonk: doesn't show hand 
*** SUMMARY ***
Total pot $0.05 | Rake $0 
Seat 1: lucksuckdonk (button) collected ($0.05)
Seat 2: VisjePaktJe (small blind) folded before Flop
Seat 3: pavlo8855 (big blind) folded before Flop
Seat 4: MarioDios folded before Flop (didn't bet)
Seat 5: Scaaalll folded before Flop (didn't bet)
Seat 6: Zamin Khan folded before Flop (didn't bet)



PokerStars Zoom Hand #229234082744:  Hold'em No Limit ($0.01/$0.02) - 2021/08/21 23:56:52 CET [2021/08/21 17:56:52 ET]
Table 'Halley' 6-max Seat #1 is the button
Seat 1: STE1NBERG ($5.31 in chips) 
Seat 2: pokerfan3999 ($2.48 in chips) 
Seat 3: hustlehero ($3.31 in chips) 
Seat 4: hsavastano6 ($1.74 in chips) 
Seat 5: Stasilo21 ($2.10 in chips) 
Seat 6: Scaaalll ($8.16 in chips) 
pokerfan3999: posts small blind $0.01
hustlehero: posts big blind $0.02
*** HOLE CARDS ***
Dealt to Scaaalll [3h Jc]
hsavastano6: calls $0.02
Stasilo21: folds 
Scaaalll: folds 
STE1NBERG: folds 
pokerfan3999: raises $0.08 to $0.10
hustlehero: calls $0.08
hsavastano6: calls $0.08
*** FLOP *** [4c Qs 9d]
pokerfan3999: bets $0.15
hustlehero: folds 
hsavastano6: calls $0.15
*** TURN *** [4c Qs 9d] [3c]
pokerfan3999: bets $0.29
hsavastano6: calls $0.29
*** RIVER *** [4c Qs 9d 3c] [4h]
pokerfan3999: bets $0.86
hsavastano6: folds 
Uncalled bet ($0.86) returned to pokerfan3999
pokerfan3999 collected $1.14 from pot
pokerfan3999: doesn't show hand 
hsavastano6 is disconnected 
*** SUMMARY ***
Total pot $1.18 | Rake $0.04 
Board [4c Qs 9d 3c 4h]
Seat 1: STE1NBERG (button) folded before Flop (didn't bet)
Seat 2: pokerfan3999 (small blind) collected ($1.14)
Seat 3: hustlehero (big blind) folded on the Flop
Seat 4: hsavastano6 folded on the River
Seat 5: Stasilo21 folded before Flop (didn't bet)
Seat 6: Scaaalll folded before Flop (didn't bet)



PokerStars Zoom Hand #229234087195:  Hold'em No Limit ($0.01/$0.02) - 2021/08/21 23:57:07 CET [2021/08/21 17:57:07 ET]
Table 'Halley' 6-max Seat #1 is the button
Seat 1: KissingTheSun ($3.58 in chips) 
Seat 2: Erwinpkr ($1.52 in chips) 
Seat 3: Scaaalll ($8.16 in chips) 
Seat 4: xoen ($2.10 in chips) 
Seat 5: bookerjee ($1.09 in chips) 
Seat 6: thekidisnuts ($3.25 in chips) 
Erwinpkr: posts small blind $0.01
Scaaalll: posts big blind $0.02
*** HOLE CARDS ***
Dealt to Scaaalll [5c 6h]
xoen: folds 
bookerjee: raises $0.02 to $0.04
thekidisnuts: folds 
KissingTheSun: folds 
Erwinpkr: calls $0.03
Scaaalll: folds 
*** FLOP *** [7h Tc 8d]
Erwinpkr: checks 
bookerjee: bets $0.02
Erwinpkr: folds 
Uncalled bet ($0.02) returned to bookerjee
bookerjee collected $0.10 from pot
bookerjee: doesn't show hand 
Erwinpkr is disconnected 
*** SUMMARY ***
Total pot $0.10 | Rake $0 
Board [7h Tc 8d]
Seat 1: KissingTheSun (button) folded before Flop (didn't bet)
Seat 2: Erwinpkr (small blind) folded on the Flop
Seat 3: Scaaalll (big blind) folded before Flop
Seat 4: xoen folded before Flop (didn't bet)
Seat 5: bookerjee collected ($0.10)
Seat 6: thekidisnuts folded before Flop (didn't bet)



PokerStars Zoom Hand #229234091686:  Hold'em No Limit ($0.01/$0.02) - 2021/08/21 23:57:22 CET [2021/08/21 17:57:22 ET]
Table 'Halley' 6-max Seat #1 is the button
Seat 1: egroj1700 ($2.01 in chips) 
Seat 2: sg.32rus ($1.13 in chips) 
Seat 3: ctaceo ($2.37 in chips) 
Seat 4: Scaaalll ($8.14 in chips) 
Seat 5: Ja9ks_Wi7d ($0.13 in chips) 
Seat 6: kcyxa ($3.77 in chips) 
sg.32rus: posts small blind $0.01
ctaceo: posts big blind $0.02
*** HOLE CARDS ***
Dealt to Scaaalll [5s 8s]
kcyxa is disconnected 
Scaaalll has timed out
Scaaalll: folds 
Ja9ks_Wi7d: raises $0.11 to $0.13 and is all-in
kcyxa: folds 
egroj1700: folds 
sg.32rus: calls $0.12
ctaceo: folds 
*** FLOP *** [3d Kc 5h]
*** TURN *** [3d Kc 5h] [2c]
*** RIVER *** [3d Kc 5h 2c] [5d]
*** SHOW DOWN ***
sg.32rus: shows [Jh Kh] (two pair, Kings and Fives)
Ja9ks_Wi7d: shows [4c Jc] (a pair of Fives)
sg.32rus collected $0.27 from pot
*** SUMMARY ***
Total pot $0.28 | Rake $0.01 
Board [3d Kc 5h 2c 5d]
Seat 1: egroj1700 (button) folded before Flop (didn't bet)
Seat 2: sg.32rus (small blind) showed [Jh Kh] and won ($0.27) with two pair, Kings and Fives
Seat 3: ctaceo (big blind) folded before Flop
Seat 4: Scaaalll folded before Flop (didn't bet)
Seat 5: Ja9ks_Wi7d showed [4c Jc] and lost with a pair of Fives
Seat 6: kcyxa folded before Flop (didn't bet)



PokerStars Zoom Hand #229234096171:  Hold'em No Limit ($0.01/$0.02) - 2021/08/21 23:57:37 CET [2021/08/21 17:57:37 ET]
Table 'Halley' 6-max Seat #1 is the button
Seat 1: Scaaalll ($8.14 in chips) 
Seat 2: Busya777 ($4.88 in chips) 
Seat 3: RspoofN ($2 in chips) 
Seat 4: hallowed_0 ($3.36 in chips) 
Seat 5: max-101219 ($0.70 in chips) 
Seat 6: PapiMik3 ($11.04 in chips) 
Busya777: posts small blind $0.01
RspoofN: posts big blind $0.02
*** HOLE CARDS ***
Dealt to Scaaalll [Qd 8h]
hallowed_0: folds 
max-101219: folds 
max-101219 is disconnected 
PapiMik3: folds 
Scaaalll: raises $0.02 to $0.04
Busya777: calls $0.03
RspoofN: calls $0.02
*** FLOP *** [6c 9c 3c]
Busya777: checks 
RspoofN: bets $0.06
Busya777 is disconnected 
Scaaalll: folds 
Busya777: folds 
Uncalled bet ($0.06) returned to RspoofN
RspoofN collected $0.12 from pot
RspoofN: doesn't show hand 
*** SUMMARY ***
Total pot $0.12 | Rake $0 
Board [6c 9c 3c]
Seat 1: Scaaalll (button) folded on the Flop
Seat 2: Busya777 (small blind) folded on the Flop
Seat 3: RspoofN (big blind) collected ($0.12)
Seat 4: hallowed_0 folded before Flop (didn't bet)
Seat 5: max-101219 folded before Flop (didn't bet)
Seat 6: PapiMik3 folded before Flop (didn't bet)



PokerStars Zoom Hand #229234104848:  Hold'em No Limit ($0.01/$0.02) - 2021/08/21 23:58:06 CET [2021/08/21 17:58:06 ET]
Table 'Halley' 6-max Seat #1 is the button
Seat 1: Stasilo21 ($2.13 in chips) 
Seat 2: Scaaalll ($8.10 in chips) 
Seat 3: Luben_76 ($2 in chips) 
Seat 4: Tabitaji ($2.78 in chips) 
Seat 5: Gamer577 ($4.73 in chips) 
Seat 6: El Chicha.CL ($2 in chips) 
Scaaalll: posts small blind $0.01
Luben_76: posts big blind $0.02
*** HOLE CARDS ***
Dealt to Scaaalll [9s Ad]
Tabitaji: folds 
Gamer577: folds 
El Chicha.CL: raises $0.04 to $0.06
Stasilo21: folds 
Scaaalll: folds 
Luben_76: folds 
Uncalled bet ($0.04) returned to El Chicha.CL
El Chicha.CL collected $0.05 from pot
El Chicha.CL: doesn't show hand 
*** SUMMARY ***
Total pot $0.05 | Rake $0 
Seat 1: Stasilo21 (button) folded before Flop (didn't bet)
Seat 2: Scaaalll (small blind) folded before Flop
Seat 3: Luben_76 (big blind) folded before Flop
Seat 4: Tabitaji folded before Flop (didn't bet)
Seat 5: Gamer577 folded before Flop (didn't bet)
Seat 6: El Chicha.CL collected ($0.05)



PokerStars Zoom Hand #229234111692:  Hold'em No Limit ($0.01/$0.02) - 2021/08/21 23:58:29 CET [2021/08/21 17:58:29 ET]
Table 'Halley' 6-max Seat #1 is the button
Seat 1: hallowed_0 ($2.39 in chips) 
Seat 2: zallav ($2 in chips) 
Seat 3: Scaaalll ($8.09 in chips) 
Seat 4: ohsimoron ($5.87 in chips) 
Seat 5: DaniilF43 ($1.03 in chips) 
Seat 6: Gamer577 ($3.85 in chips) 
zallav: posts small blind $0.01
Scaaalll: posts big blind $0.02
*** HOLE CARDS ***
Dealt to Scaaalll [Qs Jd]
zallav is disconnected 
ohsimoron: raises $0.04 to $0.06
DaniilF43: folds 
Gamer577: folds 
hallowed_0: folds 
zallav: folds 
Scaaalll: folds 
Uncalled bet ($0.04) returned to ohsimoron
ohsimoron collected $0.05 from pot
ohsimoron: doesn't show hand 
*** SUMMARY ***
Total pot $0.05 | Rake $0 
Seat 1: hallowed_0 (button) folded before Flop (didn't bet)
Seat 2: zallav (small blind) folded before Flop
Seat 3: Scaaalll (big blind) folded before Flop
Seat 4: ohsimoron collected ($0.05)
Seat 5: DaniilF43 folded before Flop (didn't bet)
Seat 6: Gamer577 folded before Flop (didn't bet)



PokerStars Zoom Hand #229234121920:  Hold'em No Limit ($0.01/$0.02) - 2021/08/21 23:58:55 CET [2021/08/21 17:58:55 ET]
Table 'Halley' 6-max Seat #1 is the button
Seat 1: gilberto98 ($2.18 in chips) 
Seat 2: AtZ3899 ($1.61 in chips) 
Seat 3: pipecmolodec ($2.19 in chips) 
Seat 4: Luben_76 ($2 in chips) 
Seat 5: pavlo8855 ($2.34 in chips) 
Seat 6: Scaaalll ($8.07 in chips) 
AtZ3899: posts small blind $0.01
pipecmolodec: posts big blind $0.02
*** HOLE CARDS ***
Dealt to Scaaalll [Jh 3h]
Luben_76: folds 
pavlo8855: folds 
Scaaalll: folds 
gilberto98: raises $0.04 to $0.06
AtZ3899: folds 
pipecmolodec: folds 
Uncalled bet ($0.04) returned to gilberto98
gilberto98 collected $0.05 from pot
gilberto98: doesn't show hand 
*** SUMMARY ***
Total pot $0.05 | Rake $0 
Seat 1: gilberto98 (button) collected ($0.05)
Seat 2: AtZ3899 (small blind) folded before Flop
Seat 3: pipecmolodec (big blind) folded before Flop
Seat 4: Luben_76 folded before Flop (didn't bet)
Seat 5: pavlo8855 folded before Flop (didn't bet)
Seat 6: Scaaalll folded before Flop (didn't bet)



PokerStars Zoom Hand #229234124006:  Hold'em No Limit ($0.01/$0.02) - 2021/08/21 23:59:02 CET [2021/08/21 17:59:02 ET]
Table 'Halley' 6-max Seat #1 is the button
Seat 1: Bol'tazar111 ($1.64 in chips) 
Seat 2: xmaksimus ($2.97 in chips) 
Seat 3: elmex886 ($2 in chips) 
Seat 4: Ck@tih@ ($2 in chips) 
Seat 5: Scaaalll ($8.07 in chips) 
Seat 6: Posaunengodi ($6.50 in chips) 
xmaksimus: posts small blind $0.01
elmex886: posts big blind $0.02
*** HOLE CARDS ***
Dealt to Scaaalll [9c Ad]
Ck@tih@: folds 
Scaaalll: folds 
Posaunengodi: folds 
Bol'tazar111: raises $0.02 to $0.04
xmaksimus: folds 
elmex886: raises $0.12 to $0.16
Bol'tazar111: folds 
Uncalled bet ($0.12) returned to elmex886
elmex886 collected $0.09 from pot
elmex886: doesn't show hand 
*** SUMMARY ***
Total pot $0.09 | Rake $0 
Seat 1: Bol'tazar111 (button) folded before Flop
Seat 2: xmaksimus (small blind) folded before Flop
Seat 3: elmex886 (big blind) collected ($0.09)
Seat 4: Ck@tih@ folded before Flop (didn't bet)
Seat 5: Scaaalll folded before Flop (didn't bet)
Seat 6: Posaunengodi folded before Flop (didn't bet)



PokerStars Zoom Hand #229234125807:  Hold'em No Limit ($0.01/$0.02) - 2021/08/21 23:59:08 CET [2021/08/21 17:59:08 ET]
Table 'Halley' 6-max Seat #1 is the button
Seat 1: Scaaalll ($8.07 in chips) 
Seat 2: aggie6529 ($2.11 in chips) 
Seat 3: 2hoesonmydick ($1.97 in chips) 
Seat 4: pipecmolodec ($2.01 in chips) 
Seat 5: igara tigara ($2.56 in chips) 
Seat 6: le_vlimeux ($4.36 in chips) 
aggie6529: posts small blind $0.01
2hoesonmydick: posts big blind $0.02
*** HOLE CARDS ***
Dealt to Scaaalll [Jh Kd]
pipecmolodec: raises $0.02 to $0.04
igara tigara: folds 
2hoesonmydick is disconnected 
le_vlimeux: folds 
Scaaalll: calls $0.04
aggie6529: folds 
2hoesonmydick: folds 
*** FLOP *** [Kh 2s Qh]
pipecmolodec: checks 
Scaaalll: bets $0.08
pipecmolodec: folds 
Uncalled bet ($0.08) returned to Scaaalll
Scaaalll collected $0.11 from pot
Scaaalll: doesn't show hand 
*** SUMMARY ***
Total pot $0.11 | Rake $0 
Board [Kh 2s Qh]
Seat 1: Scaaalll (button) collected ($0.11)
Seat 2: aggie6529 (small blind) folded before Flop
Seat 3: 2hoesonmydick (big blind) folded before Flop
Seat 4: pipecmolodec folded on the Flop
Seat 5: igara tigara folded before Flop (didn't bet)
Seat 6: le_vlimeux folded before Flop (didn't bet)



PokerStars Zoom Hand #229234133548:  Hold'em No Limit ($0.01/$0.02) - 2021/08/21 23:59:34 CET [2021/08/21 17:59:34 ET]
Table 'Halley' 6-max Seat #1 is the button
Seat 1: Agneobr ($1.56 in chips) 
Seat 2: lucky1529 ($0.59 in chips) 
Seat 3: Hallyson_23 ($9.10 in chips) 
Seat 4: Scaaalll ($8.14 in chips) 
Seat 5: VisjePaktJe ($2.47 in chips) 
Seat 6: REZAKOV72 ($2.25 in chips) 
lucky1529: posts small blind $0.01
Hallyson_23: posts big blind $0.02
*** HOLE CARDS ***
Dealt to Scaaalll [Ac 3d]
Scaaalll: folds 
VisjePaktJe: folds 
REZAKOV72: folds 
Agneobr: folds 
lucky1529: folds 
Uncalled bet ($0.01) returned to Hallyson_23
Hallyson_23 collected $0.02 from pot
Hallyson_23: doesn't show hand 
*** SUMMARY ***
Total pot $0.02 | Rake $0 
Seat 1: Agneobr (button) folded before Flop (didn't bet)
Seat 2: lucky1529 (small blind) folded before Flop
Seat 3: Hallyson_23 (big blind) collected ($0.02)
Seat 4: Scaaalll folded before Flop (didn't bet)
Seat 5: VisjePaktJe folded before Flop (didn't bet)
Seat 6: REZAKOV72 folded before Flop (didn't bet)



PokerStars Zoom Hand #229234136822:  Hold'em No Limit ($0.01/$0.02) - 2021/08/21 23:59:45 CET [2021/08/21 17:59:45 ET]
Table 'Halley' 6-max Seat #1 is the button
Seat 1: rodrigoasor ($2.53 in chips) 
Seat 2: Scaaalll ($8.14 in chips) 
Seat 3: ZermeloFraenkel ($2.21 in chips) 
Seat 4: Erwinpkr ($1.18 in chips) 
Seat 5: pipecmolodec ($2 in chips) 
Seat 6: vovan100157 ($3.06 in chips) 
Scaaalll: posts small blind $0.01
ZermeloFraenkel: posts big blind $0.02
*** HOLE CARDS ***
Dealt to Scaaalll [3s 5c]
Erwinpkr: raises $0.04 to $0.06
pipecmolodec: folds 
vovan100157: folds 
rodrigoasor: folds 
Scaaalll: folds 
ZermeloFraenkel: folds 
Uncalled bet ($0.04) returned to Erwinpkr
Erwinpkr collected $0.05 from pot
Erwinpkr: doesn't show hand 
*** SUMMARY ***
Total pot $0.05 | Rake $0 
Seat 1: rodrigoasor (button) folded before Flop (didn't bet)
Seat 2: Scaaalll (small blind) folded before Flop
Seat 3: ZermeloFraenkel (big blind) folded before Flop
Seat 4: Erwinpkr collected ($0.05)
Seat 5: pipecmolodec folded before Flop (didn't bet)
Seat 6: vovan100157 folded before Flop (didn't bet)



PokerStars Zoom Hand #229234142194:  Hold'em No Limit ($0.01/$0.02) - 2021/08/22 0:00:02 CET [2021/08/21 18:00:02 ET]
Table 'Halley' 6-max Seat #1 is the button
Seat 1: WolvegastL ($1 in chips) 
Seat 2: MattieBOZ ($1.63 in chips) 
Seat 3: LalaBee21 ($2 in chips) 
Seat 4: ulisessoria ($2 in chips) 
Seat 5: spirosz1000 ($2.25 in chips) 
Seat 6: Scaaalll ($8.13 in chips) 
MattieBOZ: posts small blind $0.01
LalaBee21: posts big blind $0.02
*** HOLE CARDS ***
Dealt to Scaaalll [Qc 7c]
MattieBOZ is disconnected 
ulisessoria: folds 
spirosz1000: raises $0.02 to $0.04
LalaBee21 is disconnected 
Scaaalll: folds 
WolvegastL: folds 
MattieBOZ: folds 
LalaBee21: folds 
Uncalled bet ($0.02) returned to spirosz1000
spirosz1000 collected $0.05 from pot
spirosz1000: doesn't show hand 
*** SUMMARY ***
Total pot $0.05 | Rake $0 
Seat 1: WolvegastL (button) folded before Flop (didn't bet)
Seat 2: MattieBOZ (small blind) folded before Flop
Seat 3: LalaBee21 (big blind) folded before Flop
Seat 4: ulisessoria folded before Flop (didn't bet)
Seat 5: spirosz1000 collected ($0.05)
Seat 6: Scaaalll folded before Flop (didn't bet)



PokerStars Zoom Hand #229234147565:  Hold'em No Limit ($0.01/$0.02) - 2021/08/22 0:00:19 CET [2021/08/21 18:00:19 ET]
Table 'Halley' 6-max Seat #1 is the button
Seat 1: KKARMELO ($2.10 in chips) 
Seat 2: arex194 ($2.01 in chips) 
Seat 3: Scaaalll ($8.13 in chips) 
Seat 4: le_vlimeux ($4.29 in chips) 
Seat 5: hustlehero ($2.66 in chips) 
Seat 6: Nihility77 ($3.37 in chips) 
arex194: posts small blind $0.01
Scaaalll: posts big blind $0.02
*** HOLE CARDS ***
Dealt to Scaaalll [6h As]
le_vlimeux: folds 
hustlehero: raises $0.04 to $0.06
Nihility77: folds 
KKARMELO: folds 
arex194: calls $0.05
Scaaalll: folds 
*** FLOP *** [Qh 8d Ah]
arex194: checks 
hustlehero: bets $0.08
arex194: calls $0.08
*** TURN *** [Qh 8d Ah] [4s]
arex194: checks 
hustlehero: bets $0.29
arex194: calls $0.29
*** RIVER *** [Qh 8d Ah 4s] [8h]
arex194: bets $0.85
hustlehero: calls $0.85
*** SHOW DOWN ***
arex194: shows [Js 9d] (a pair of Eights)
hustlehero: shows [Tc Ac] (two pair, Aces and Eights)
hustlehero collected $2.47 from pot
*** SUMMARY ***
Total pot $2.58 | Rake $0.11 
Board [Qh 8d Ah 4s 8h]
Seat 1: KKARMELO (button) folded before Flop (didn't bet)
Seat 2: arex194 (small blind) showed [Js 9d] and lost with a pair of Eights
Seat 3: Scaaalll (big blind) folded before Flop
Seat 4: le_vlimeux folded before Flop (didn't bet)
Seat 5: hustlehero showed [Tc Ac] and won ($2.47) with two pair, Aces and Eights
Seat 6: Nihility77 folded before Flop (didn't bet)



PokerStars Zoom Hand #229234156749:  Hold'em No Limit ($0.01/$0.02) - 2021/08/22 0:00:47 CET [2021/08/21 18:00:47 ET]
Table 'Halley' 6-max Seat #1 is the button
Seat 1: 888lifeIS ($2 in chips) 
Seat 2: tarogame ($2.50 in chips) 
Seat 3: Agneobr ($1.93 in chips) 
Seat 4: Merlin_Arg ($2.34 in chips) 
Seat 5: Scaaalll ($8.10 in chips) 
Seat 6: PapiMik3 ($6.07 in chips) 
tarogame: posts small blind $0.01
Agneobr: posts big blind $0.02
*** HOLE CARDS ***
Dealt to Scaaalll [4d 3c]
Merlin_Arg: folds 
Scaaalll: folds 
PapiMik3: folds 
888lifeIS: folds 
tarogame: folds 
Uncalled bet ($0.01) returned to Agneobr
Agneobr collected $0.02 from pot
Agneobr: doesn't show hand 
*** SUMMARY ***
Total pot $0.02 | Rake $0 
Seat 1: 888lifeIS (button) folded before Flop (didn't bet)
Seat 2: tarogame (small blind) folded before Flop
Seat 3: Agneobr (big blind) collected ($0.02)
Seat 4: Merlin_Arg folded before Flop (didn't bet)
Seat 5: Scaaalll folded before Flop (didn't bet)
Seat 6: PapiMik3 folded before Flop (didn't bet)



PokerStars Zoom Hand #229234150783:  Hold'em No Limit ($0.01/$0.02) - 2021/08/22 0:00:29 CET [2021/08/21 18:00:29 ET]
Table 'Halley' 6-max Seat #1 is the button
Seat 1: Feyqdoi ($2.10 in chips) 
Seat 2: Scaaalll ($8.11 in chips) 
Seat 3: SKV_1985 ($2.13 in chips) 
Seat 4: JTbukowski ($5.49 in chips) 
Seat 5: zergmiky ($2 in chips) 
Seat 6: CYBOPOB66 ($2.99 in chips) 
Scaaalll: posts small blind $0.01
SKV_1985: posts big blind $0.02
*** HOLE CARDS ***
Dealt to Scaaalll [7d 6h]
JTbukowski: folds 
zergmiky: folds 
CYBOPOB66: folds 
Feyqdoi: raises $0.04 to $0.06
Scaaalll: folds 
SKV_1985: raises $0.18 to $0.24
Feyqdoi: calls $0.18
*** FLOP *** [7c Jd 2h]
SKV_1985: bets $0.31
Feyqdoi: folds 
Uncalled bet ($0.31) returned to SKV_1985
SKV_1985 collected $0.47 from pot
SKV_1985: doesn't show hand 
*** SUMMARY ***
Total pot $0.49 | Rake $0.02 
Board [7c Jd 2h]
Seat 1: Feyqdoi (button) folded on the Flop
Seat 2: Scaaalll (small blind) folded before Flop
Seat 3: SKV_1985 (big blind) collected ($0.47)
Seat 4: JTbukowski folded before Flop (didn't bet)
Seat 5: zergmiky folded before Flop (didn't bet)
Seat 6: CYBOPOB66 folded before Flop (didn't bet)



PokerStars Zoom Hand #229234161541:  Hold'em No Limit ($0.01/$0.02) - 2021/08/22 0:01:01 CET [2021/08/21 18:01:01 ET]
Table 'Halley' 6-max Seat #1 is the button
Seat 1: Scaaalll ($8.10 in chips) 
Seat 2: rancing87 ($4.01 in chips) 
Seat 3: LalaBee21 ($2.07 in chips) 
Seat 4: Nihility77 ($6.77 in chips) 
Seat 5: alphabeta1d ($2.89 in chips) 
Seat 6: ussr246 ($2.97 in chips) 
rancing87: posts small blind $0.01
LalaBee21: posts big blind $0.02
*** HOLE CARDS ***
Dealt to Scaaalll [5s 5h]
Nihility77: folds 
alphabeta1d: folds 
ussr246: folds 
Scaaalll: raises $0.02 to $0.04
rancing87: calls $0.03
LalaBee21: calls $0.02
*** FLOP *** [7c 9s 6c]
rancing87: checks 
LalaBee21: checks 
Scaaalll: checks 
*** TURN *** [7c 9s 6c] [3h]
rancing87: checks 
LalaBee21: bets $0.06
Scaaalll: folds 
rancing87: folds 
Uncalled bet ($0.06) returned to LalaBee21
LalaBee21 collected $0.12 from pot
LalaBee21: doesn't show hand 
*** SUMMARY ***
Total pot $0.12 | Rake $0 
Board [7c 9s 6c 3h]
Seat 1: Scaaalll (button) folded on the Turn
Seat 2: rancing87 (small blind) folded on the Turn
Seat 3: LalaBee21 (big blind) collected ($0.12)
Seat 4: Nihility77 folded before Flop (didn't bet)
Seat 5: alphabeta1d folded before Flop (didn't bet)
Seat 6: ussr246 folded before Flop (didn't bet)



PokerStars Zoom Hand #229234175398:  Hold'em No Limit ($0.01/$0.02) - 2021/08/22 0:01:40 CET [2021/08/21 18:01:40 ET]
Table 'Halley' 6-max Seat #1 is the button
Seat 1: thekidisnuts ($2.63 in chips) 
Seat 2: Nihility77 ($6.78 in chips) 
Seat 3: FWRWest ($2.92 in chips) 
Seat 4: h3cTics ($1.13 in chips) 
Seat 5: tarogame ($4.76 in chips) 
Seat 6: Scaaalll ($8.06 in chips) 
Nihility77: posts small blind $0.01
FWRWest: posts big blind $0.02
*** HOLE CARDS ***
Dealt to Scaaalll [2h Qh]
h3cTics: calls $0.02
tarogame: folds 
Scaaalll: folds 
thekidisnuts: folds 
Nihility77: folds 
FWRWest: checks 
*** FLOP *** [As 6d 4d]
FWRWest: bets $0.04
h3cTics: calls $0.04
*** TURN *** [As 6d 4d] [2s]
FWRWest: bets $0.07
h3cTics: calls $0.07
*** RIVER *** [As 6d 4d 2s] [6h]
FWRWest: bets $0.22
h3cTics: calls $0.22
*** SHOW DOWN ***
FWRWest: shows [4c Jh] (two pair, Sixes and Fours)
h3cTics: shows [Js 4s] (two pair, Sixes and Fours)
FWRWest collected $0.35 from pot
h3cTics collected $0.34 from pot
*** SUMMARY ***
Total pot $0.71 | Rake $0.02 
Board [As 6d 4d 2s 6h]
Seat 1: thekidisnuts (button) folded before Flop (didn't bet)
Seat 2: Nihility77 (small blind) folded before Flop
Seat 3: FWRWest (big blind) showed [4c Jh] and won ($0.35) with two pair, Sixes and Fours
Seat 4: h3cTics showed [Js 4s] and won ($0.34) with two pair, Sixes and Fours
Seat 5: tarogame folded before Flop (didn't bet)
Seat 6: Scaaalll folded before Flop (didn't bet)



PokerStars Zoom Hand #229234181246:  Hold'em No Limit ($0.01/$0.02) - 2021/08/22 0:01:55 CET [2021/08/21 18:01:55 ET]
Table 'Halley' 6-max Seat #1 is the button
Seat 1: slaweksen ($2.20 in chips) 
Seat 2: Feyqdoi ($2 in chips) 
Seat 3: tarogame ($2.51 in chips) 
Seat 4: Scaaalll ($8.06 in chips) 
Seat 5: martuska88 ($2.48 in chips) 
Seat 6: BTEK5889 ($3.13 in chips) 
Feyqdoi: posts small blind $0.01
tarogame: posts big blind $0.02
*** HOLE CARDS ***
Dealt to Scaaalll [9h 9s]
Scaaalll: raises $0.04 to $0.06
martuska88: folds 
BTEK5889: folds 
slaweksen: folds 
slaweksen is disconnected 
Feyqdoi: folds 
tarogame: calls $0.04
*** FLOP *** [3s Ts 4d]
tarogame: checks 
Scaaalll: bets $0.08
tarogame: folds 
Uncalled bet ($0.08) returned to Scaaalll
Scaaalll collected $0.13 from pot
Scaaalll: doesn't show hand 
*** SUMMARY ***
Total pot $0.13 | Rake $0 
Board [3s Ts 4d]
Seat 1: slaweksen (button) folded before Flop (didn't bet)
Seat 2: Feyqdoi (small blind) folded before Flop
Seat 3: tarogame (big blind) folded on the Flop
Seat 4: Scaaalll collected ($0.13)
Seat 5: martuska88 folded before Flop (didn't bet)
Seat 6: BTEK5889 folded before Flop (didn't bet)



