PokerStars Zoom Hand #229229013726:  Hold'em No Limit ($0.01/$0.02) - 2021/08/21 20:42:58 CET [2021/08/21 14:42:58 ET]
Table 'Halley' 6-max Seat #1 is the button
Seat 1: gugatiba ($2.66 in chips) 
Seat 2: Artem00071000 ($8.23 in chips) 
Seat 3: Scaaalll ($2 in chips) 
Seat 4: Dulli007 ($3.30 in chips) 
Seat 5: Oprichnick90 ($2.17 in chips) 
Seat 6: BlueMoon2050 ($2.07 in chips) 
Artem00071000: posts small blind $0.01
Scaaalll: posts big blind $0.02
*** HOLE CARDS ***
Dealt to Scaaalll [7h 3c]
Dulli007: folds 
Oprichnick90: folds 
BlueMoon2050: folds 
gugatiba: folds 
Artem00071000: raises $0.02 to $0.04
Scaaalll: folds 
Uncalled bet ($0.02) returned to Artem00071000
Artem00071000 collected $0.04 from pot
Artem00071000: doesn't show hand 
*** SUMMARY ***
Total pot $0.04 | Rake $0 
Seat 1: gugatiba (button) folded before Flop (didn't bet)
Seat 2: Artem00071000 (small blind) collected ($0.04)
Seat 3: Scaaalll (big blind) folded before Flop
Seat 4: Dulli007 folded before Flop (didn't bet)
Seat 5: Oprichnick90 folded before Flop (didn't bet)
Seat 6: BlueMoon2050 folded before Flop (didn't bet)



PokerStars Zoom Hand #229229021793:  Hold'em No Limit ($0.01/$0.02) - 2021/08/21 20:43:17 CET [2021/08/21 14:43:17 ET]
Table 'Halley' 6-max Seat #1 is the button
Seat 1: kite1966 ($2 in chips) 
Seat 2: Scaaalll ($2 in chips) 
Seat 3: HellNative ($3.03 in chips) 
Seat 4: Superfish I ($1.41 in chips) 
Seat 5: manutp96 ($2.34 in chips) 
Seat 6: klausC3 ($2.99 in chips) 
Scaaalll: posts small blind $0.01
HellNative: posts big blind $0.02
*** HOLE CARDS ***
Dealt to Scaaalll [Kd Ah]
Superfish I: folds 
manutp96 has timed out
manutp96: folds 
klausC3: folds 
kite1966: raises $0.03 to $0.05
Scaaalll: raises $0.13 to $0.18
HellNative: folds 
kite1966: folds 
Uncalled bet ($0.13) returned to Scaaalll
Scaaalll collected $0.12 from pot
Scaaalll: doesn't show hand 
*** SUMMARY ***
Total pot $0.12 | Rake $0 
Seat 1: kite1966 (button) folded before Flop
Seat 2: Scaaalll (small blind) collected ($0.12)
Seat 3: HellNative (big blind) folded before Flop
Seat 4: Superfish I folded before Flop (didn't bet)
Seat 5: manutp96 folded before Flop (didn't bet)
Seat 6: klausC3 folded before Flop (didn't bet)



PokerStars Zoom Hand #229229040559:  Hold'em No Limit ($0.01/$0.02) - 2021/08/21 20:44:01 CET [2021/08/21 14:44:01 ET]
Table 'Halley' 6-max Seat #1 is the button
Seat 1: Scaaalll ($2.07 in chips) 
Seat 2: Hsekir ($0.95 in chips) 
Seat 3: CaptainPkr X ($3.60 in chips) 
Seat 4: Aroma Iceland ($2.52 in chips) 
Seat 5: Sharabora ($2.06 in chips) 
Seat 6: joaoottavio ($1.52 in chips) 
Hsekir: posts small blind $0.01
CaptainPkr X: posts big blind $0.02
*** HOLE CARDS ***
Dealt to Scaaalll [6h Jh]
Hsekir is disconnected 
Aroma Iceland: raises $0.03 to $0.05
Sharabora: folds 
joaoottavio: folds 
Scaaalll: folds 
Hsekir: folds 
CaptainPkr X: folds 
Uncalled bet ($0.03) returned to Aroma Iceland
Aroma Iceland collected $0.05 from pot
Aroma Iceland: doesn't show hand 
*** SUMMARY ***
Total pot $0.05 | Rake $0 
Seat 1: Scaaalll (button) folded before Flop (didn't bet)
Seat 2: Hsekir (small blind) folded before Flop
Seat 3: CaptainPkr X (big blind) folded before Flop
Seat 4: Aroma Iceland collected ($0.05)
Seat 5: Sharabora folded before Flop (didn't bet)
Seat 6: joaoottavio folded before Flop (didn't bet)



PokerStars Zoom Hand #229229043462:  Hold'em No Limit ($0.01/$0.02) - 2021/08/21 20:44:08 CET [2021/08/21 14:44:08 ET]
Table 'Halley' 6-max Seat #1 is the button
Seat 1: Zhyla95 ($2.30 in chips) 
Seat 2: fabor1303 ($2.01 in chips) 
Seat 3: KoAlRy ($2 in chips) 
Seat 4: AligatorsBlood ($2 in chips) 
Seat 5: Scaaalll ($2.07 in chips) 
Seat 6: Stormzilla ($2.05 in chips) 
fabor1303: posts small blind $0.01
KoAlRy: posts big blind $0.02
*** HOLE CARDS ***
Dealt to Scaaalll [7c 4d]
AligatorsBlood: folds 
Scaaalll: folds 
Stormzilla: folds 
Zhyla95: folds 
fabor1303: raises $0.04 to $0.06
KoAlRy: folds 
Uncalled bet ($0.04) returned to fabor1303
fabor1303 collected $0.04 from pot
fabor1303: doesn't show hand 
*** SUMMARY ***
Total pot $0.04 | Rake $0 
Seat 1: Zhyla95 (button) folded before Flop (didn't bet)
Seat 2: fabor1303 (small blind) collected ($0.04)
Seat 3: KoAlRy (big blind) folded before Flop
Seat 4: AligatorsBlood folded before Flop (didn't bet)
Seat 5: Scaaalll folded before Flop (didn't bet)
Seat 6: Stormzilla folded before Flop (didn't bet)



PokerStars Zoom Hand #229229050231:  Hold'em No Limit ($0.01/$0.02) - 2021/08/21 20:44:24 CET [2021/08/21 14:44:24 ET]
Table 'Halley' 6-max Seat #1 is the button
Seat 1: Bubobubob ($2.27 in chips) 
Seat 2: estelionat171 ($0.70 in chips) 
Seat 3: Alex_pro4747 ($1.20 in chips) 
Seat 4: Doktor Yes ($4.35 in chips) 
Seat 5: Scaaalll ($2.07 in chips) 
Seat 6: cord86 ($2.05 in chips) 
estelionat171: posts small blind $0.01
Alex_pro4747: posts big blind $0.02
*** HOLE CARDS ***
Dealt to Scaaalll [8d 2s]
Doktor Yes: folds 
Scaaalll: folds 
cord86: raises $0.04 to $0.06
Bubobubob: folds 
estelionat171: folds 
Alex_pro4747: folds 
Uncalled bet ($0.04) returned to cord86
cord86 collected $0.05 from pot
cord86: doesn't show hand 
*** SUMMARY ***
Total pot $0.05 | Rake $0 
Seat 1: Bubobubob (button) folded before Flop (didn't bet)
Seat 2: estelionat171 (small blind) folded before Flop
Seat 3: Alex_pro4747 (big blind) folded before Flop
Seat 4: Doktor Yes folded before Flop (didn't bet)
Seat 5: Scaaalll folded before Flop (didn't bet)
Seat 6: cord86 collected ($0.05)



PokerStars Zoom Hand #229229047304:  Hold'em No Limit ($0.01/$0.02) - 2021/08/21 20:44:17 CET [2021/08/21 14:44:17 ET]
Table 'Halley' 6-max Seat #1 is the button
Seat 1: HellNative ($2.30 in chips) 
Seat 2: trakiar ($7.29 in chips) 
Seat 3: Antipirate ($1.96 in chips) 
Seat 4: Scaaalll ($2.07 in chips) 
Seat 5: Hallyson_23 ($2.73 in chips) 
Seat 6: cruisinjack ($2.26 in chips) 
trakiar: posts small blind $0.01
Antipirate: posts big blind $0.02
*** HOLE CARDS ***
Dealt to Scaaalll [6s 9c]
Scaaalll: folds 
Hallyson_23: folds 
cruisinjack: folds 
HellNative: folds 
trakiar: raises $0.04 to $0.06
Antipirate: raises $0.16 to $0.22
trakiar: folds 
Uncalled bet ($0.16) returned to Antipirate
Antipirate collected $0.12 from pot
Antipirate: doesn't show hand 
trakiar is disconnected 
*** SUMMARY ***
Total pot $0.12 | Rake $0 
Seat 1: HellNative (button) folded before Flop (didn't bet)
Seat 2: trakiar (small blind) folded before Flop
Seat 3: Antipirate (big blind) collected ($0.12)
Seat 4: Scaaalll folded before Flop (didn't bet)
Seat 5: Hallyson_23 folded before Flop (didn't bet)
Seat 6: cruisinjack folded before Flop (didn't bet)



PokerStars Zoom Hand #229229056543:  Hold'em No Limit ($0.01/$0.02) - 2021/08/21 20:44:39 CET [2021/08/21 14:44:39 ET]
Table 'Halley' 6-max Seat #1 is the button
Seat 1: rAxt24 ($1.79 in chips) 
Seat 2: Scaaalll ($2.05 in chips) 
Seat 3: Kuzmich_2502 ($1.99 in chips) 
Seat 4: Hallyson_23 ($2.73 in chips) 
Seat 5: renova0813 ($9.63 in chips) 
Seat 6: ggGoldenPunk ($1.95 in chips) 
Scaaalll: posts small blind $0.01
Kuzmich_2502: posts big blind $0.02
*** HOLE CARDS ***
Dealt to Scaaalll [2s 5h]
Hallyson_23: folds 
renova0813: folds 
ggGoldenPunk: folds 
rAxt24: folds 
Scaaalll: folds 
Uncalled bet ($0.01) returned to Kuzmich_2502
Kuzmich_2502 collected $0.02 from pot
Kuzmich_2502: doesn't show hand 
*** SUMMARY ***
Total pot $0.02 | Rake $0 
Seat 1: rAxt24 (button) folded before Flop (didn't bet)
Seat 2: Scaaalll (small blind) folded before Flop
Seat 3: Kuzmich_2502 (big blind) collected ($0.02)
Seat 4: Hallyson_23 folded before Flop (didn't bet)
Seat 5: renova0813 folded before Flop (didn't bet)
Seat 6: ggGoldenPunk folded before Flop (didn't bet)



PokerStars Zoom Hand #229229058680:  Hold'em No Limit ($0.01/$0.02) - 2021/08/21 20:44:44 CET [2021/08/21 14:44:44 ET]
Table 'Halley' 6-max Seat #1 is the button
Seat 1: Kb013497 ($3.46 in chips) 
Seat 2: no way yo ($0.90 in chips) 
Seat 3: Artem00071000 ($8.28 in chips) 
Seat 4: dorro61966 ($2.74 in chips) 
Seat 5: Stormzilla ($2.13 in chips) 
Seat 6: Scaaalll ($2.04 in chips) 
no way yo: posts small blind $0.01
Artem00071000: posts big blind $0.02
*** HOLE CARDS ***
Dealt to Scaaalll [2d 6s]
dorro61966: folds 
Stormzilla: folds 
Scaaalll: folds 
Kb013497: folds 
no way yo: folds 
Uncalled bet ($0.01) returned to Artem00071000
Artem00071000 collected $0.02 from pot
Artem00071000: doesn't show hand 
*** SUMMARY ***
Total pot $0.02 | Rake $0 
Seat 1: Kb013497 (button) folded before Flop (didn't bet)
Seat 2: no way yo (small blind) folded before Flop
Seat 3: Artem00071000 (big blind) collected ($0.02)
Seat 4: dorro61966 folded before Flop (didn't bet)
Seat 5: Stormzilla folded before Flop (didn't bet)
Seat 6: Scaaalll folded before Flop (didn't bet)



PokerStars Zoom Hand #229229061160:  Hold'em No Limit ($0.01/$0.02) - 2021/08/21 20:44:50 CET [2021/08/21 14:44:50 ET]
Table 'Halley' 6-max Seat #1 is the button
Seat 1: Scaaalll ($2.04 in chips) 
Seat 2: ash1448 ($3.59 in chips) 
Seat 3: yositoas ($3.88 in chips) 
Seat 4: SPACECASH 9 ($1.26 in chips) 
Seat 5: CordiPS ($2 in chips) 
Seat 6: Irorek6643 ($1.19 in chips) 
ash1448: posts small blind $0.01
yositoas: posts big blind $0.02
*** HOLE CARDS ***
Dealt to Scaaalll [Kc Qd]
SPACECASH 9: folds 
Irorek6643 is disconnected 
CordiPS: folds 
Irorek6643: folds 
Scaaalll: raises $0.02 to $0.04
ash1448: folds 
yositoas: folds 
Uncalled bet ($0.02) returned to Scaaalll
Scaaalll collected $0.05 from pot
Scaaalll: doesn't show hand 
*** SUMMARY ***
Total pot $0.05 | Rake $0 
Seat 1: Scaaalll (button) collected ($0.05)
Seat 2: ash1448 (small blind) folded before Flop
Seat 3: yositoas (big blind) folded before Flop
Seat 4: SPACECASH 9 folded before Flop (didn't bet)
Seat 5: CordiPS folded before Flop (didn't bet)
Seat 6: Irorek6643 folded before Flop (didn't bet)



PokerStars Zoom Hand #229229054474:  Hold'em No Limit ($0.01/$0.02) - 2021/08/21 20:44:34 CET [2021/08/21 14:44:34 ET]
Table 'Halley' 6-max Seat #1 is the button
Seat 1: snowy_96 ($2 in chips) 
Seat 2: tsantanapoker ($2.95 in chips) 
Seat 3: Scaaalll ($2.07 in chips) 
Seat 4: satti1337 ($2.23 in chips) 
Seat 5: KoAlRy ($2.03 in chips) 
Seat 6: estelionat171 ($0.34 in chips) 
tsantanapoker: posts small blind $0.01
Scaaalll: posts big blind $0.02
*** HOLE CARDS ***
Dealt to Scaaalll [3s Kc]
satti1337: raises $0.03 to $0.05
KoAlRy: folds 
estelionat171: folds 
snowy_96: calls $0.05
tsantanapoker: calls $0.04
Scaaalll: folds 
*** FLOP *** [6h 4c 3c]
tsantanapoker: checks 
satti1337: checks 
snowy_96: checks 
*** TURN *** [6h 4c 3c] [Td]
tsantanapoker: checks 
satti1337: checks 
snowy_96: checks 
*** RIVER *** [6h 4c 3c Td] [Kd]
tsantanapoker: checks 
satti1337: checks 
snowy_96: checks 
*** SHOW DOWN ***
tsantanapoker: shows [2h 4h] (a pair of Fours)
satti1337: mucks hand 
snowy_96: shows [9d 9s] (a pair of Nines)
snowy_96 collected $0.16 from pot
*** SUMMARY ***
Total pot $0.17 | Rake $0.01 
Board [6h 4c 3c Td Kd]
Seat 1: snowy_96 (button) showed [9d 9s] and won ($0.16) with a pair of Nines
Seat 2: tsantanapoker (small blind) showed [2h 4h] and lost with a pair of Fours
Seat 3: Scaaalll (big blind) folded before Flop
Seat 4: satti1337 mucked [Ac Qd]
Seat 5: KoAlRy folded before Flop (didn't bet)
Seat 6: estelionat171 folded before Flop (didn't bet)



PokerStars Zoom Hand #229229037599:  Hold'em No Limit ($0.01/$0.02) - 2021/08/21 20:43:54 CET [2021/08/21 14:43:54 ET]
Table 'Halley' 6-max Seat #1 is the button
Seat 1: PJ4F ($2.18 in chips) 
Seat 2: rekopo203 ($1.94 in chips) 
Seat 3: Syd Wright ($2 in chips) 
Seat 4: iPitbull1 ($2.21 in chips) 
Seat 5: superstar1070 ($0.60 in chips) 
Seat 6: Scaaalll ($2.07 in chips) 
rekopo203: posts small blind $0.01
Syd Wright: posts big blind $0.02
*** HOLE CARDS ***
Dealt to Scaaalll [Kc 7d]
iPitbull1: folds 
superstar1070: folds 
superstar1070 is disconnected 
Scaaalll: folds 
PJ4F: raises $0.05 to $0.07
rekopo203: folds 
Syd Wright: calls $0.05
*** FLOP *** [8c Qc 2s]
Syd Wright: checks 
PJ4F: bets $0.09
Syd Wright: calls $0.09
*** TURN *** [8c Qc 2s] [Kh]
Syd Wright: checks 
PJ4F: checks 
*** RIVER *** [8c Qc 2s Kh] [7c]
Syd Wright: checks 
PJ4F: bets $0.21
Syd Wright: raises $0.42 to $0.63
PJ4F: raises $1.39 to $2.02 and is all-in
Syd Wright: calls $1.21 and is all-in
Uncalled bet ($0.18) returned to PJ4F
*** SHOW DOWN ***
PJ4F: shows [Ac 6c] (a flush, Ace high)
Syd Wright: shows [2c 2d] (three of a kind, Deuces)
PJ4F collected $3.83 from pot
*** SUMMARY ***
Total pot $4.01 | Rake $0.18 
Board [8c Qc 2s Kh 7c]
Seat 1: PJ4F (button) showed [Ac 6c] and won ($3.83) with a flush, Ace high
Seat 2: rekopo203 (small blind) folded before Flop
Seat 3: Syd Wright (big blind) showed [2c 2d] and lost with three of a kind, Deuces
Seat 4: iPitbull1 folded before Flop (didn't bet)
Seat 5: superstar1070 folded before Flop (didn't bet)
Seat 6: Scaaalll folded before Flop (didn't bet)



PokerStars Zoom Hand #229229070026:  Hold'em No Limit ($0.01/$0.02) - 2021/08/21 20:45:11 CET [2021/08/21 14:45:11 ET]
Table 'Halley' 6-max Seat #1 is the button
Seat 1: Zazill ($4.17 in chips) 
Seat 2: Scaaalll ($2.07 in chips) 
Seat 3: Quantum771 ($2.26 in chips) 
Seat 4: MIT_PKR ($3.25 in chips) 
Seat 5: Kb013497 ($3.43 in chips) 
Seat 6: Natali172737 ($3.03 in chips) 
Scaaalll: posts small blind $0.01
Quantum771: posts big blind $0.02
*** HOLE CARDS ***
Dealt to Scaaalll [7d 7c]
MIT_PKR: folds 
Kb013497: calls $0.02
Natali172737: folds 
Zazill: folds 
Scaaalll: raises $0.06 to $0.08
Quantum771: folds 
Kb013497: calls $0.06
*** FLOP *** [Qh 9s Th]
Scaaalll: checks 
Kb013497: checks 
*** TURN *** [Qh 9s Th] [4c]
Scaaalll: checks 
Kb013497: checks 
*** RIVER *** [Qh 9s Th 4c] [Jh]
Scaaalll: checks 
Kb013497: checks 
*** SHOW DOWN ***
Scaaalll: shows [7d 7c] (a pair of Sevens)
Kb013497: mucks hand 
Scaaalll collected $0.17 from pot
*** SUMMARY ***
Total pot $0.18 | Rake $0.01 
Board [Qh 9s Th 4c Jh]
Seat 1: Zazill (button) folded before Flop (didn't bet)
Seat 2: Scaaalll (small blind) showed [7d 7c] and won ($0.17) with a pair of Sevens
Seat 3: Quantum771 (big blind) folded before Flop
Seat 4: MIT_PKR folded before Flop (didn't bet)
Seat 5: Kb013497 mucked [5c 5s]
Seat 6: Natali172737 folded before Flop (didn't bet)



PokerStars Zoom Hand #229229084933:  Hold'em No Limit ($0.01/$0.02) - 2021/08/21 20:45:46 CET [2021/08/21 14:45:46 ET]
Table 'Halley' 6-max Seat #1 is the button
Seat 1: Flankeris ($8.54 in chips) 
Seat 2: kickBrain ($7.48 in chips) 
Seat 3: Scaaalll ($2.16 in chips) 
Seat 4: rekopo203 ($3.19 in chips) 
Seat 5: Kb013497 ($1.97 in chips) 
Seat 6: putya-putya ($9.80 in chips) 
kickBrain: posts small blind $0.01
Scaaalll: posts big blind $0.02
*** HOLE CARDS ***
Dealt to Scaaalll [6d Kc]
rekopo203 has timed out
rekopo203: folds 
Kb013497: folds 
putya-putya: folds 
Flankeris: folds 
kickBrain: folds 
Uncalled bet ($0.01) returned to Scaaalll
Scaaalll collected $0.02 from pot
Scaaalll: doesn't show hand 
*** SUMMARY ***
Total pot $0.02 | Rake $0 
Seat 1: Flankeris (button) folded before Flop (didn't bet)
Seat 2: kickBrain (small blind) folded before Flop
Seat 3: Scaaalll (big blind) collected ($0.02)
Seat 4: rekopo203 folded before Flop (didn't bet)
Seat 5: Kb013497 folded before Flop (didn't bet)
Seat 6: putya-putya folded before Flop (didn't bet)



PokerStars Zoom Hand #229229094264:  Hold'em No Limit ($0.01/$0.02) - 2021/08/21 20:46:08 CET [2021/08/21 14:46:08 ET]
Table 'Halley' 6-max Seat #1 is the button
Seat 1: Scaaalll ($2.17 in chips) 
Seat 2: GorillaMode369 ($1.87 in chips) 
Seat 3: MarkPojarski ($2.50 in chips) 
Seat 4: Halbschatten ($2.83 in chips) 
Seat 5: 888lifeIS ($2.37 in chips) 
Seat 6: ciucibaby ($4.33 in chips) 
GorillaMode369: posts small blind $0.01
MarkPojarski: posts big blind $0.02
*** HOLE CARDS ***
Dealt to Scaaalll [5s 9d]
Halbschatten: folds 
888lifeIS: folds 
ciucibaby: folds 
Scaaalll: folds 
GorillaMode369: raises $0.03 to $0.05
MarkPojarski: calls $0.03
*** FLOP *** [3d 3c Qc]
GorillaMode369: checks 
MarkPojarski: bets $0.05
GorillaMode369: calls $0.05
*** TURN *** [3d 3c Qc] [8c]
GorillaMode369: bets $0.10
MarkPojarski: folds 
Uncalled bet ($0.10) returned to GorillaMode369
GorillaMode369 collected $0.19 from pot
GorillaMode369: doesn't show hand 
MarkPojarski is disconnected 
*** SUMMARY ***
Total pot $0.20 | Rake $0.01 
Board [3d 3c Qc 8c]
Seat 1: Scaaalll (button) folded before Flop (didn't bet)
Seat 2: GorillaMode369 (small blind) collected ($0.19)
Seat 3: MarkPojarski (big blind) folded on the Turn
Seat 4: Halbschatten folded before Flop (didn't bet)
Seat 5: 888lifeIS folded before Flop (didn't bet)
Seat 6: ciucibaby folded before Flop (didn't bet)



PokerStars Zoom Hand #229229097245:  Hold'em No Limit ($0.01/$0.02) - 2021/08/21 20:46:15 CET [2021/08/21 14:46:15 ET]
Table 'Halley' 6-max Seat #1 is the button
Seat 1: thiagohbueno ($3.38 in chips) 
Seat 2: bigbaddaddy9 ($3.73 in chips) 
Seat 3: kardan641 ($2.81 in chips) 
Seat 4: cord86 ($2.16 in chips) 
Seat 5: cabe839 ($1.59 in chips) 
Seat 6: Scaaalll ($2.17 in chips) 
bigbaddaddy9: posts small blind $0.01
kardan641: posts big blind $0.02
*** HOLE CARDS ***
Dealt to Scaaalll [2d 9h]
cord86: folds 
cabe839: folds 
Scaaalll: folds 
thiagohbueno: raises $0.02 to $0.04
bigbaddaddy9: folds 
kardan641: folds 
Uncalled bet ($0.02) returned to thiagohbueno
thiagohbueno collected $0.05 from pot
thiagohbueno: doesn't show hand 
kardan641 is disconnected 
*** SUMMARY ***
Total pot $0.05 | Rake $0 
Seat 1: thiagohbueno (button) collected ($0.05)
Seat 2: bigbaddaddy9 (small blind) folded before Flop
Seat 3: kardan641 (big blind) folded before Flop
Seat 4: cord86 folded before Flop (didn't bet)
Seat 5: cabe839 folded before Flop (didn't bet)
Seat 6: Scaaalll folded before Flop (didn't bet)



PokerStars Zoom Hand #229229106125:  Hold'em No Limit ($0.01/$0.02) - 2021/08/21 20:46:36 CET [2021/08/21 14:46:36 ET]
Table 'Halley' 6-max Seat #1 is the button
Seat 1: beber_1613 ($2.43 in chips) 
Seat 2: Natali172737 ($2 in chips) 
Seat 3: Scaaalll ($2.16 in chips) 
Seat 4: emte1kaa ($2.25 in chips) 
Seat 5: BO/\KODAB 22 ($1.68 in chips) 
Seat 6: sokolik81 ($2.03 in chips) 
Natali172737: posts small blind $0.01
Scaaalll: posts big blind $0.02
*** HOLE CARDS ***
Dealt to Scaaalll [7d Jh]
emte1kaa: folds 
BO/\KODAB 22: raises $0.04 to $0.06
sokolik81: folds 
beber_1613: folds 
Natali172737: folds 
Scaaalll: folds 
Uncalled bet ($0.04) returned to BO/\KODAB 22
BO/\KODAB 22 collected $0.05 from pot
BO/\KODAB 22: doesn't show hand 
*** SUMMARY ***
Total pot $0.05 | Rake $0 
Seat 1: beber_1613 (button) folded before Flop (didn't bet)
Seat 2: Natali172737 (small blind) folded before Flop
Seat 3: Scaaalll (big blind) folded before Flop
Seat 4: emte1kaa folded before Flop (didn't bet)
Seat 5: BO/\KODAB 22 collected ($0.05)
Seat 6: sokolik81 folded before Flop (didn't bet)



PokerStars Zoom Hand #229229103997:  Hold'em No Limit ($0.01/$0.02) - 2021/08/21 20:46:31 CET [2021/08/21 14:46:31 ET]
Table 'Halley' 6-max Seat #1 is the button
Seat 1: arsad725 ($4.50 in chips) 
Seat 2: lyapis75 ($3.77 in chips) 
Seat 3: gasmar_29 ($2.03 in chips) 
Seat 4: zairyoku ($2.77 in chips) 
Seat 5: Scaaalll ($2.16 in chips) 
Seat 6: Hallyson_23 ($2.75 in chips) 
lyapis75: posts small blind $0.01
gasmar_29: posts big blind $0.02
*** HOLE CARDS ***
Dealt to Scaaalll [6d 3s]
zairyoku: folds 
Scaaalll: folds 
Hallyson_23: folds 
arsad725: folds 
lyapis75: raises $0.03 to $0.05
gasmar_29: folds 
Uncalled bet ($0.03) returned to lyapis75
lyapis75 collected $0.04 from pot
lyapis75: doesn't show hand 
*** SUMMARY ***
Total pot $0.04 | Rake $0 
Seat 1: arsad725 (button) folded before Flop (didn't bet)
Seat 2: lyapis75 (small blind) collected ($0.04)
Seat 3: gasmar_29 (big blind) folded before Flop
Seat 4: zairyoku folded before Flop (didn't bet)
Seat 5: Scaaalll folded before Flop (didn't bet)
Seat 6: Hallyson_23 folded before Flop (didn't bet)



PokerStars Zoom Hand #229229091712:  Hold'em No Limit ($0.01/$0.02) - 2021/08/21 20:46:02 CET [2021/08/21 14:46:02 ET]
Table 'Halley' 6-max Seat #1 is the button
Seat 1: gasmar_29 ($2.10 in chips) 
Seat 2: estelionat171 ($1.03 in chips) 
Seat 3: Clavis Noa ($1.74 in chips) 
Seat 4: martoniv ($3.15 in chips) 
Seat 5: Scaaalll ($2.17 in chips) 
Seat 6: pavlo8855 ($2.01 in chips) 
estelionat171: posts small blind $0.01
Clavis Noa: posts big blind $0.02
*** HOLE CARDS ***
Dealt to Scaaalll [8h 5h]
martoniv: raises $0.02 to $0.04
Scaaalll: folds 
pavlo8855: calls $0.04
gasmar_29: calls $0.04
estelionat171: folds 
Clavis Noa: calls $0.02
*** FLOP *** [Qs Tc 8d]
Clavis Noa: bets $0.16
martoniv: calls $0.16
pavlo8855: folds 
gasmar_29: folds 
*** TURN *** [Qs Tc 8d] [4c]
Clavis Noa: bets $0.24
martoniv: calls $0.24
*** RIVER *** [Qs Tc 8d 4c] [Ah]
Clavis Noa: bets $0.47
martoniv: raises $0.47 to $0.94
Clavis Noa: calls $0.47
*** SHOW DOWN ***
martoniv: shows [Ks Js] (a straight, Ten to Ace)
Clavis Noa: mucks hand 
martoniv collected $2.75 from pot
*** SUMMARY ***
Total pot $2.85 | Rake $0.10 
Board [Qs Tc 8d 4c Ah]
Seat 1: gasmar_29 (button) folded on the Flop
Seat 2: estelionat171 (small blind) folded before Flop
Seat 3: Clavis Noa (big blind) mucked [Td Qd]
Seat 4: martoniv showed [Ks Js] and won ($2.75) with a straight, Ten to Ace
Seat 5: Scaaalll folded before Flop (didn't bet)
Seat 6: pavlo8855 folded on the Flop



PokerStars Zoom Hand #229229111711:  Hold'em No Limit ($0.01/$0.02) - 2021/08/21 20:46:49 CET [2021/08/21 14:46:49 ET]
Table 'Halley' 6-max Seat #1 is the button
Seat 1: kowak666 ($1.07 in chips) 
Seat 2: comptonBL ($2 in chips) 
Seat 3: vps3 ($0.94 in chips) 
Seat 4: gasmar_29 ($2.01 in chips) 
Seat 5: egroj1700 ($2 in chips) 
Seat 6: Scaaalll ($2.14 in chips) 
comptonBL: posts small blind $0.01
vps3: posts big blind $0.02
*** HOLE CARDS ***
Dealt to Scaaalll [4c 8s]
gasmar_29: folds 
egroj1700: folds 
Scaaalll: folds 
kowak666: folds 
comptonBL: folds 
Uncalled bet ($0.01) returned to vps3
kowak666 is disconnected 
vps3 collected $0.02 from pot
vps3: doesn't show hand 
*** SUMMARY ***
Total pot $0.02 | Rake $0 
Seat 1: kowak666 (button) folded before Flop (didn't bet)
Seat 2: comptonBL (small blind) folded before Flop
Seat 3: vps3 (big blind) collected ($0.02)
Seat 4: gasmar_29 folded before Flop (didn't bet)
Seat 5: egroj1700 folded before Flop (didn't bet)
Seat 6: Scaaalll folded before Flop (didn't bet)



PokerStars Zoom Hand #229229098905:  Hold'em No Limit ($0.01/$0.02) - 2021/08/21 20:46:19 CET [2021/08/21 14:46:19 ET]
Table 'Halley' 6-max Seat #1 is the button
Seat 1: Makrus686 ($1.80 in chips) 
Seat 2: Scaaalll ($2.17 in chips) 
Seat 3: MicroLocoNL ($2 in chips) 
Seat 4: gasmar_29 ($2.05 in chips) 
Seat 5: so0love ($2.61 in chips) 
Seat 6: iberieli ($2.28 in chips) 
Scaaalll: posts small blind $0.01
MicroLocoNL: posts big blind $0.02
*** HOLE CARDS ***
Dealt to Scaaalll [Qh 4s]
gasmar_29: folds 
so0love: folds 
iberieli: folds 
Makrus686: calls $0.02
Scaaalll: folds 
MicroLocoNL: checks 
*** FLOP *** [Ac 4h 6h]
MicroLocoNL: checks 
Makrus686: checks 
*** TURN *** [Ac 4h 6h] [9c]
MicroLocoNL: checks 
Makrus686: checks 
*** RIVER *** [Ac 4h 6h 9c] [2h]
MicroLocoNL: checks 
Makrus686: checks 
*** SHOW DOWN ***
MicroLocoNL: shows [Qs Jh] (high card Ace)
Makrus686: mucks hand 
MicroLocoNL collected $0.05 from pot
*** SUMMARY ***
Total pot $0.05 | Rake $0 
Board [Ac 4h 6h 9c 2h]
Seat 1: Makrus686 (button) mucked [8h Jc]
Seat 2: Scaaalll (small blind) folded before Flop
Seat 3: MicroLocoNL (big blind) showed [Qs Jh] and won ($0.05) with high card Ace
Seat 4: gasmar_29 folded before Flop (didn't bet)
Seat 5: so0love folded before Flop (didn't bet)
Seat 6: iberieli folded before Flop (didn't bet)



PokerStars Zoom Hand #229229113409:  Hold'em No Limit ($0.01/$0.02) - 2021/08/21 20:46:53 CET [2021/08/21 14:46:53 ET]
Table 'Halley' 6-max Seat #1 is the button
Seat 1: Scaaalll ($2.14 in chips) 
Seat 2: BlueMoon2050 ($0.66 in chips) 
Seat 3: pphit ($2 in chips) 
Seat 4: PlayPokerHappy1 ($3.07 in chips) 
Seat 5: Sul07 ($1.26 in chips) 
Seat 6: Irorek6643 ($0.89 in chips) 
BlueMoon2050: posts small blind $0.01
pphit: posts big blind $0.02
*** HOLE CARDS ***
Dealt to Scaaalll [5h Ad]
PlayPokerHappy1: folds 
Irorek6643 is disconnected 
Sul07: folds 
Irorek6643: folds 
Scaaalll: raises $0.02 to $0.04
BlueMoon2050: calls $0.03
pphit: folds 
*** FLOP *** [Qd 5s Ah]
BlueMoon2050: checks 
Scaaalll: bets $0.07
BlueMoon2050: calls $0.07
*** TURN *** [Qd 5s Ah] [Kh]
BlueMoon2050: checks 
Scaaalll: bets $0.16
BlueMoon2050: calls $0.16
*** RIVER *** [Qd 5s Ah Kh] [Ks]
BlueMoon2050: checks 
Scaaalll: checks 
*** SHOW DOWN ***
BlueMoon2050: shows [8d 8h] (two pair, Kings and Eights)
Scaaalll: shows [5h Ad] (two pair, Aces and Kings)
Scaaalll collected $0.54 from pot
*** SUMMARY ***
Total pot $0.56 | Rake $0.02 
Board [Qd 5s Ah Kh Ks]
Seat 1: Scaaalll (button) showed [5h Ad] and won ($0.54) with two pair, Aces and Kings
Seat 2: BlueMoon2050 (small blind) showed [8d 8h] and lost with two pair, Kings and Eights
Seat 3: pphit (big blind) folded before Flop
Seat 4: PlayPokerHappy1 folded before Flop (didn't bet)
Seat 5: Sul07 folded before Flop (didn't bet)
Seat 6: Irorek6643 folded before Flop (didn't bet)



PokerStars Zoom Hand #229229130772:  Hold'em No Limit ($0.01/$0.02) - 2021/08/21 20:47:34 CET [2021/08/21 14:47:34 ET]
Table 'Halley' 6-max Seat #1 is the button
Seat 1: 01527368 ($3.42 in chips) 
Seat 2: py100ta ($6.10 in chips) 
Seat 3: arsad725 ($4.49 in chips) 
Seat 4: Scaaalll ($2.40 in chips) 
Seat 5: Finderra ($2.09 in chips) 
Seat 6: kahzura ($2.04 in chips) 
py100ta: posts small blind $0.01
arsad725: posts big blind $0.02
*** HOLE CARDS ***
Dealt to Scaaalll [2s 5s]
Scaaalll: folds 
Finderra: folds 
kahzura: raises $0.03 to $0.05
01527368: folds 
py100ta: folds 
arsad725: folds 
Uncalled bet ($0.03) returned to kahzura
kahzura collected $0.05 from pot
kahzura: doesn't show hand 
*** SUMMARY ***
Total pot $0.05 | Rake $0 
Seat 1: 01527368 (button) folded before Flop (didn't bet)
Seat 2: py100ta (small blind) folded before Flop
Seat 3: arsad725 (big blind) folded before Flop
Seat 4: Scaaalll folded before Flop (didn't bet)
Seat 5: Finderra folded before Flop (didn't bet)
Seat 6: kahzura collected ($0.05)



PokerStars Zoom Hand #229229129044:  Hold'em No Limit ($0.01/$0.02) - 2021/08/21 20:47:30 CET [2021/08/21 14:47:30 ET]
Table 'Halley' 6-max Seat #1 is the button
Seat 1: rassew ($2.05 in chips) 
Seat 2: markzoom6894 ($1.13 in chips) 
Seat 3: andreydgk ($3.09 in chips) 
Seat 4: Scaaalll ($2.40 in chips) 
Seat 5: Slirey ($1.61 in chips) 
Seat 6: comptonBL ($2 in chips) 
markzoom6894: posts small blind $0.01
andreydgk: posts big blind $0.02
*** HOLE CARDS ***
Dealt to Scaaalll [2c Kh]
Scaaalll: folds 
Slirey: calls $0.02
comptonBL: folds 
rassew: folds 
markzoom6894: folds 
andreydgk: checks 
*** FLOP *** [As 2h 2s]
andreydgk: checks 
Slirey: bets $0.02
andreydgk: folds 
Uncalled bet ($0.02) returned to Slirey
Slirey collected $0.05 from pot
Slirey: doesn't show hand 
*** SUMMARY ***
Total pot $0.05 | Rake $0 
Board [As 2h 2s]
Seat 1: rassew (button) folded before Flop (didn't bet)
Seat 2: markzoom6894 (small blind) folded before Flop
Seat 3: andreydgk (big blind) folded on the Flop
Seat 4: Scaaalll folded before Flop (didn't bet)
Seat 5: Slirey collected ($0.05)
Seat 6: comptonBL folded before Flop (didn't bet)



PokerStars Zoom Hand #229229134029:  Hold'em No Limit ($0.01/$0.02) - 2021/08/21 20:47:42 CET [2021/08/21 14:47:42 ET]
Table 'Halley' 6-max Seat #1 is the button
Seat 1: Draat505 ($2.25 in chips) 
Seat 2: yositoas ($2.03 in chips) 
Seat 3: Scaaalll ($2.40 in chips) 
Seat 4: Xlavariable ($2 in chips) 
Seat 5: 888lifeIS ($2.28 in chips) 
Seat 6: Koldun 2636 ($2 in chips) 
yositoas: posts small blind $0.01
Scaaalll: posts big blind $0.02
*** HOLE CARDS ***
Dealt to Scaaalll [As 6s]
Xlavariable: folds 
888lifeIS: folds 
Koldun 2636: folds 
Draat505: folds 
yositoas: folds 
Uncalled bet ($0.01) returned to Scaaalll
Scaaalll collected $0.02 from pot
Scaaalll: doesn't show hand 
*** SUMMARY ***
Total pot $0.02 | Rake $0 
Seat 1: Draat505 (button) folded before Flop (didn't bet)
Seat 2: yositoas (small blind) folded before Flop
Seat 3: Scaaalll (big blind) collected ($0.02)
Seat 4: Xlavariable folded before Flop (didn't bet)
Seat 5: 888lifeIS folded before Flop (didn't bet)
Seat 6: Koldun 2636 folded before Flop (didn't bet)



PokerStars Zoom Hand #229229142383:  Hold'em No Limit ($0.01/$0.02) - 2021/08/21 20:47:58 CET [2021/08/21 14:47:58 ET]
Table 'Halley' 6-max Seat #1 is the button
Seat 1: kamburova ($2.11 in chips) 
Seat 2: takeatrip180 ($1.44 in chips) 
Seat 3: iberieli ($2.25 in chips) 
Seat 4: Scaaalll ($2.41 in chips) 
Seat 5: emris13213 ($1.10 in chips) 
Seat 6: gugatiba ($1.04 in chips) 
takeatrip180: posts small blind $0.01
iberieli: posts big blind $0.02
*** HOLE CARDS ***
Dealt to Scaaalll [Kc Ks]
emris13213 is disconnected 
Scaaalll: raises $0.04 to $0.06
emris13213: folds 
gugatiba: folds 
kamburova: folds 
takeatrip180: folds 
iberieli: folds 
Uncalled bet ($0.04) returned to Scaaalll
kamburova is disconnected 
Scaaalll collected $0.05 from pot
Scaaalll: doesn't show hand 
*** SUMMARY ***
Total pot $0.05 | Rake $0 
Seat 1: kamburova (button) folded before Flop (didn't bet)
Seat 2: takeatrip180 (small blind) folded before Flop
Seat 3: iberieli (big blind) folded before Flop
Seat 4: Scaaalll collected ($0.05)
Seat 5: emris13213 folded before Flop (didn't bet)
Seat 6: gugatiba folded before Flop (didn't bet)



PokerStars Zoom Hand #229229132406:  Hold'em No Limit ($0.01/$0.02) - 2021/08/21 20:47:38 CET [2021/08/21 14:47:38 ET]
Table 'Halley' 6-max Seat #1 is the button
Seat 1: pphit ($2.05 in chips) 
Seat 2: beber_1613 ($2.30 in chips) 
Seat 3: 7LEV77 ($2 in chips) 
Seat 4: Scaaalll ($2.40 in chips) 
Seat 5: RonilsonCosta ($2 in chips) 
Seat 6: gasmar_29 ($2.08 in chips) 
beber_1613: posts small blind $0.01
7LEV77: posts big blind $0.02
*** HOLE CARDS ***
Dealt to Scaaalll [9s 7s]
Scaaalll: folds 
RonilsonCosta: folds 
gasmar_29: raises $0.04 to $0.06
pphit: folds 
beber_1613: calls $0.05
7LEV77: raises $0.18 to $0.24
gasmar_29: calls $0.18
beber_1613: folds 
*** FLOP *** [Ad Qc 7c]
7LEV77: bets $0.31
gasmar_29: folds 
Uncalled bet ($0.31) returned to 7LEV77
7LEV77 collected $0.52 from pot
7LEV77: doesn't show hand 
*** SUMMARY ***
Total pot $0.54 | Rake $0.02 
Board [Ad Qc 7c]
Seat 1: pphit (button) folded before Flop (didn't bet)
Seat 2: beber_1613 (small blind) folded before Flop
Seat 3: 7LEV77 (big blind) collected ($0.52)
Seat 4: Scaaalll folded before Flop (didn't bet)
Seat 5: RonilsonCosta folded before Flop (didn't bet)
Seat 6: gasmar_29 folded on the Flop



PokerStars Zoom Hand #229229147857:  Hold'em No Limit ($0.01/$0.02) - 2021/08/21 20:48:10 CET [2021/08/21 14:48:10 ET]
Table 'Halley' 6-max Seat #1 is the button
Seat 1: elmex886 ($2.16 in chips) 
Seat 2: Scaaalll ($2.44 in chips) 
Seat 3: Denisov V. ($1.93 in chips) 
Seat 4: kite1966 ($2 in chips) 
Seat 5: Natali172737 ($4.72 in chips) 
Seat 6: Runway26 ($2 in chips) 
Scaaalll: posts small blind $0.01
Denisov V.: posts big blind $0.02
*** HOLE CARDS ***
Dealt to Scaaalll [7h 5d]
kite1966: folds 
Natali172737: folds 
Runway26: folds 
elmex886: folds 
Scaaalll: folds 
Uncalled bet ($0.01) returned to Denisov V.
Denisov V. collected $0.02 from pot
Denisov V.: doesn't show hand 
*** SUMMARY ***
Total pot $0.02 | Rake $0 
Seat 1: elmex886 (button) folded before Flop (didn't bet)
Seat 2: Scaaalll (small blind) folded before Flop
Seat 3: Denisov V. (big blind) collected ($0.02)
Seat 4: kite1966 folded before Flop (didn't bet)
Seat 5: Natali172737 folded before Flop (didn't bet)
Seat 6: Runway26 folded before Flop (didn't bet)



PokerStars Zoom Hand #229229126462:  Hold'em No Limit ($0.01/$0.02) - 2021/08/21 20:47:24 CET [2021/08/21 14:47:24 ET]
Table 'Halley' 6-max Seat #1 is the button
Seat 1: MicroLocoNL ($2 in chips) 
Seat 2: Scaaalll ($2.41 in chips) 
Seat 3: Syd Wright ($3.14 in chips) 
Seat 4: Dmitri Anat ($1.81 in chips) 
Seat 5: BlueMoon2050 ($0.39 in chips) 
Seat 6: Allekccc ($2.02 in chips) 
Scaaalll: posts small blind $0.01
Syd Wright: posts big blind $0.02
*** HOLE CARDS ***
Dealt to Scaaalll [Ts 7d]
Dmitri Anat: folds 
BlueMoon2050: folds 
Allekccc: raises $0.02 to $0.04
MicroLocoNL: folds 
Scaaalll: folds 
Syd Wright: calls $0.02
*** FLOP *** [7h Kh Qc]
Syd Wright: checks 
Allekccc: checks 
*** TURN *** [7h Kh Qc] [Ah]
Syd Wright: checks 
Allekccc: checks 
*** RIVER *** [7h Kh Qc Ah] [5s]
Syd Wright: checks 
Allekccc: checks 
*** SHOW DOWN ***
Syd Wright: shows [8c 6c] (high card Ace)
Allekccc: shows [6s 6h] (a pair of Sixes)
Allekccc collected $0.09 from pot
*** SUMMARY ***
Total pot $0.09 | Rake $0 
Board [7h Kh Qc Ah 5s]
Seat 1: MicroLocoNL (button) folded before Flop (didn't bet)
Seat 2: Scaaalll (small blind) folded before Flop
Seat 3: Syd Wright (big blind) showed [8c 6c] and lost with high card Ace
Seat 4: Dmitri Anat folded before Flop (didn't bet)
Seat 5: BlueMoon2050 folded before Flop (didn't bet)
Seat 6: Allekccc showed [6s 6h] and won ($0.09) with a pair of Sixes



PokerStars Zoom Hand #229229146183:  Hold'em No Limit ($0.01/$0.02) - 2021/08/21 20:48:06 CET [2021/08/21 14:48:06 ET]
Table 'Halley' 6-max Seat #1 is the button
Seat 1: Scaaalll ($2.44 in chips) 
Seat 2: CaptainPkr X ($3.36 in chips) 
Seat 3: bigthereal ($2.49 in chips) 
Seat 4: yositoas ($4.11 in chips) 
Seat 5: Koeninho86 ($2.17 in chips) 
Seat 6: Flankeris ($2.67 in chips) 
CaptainPkr X: posts small blind $0.01
bigthereal: posts big blind $0.02
*** HOLE CARDS ***
Dealt to Scaaalll [5c 3d]
yositoas: folds 
Koeninho86: raises $0.04 to $0.06
Flankeris: folds 
Scaaalll: folds 
CaptainPkr X: folds 
bigthereal: folds 
Uncalled bet ($0.04) returned to Koeninho86
Koeninho86 collected $0.05 from pot
Koeninho86: doesn't show hand 
*** SUMMARY ***
Total pot $0.05 | Rake $0 
Seat 1: Scaaalll (button) folded before Flop (didn't bet)
Seat 2: CaptainPkr X (small blind) folded before Flop
Seat 3: bigthereal (big blind) folded before Flop
Seat 4: yositoas folded before Flop (didn't bet)
Seat 5: Koeninho86 collected ($0.05)
Seat 6: Flankeris folded before Flop (didn't bet)



PokerStars Zoom Hand #229229151177:  Hold'em No Limit ($0.01/$0.02) - 2021/08/21 20:48:18 CET [2021/08/21 14:48:18 ET]
Table 'Halley' 6-max Seat #1 is the button
Seat 1: cord86 ($2.31 in chips) 
Seat 2: Ketsudan ($2 in chips) 
Seat 3: Scaaalll ($2.43 in chips) 
Seat 4: zizu1014 ($2 in chips) 
Seat 5: iPitbull1 ($2.49 in chips) 
Seat 6: CaptainPkr X ($3.35 in chips) 
Ketsudan: posts small blind $0.01
Scaaalll: posts big blind $0.02
*** HOLE CARDS ***
Dealt to Scaaalll [6c 8c]
zizu1014: folds 
iPitbull1: folds 
CaptainPkr X: folds 
cord86: folds 
Ketsudan: folds 
Uncalled bet ($0.01) returned to Scaaalll
Scaaalll collected $0.02 from pot
Scaaalll: doesn't show hand 
*** SUMMARY ***
Total pot $0.02 | Rake $0 
Seat 1: cord86 (button) folded before Flop (didn't bet)
Seat 2: Ketsudan (small blind) folded before Flop
Seat 3: Scaaalll (big blind) collected ($0.02)
Seat 4: zizu1014 folded before Flop (didn't bet)
Seat 5: iPitbull1 folded before Flop (didn't bet)
Seat 6: CaptainPkr X folded before Flop (didn't bet)



PokerStars Zoom Hand #229229155363:  Hold'em No Limit ($0.01/$0.02) - 2021/08/21 20:48:28 CET [2021/08/21 14:48:28 ET]
Table 'Halley' 6-max Seat #1 is the button
Seat 1: Addon289174 ($1.75 in chips) 
Seat 2: cabe839 ($1.64 in chips) 
Seat 3: gresso0756 ($2.08 in chips) 
Seat 4: ash1448 ($3.62 in chips) 
Seat 5: Scaaalll ($2.44 in chips) 
Seat 6: franquillooo ($2.18 in chips) 
cabe839: posts small blind $0.01
gresso0756: posts big blind $0.02
*** HOLE CARDS ***
Dealt to Scaaalll [6d 3d]
ash1448: raises $0.02 to $0.04
Scaaalll: folds 
franquillooo: folds 
Addon289174: folds 
cabe839: folds 
gresso0756: folds 
Uncalled bet ($0.02) returned to ash1448
ash1448 collected $0.05 from pot
ash1448: doesn't show hand 
*** SUMMARY ***
Total pot $0.05 | Rake $0 
Seat 1: Addon289174 (button) folded before Flop (didn't bet)
Seat 2: cabe839 (small blind) folded before Flop
Seat 3: gresso0756 (big blind) folded before Flop
Seat 4: ash1448 collected ($0.05)
Seat 5: Scaaalll folded before Flop (didn't bet)
Seat 6: franquillooo folded before Flop (didn't bet)



PokerStars Zoom Hand #229229149534:  Hold'em No Limit ($0.01/$0.02) - 2021/08/21 20:48:14 CET [2021/08/21 14:48:14 ET]
Table 'Halley' 6-max Seat #1 is the button
Seat 1: so0love ($2.99 in chips) 
Seat 2: kamburova ($2.11 in chips) 
Seat 3: Kergie ($6.16 in chips) 
Seat 4: yositoas ($2.51 in chips) 
Seat 5: PlayPokerHappy1 ($3 in chips) 
Seat 6: Scaaalll ($2.43 in chips) 
kamburova: posts small blind $0.01
Kergie: posts big blind $0.02
*** HOLE CARDS ***
Dealt to Scaaalll [7c Ah]
yositoas: folds 
PlayPokerHappy1: folds 
Scaaalll: folds 
kamburova is disconnected 
so0love: raises $0.02 to $0.04
kamburova: folds 
Kergie: calls $0.02
*** FLOP *** [4s Qs Kh]
Kergie: checks 
so0love: bets $0.04
Kergie: raises $0.09 to $0.13
so0love: raises $0.35 to $0.48
Kergie: calls $0.35
*** TURN *** [4s Qs Kh] [9d]
Kergie: checks 
so0love: bets $1.01
Kergie: folds 
Uncalled bet ($1.01) returned to so0love
so0love collected $1.01 from pot
so0love: doesn't show hand 
*** SUMMARY ***
Total pot $1.05 | Rake $0.04 
Board [4s Qs Kh 9d]
Seat 1: so0love (button) collected ($1.01)
Seat 2: kamburova (small blind) folded before Flop
Seat 3: Kergie (big blind) folded on the Turn
Seat 4: yositoas folded before Flop (didn't bet)
Seat 5: PlayPokerHappy1 folded before Flop (didn't bet)
Seat 6: Scaaalll folded before Flop (didn't bet)



PokerStars Zoom Hand #229229159189:  Hold'em No Limit ($0.01/$0.02) - 2021/08/21 20:48:37 CET [2021/08/21 14:48:37 ET]
Table 'Halley' 6-max Seat #1 is the button
Seat 1: tronghai1994 ($2.47 in chips) 
Seat 2: FishOnPlate ($2.08 in chips) 
Seat 3: egroj1700 ($2 in chips) 
Seat 4: CaptainPkr X ($2.61 in chips) 
Seat 5: vovo4kapooh ($2.01 in chips) 
Seat 6: Scaaalll ($2.44 in chips) 
FishOnPlate: posts small blind $0.01
egroj1700: posts big blind $0.02
*** HOLE CARDS ***
Dealt to Scaaalll [Jh 5s]
CaptainPkr X: folds 
vovo4kapooh: folds 
Scaaalll: folds 
tronghai1994: folds 
FishOnPlate: raises $0.04 to $0.06
egroj1700: raises $0.12 to $0.18
FishOnPlate: folds 
Uncalled bet ($0.12) returned to egroj1700
egroj1700 collected $0.12 from pot
egroj1700: doesn't show hand 
*** SUMMARY ***
Total pot $0.12 | Rake $0 
Seat 1: tronghai1994 (button) folded before Flop (didn't bet)
Seat 2: FishOnPlate (small blind) folded before Flop
Seat 3: egroj1700 (big blind) collected ($0.12)
Seat 4: CaptainPkr X folded before Flop (didn't bet)
Seat 5: vovo4kapooh folded before Flop (didn't bet)
Seat 6: Scaaalll folded before Flop (didn't bet)



PokerStars Zoom Hand #229229162950:  Hold'em No Limit ($0.01/$0.02) - 2021/08/21 20:48:46 CET [2021/08/21 14:48:46 ET]
Table 'Halley' 6-max Seat #1 is the button
Seat 1: Scaaalll ($2.44 in chips) 
Seat 2: Koeninho86 ($2.23 in chips) 
Seat 3: rasmas80 ($2.48 in chips) 
Seat 4: Finderra ($2.05 in chips) 
Seat 5: Natali172737 ($4.72 in chips) 
Seat 6: rassew ($2.12 in chips) 
Koeninho86: posts small blind $0.01
rasmas80: posts big blind $0.02
*** HOLE CARDS ***
Dealt to Scaaalll [Qh Ah]
Finderra: folds 
Natali172737: folds 
rassew: folds 
Scaaalll: raises $0.03 to $0.05
Koeninho86: calls $0.04
rasmas80: calls $0.03
*** FLOP *** [8c 5h 8d]
Koeninho86: checks 
rasmas80: checks 
Scaaalll: bets $0.08
Koeninho86: calls $0.08
rasmas80: folds 
*** TURN *** [8c 5h 8d] [9s]
Koeninho86: checks 
Scaaalll: checks 
*** RIVER *** [8c 5h 8d 9s] [2h]
Koeninho86: checks 
Scaaalll: checks 
*** SHOW DOWN ***
Koeninho86: shows [7d 9d] (two pair, Nines and Eights)
Scaaalll: mucks hand 
Koeninho86 collected $0.30 from pot
*** SUMMARY ***
Total pot $0.31 | Rake $0.01 
Board [8c 5h 8d 9s 2h]
Seat 1: Scaaalll (button) mucked [Qh Ah]
Seat 2: Koeninho86 (small blind) showed [7d 9d] and won ($0.30) with two pair, Nines and Eights
Seat 3: rasmas80 (big blind) folded on the Flop
Seat 4: Finderra folded before Flop (didn't bet)
Seat 5: Natali172737 folded before Flop (didn't bet)
Seat 6: rassew folded before Flop (didn't bet)



PokerStars Zoom Hand #229229194539:  Hold'em No Limit ($0.01/$0.02) - 2021/08/21 20:49:53 CET [2021/08/21 14:49:53 ET]
Table 'Halley' 6-max Seat #1 is the button
Seat 1: Pechorin.G ($1.98 in chips) 
Seat 2: RodRuenRus ($2.05 in chips) 
Seat 3: fishh_play ($2 in chips) 
Seat 4: Goose Of Poker ($3.37 in chips) 
Seat 5: Scaaalll ($2.31 in chips) 
Seat 6: cord86 ($2.23 in chips) 
RodRuenRus: posts small blind $0.01
fishh_play: posts big blind $0.02
*** HOLE CARDS ***
Dealt to Scaaalll [Kd 2s]
Goose Of Poker: folds 
Scaaalll: folds 
cord86: folds 
Pechorin.G has timed out while disconnected
Pechorin.G: folds 
RodRuenRus: folds 
Uncalled bet ($0.01) returned to fishh_play
fishh_play collected $0.02 from pot
fishh_play: doesn't show hand 
*** SUMMARY ***
Total pot $0.02 | Rake $0 
Seat 1: Pechorin.G (button) folded before Flop (didn't bet)
Seat 2: RodRuenRus (small blind) folded before Flop
Seat 3: fishh_play (big blind) collected ($0.02)
Seat 4: Goose Of Poker folded before Flop (didn't bet)
Seat 5: Scaaalll folded before Flop (didn't bet)
Seat 6: cord86 folded before Flop (didn't bet)



PokerStars Zoom Hand #229229197820:  Hold'em No Limit ($0.01/$0.02) - 2021/08/21 20:50:01 CET [2021/08/21 14:50:01 ET]
Table 'Halley' 6-max Seat #1 is the button
Seat 1: Sul07 ($1.20 in chips) 
Seat 2: Scaaalll ($2.31 in chips) 
Seat 3: pavlo8855 ($2.03 in chips) 
Seat 4: bAttery01 ($2.02 in chips) 
Seat 5: Fastidium ($1.80 in chips) 
Seat 6: comptonBL ($2.22 in chips) 
Scaaalll: posts small blind $0.01
pavlo8855: posts big blind $0.02
*** HOLE CARDS ***
Dealt to Scaaalll [Qh 8s]
bAttery01: folds 
Fastidium: folds 
comptonBL: raises $0.04 to $0.06
Sul07: folds 
Scaaalll: folds 
pavlo8855: folds 
Uncalled bet ($0.04) returned to comptonBL
comptonBL collected $0.05 from pot
comptonBL: doesn't show hand 
*** SUMMARY ***
Total pot $0.05 | Rake $0 
Seat 1: Sul07 (button) folded before Flop (didn't bet)
Seat 2: Scaaalll (small blind) folded before Flop
Seat 3: pavlo8855 (big blind) folded before Flop
Seat 4: bAttery01 folded before Flop (didn't bet)
Seat 5: Fastidium folded before Flop (didn't bet)
Seat 6: comptonBL collected ($0.05)



PokerStars Zoom Hand #229229205474:  Hold'em No Limit ($0.01/$0.02) - 2021/08/21 20:50:19 CET [2021/08/21 14:50:19 ET]
Table 'Halley' 6-max Seat #1 is the button
Seat 1: HellNative ($2.59 in chips) 
Seat 2: Kb013497 ($4.36 in chips) 
Seat 3: Scaaalll ($2.30 in chips) 
Seat 4: MIT_PKR ($3.23 in chips) 
Seat 5: medbxl1971 ($1.86 in chips) 
Seat 6: Quantum771 ($2 in chips) 
Kb013497: posts small blind $0.01
Scaaalll: posts big blind $0.02
*** HOLE CARDS ***
Dealt to Scaaalll [4d 9h]
medbxl1971 is disconnected 
MIT_PKR: raises $0.03 to $0.05
medbxl1971: folds 
Quantum771: folds 
HellNative: folds 
Kb013497: folds 
Scaaalll: folds 
Uncalled bet ($0.03) returned to MIT_PKR
MIT_PKR collected $0.05 from pot
MIT_PKR: doesn't show hand 
*** SUMMARY ***
Total pot $0.05 | Rake $0 
Seat 1: HellNative (button) folded before Flop (didn't bet)
Seat 2: Kb013497 (small blind) folded before Flop
Seat 3: Scaaalll (big blind) folded before Flop
Seat 4: MIT_PKR collected ($0.05)
Seat 5: medbxl1971 folded before Flop (didn't bet)
Seat 6: Quantum771 folded before Flop (didn't bet)



PokerStars Zoom Hand #229229209691:  Hold'em No Limit ($0.01/$0.02) - 2021/08/21 20:50:29 CET [2021/08/21 14:50:29 ET]
Table 'Halley' 6-max Seat #1 is the button
Seat 1: CaptainPkr X ($3.17 in chips) 
Seat 2: rpycmbEM ($4.23 in chips) 
Seat 3: rekopo203 ($4.10 in chips) 
Seat 4: Koldun 2636 ($2.05 in chips) 
Seat 5: pavlo8855 ($2.34 in chips) 
Seat 6: Scaaalll ($2.28 in chips) 
rpycmbEM: posts small blind $0.01
rekopo203: posts big blind $0.02
*** HOLE CARDS ***
Dealt to Scaaalll [4c 5h]
Koldun 2636: folds 
pavlo8855: folds 
Scaaalll: folds 
CaptainPkr X: folds 
rpycmbEM: folds 
Uncalled bet ($0.01) returned to rekopo203
rekopo203 collected $0.02 from pot
rekopo203: doesn't show hand 
*** SUMMARY ***
Total pot $0.02 | Rake $0 
Seat 1: CaptainPkr X (button) folded before Flop (didn't bet)
Seat 2: rpycmbEM (small blind) folded before Flop
Seat 3: rekopo203 (big blind) collected ($0.02)
Seat 4: Koldun 2636 folded before Flop (didn't bet)
Seat 5: pavlo8855 folded before Flop (didn't bet)
Seat 6: Scaaalll folded before Flop (didn't bet)



PokerStars Zoom Hand #229229211811:  Hold'em No Limit ($0.01/$0.02) - 2021/08/21 20:50:35 CET [2021/08/21 14:50:35 ET]
Table 'Halley' 6-max Seat #1 is the button
Seat 1: estelionat171 ($0.50 in chips) 
Seat 2: Scaaalll ($2.28 in chips) 
Seat 3: KoAlRy ($2 in chips) 
Seat 4: amario89 ($2 in chips) 
Seat 5: PlayPokerHappy1 ($2.08 in chips) 
Seat 6: renova0813 ($2.51 in chips) 
Scaaalll: posts small blind $0.01
KoAlRy: posts big blind $0.02
*** HOLE CARDS ***
Dealt to Scaaalll [4h 6s]
amario89: raises $0.04 to $0.06
PlayPokerHappy1: calls $0.06
renova0813: folds 
estelionat171: folds 
Scaaalll: folds 
KoAlRy: folds 
*** FLOP *** [Jc 7c 8c]
amario89: bets $0.07
PlayPokerHappy1: folds 
Uncalled bet ($0.07) returned to amario89
amario89 collected $0.14 from pot
amario89: doesn't show hand 
*** SUMMARY ***
Total pot $0.15 | Rake $0.01 
Board [Jc 7c 8c]
Seat 1: estelionat171 (button) folded before Flop (didn't bet)
Seat 2: Scaaalll (small blind) folded before Flop
Seat 3: KoAlRy (big blind) folded before Flop
Seat 4: amario89 collected ($0.14)
Seat 5: PlayPokerHappy1 folded on the Flop
Seat 6: renova0813 folded before Flop (didn't bet)



PokerStars Zoom Hand #229229213426:  Hold'em No Limit ($0.01/$0.02) - 2021/08/21 20:50:38 CET [2021/08/21 14:50:38 ET]
Table 'Halley' 6-max Seat #1 is the button
Seat 1: Scaaalll ($2.27 in chips) 
Seat 2: elcuchu168 ($1.98 in chips) 
Seat 3: Zazill ($4.13 in chips) 
Seat 4: anakondda ($1 in chips) 
Seat 5: vovo4kapooh ($2.03 in chips) 
Seat 6: sorinysu ($0.99 in chips) 
elcuchu168: posts small blind $0.01
Zazill: posts big blind $0.02
*** HOLE CARDS ***
Dealt to Scaaalll [Ks Jh]
anakondda: folds 
vovo4kapooh: folds 
sorinysu: folds 
sorinysu is disconnected 
Scaaalll: raises $0.02 to $0.04
elcuchu168: calls $0.03
Zazill: folds 
*** FLOP *** [4h 5c 3d]
elcuchu168: bets $0.04
Scaaalll: folds 
Uncalled bet ($0.04) returned to elcuchu168
elcuchu168 collected $0.10 from pot
elcuchu168: doesn't show hand 
*** SUMMARY ***
Total pot $0.10 | Rake $0 
Board [4h 5c 3d]
Seat 1: Scaaalll (button) folded on the Flop
Seat 2: elcuchu168 (small blind) collected ($0.10)
Seat 3: Zazill (big blind) folded before Flop
Seat 4: anakondda folded before Flop (didn't bet)
Seat 5: vovo4kapooh folded before Flop (didn't bet)
Seat 6: sorinysu folded before Flop (didn't bet)



PokerStars Zoom Hand #229229203786:  Hold'em No Limit ($0.01/$0.02) - 2021/08/21 20:50:15 CET [2021/08/21 14:50:15 ET]
Table 'Halley' 6-max Seat #1 is the button
Seat 1: JBPY ($0.84 in chips) 
Seat 2: BlueMoon2050 ($0.71 in chips) 
Seat 3: kickBrain ($5.39 in chips) 
Seat 4: Scaaalll ($2.30 in chips) 
Seat 5: zairyoku ($2 in chips) 
Seat 6: renova0813 ($11.64 in chips) 
BlueMoon2050: posts small blind $0.01
kickBrain: posts big blind $0.02
*** HOLE CARDS ***
Dealt to Scaaalll [Ah 4s]
Scaaalll: folds 
zairyoku: raises $0.04 to $0.06
renova0813: folds 
JBPY: calls $0.06
BlueMoon2050: folds 
kickBrain: calls $0.04
*** FLOP *** [Td 6c 9d]
kickBrain: checks 
zairyoku: bets $0.06
JBPY: calls $0.06
kickBrain: calls $0.06
*** TURN *** [Td 6c 9d] [Tc]
kickBrain: checks 
zairyoku: bets $0.12
JBPY: calls $0.12
kickBrain: calls $0.12
*** RIVER *** [Td 6c 9d Tc] [Ad]
kickBrain: checks 
zairyoku: checks 
JBPY: checks 
*** SHOW DOWN ***
kickBrain: shows [5d 6d] (a flush, Ace high)
zairyoku: mucks hand 
JBPY: mucks hand 
kickBrain collected $0.70 from pot
*** SUMMARY ***
Total pot $0.73 | Rake $0.03 
Board [Td 6c 9d Tc Ad]
Seat 1: JBPY (button) mucked [Kh Th]
Seat 2: BlueMoon2050 (small blind) folded before Flop
Seat 3: kickBrain (big blind) showed [5d 6d] and won ($0.70) with a flush, Ace high
Seat 4: Scaaalll folded before Flop (didn't bet)
Seat 5: zairyoku mucked [Jh Jd]
Seat 6: renova0813 folded before Flop (didn't bet)



PokerStars Zoom Hand #229229226946:  Hold'em No Limit ($0.01/$0.02) - 2021/08/21 20:51:10 CET [2021/08/21 14:51:10 ET]
Table 'Halley' 6-max Seat #1 is the button
Seat 1: arsad725 ($8.32 in chips) 
Seat 2: CréééW!!! ($1.07 in chips) 
Seat 3: Natali172737 ($2.20 in chips) 
Seat 4: Scaaalll ($2.23 in chips) 
Seat 5: CordiPS ($2 in chips) 
Seat 6: iPitbull1 ($2.32 in chips) 
CréééW!!!: posts small blind $0.01
Natali172737: posts big blind $0.02
*** HOLE CARDS ***
Dealt to Scaaalll [9h 8d]
Scaaalll: folds 
CordiPS: folds 
iPitbull1: folds 
arsad725: raises $0.03 to $0.05
CréééW!!!: folds 
Natali172737: folds 
Uncalled bet ($0.03) returned to arsad725
arsad725 collected $0.05 from pot
arsad725: doesn't show hand 
*** SUMMARY ***
Total pot $0.05 | Rake $0 
Seat 1: arsad725 (button) collected ($0.05)
Seat 2: CréééW!!! (small blind) folded before Flop
Seat 3: Natali172737 (big blind) folded before Flop
Seat 4: Scaaalll folded before Flop (didn't bet)
Seat 5: CordiPS folded before Flop (didn't bet)
Seat 6: iPitbull1 folded before Flop (didn't bet)



PokerStars Zoom Hand #229229230331:  Hold'em No Limit ($0.01/$0.02) - 2021/08/21 20:51:18 CET [2021/08/21 14:51:18 ET]
Table 'Halley' 6-max Seat #1 is the button
Seat 1: wikkers ($2 in chips) 
Seat 2: cacomaz ($1.25 in chips) 
Seat 3: mMartie ($1.16 in chips) 
Seat 4: Fedor_Gar ($2.77 in chips) 
Seat 5: In2win26 ($1.20 in chips) 
Seat 6: Scaaalll ($2.23 in chips) 
cacomaz: posts small blind $0.01
mMartie: posts big blind $0.02
*** HOLE CARDS ***
Dealt to Scaaalll [Kd Jh]
In2win26 is disconnected 
Fedor_Gar: folds 
In2win26: folds 
Scaaalll: raises $0.04 to $0.06
wikkers: folds 
cacomaz: calls $0.05
mMartie: folds 
*** FLOP *** [6d Ts 6s]
cacomaz: bets $0.02
Scaaalll: folds 
Uncalled bet ($0.02) returned to cacomaz
cacomaz collected $0.14 from pot
cacomaz: doesn't show hand 
*** SUMMARY ***
Total pot $0.14 | Rake $0 
Board [6d Ts 6s]
Seat 1: wikkers (button) folded before Flop (didn't bet)
Seat 2: cacomaz (small blind) collected ($0.14)
Seat 3: mMartie (big blind) folded before Flop
Seat 4: Fedor_Gar folded before Flop (didn't bet)
Seat 5: In2win26 folded before Flop (didn't bet)
Seat 6: Scaaalll folded on the Flop



PokerStars Zoom Hand #229229228652:  Hold'em No Limit ($0.01/$0.02) - 2021/08/21 20:51:14 CET [2021/08/21 14:51:14 ET]
Table 'Halley' 6-max Seat #1 is the button
Seat 1: Kb013497 ($3.21 in chips) 
Seat 2: borges692 ($3.06 in chips) 
Seat 3: 888lifeIS ($2 in chips) 
Seat 4: JuninhoXapa ($2.10 in chips) 
Seat 5: Scaaalll ($2.23 in chips) 
Seat 6: Litotes980 ($2.99 in chips) 
borges692: posts small blind $0.01
888lifeIS: posts big blind $0.02
*** HOLE CARDS ***
Dealt to Scaaalll [7h 4s]
JuninhoXapa: raises $0.03 to $0.05
Scaaalll: folds 
Litotes980: raises $0.09 to $0.14
Kb013497: folds 
borges692: calls $0.13
888lifeIS: folds 
JuninhoXapa: folds 
*** FLOP *** [Qd 6d Qh]
borges692: checks 
Litotes980: bets $0.17
borges692: folds 
Uncalled bet ($0.17) returned to Litotes980
Litotes980 collected $0.34 from pot
Litotes980: doesn't show hand 
*** SUMMARY ***
Total pot $0.35 | Rake $0.01 
Board [Qd 6d Qh]
Seat 1: Kb013497 (button) folded before Flop (didn't bet)
Seat 2: borges692 (small blind) folded on the Flop
Seat 3: 888lifeIS (big blind) folded before Flop
Seat 4: JuninhoXapa folded before Flop
Seat 5: Scaaalll folded before Flop (didn't bet)
Seat 6: Litotes980 collected ($0.34)



PokerStars Zoom Hand #229229239893:  Hold'em No Limit ($0.01/$0.02) - 2021/08/21 20:51:41 CET [2021/08/21 14:51:41 ET]
Table 'Halley' 6-max Seat #1 is the button
Seat 1: cvrcak5 ($2.44 in chips) 
Seat 2: Xlavariable ($2.01 in chips) 
Seat 3: Scaaalll ($2.17 in chips) 
Seat 4: petit-145 ($2.83 in chips) 
Seat 5: arsad725 ($4.24 in chips) 
Seat 6: Aroma Iceland ($2.05 in chips) 
Xlavariable: posts small blind $0.01
Scaaalll: posts big blind $0.02
*** HOLE CARDS ***
Dealt to Scaaalll [7c Jc]
petit-145: folds 
arsad725: folds 
Aroma Iceland: folds 
cvrcak5: folds 
petit-145 is disconnected 
Xlavariable: raises $0.04 to $0.06
Scaaalll: raises $0.12 to $0.18
Xlavariable: folds 
Uncalled bet ($0.12) returned to Scaaalll
Scaaalll collected $0.12 from pot
Scaaalll: doesn't show hand 
*** SUMMARY ***
Total pot $0.12 | Rake $0 
Seat 1: cvrcak5 (button) folded before Flop (didn't bet)
Seat 2: Xlavariable (small blind) folded before Flop
Seat 3: Scaaalll (big blind) collected ($0.12)
Seat 4: petit-145 folded before Flop (didn't bet)
Seat 5: arsad725 folded before Flop (didn't bet)
Seat 6: Aroma Iceland folded before Flop (didn't bet)



PokerStars Zoom Hand #229229249133:  Hold'em No Limit ($0.01/$0.02) - 2021/08/21 20:52:03 CET [2021/08/21 14:52:03 ET]
Table 'Halley' 6-max Seat #1 is the button
Seat 1: Tj741 ($3.84 in chips) 
Seat 2: Scaaalll ($2.23 in chips) 
Seat 3: Natali172737 ($2.99 in chips) 
Seat 4: Ketsudan ($2.03 in chips) 
Seat 5: estelionat171 ($2.09 in chips) 
Seat 6: dominik7315 ($2.34 in chips) 
Scaaalll: posts small blind $0.01
Natali172737: posts big blind $0.02
*** HOLE CARDS ***
Dealt to Scaaalll [Qd Ac]
dominik7315 is disconnected 
Ketsudan: raises $0.04 to $0.06
estelionat171: folds 
dominik7315: folds 
Tj741: folds 
Scaaalll: calls $0.05
Natali172737: folds 
*** FLOP *** [5c 4d Ad]
Scaaalll: checks 
Ketsudan: bets $0.11
Scaaalll: calls $0.11
*** TURN *** [5c 4d Ad] [9h]
Scaaalll: checks 
Ketsudan: bets $0.28
Scaaalll: calls $0.28
*** RIVER *** [5c 4d Ad 9h] [4h]
Scaaalll: checks 
Ketsudan: bets $0.49
Scaaalll: folds 
Uncalled bet ($0.49) returned to Ketsudan
Ketsudan collected $0.89 from pot
Ketsudan: doesn't show hand 
*** SUMMARY ***
Total pot $0.92 | Rake $0.03 
Board [5c 4d Ad 9h 4h]
Seat 1: Tj741 (button) folded before Flop (didn't bet)
Seat 2: Scaaalll (small blind) folded on the River
Seat 3: Natali172737 (big blind) folded before Flop
Seat 4: Ketsudan collected ($0.89)
Seat 5: estelionat171 folded before Flop (didn't bet)
Seat 6: dominik7315 folded before Flop (didn't bet)



PokerStars Zoom Hand #229229281467:  Hold'em No Limit ($0.01/$0.02) - 2021/08/21 20:53:20 CET [2021/08/21 14:53:20 ET]
Table 'Halley' 6-max Seat #1 is the button
Seat 1: Scaaalll ($2 in chips) 
Seat 2: putya-putya ($9.06 in chips) 
Seat 3: 77omsk ($2.34 in chips) 
Seat 4: MEUZZO ($4.14 in chips) 
Seat 5: Victor151886 ($2.80 in chips) 
Seat 6: Pulp Hands ($1.97 in chips) 
putya-putya: posts small blind $0.01
77omsk: posts big blind $0.02
*** HOLE CARDS ***
Dealt to Scaaalll [2d Ks]
MEUZZO: folds 
Victor151886: folds 
Pulp Hands: folds 
Scaaalll: folds 
putya-putya: folds 
Uncalled bet ($0.01) returned to 77omsk
77omsk collected $0.02 from pot
77omsk: doesn't show hand 
*** SUMMARY ***
Total pot $0.02 | Rake $0 
Seat 1: Scaaalll (button) folded before Flop (didn't bet)
Seat 2: putya-putya (small blind) folded before Flop
Seat 3: 77omsk (big blind) collected ($0.02)
Seat 4: MEUZZO folded before Flop (didn't bet)
Seat 5: Victor151886 folded before Flop (didn't bet)
Seat 6: Pulp Hands folded before Flop (didn't bet)



PokerStars Zoom Hand #229229283167:  Hold'em No Limit ($0.01/$0.02) - 2021/08/21 20:53:24 CET [2021/08/21 14:53:24 ET]
Table 'Halley' 6-max Seat #1 is the button
Seat 1: Aroma Iceland ($2.56 in chips) 
Seat 2: snowy_96 ($2 in chips) 
Seat 3: xmaksimus ($6.53 in chips) 
Seat 4: HellNative ($3.94 in chips) 
Seat 5: Scaaalll ($2 in chips) 
Seat 6: Gibsondelux ($1.63 in chips) 
snowy_96: posts small blind $0.01
xmaksimus: posts big blind $0.02
*** HOLE CARDS ***
Dealt to Scaaalll [4s 4h]
Gibsondelux is disconnected 
HellNative: folds 
Scaaalll: raises $0.04 to $0.06
Gibsondelux: folds 
Aroma Iceland: folds 
snowy_96: folds 
xmaksimus: folds 
Uncalled bet ($0.04) returned to Scaaalll
Scaaalll collected $0.05 from pot
Scaaalll: doesn't show hand 
*** SUMMARY ***
Total pot $0.05 | Rake $0 
Seat 1: Aroma Iceland (button) folded before Flop (didn't bet)
Seat 2: snowy_96 (small blind) folded before Flop
Seat 3: xmaksimus (big blind) folded before Flop
Seat 4: HellNative folded before Flop (didn't bet)
Seat 5: Scaaalll collected ($0.05)
Seat 6: Gibsondelux folded before Flop (didn't bet)



PokerStars Zoom Hand #229229289026:  Hold'em No Limit ($0.01/$0.02) - 2021/08/21 20:53:38 CET [2021/08/21 14:53:38 ET]
Table 'Halley' 6-max Seat #1 is the button
Seat 1: the.fire71 ($2.80 in chips) 
Seat 2: kahzura ($2.20 in chips) 
Seat 3: Koldun 2636 ($2.02 in chips) 
Seat 4: Scaaalll ($2.03 in chips) 
Seat 5: gekke_peety ($1.94 in chips) 
Seat 6: MicroLocoNL ($2.31 in chips) 
kahzura: posts small blind $0.01
Koldun 2636: posts big blind $0.02
*** HOLE CARDS ***
Dealt to Scaaalll [Tc Qc]
Scaaalll: raises $0.04 to $0.06
gekke_peety: folds 
MicroLocoNL: folds 
the.fire71: folds 
kahzura: folds 
Koldun 2636: calls $0.04
*** FLOP *** [7d 4d 6h]
Koldun 2636: checks 
Scaaalll: bets $0.08
Koldun 2636: folds 
Uncalled bet ($0.08) returned to Scaaalll
Scaaalll collected $0.13 from pot
Scaaalll: doesn't show hand 
*** SUMMARY ***
Total pot $0.13 | Rake $0 
Board [7d 4d 6h]
Seat 1: the.fire71 (button) folded before Flop (didn't bet)
Seat 2: kahzura (small blind) folded before Flop
Seat 3: Koldun 2636 (big blind) folded on the Flop
Seat 4: Scaaalll collected ($0.13)
Seat 5: gekke_peety folded before Flop (didn't bet)
Seat 6: MicroLocoNL folded before Flop (didn't bet)



PokerStars Zoom Hand #229229300270:  Hold'em No Limit ($0.01/$0.02) - 2021/08/21 20:54:05 CET [2021/08/21 14:54:05 ET]
Table 'Halley' 6-max Seat #1 is the button
Seat 1: PlayPokerHappy1 ($2.04 in chips) 
Seat 2: Koldun 2636 ($2 in chips) 
Seat 3: Scaaalll ($2.10 in chips) 
Seat 4: so0love ($2.74 in chips) 
Seat 5: Armando.Bordi ($2.13 in chips) 
Seat 6: 7LEV77 ($3.14 in chips) 
Koldun 2636: posts small blind $0.01
Scaaalll: posts big blind $0.02
*** HOLE CARDS ***
Dealt to Scaaalll [5d 3s]
so0love: folds 
Armando.Bordi: folds 
7LEV77: raises $0.05 to $0.07
PlayPokerHappy1: folds 
Koldun 2636: folds 
Scaaalll: folds 
Uncalled bet ($0.05) returned to 7LEV77
7LEV77 collected $0.05 from pot
7LEV77: doesn't show hand 
*** SUMMARY ***
Total pot $0.05 | Rake $0 
Seat 1: PlayPokerHappy1 (button) folded before Flop (didn't bet)
Seat 2: Koldun 2636 (small blind) folded before Flop
Seat 3: Scaaalll (big blind) folded before Flop
Seat 4: so0love folded before Flop (didn't bet)
Seat 5: Armando.Bordi folded before Flop (didn't bet)
Seat 6: 7LEV77 collected ($0.05)



PokerStars Zoom Hand #229229305243:  Hold'em No Limit ($0.01/$0.02) - 2021/08/21 20:54:17 CET [2021/08/21 14:54:17 ET]
Table 'Halley' 6-max Seat #1 is the button
Seat 1: vindoffree ($2.53 in chips) 
Seat 2: ponomarinho ($2.30 in chips) 
Seat 3: ash1448 ($2.79 in chips) 
Seat 4: SaRCh_Ale ($2 in chips) 
Seat 5: Scaaalll ($2.08 in chips) 
Seat 6: MicroLocoNL ($2.24 in chips) 
ponomarinho: posts small blind $0.01
ash1448: posts big blind $0.02
*** HOLE CARDS ***
Dealt to Scaaalll [8c Qs]
SaRCh_Ale: folds 
Scaaalll: folds 
MicroLocoNL: folds 
vindoffree: raises $0.04 to $0.06
ponomarinho: folds 
ash1448: folds 
Uncalled bet ($0.04) returned to vindoffree
vindoffree collected $0.05 from pot
vindoffree: doesn't show hand 
*** SUMMARY ***
Total pot $0.05 | Rake $0 
Seat 1: vindoffree (button) collected ($0.05)
Seat 2: ponomarinho (small blind) folded before Flop
Seat 3: ash1448 (big blind) folded before Flop
Seat 4: SaRCh_Ale folded before Flop (didn't bet)
Seat 5: Scaaalll folded before Flop (didn't bet)
Seat 6: MicroLocoNL folded before Flop (didn't bet)



PokerStars Zoom Hand #229229314917:  Hold'em No Limit ($0.01/$0.02) - 2021/08/21 20:54:40 CET [2021/08/21 14:54:40 ET]
Table 'Halley' 6-max Seat #1 is the button
Seat 1: musirov ($2.79 in chips) 
Seat 2: Scaaalll ($2.08 in chips) 
Seat 3: PaddyPoland ($2 in chips) 
Seat 4: sigrivas ($4.12 in chips) 
Seat 5: slaweksen ($2 in chips) 
Seat 6: arturtsutsaev ($1.46 in chips) 
Scaaalll: posts small blind $0.01
PaddyPoland: posts big blind $0.02
*** HOLE CARDS ***
Dealt to Scaaalll [Qh 7d]
arturtsutsaev is disconnected 
sigrivas: folds 
slaweksen: folds 
arturtsutsaev: folds 
musirov: folds 
Scaaalll: folds 
Uncalled bet ($0.01) returned to PaddyPoland
PaddyPoland collected $0.02 from pot
PaddyPoland: doesn't show hand 
*** SUMMARY ***
Total pot $0.02 | Rake $0 
Seat 1: musirov (button) folded before Flop (didn't bet)
Seat 2: Scaaalll (small blind) folded before Flop
Seat 3: PaddyPoland (big blind) collected ($0.02)
Seat 4: sigrivas folded before Flop (didn't bet)
Seat 5: slaweksen folded before Flop (didn't bet)
Seat 6: arturtsutsaev folded before Flop (didn't bet)



PokerStars Zoom Hand #229229322330:  Hold'em No Limit ($0.01/$0.02) - 2021/08/21 20:54:58 CET [2021/08/21 14:54:58 ET]
Table 'Halley' 6-max Seat #1 is the button
Seat 1: sewq55 ($0.60 in chips) 
Seat 2: Dominykas ($2.57 in chips) 
Seat 3: Scaaalll ($2.07 in chips) 
Seat 4: diegohgmelo ($1.70 in chips) 
Seat 5: kahzura ($2.55 in chips) 
Seat 6: Flankeris ($6.12 in chips) 
Dominykas: posts small blind $0.01
Scaaalll: posts big blind $0.02
*** HOLE CARDS ***
Dealt to Scaaalll [9c Js]
diegohgmelo: folds 
diegohgmelo is disconnected 
kahzura: folds 
Flankeris: folds 
sewq55: folds 
Dominykas: folds 
Uncalled bet ($0.01) returned to Scaaalll
Scaaalll collected $0.02 from pot
Scaaalll: doesn't show hand 
*** SUMMARY ***
Total pot $0.02 | Rake $0 
Seat 1: sewq55 (button) folded before Flop (didn't bet)
Seat 2: Dominykas (small blind) folded before Flop
Seat 3: Scaaalll (big blind) collected ($0.02)
Seat 4: diegohgmelo folded before Flop (didn't bet)
Seat 5: kahzura folded before Flop (didn't bet)
Seat 6: Flankeris folded before Flop (didn't bet)



PokerStars Zoom Hand #229229316530:  Hold'em No Limit ($0.01/$0.02) - 2021/08/21 20:54:44 CET [2021/08/21 14:54:44 ET]
Table 'Halley' 6-max Seat #1 is the button
Seat 1: BDFather ($2.96 in chips) 
Seat 2: ckooistra36 ($0.64 in chips) 
Seat 3: SpartanRace1 ($4.04 in chips) 
Seat 4: Scaaalll ($2.07 in chips) 
Seat 5: MIT_PKR ($3.40 in chips) 
Seat 6: alecha11 ($2.84 in chips) 
ckooistra36: posts small blind $0.01
SpartanRace1: posts big blind $0.02
*** HOLE CARDS ***
Dealt to Scaaalll [3d 6c]
Scaaalll: folds 
MIT_PKR: folds 
alecha11: folds 
BDFather: raises $0.03 to $0.05
ckooistra36: raises $0.12 to $0.17
SpartanRace1: folds 
BDFather: calls $0.12
*** FLOP *** [2h Td 2d]
ckooistra36: bets $0.47 and is all-in
BDFather: calls $0.47
*** TURN *** [2h Td 2d] [Kd]
*** RIVER *** [2h Td 2d Kd] [Ts]
*** SHOW DOWN ***
ckooistra36: shows [As Ks] (two pair, Kings and Tens)
BDFather: shows [8c Tc] (a full house, Tens full of Deuces)
BDFather collected $1.25 from pot
*** SUMMARY ***
Total pot $1.30 | Rake $0.05 
Board [2h Td 2d Kd Ts]
Seat 1: BDFather (button) showed [8c Tc] and won ($1.25) with a full house, Tens full of Deuces
Seat 2: ckooistra36 (small blind) showed [As Ks] and lost with two pair, Kings and Tens
Seat 3: SpartanRace1 (big blind) folded before Flop
Seat 4: Scaaalll folded before Flop (didn't bet)
Seat 5: MIT_PKR folded before Flop (didn't bet)
Seat 6: alecha11 folded before Flop (didn't bet)



PokerStars Zoom Hand #229229320262:  Hold'em No Limit ($0.01/$0.02) - 2021/08/21 20:54:53 CET [2021/08/21 14:54:53 ET]
Table 'Halley' 6-max Seat #1 is the button
Seat 1: Astron2020 ($0.30 in chips) 
Seat 2: Ketsudan ($3.20 in chips) 
Seat 3: ggGoldenPunk ($2.68 in chips) 
Seat 4: Zhyla95 ($2.17 in chips) 
Seat 5: Scaaalll ($2.07 in chips) 
Seat 6: rodrigoasor ($1.79 in chips) 
Ketsudan: posts small blind $0.01
ggGoldenPunk: posts big blind $0.02
*** HOLE CARDS ***
Dealt to Scaaalll [As 3c]
Zhyla95: folds 
Scaaalll: folds 
rodrigoasor: folds 
Astron2020: calls $0.02
Ketsudan: folds 
ggGoldenPunk: checks 
*** FLOP *** [Jh 4h 6h]
ggGoldenPunk: bets $0.02
Astron2020: calls $0.02
*** TURN *** [Jh 4h 6h] [Ah]
ggGoldenPunk: bets $0.02
Astron2020: calls $0.02
*** RIVER *** [Jh 4h 6h Ah] [Qs]
ggGoldenPunk: bets $0.07
Astron2020: calls $0.07
*** SHOW DOWN ***
ggGoldenPunk: shows [9h 6s] (a flush, Ace high)
Astron2020: mucks hand 
ggGoldenPunk collected $0.26 from pot
*** SUMMARY ***
Total pot $0.27 | Rake $0.01 
Board [Jh 4h 6h Ah Qs]
Seat 1: Astron2020 (button) mucked [Js Ac]
Seat 2: Ketsudan (small blind) folded before Flop
Seat 3: ggGoldenPunk (big blind) showed [9h 6s] and won ($0.26) with a flush, Ace high
Seat 4: Zhyla95 folded before Flop (didn't bet)
Seat 5: Scaaalll folded before Flop (didn't bet)
Seat 6: rodrigoasor folded before Flop (didn't bet)



PokerStars Zoom Hand #229229306935:  Hold'em No Limit ($0.01/$0.02) - 2021/08/21 20:54:21 CET [2021/08/21 14:54:21 ET]
Table 'Halley' 6-max Seat #1 is the button
Seat 1: KensiKion ($0.38 in chips) 
Seat 2: rpycmbEM ($5.97 in chips) 
Seat 3: pescador2 ($2.18 in chips) 
Seat 4: Xlavariable ($2 in chips) 
Seat 5: Finderra ($3.96 in chips) 
Seat 6: Scaaalll ($2.08 in chips) 
rpycmbEM: posts small blind $0.01
pescador2: posts big blind $0.02
*** HOLE CARDS ***
Dealt to Scaaalll [3h 2s]
KensiKion is disconnected 
Xlavariable: folds 
Finderra: raises $0.04 to $0.06
Scaaalll: folds 
KensiKion: folds 
rpycmbEM: folds 
pescador2: calls $0.04
*** FLOP *** [3c 9c 4s]
pescador2: bets $0.06
Finderra: calls $0.06
*** TURN *** [3c 9c 4s] [4d]
pescador2: bets $0.08
Finderra: folds 
Uncalled bet ($0.08) returned to pescador2
pescador2 collected $0.24 from pot
pescador2: doesn't show hand 
*** SUMMARY ***
Total pot $0.25 | Rake $0.01 
Board [3c 9c 4s 4d]
Seat 1: KensiKion (button) folded before Flop (didn't bet)
Seat 2: rpycmbEM (small blind) folded before Flop
Seat 3: pescador2 (big blind) collected ($0.24)
Seat 4: Xlavariable folded before Flop (didn't bet)
Seat 5: Finderra folded on the Turn
Seat 6: Scaaalll folded before Flop (didn't bet)



PokerStars Zoom Hand #229229308622:  Hold'em No Limit ($0.01/$0.02) - 2021/08/21 20:54:25 CET [2021/08/21 14:54:25 ET]
Table 'Halley' 6-max Seat #1 is the button
Seat 1: Scaaalll ($2.08 in chips) 
Seat 2: YPAXAPA555 ($2.69 in chips) 
Seat 3: arsad725 ($8.39 in chips) 
Seat 4: turbolya60 ($1.85 in chips) 
Seat 5: StAntoha ($2 in chips) 
Seat 6: WithMyWalker ($2 in chips) 
YPAXAPA555: posts small blind $0.01
arsad725: posts big blind $0.02
*** HOLE CARDS ***
Dealt to Scaaalll [Js 2s]
turbolya60: folds 
StAntoha: raises $0.04 to $0.06
WithMyWalker: raises $0.12 to $0.18
Scaaalll: folds 
YPAXAPA555: folds 
arsad725: folds 
StAntoha: calls $0.12
*** FLOP *** [3d 2d Jh]
StAntoha: checks 
WithMyWalker: checks 
*** TURN *** [3d 2d Jh] [5c]
StAntoha: bets $0.16
WithMyWalker: calls $0.16
*** RIVER *** [3d 2d Jh 5c] [9c]
StAntoha: checks 
WithMyWalker: checks 
*** SHOW DOWN ***
StAntoha: shows [Kc Qc] (high card King)
WithMyWalker: shows [Kd Ah] (high card Ace)
WithMyWalker collected $0.69 from pot
*** SUMMARY ***
Total pot $0.71 | Rake $0.02 
Board [3d 2d Jh 5c 9c]
Seat 1: Scaaalll (button) folded before Flop (didn't bet)
Seat 2: YPAXAPA555 (small blind) folded before Flop
Seat 3: arsad725 (big blind) folded before Flop
Seat 4: turbolya60 folded before Flop (didn't bet)
Seat 5: StAntoha showed [Kc Qc] and lost with high card King
Seat 6: WithMyWalker showed [Kd Ah] and won ($0.69) with high card Ace



PokerStars Zoom Hand #229229329552:  Hold'em No Limit ($0.01/$0.02) - 2021/08/21 20:55:21 CET [2021/08/21 14:55:21 ET]
Table 'Halley' 6-max Seat #1 is the button
Seat 1: Scaaalll ($2.08 in chips) 
Seat 2: manutp96 ($1.68 in chips) 
Seat 3: Kb013497 ($4.41 in chips) 
Seat 4: gasmar_29 ($2.03 in chips) 
Seat 5: RonilsonCosta ($2.03 in chips) 
Seat 6: lucksuckdonk ($2.42 in chips) 
manutp96: posts small blind $0.01
Kb013497: posts big blind $0.02
*** HOLE CARDS ***
Dealt to Scaaalll [2d Kc]
gasmar_29: folds 
RonilsonCosta: folds 
lucksuckdonk: raises $0.04 to $0.06
Scaaalll: folds 
manutp96: folds 
Kb013497: folds 
Uncalled bet ($0.04) returned to lucksuckdonk
lucksuckdonk collected $0.05 from pot
lucksuckdonk: doesn't show hand 
*** SUMMARY ***
Total pot $0.05 | Rake $0 
Seat 1: Scaaalll (button) folded before Flop (didn't bet)
Seat 2: manutp96 (small blind) folded before Flop
Seat 3: Kb013497 (big blind) folded before Flop
Seat 4: gasmar_29 folded before Flop (didn't bet)
Seat 5: RonilsonCosta folded before Flop (didn't bet)
Seat 6: lucksuckdonk collected ($0.05)



PokerStars Zoom Hand #229229325443:  Hold'em No Limit ($0.01/$0.02) - 2021/08/21 20:55:07 CET [2021/08/21 14:55:07 ET]
Table 'Halley' 6-max Seat #1 is the button
Seat 1: shingo594 ($2.38 in chips) 
Seat 2: picuur ($1.39 in chips) 
Seat 3: torov999 ($1.87 in chips) 
Seat 4: maliniak75 ($2.01 in chips) 
Seat 5: TESTGOSHI ($1.87 in chips) 
Seat 6: Scaaalll ($2.08 in chips) 
picuur: posts small blind $0.01
torov999: posts big blind $0.02
*** HOLE CARDS ***
Dealt to Scaaalll [Jh Qd]
maliniak75: calls $0.02
shingo594 is disconnected 
TESTGOSHI: folds 
Scaaalll: folds 
shingo594: folds 
picuur: calls $0.01
torov999: checks 
*** FLOP *** [Js Td 7d]
picuur: bets $0.06
torov999: folds 
maliniak75: calls $0.06
*** TURN *** [Js Td 7d] [3d]
picuur: bets $0.14
maliniak75: folds 
Uncalled bet ($0.14) returned to picuur
picuur collected $0.17 from pot
picuur: doesn't show hand 
*** SUMMARY ***
Total pot $0.18 | Rake $0.01 
Board [Js Td 7d 3d]
Seat 1: shingo594 (button) folded before Flop (didn't bet)
Seat 2: picuur (small blind) collected ($0.17)
Seat 3: torov999 (big blind) folded on the Flop
Seat 4: maliniak75 folded on the Turn
Seat 5: TESTGOSHI folded before Flop (didn't bet)
Seat 6: Scaaalll folded before Flop (didn't bet)



PokerStars Zoom Hand #229229335419:  Hold'em No Limit ($0.01/$0.02) - 2021/08/21 20:55:42 CET [2021/08/21 14:55:42 ET]
Table 'Halley' 6-max Seat #1 is the button
Seat 1: SpartanRace1 ($9.41 in chips) 
Seat 2: sewq55 ($1.33 in chips) 
Seat 3: Fedor_Gar ($2.81 in chips) 
Seat 4: pavlo8855 ($2 in chips) 
Seat 5: KKARMELO ($2.83 in chips) 
Seat 6: Scaaalll ($2.07 in chips) 
sewq55: posts small blind $0.01
Fedor_Gar: posts big blind $0.02
*** HOLE CARDS ***
Dealt to Scaaalll [Js 2h]
pavlo8855: raises $0.04 to $0.06
KKARMELO: folds 
Scaaalll: folds 
SpartanRace1: folds 
sewq55: folds 
Fedor_Gar: folds 
Uncalled bet ($0.04) returned to pavlo8855
pavlo8855 collected $0.05 from pot
pavlo8855: doesn't show hand 
*** SUMMARY ***
Total pot $0.05 | Rake $0 
Seat 1: SpartanRace1 (button) folded before Flop (didn't bet)
Seat 2: sewq55 (small blind) folded before Flop
Seat 3: Fedor_Gar (big blind) folded before Flop
Seat 4: pavlo8855 collected ($0.05)
Seat 5: KKARMELO folded before Flop (didn't bet)
Seat 6: Scaaalll folded before Flop (didn't bet)



PokerStars Zoom Hand #229229326881:  Hold'em No Limit ($0.01/$0.02) - 2021/08/21 20:55:12 CET [2021/08/21 14:55:12 ET]
Table 'Halley' 6-max Seat #1 is the button
Seat 1: Victor151886 ($3.03 in chips) 
Seat 2: diegohgmelo ($1.68 in chips) 
Seat 3: sorinysu ($1.01 in chips) 
Seat 4: Scaaalll ($2.08 in chips) 
Seat 5: alecha11 ($2.81 in chips) 
Seat 6: XHerrTUMNUSX ($5.18 in chips) 
diegohgmelo: posts small blind $0.01
sorinysu: posts big blind $0.02
*** HOLE CARDS ***
Dealt to Scaaalll [6h 8d]
Scaaalll: folds 
alecha11: folds 
XHerrTUMNUSX: folds 
Victor151886: raises $0.05 to $0.07
diegohgmelo: calls $0.06
sorinysu: folds 
*** FLOP *** [Js 9h Kd]
sorinysu is disconnected 
diegohgmelo: checks 
Victor151886: bets $0.11
diegohgmelo: folds 
Uncalled bet ($0.11) returned to Victor151886
Victor151886 collected $0.15 from pot
Victor151886: doesn't show hand 
diegohgmelo is disconnected 
*** SUMMARY ***
Total pot $0.16 | Rake $0.01 
Board [Js 9h Kd]
Seat 1: Victor151886 (button) collected ($0.15)
Seat 2: diegohgmelo (small blind) folded on the Flop
Seat 3: sorinysu (big blind) folded before Flop
Seat 4: Scaaalll folded before Flop (didn't bet)
Seat 5: alecha11 folded before Flop (didn't bet)
Seat 6: XHerrTUMNUSX folded before Flop (didn't bet)



PokerStars Zoom Hand #229229336611:  Hold'em No Limit ($0.01/$0.02) - 2021/08/21 20:55:45 CET [2021/08/21 14:55:45 ET]
Table 'Halley' 6-max Seat #1 is the button
Seat 1: Fanatspartak ($2.06 in chips) 
Seat 2: BIITRU ($3.91 in chips) 
Seat 3: Scaaalll ($2.07 in chips) 
Seat 4: Anan71 ($3.23 in chips) 
Seat 5: kardan641 ($0.99 in chips) 
Seat 6: SpartanRace1 ($9.41 in chips) 
BIITRU: posts small blind $0.01
Scaaalll: posts big blind $0.02
*** HOLE CARDS ***
Dealt to Scaaalll [3c Tc]
kardan641 is disconnected 
Anan71: folds 
kardan641: folds 
Anan71 is disconnected 
SpartanRace1: folds 
Fanatspartak: raises $0.04 to $0.06
BIITRU: folds 
Scaaalll: folds 
Uncalled bet ($0.04) returned to Fanatspartak
Fanatspartak collected $0.05 from pot
Fanatspartak: doesn't show hand 
*** SUMMARY ***
Total pot $0.05 | Rake $0 
Seat 1: Fanatspartak (button) collected ($0.05)
Seat 2: BIITRU (small blind) folded before Flop
Seat 3: Scaaalll (big blind) folded before Flop
Seat 4: Anan71 folded before Flop (didn't bet)
Seat 5: kardan641 folded before Flop (didn't bet)
Seat 6: SpartanRace1 folded before Flop (didn't bet)



PokerStars Zoom Hand #229229341846:  Hold'em No Limit ($0.01/$0.02) - 2021/08/21 20:56:03 CET [2021/08/21 14:56:03 ET]
Table 'Halley' 6-max Seat #1 is the button
Seat 1: 77omsk ($2.29 in chips) 
Seat 2: Anan71 ($3.21 in chips) 
Seat 3: kite1966 ($2 in chips) 
Seat 4: MicroLocoNL ($2.80 in chips) 
Seat 5: Scaaalll ($2.05 in chips) 
Seat 6: Pechorin.G ($2.13 in chips) 
Anan71: posts small blind $0.01
kite1966: posts big blind $0.02
*** HOLE CARDS ***
Dealt to Scaaalll [3h Ks]
MicroLocoNL: folds 
Scaaalll: folds 
Pechorin.G: folds 
77omsk: folds 
Anan71: raises $0.02 to $0.04
kite1966: folds 
Uncalled bet ($0.02) returned to Anan71
Anan71 collected $0.04 from pot
Anan71: doesn't show hand 
*** SUMMARY ***
Total pot $0.04 | Rake $0 
Seat 1: 77omsk (button) folded before Flop (didn't bet)
Seat 2: Anan71 (small blind) collected ($0.04)
Seat 3: kite1966 (big blind) folded before Flop
Seat 4: MicroLocoNL folded before Flop (didn't bet)
Seat 5: Scaaalll folded before Flop (didn't bet)
Seat 6: Pechorin.G folded before Flop (didn't bet)



PokerStars Zoom Hand #229229343376:  Hold'em No Limit ($0.01/$0.02) - 2021/08/21 20:56:08 CET [2021/08/21 14:56:08 ET]
Table 'Halley' 6-max Seat #1 is the button
Seat 1: Pulp Hands ($1.40 in chips) 
Seat 2: Scaaalll ($2.05 in chips) 
Seat 3: BossTH4 ($2 in chips) 
Seat 4: fishh_play ($2 in chips) 
Seat 5: SpartanRace1 ($9.50 in chips) 
Seat 6: ignat-of 777 ($0.98 in chips) 
Scaaalll: posts small blind $0.01
BossTH4: posts big blind $0.02
*** HOLE CARDS ***
Dealt to Scaaalll [9c 2c]
fishh_play: folds 
SpartanRace1: folds 
ignat-of 777: folds 
Pulp Hands: folds 
Scaaalll: folds 
Uncalled bet ($0.01) returned to BossTH4
BossTH4 collected $0.02 from pot
BossTH4: doesn't show hand 
*** SUMMARY ***
Total pot $0.02 | Rake $0 
Seat 1: Pulp Hands (button) folded before Flop (didn't bet)
Seat 2: Scaaalll (small blind) folded before Flop
Seat 3: BossTH4 (big blind) collected ($0.02)
Seat 4: fishh_play folded before Flop (didn't bet)
Seat 5: SpartanRace1 folded before Flop (didn't bet)
Seat 6: ignat-of 777 folded before Flop (didn't bet)



PokerStars Zoom Hand #229229330740:  Hold'em No Limit ($0.01/$0.02) - 2021/08/21 20:55:25 CET [2021/08/21 14:55:25 ET]
Table 'Halley' 6-max Seat #1 is the button
Seat 1: so0love ($3.56 in chips) 
Seat 2: Scaaalll ($2.08 in chips) 
Seat 3: RonilsonCosta ($2.03 in chips) 
Seat 4: rAxt24 ($2.56 in chips) 
Seat 5: ctaceo ($2.01 in chips) 
Seat 6: comptonBL ($2.22 in chips) 
Scaaalll: posts small blind $0.01
RonilsonCosta: posts big blind $0.02
*** HOLE CARDS ***
Dealt to Scaaalll [Kh Td]
rAxt24: calls $0.02
ctaceo: folds 
comptonBL: raises $0.04 to $0.06
so0love: folds 
Scaaalll: folds 
RonilsonCosta: folds 
rAxt24: calls $0.04
*** FLOP *** [Ks 6d 5s]
rAxt24: checks 
comptonBL: bets $0.06
rAxt24: calls $0.06
*** TURN *** [Ks 6d 5s] [7d]
rAxt24: checks 
comptonBL: bets $0.20
rAxt24: calls $0.20
*** RIVER *** [Ks 6d 5s 7d] [6s]
rAxt24: bets $0.64
comptonBL: folds 
Uncalled bet ($0.64) returned to rAxt24
rAxt24 collected $0.65 from pot
rAxt24: doesn't show hand 
*** SUMMARY ***
Total pot $0.67 | Rake $0.02 
Board [Ks 6d 5s 7d 6s]
Seat 1: so0love (button) folded before Flop (didn't bet)
Seat 2: Scaaalll (small blind) folded before Flop
Seat 3: RonilsonCosta (big blind) folded before Flop
Seat 4: rAxt24 collected ($0.65)
Seat 5: ctaceo folded before Flop (didn't bet)
Seat 6: comptonBL folded on the River



PokerStars Zoom Hand #229229345455:  Hold'em No Limit ($0.01/$0.02) - 2021/08/21 20:56:15 CET [2021/08/21 14:56:15 ET]
Table 'Halley' 6-max Seat #1 is the button
Seat 1: lucksuckdonk ($3.04 in chips) 
Seat 2: YPAXAPA555 ($2.01 in chips) 
Seat 3: Fanatspartak ($2.09 in chips) 
Seat 4: amario89 ($2.15 in chips) 
Seat 5: arsad725 ($4.12 in chips) 
Seat 6: Scaaalll ($2.04 in chips) 
YPAXAPA555: posts small blind $0.01
Fanatspartak: posts big blind $0.02
*** HOLE CARDS ***
Dealt to Scaaalll [8d Ac]
amario89: folds 
amario89 is disconnected 
arsad725: folds 
Scaaalll: folds 
lucksuckdonk: folds 
YPAXAPA555: folds 
Uncalled bet ($0.01) returned to Fanatspartak
Fanatspartak collected $0.02 from pot
Fanatspartak: doesn't show hand 
*** SUMMARY ***
Total pot $0.02 | Rake $0 
Seat 1: lucksuckdonk (button) folded before Flop (didn't bet)
Seat 2: YPAXAPA555 (small blind) folded before Flop
Seat 3: Fanatspartak (big blind) collected ($0.02)
Seat 4: amario89 folded before Flop (didn't bet)
Seat 5: arsad725 folded before Flop (didn't bet)
Seat 6: Scaaalll folded before Flop (didn't bet)



PokerStars Zoom Hand #229229348106:  Hold'em No Limit ($0.01/$0.02) - 2021/08/21 20:56:24 CET [2021/08/21 14:56:24 ET]
Table 'Halley' 6-max Seat #1 is the button
Seat 1: Scaaalll ($2.04 in chips) 
Seat 2: gasmar_29 ($2.88 in chips) 
Seat 3: In2win26 ($1.41 in chips) 
Seat 4: Quantum771 ($2.44 in chips) 
Seat 5: MrK_Leuven ($2 in chips) 
Seat 6: sigrivas ($4.10 in chips) 
gasmar_29: posts small blind $0.01
In2win26: posts big blind $0.02
*** HOLE CARDS ***
Dealt to Scaaalll [6h Tc]
Quantum771: folds 
MrK_Leuven: folds 
sigrivas: folds 
Scaaalll: folds 
gasmar_29: folds 
Uncalled bet ($0.01) returned to In2win26
In2win26 collected $0.02 from pot
In2win26: doesn't show hand 
*** SUMMARY ***
Total pot $0.02 | Rake $0 
Seat 1: Scaaalll (button) folded before Flop (didn't bet)
Seat 2: gasmar_29 (small blind) folded before Flop
Seat 3: In2win26 (big blind) collected ($0.02)
Seat 4: Quantum771 folded before Flop (didn't bet)
Seat 5: MrK_Leuven folded before Flop (didn't bet)
Seat 6: sigrivas folded before Flop (didn't bet)



PokerStars Zoom Hand #229229357312:  Hold'em No Limit ($0.01/$0.02) - 2021/08/21 20:56:51 CET [2021/08/21 14:56:51 ET]
Table 'Halley' 6-max Seat #1 is the button
Seat 1: Munavili ($2.32 in chips) 
Seat 2: Mikel226 ($1.42 in chips) 
Seat 3: YPAXAPA555 ($2.82 in chips) 
Seat 4: Scaaalll ($2.02 in chips) 
Seat 5: Zhyla95 ($2.23 in chips) 
Seat 6: Sergio Rigel ($2.19 in chips) 
Mikel226: posts small blind $0.01
YPAXAPA555: posts big blind $0.02
*** HOLE CARDS ***
Dealt to Scaaalll [7h Js]
Scaaalll: folds 
Zhyla95: folds 
Sergio Rigel: folds 
Munavili: raises $0.03 to $0.05
Mikel226: folds 
YPAXAPA555: folds 
Uncalled bet ($0.03) returned to Munavili
Munavili collected $0.05 from pot
Munavili: doesn't show hand 
*** SUMMARY ***
Total pot $0.05 | Rake $0 
Seat 1: Munavili (button) collected ($0.05)
Seat 2: Mikel226 (small blind) folded before Flop
Seat 3: YPAXAPA555 (big blind) folded before Flop
Seat 4: Scaaalll folded before Flop (didn't bet)
Seat 5: Zhyla95 folded before Flop (didn't bet)
Seat 6: Sergio Rigel folded before Flop (didn't bet)



PokerStars Zoom Hand #229229351112:  Hold'em No Limit ($0.01/$0.02) - 2021/08/21 20:56:30 CET [2021/08/21 14:56:30 ET]
Table 'Halley' 6-max Seat #1 is the button
Seat 1: Bubobubob ($2.98 in chips) 
Seat 2: ckooistra36 ($0.80 in chips) 
Seat 3: Scaaalll ($2.04 in chips) 
Seat 4: Taallt ($2 in chips) 
Seat 5: bAttery01 ($2 in chips) 
Seat 6: ximik D V ($2.29 in chips) 
ckooistra36: posts small blind $0.01
Scaaalll: posts big blind $0.02
*** HOLE CARDS ***
Dealt to Scaaalll [Jc Qh]
Taallt: folds 
bAttery01: folds 
ximik D V: raises $0.04 to $0.06
Bubobubob: raises $0.12 to $0.18
ckooistra36: folds 
Scaaalll: folds 
ximik D V: folds 
Uncalled bet ($0.12) returned to Bubobubob
Bubobubob collected $0.15 from pot
Bubobubob: doesn't show hand 
*** SUMMARY ***
Total pot $0.15 | Rake $0 
Seat 1: Bubobubob (button) collected ($0.15)
Seat 2: ckooistra36 (small blind) folded before Flop
Seat 3: Scaaalll (big blind) folded before Flop
Seat 4: Taallt folded before Flop (didn't bet)
Seat 5: bAttery01 folded before Flop (didn't bet)
Seat 6: ximik D V folded before Flop



PokerStars Zoom Hand #229229358744:  Hold'em No Limit ($0.01/$0.02) - 2021/08/21 20:56:56 CET [2021/08/21 14:56:56 ET]
Table 'Halley' 6-max Seat #1 is the button
Seat 1: Scaaalll ($2.02 in chips) 
Seat 2: VasquezSancho96 ($3.37 in chips) 
Seat 3: AlexRexer ($1.57 in chips) 
Seat 4: Alex_pro4747 ($1.76 in chips) 
Seat 5: Koldun 2636 ($2 in chips) 
Seat 6: Dmitri Anat ($0.41 in chips) 
VasquezSancho96: posts small blind $0.01
AlexRexer: posts big blind $0.02
*** HOLE CARDS ***
Dealt to Scaaalll [Ah 2h]
Alex_pro4747: raises $0.05 to $0.07
Koldun 2636: folds 
Dmitri Anat: calls $0.07
AlexRexer is disconnected 
Scaaalll: folds 
VasquezSancho96: raises $0.05 to $0.12
AlexRexer: folds 
Alex_pro4747: calls $0.05
Dmitri Anat: folds 
*** FLOP *** [3d Ts Qh]
VasquezSancho96: checks 
Alex_pro4747: bets $0.10
VasquezSancho96: calls $0.10
*** TURN *** [3d Ts Qh] [7s]
VasquezSancho96: checks 
Alex_pro4747: checks 
*** RIVER *** [3d Ts Qh 7s] [5s]
VasquezSancho96: bets $0.26
Alex_pro4747: calls $0.26
*** SHOW DOWN ***
VasquezSancho96: shows [5d 3h] (two pair, Fives and Threes)
Alex_pro4747: mucks hand 
VasquezSancho96 collected $1.01 from pot
*** SUMMARY ***
Total pot $1.05 | Rake $0.04 
Board [3d Ts Qh 7s 5s]
Seat 1: Scaaalll (button) folded before Flop (didn't bet)
Seat 2: VasquezSancho96 (small blind) showed [5d 3h] and won ($1.01) with two pair, Fives and Threes
Seat 3: AlexRexer (big blind) folded before Flop
Seat 4: Alex_pro4747 mucked [Qd As]
Seat 5: Koldun 2636 folded before Flop (didn't bet)
Seat 6: Dmitri Anat folded before Flop



PokerStars Zoom Hand #229229366698:  Hold'em No Limit ($0.01/$0.02) - 2021/08/21 20:57:24 CET [2021/08/21 14:57:24 ET]
Table 'Halley' 6-max Seat #1 is the button
Seat 1: the.fire71 ($3.21 in chips) 
Seat 2: Halbschatten ($2.35 in chips) 
Seat 3: fishh_play ($2.64 in chips) 
Seat 4: Scaaalll ($2.02 in chips) 
Seat 5: mMartie ($0.83 in chips) 
Seat 6: luckybadoo ($0.82 in chips) 
Halbschatten: posts small blind $0.01
fishh_play: posts big blind $0.02
*** HOLE CARDS ***
Dealt to Scaaalll [8c 5d]
Scaaalll: folds 
mMartie: folds 
luckybadoo: folds 
the.fire71: folds 
Halbschatten: raises $0.04 to $0.06
fishh_play: calls $0.04
*** FLOP *** [Ac 9h 4s]
Halbschatten: checks 
fishh_play: bets $0.07
Halbschatten: folds 
Uncalled bet ($0.07) returned to fishh_play
fishh_play collected $0.12 from pot
fishh_play: doesn't show hand 
*** SUMMARY ***
Total pot $0.12 | Rake $0 
Board [Ac 9h 4s]
Seat 1: the.fire71 (button) folded before Flop (didn't bet)
Seat 2: Halbschatten (small blind) folded on the Flop
Seat 3: fishh_play (big blind) collected ($0.12)
Seat 4: Scaaalll folded before Flop (didn't bet)
Seat 5: mMartie folded before Flop (didn't bet)
Seat 6: luckybadoo folded before Flop (didn't bet)



PokerStars Zoom Hand #229229368125:  Hold'em No Limit ($0.01/$0.02) - 2021/08/21 20:57:28 CET [2021/08/21 14:57:28 ET]
Table 'Halley' 6-max Seat #1 is the button
Seat 1: z.tank.71 ($1.62 in chips) 
Seat 2: Scaaalll ($2.02 in chips) 
Seat 3: tosticious ($2 in chips) 
Seat 4: Loto70 ($3.68 in chips) 
Seat 5: estelionat171 ($1.10 in chips) 
Seat 6: bAttery01 ($2 in chips) 
Scaaalll: posts small blind $0.01
tosticious: posts big blind $0.02
*** HOLE CARDS ***
Dealt to Scaaalll [Qc 8d]
Loto70: raises $0.03 to $0.05
estelionat171: folds 
bAttery01: folds 
z.tank.71: folds 
Scaaalll: folds 
tosticious: folds 
Uncalled bet ($0.03) returned to Loto70
Loto70 collected $0.05 from pot
Loto70: doesn't show hand 
*** SUMMARY ***
Total pot $0.05 | Rake $0 
Seat 1: z.tank.71 (button) folded before Flop (didn't bet)
Seat 2: Scaaalll (small blind) folded before Flop
Seat 3: tosticious (big blind) folded before Flop
Seat 4: Loto70 collected ($0.05)
Seat 5: estelionat171 folded before Flop (didn't bet)
Seat 6: bAttery01 folded before Flop (didn't bet)



PokerStars Zoom Hand #229229363698:  Hold'em No Limit ($0.01/$0.02) - 2021/08/21 20:57:14 CET [2021/08/21 14:57:14 ET]
Table 'Halley' 6-max Seat #1 is the button
Seat 1: yositoas ($2.07 in chips) 
Seat 2: Shoxuzb ($6.72 in chips) 
Seat 3: Clavis Noa ($2.61 in chips) 
Seat 4: BDFather ($3.44 in chips) 
Seat 5: Scaaalll ($2.02 in chips) 
Seat 6: AndreaBsAs ($2.02 in chips) 
Shoxuzb: posts small blind $0.01
Clavis Noa: posts big blind $0.02
*** HOLE CARDS ***
Dealt to Scaaalll [6c 4c]
BDFather: folds 
Scaaalll: folds 
AndreaBsAs: folds 
yositoas: raises $0.03 to $0.05
Shoxuzb: calls $0.04
Clavis Noa: folds 
*** FLOP *** [7h Qd 5h]
Shoxuzb: checks 
yositoas: bets $0.04
Shoxuzb: calls $0.04
*** TURN *** [7h Qd 5h] [8h]
Shoxuzb: checks 
yositoas: checks 
*** RIVER *** [7h Qd 5h 8h] [3s]
Shoxuzb: bets $0.11
yositoas: folds 
Uncalled bet ($0.11) returned to Shoxuzb
Shoxuzb collected $0.19 from pot
Shoxuzb: doesn't show hand 
*** SUMMARY ***
Total pot $0.20 | Rake $0.01 
Board [7h Qd 5h 8h 3s]
Seat 1: yositoas (button) folded on the River
Seat 2: Shoxuzb (small blind) collected ($0.19)
Seat 3: Clavis Noa (big blind) folded before Flop
Seat 4: BDFather folded before Flop (didn't bet)
Seat 5: Scaaalll folded before Flop (didn't bet)
Seat 6: AndreaBsAs folded before Flop (didn't bet)



PokerStars Zoom Hand #229229370524:  Hold'em No Limit ($0.01/$0.02) - 2021/08/21 20:57:36 CET [2021/08/21 14:57:36 ET]
Table 'Halley' 6-max Seat #1 is the button
Seat 1: cord86 ($2.71 in chips) 
Seat 2: bigthereal ($2.43 in chips) 
Seat 3: Scaaalll ($2.01 in chips) 
Seat 4: man070707 ($0.92 in chips) 
Seat 5: Natali172737 ($2.53 in chips) 
Seat 6: Hallyson_23 ($2 in chips) 
bigthereal: posts small blind $0.01
Scaaalll: posts big blind $0.02
*** HOLE CARDS ***
Dealt to Scaaalll [Qs Tc]
man070707: folds 
Natali172737: folds 
man070707 is disconnected 
Hallyson_23: folds 
cord86: folds 
bigthereal: raises $0.02 to $0.04
Scaaalll: calls $0.02
*** FLOP *** [2d 3c 6s]
bigthereal: checks 
Scaaalll: checks 
*** TURN *** [2d 3c 6s] [Qh]
bigthereal: checks 
Scaaalll: bets $0.04
bigthereal: folds 
Uncalled bet ($0.04) returned to Scaaalll
Scaaalll collected $0.08 from pot
Scaaalll: doesn't show hand 
*** SUMMARY ***
Total pot $0.08 | Rake $0 
Board [2d 3c 6s Qh]
Seat 1: cord86 (button) folded before Flop (didn't bet)
Seat 2: bigthereal (small blind) folded on the Turn
Seat 3: Scaaalll (big blind) collected ($0.08)
Seat 4: man070707 folded before Flop (didn't bet)
Seat 5: Natali172737 folded before Flop (didn't bet)
Seat 6: Hallyson_23 folded before Flop (didn't bet)



PokerStars Zoom Hand #229229381491:  Hold'em No Limit ($0.01/$0.02) - 2021/08/21 20:58:13 CET [2021/08/21 14:58:13 ET]
Table 'Halley' 6-max Seat #1 is the button
Seat 1: musirov ($2.76 in chips) 
Seat 2: sewq55 ($1.28 in chips) 
Seat 3: Laonikos ($3.38 in chips) 
Seat 4: PlayPokerHappy1 ($2 in chips) 
Seat 5: Scaaalll ($2.05 in chips) 
Seat 6: 01527368 ($4.08 in chips) 
sewq55: posts small blind $0.01
Laonikos: posts big blind $0.02
*** HOLE CARDS ***
Dealt to Scaaalll [Kh Ac]
PlayPokerHappy1: folds 
Scaaalll: raises $0.04 to $0.06
01527368: folds 
musirov: folds 
sewq55: folds 
Laonikos: folds 
Uncalled bet ($0.04) returned to Scaaalll
Scaaalll collected $0.05 from pot
Scaaalll: doesn't show hand 
*** SUMMARY ***
Total pot $0.05 | Rake $0 
Seat 1: musirov (button) folded before Flop (didn't bet)
Seat 2: sewq55 (small blind) folded before Flop
Seat 3: Laonikos (big blind) folded before Flop
Seat 4: PlayPokerHappy1 folded before Flop (didn't bet)
Seat 5: Scaaalll collected ($0.05)
Seat 6: 01527368 folded before Flop (didn't bet)



PokerStars Zoom Hand #229229385328:  Hold'em No Limit ($0.01/$0.02) - 2021/08/21 20:58:26 CET [2021/08/21 14:58:26 ET]
Table 'Halley' 6-max Seat #1 is the button
Seat 1: FishOnPlate ($2.03 in chips) 
Seat 2: Scaaalll ($2.08 in chips) 
Seat 3: thiagohbueno ($1.69 in chips) 
Seat 4: andreydgk ($2.73 in chips) 
Seat 5: valua976 ($0.82 in chips) 
Seat 6: Victor151886 ($2.16 in chips) 
Scaaalll: posts small blind $0.01
thiagohbueno: posts big blind $0.02
*** HOLE CARDS ***
Dealt to Scaaalll [Qd 2h]
andreydgk: folds 
valua976: folds 
Victor151886: folds 
FishOnPlate: raises $0.03 to $0.05
Scaaalll: folds 
thiagohbueno: folds 
Uncalled bet ($0.03) returned to FishOnPlate
FishOnPlate collected $0.05 from pot
FishOnPlate: doesn't show hand 
*** SUMMARY ***
Total pot $0.05 | Rake $0 
Seat 1: FishOnPlate (button) collected ($0.05)
Seat 2: Scaaalll (small blind) folded before Flop
Seat 3: thiagohbueno (big blind) folded before Flop
Seat 4: andreydgk folded before Flop (didn't bet)
Seat 5: valua976 folded before Flop (didn't bet)
Seat 6: Victor151886 folded before Flop (didn't bet)



PokerStars Zoom Hand #229229393465:  Hold'em No Limit ($0.01/$0.02) - 2021/08/21 20:58:53 CET [2021/08/21 14:58:53 ET]
Table 'Halley' 6-max Seat #1 is the button
Seat 1: Scaaalll ($2.07 in chips) 
Seat 2: AndreaBsAs ($2.02 in chips) 
Seat 3: E Z TAKEDOWN ($2.38 in chips) 
Seat 4: Loto70 ($2.76 in chips) 
Seat 5: olga3021221 ($2.33 in chips) 
Seat 6: renova0813 ($13.57 in chips) 
AndreaBsAs: posts small blind $0.01
E Z TAKEDOWN: posts big blind $0.02
*** HOLE CARDS ***
Dealt to Scaaalll [7d 3s]
Loto70: raises $0.03 to $0.05
olga3021221: folds 
renova0813: folds 
Scaaalll: folds 
AndreaBsAs: folds 
E Z TAKEDOWN: folds 
Uncalled bet ($0.03) returned to Loto70
Loto70 collected $0.05 from pot
Loto70: doesn't show hand 
*** SUMMARY ***
Total pot $0.05 | Rake $0 
Seat 1: Scaaalll (button) folded before Flop (didn't bet)
Seat 2: AndreaBsAs (small blind) folded before Flop
Seat 3: E Z TAKEDOWN (big blind) folded before Flop
Seat 4: Loto70 collected ($0.05)
Seat 5: olga3021221 folded before Flop (didn't bet)
Seat 6: renova0813 folded before Flop (didn't bet)



PokerStars Zoom Hand #229229391339:  Hold'em No Limit ($0.01/$0.02) - 2021/08/21 20:58:47 CET [2021/08/21 14:58:47 ET]
Table 'Halley' 6-max Seat #1 is the button
Seat 1: CréééW!!! ($1.09 in chips) 
Seat 2: olga3021221 ($2.34 in chips) 
Seat 3: valua976 ($0.82 in chips) 
Seat 4: no way yo ($4.59 in chips) 
Seat 5: cord86 ($2 in chips) 
Seat 6: Scaaalll ($2.07 in chips) 
olga3021221: posts small blind $0.01
valua976: posts big blind $0.02
*** HOLE CARDS ***
Dealt to Scaaalll [Js 2s]
no way yo: folds 
cord86: folds 
Scaaalll: folds 
CréééW!!! has timed out
CréééW!!!: folds 
olga3021221: folds 
Uncalled bet ($0.01) returned to valua976
valua976 collected $0.02 from pot
valua976: doesn't show hand 
*** SUMMARY ***
Total pot $0.02 | Rake $0 
Seat 1: CréééW!!! (button) folded before Flop (didn't bet)
Seat 2: olga3021221 (small blind) folded before Flop
Seat 3: valua976 (big blind) collected ($0.02)
Seat 4: no way yo folded before Flop (didn't bet)
Seat 5: cord86 folded before Flop (didn't bet)
Seat 6: Scaaalll folded before Flop (didn't bet)



PokerStars Zoom Hand #229229397931:  Hold'em No Limit ($0.01/$0.02) - 2021/08/21 20:59:08 CET [2021/08/21 14:59:08 ET]
Table 'Halley' 6-max Seat #1 is the button
Seat 1: klausC3 ($3.01 in chips) 
Seat 2: tosticious ($2.16 in chips) 
Seat 3: xxRoseIloveu ($2.04 in chips) 
Seat 4: Munavili ($2.25 in chips) 
Seat 5: cruisinjack ($1.25 in chips) 
Seat 6: Scaaalll ($2.07 in chips) 
tosticious: posts small blind $0.01
xxRoseIloveu: posts big blind $0.02
*** HOLE CARDS ***
Dealt to Scaaalll [Kc Ad]
Munavili: folds 
cruisinjack: folds 
Scaaalll: raises $0.04 to $0.06
klausC3: raises $0.12 to $0.18
tosticious: folds 
xxRoseIloveu: folds 
Scaaalll: raises $0.28 to $0.46
klausC3: folds 
Uncalled bet ($0.28) returned to Scaaalll
Scaaalll collected $0.39 from pot
Scaaalll: doesn't show hand 
*** SUMMARY ***
Total pot $0.39 | Rake $0 
Seat 1: klausC3 (button) folded before Flop
Seat 2: tosticious (small blind) folded before Flop
Seat 3: xxRoseIloveu (big blind) folded before Flop
Seat 4: Munavili folded before Flop (didn't bet)
Seat 5: cruisinjack folded before Flop (didn't bet)
Seat 6: Scaaalll collected ($0.39)



PokerStars Zoom Hand #229229396761:  Hold'em No Limit ($0.01/$0.02) - 2021/08/21 20:59:04 CET [2021/08/21 14:59:04 ET]
Table 'Halley' 6-max Seat #1 is the button
Seat 1: Berti281 ($2.07 in chips) 
Seat 2: Pokerkass ($3.22 in chips) 
Seat 3: ggGoldenPunk ($2.84 in chips) 
Seat 4: Scaaalll ($2.07 in chips) 
Seat 5: Bauruteam2 ($2.25 in chips) 
Seat 6: PaddyPoland ($2.24 in chips) 
Pokerkass: posts small blind $0.01
ggGoldenPunk: posts big blind $0.02
*** HOLE CARDS ***
Dealt to Scaaalll [3h Ad]
Scaaalll: folds 
Bauruteam2: folds 
PaddyPoland: folds 
Berti281: raises $0.03 to $0.05
Pokerkass: calls $0.04
ggGoldenPunk: calls $0.03
*** FLOP *** [Kc 6s 9h]
Pokerkass: checks 
ggGoldenPunk: checks 
Berti281: checks 
*** TURN *** [Kc 6s 9h] [Jd]
Pokerkass: checks 
ggGoldenPunk: checks 
Berti281: checks 
*** RIVER *** [Kc 6s 9h Jd] [2c]
Pokerkass: checks 
ggGoldenPunk: checks 
Berti281: bets $0.06
Pokerkass: calls $0.06
ggGoldenPunk: calls $0.06
*** SHOW DOWN ***
Berti281: shows [As Jh] (a pair of Jacks)
Pokerkass: mucks hand 
ggGoldenPunk: mucks hand 
Berti281 collected $0.32 from pot
*** SUMMARY ***
Total pot $0.33 | Rake $0.01 
Board [Kc 6s 9h Jd 2c]
Seat 1: Berti281 (button) showed [As Jh] and won ($0.32) with a pair of Jacks
Seat 2: Pokerkass (small blind) mucked [2h Ah]
Seat 3: ggGoldenPunk (big blind) mucked [7d 9d]
Seat 4: Scaaalll folded before Flop (didn't bet)
Seat 5: Bauruteam2 folded before Flop (didn't bet)
Seat 6: PaddyPoland folded before Flop (didn't bet)



PokerStars Zoom Hand #229229413907:  Hold'em No Limit ($0.01/$0.02) - 2021/08/21 21:00:02 CET [2021/08/21 15:00:02 ET]
Table 'Halley' 6-max Seat #1 is the button
Seat 1: qpsq ($2 in chips) 
Seat 2: so0love ($3.68 in chips) 
Seat 3: Henry Chinasky ($16.71 in chips) 
Seat 4: renova0813 ($11.89 in chips) 
Seat 5: Scaaalll ($2.26 in chips) 
Seat 6: Ne0net ($2.89 in chips) 
so0love: posts small blind $0.01
Henry Chinasky: posts big blind $0.02
*** HOLE CARDS ***
Dealt to Scaaalll [4s Kc]
renova0813: folds 
Scaaalll: folds 
Ne0net: folds 
qpsq: folds 
so0love: folds 
Uncalled bet ($0.01) returned to Henry Chinasky
Henry Chinasky collected $0.02 from pot
Henry Chinasky: doesn't show hand 
*** SUMMARY ***
Total pot $0.02 | Rake $0 
Seat 1: qpsq (button) folded before Flop (didn't bet)
Seat 2: so0love (small blind) folded before Flop
Seat 3: Henry Chinasky (big blind) collected ($0.02)
Seat 4: renova0813 folded before Flop (didn't bet)
Seat 5: Scaaalll folded before Flop (didn't bet)
Seat 6: Ne0net folded before Flop (didn't bet)



PokerStars Zoom Hand #229229417659:  Hold'em No Limit ($0.01/$0.02) - 2021/08/21 21:00:13 CET [2021/08/21 15:00:13 ET]
Table 'Halley' 6-max Seat #1 is the button
Seat 1: Scaaalll ($2.26 in chips) 
Seat 2: SideshowPen ($2 in chips) 
Seat 3: KoAlRy ($2 in chips) 
Seat 4: stealth_ua ($3.12 in chips) 
Seat 5: Flankeris ($2.64 in chips) 
Seat 6: Addon289174 ($3.04 in chips) 
SideshowPen: posts small blind $0.01
KoAlRy: posts big blind $0.02
*** HOLE CARDS ***
Dealt to Scaaalll [8d 6s]
stealth_ua: folds 
Flankeris: folds 
Addon289174: folds 
Scaaalll: folds 
SideshowPen: raises $0.04 to $0.06
KoAlRy: folds 
Uncalled bet ($0.04) returned to SideshowPen
SideshowPen collected $0.04 from pot
SideshowPen: doesn't show hand 
*** SUMMARY ***
Total pot $0.04 | Rake $0 
Seat 1: Scaaalll (button) folded before Flop (didn't bet)
Seat 2: SideshowPen (small blind) collected ($0.04)
Seat 3: KoAlRy (big blind) folded before Flop
Seat 4: stealth_ua folded before Flop (didn't bet)
Seat 5: Flankeris folded before Flop (didn't bet)
Seat 6: Addon289174 folded before Flop (didn't bet)



PokerStars Zoom Hand #229229408398:  Hold'em No Limit ($0.01/$0.02) - 2021/08/21 20:59:43 CET [2021/08/21 14:59:43 ET]
Table 'Halley' 6-max Seat #1 is the button
Seat 1: nyuta77 ($0.64 in chips) 
Seat 2: iPitbull1 ($2.92 in chips) 
Seat 3: Scaaalll ($2.28 in chips) 
Seat 4: Fedor_Gar ($2 in chips) 
Seat 5: rideofpoker ($1.91 in chips) 
Seat 6: so0love ($2.51 in chips) 
iPitbull1: posts small blind $0.01
Scaaalll: posts big blind $0.02
*** HOLE CARDS ***
Dealt to Scaaalll [2h Kd]
Fedor_Gar: folds 
rideofpoker: folds 
so0love: folds 
nyuta77: raises $0.02 to $0.04
iPitbull1: raises $0.12 to $0.16
Scaaalll: folds 
nyuta77: calls $0.12
*** FLOP *** [5c 4c 4s]
iPitbull1: checks 
nyuta77: checks 
*** TURN *** [5c 4c 4s] [5h]
iPitbull1: checks 
nyuta77: checks 
*** RIVER *** [5c 4c 4s 5h] [6h]
iPitbull1: checks 
nyuta77: checks 
*** SHOW DOWN ***
iPitbull1: shows [Ks Ah] (two pair, Fives and Fours)
nyuta77: shows [As 7s] (two pair, Fives and Fours)
iPitbull1 collected $0.17 from pot
nyuta77 collected $0.16 from pot
*** SUMMARY ***
Total pot $0.34 | Rake $0.01 
Board [5c 4c 4s 5h 6h]
Seat 1: nyuta77 (button) showed [As 7s] and won ($0.16) with two pair, Fives and Fours
Seat 2: iPitbull1 (small blind) showed [Ks Ah] and won ($0.17) with two pair, Fives and Fours
Seat 3: Scaaalll (big blind) folded before Flop
Seat 4: Fedor_Gar folded before Flop (didn't bet)
Seat 5: rideofpoker folded before Flop (didn't bet)
Seat 6: so0love folded before Flop (didn't bet)



PokerStars Zoom Hand #229229418990:  Hold'em No Limit ($0.01/$0.02) - 2021/08/21 21:00:17 CET [2021/08/21 15:00:17 ET]
Table 'Halley' 6-max Seat #1 is the button
Seat 1: 77omsk ($5.98 in chips) 
Seat 2: Scaaalll ($2.26 in chips) 
Seat 3: andreydgk ($2.62 in chips) 
Seat 4: fishh_play ($2.30 in chips) 
Seat 5: Vizator ($2.54 in chips) 
Seat 6: LalaBee21 ($2.27 in chips) 
Scaaalll: posts small blind $0.01
andreydgk: posts big blind $0.02
*** HOLE CARDS ***
Dealt to Scaaalll [2h Tc]
fishh_play: folds 
Vizator: folds 
LalaBee21: raises $0.04 to $0.06
77omsk: folds 
Scaaalll: folds 
andreydgk: raises $0.12 to $0.18
LalaBee21: folds 
Uncalled bet ($0.12) returned to andreydgk
andreydgk collected $0.13 from pot
andreydgk: doesn't show hand 
*** SUMMARY ***
Total pot $0.13 | Rake $0 
Seat 1: 77omsk (button) folded before Flop (didn't bet)
Seat 2: Scaaalll (small blind) folded before Flop
Seat 3: andreydgk (big blind) collected ($0.13)
Seat 4: fishh_play folded before Flop (didn't bet)
Seat 5: Vizator folded before Flop (didn't bet)
Seat 6: LalaBee21 folded before Flop



PokerStars Zoom Hand #229229432129:  Hold'em No Limit ($0.01/$0.02) - 2021/08/21 21:00:56 CET [2021/08/21 15:00:56 ET]
Table 'Halley' 6-max Seat #1 is the button
Seat 1: Adekvat.ua ($1.39 in chips) 
Seat 2: AligatorsBlood ($2.04 in chips) 
Seat 3: Scaaalll ($2.25 in chips) 
Seat 4: PaddyPoland ($2.20 in chips) 
Seat 5: cabe839 ($2.36 in chips) 
Seat 6: KRITAYA ($1.20 in chips) 
AligatorsBlood: posts small blind $0.01
Scaaalll: posts big blind $0.02
*** HOLE CARDS ***
Dealt to Scaaalll [3d 5s]
PaddyPoland: folds 
cabe839: raises $0.03 to $0.05
KRITAYA: folds 
Adekvat.ua: folds 
AligatorsBlood: folds 
Scaaalll: folds 
Uncalled bet ($0.03) returned to cabe839
cabe839 collected $0.05 from pot
cabe839: doesn't show hand 
*** SUMMARY ***
Total pot $0.05 | Rake $0 
Seat 1: Adekvat.ua (button) folded before Flop (didn't bet)
Seat 2: AligatorsBlood (small blind) folded before Flop
Seat 3: Scaaalll (big blind) folded before Flop
Seat 4: PaddyPoland folded before Flop (didn't bet)
Seat 5: cabe839 collected ($0.05)
Seat 6: KRITAYA folded before Flop (didn't bet)



PokerStars Zoom Hand #229229430731:  Hold'em No Limit ($0.01/$0.02) - 2021/08/21 21:00:52 CET [2021/08/21 15:00:52 ET]
Table 'Halley' 6-max Seat #1 is the button
Seat 1: StAntoha ($2.90 in chips) 
Seat 2: BIITRU ($3.46 in chips) 
Seat 3: syndikkat ($2.30 in chips) 
Seat 4: no way yo ($1.30 in chips) 
Seat 5: Scaaalll ($2.25 in chips) 
Seat 6: Brigistul ($2.27 in chips) 
BIITRU: posts small blind $0.01
syndikkat: posts big blind $0.02
*** HOLE CARDS ***
Dealt to Scaaalll [8h As]
no way yo: folds 
Scaaalll: folds 
Brigistul: folds 
StAntoha has timed out
StAntoha: folds 
BIITRU: folds 
Uncalled bet ($0.01) returned to syndikkat
syndikkat collected $0.02 from pot
syndikkat: doesn't show hand 
*** SUMMARY ***
Total pot $0.02 | Rake $0 
Seat 1: StAntoha (button) folded before Flop (didn't bet)
Seat 2: BIITRU (small blind) folded before Flop
Seat 3: syndikkat (big blind) collected ($0.02)
Seat 4: no way yo folded before Flop (didn't bet)
Seat 5: Scaaalll folded before Flop (didn't bet)
Seat 6: Brigistul folded before Flop (didn't bet)



PokerStars Zoom Hand #229229437865:  Hold'em No Limit ($0.01/$0.02) - 2021/08/21 21:01:07 CET [2021/08/21 15:01:07 ET]
Table 'Halley' 6-max Seat #1 is the button
Seat 1: shingo594 ($2.42 in chips) 
Seat 2: Sharabora ($0.98 in chips) 
Seat 3: Akrobat94 ($1.27 in chips) 
Seat 4: der Kater464 ($3.37 in chips) 
Seat 5: 77omsk ($5.95 in chips) 
Seat 6: Scaaalll ($2.23 in chips) 
Sharabora: posts small blind $0.01
Akrobat94: posts big blind $0.02
*** HOLE CARDS ***
Dealt to Scaaalll [9d 6d]
der Kater464: folds 
77omsk: folds 
Scaaalll: folds 
shingo594: raises $0.04 to $0.06
Sharabora: folds 
Akrobat94: folds 
Uncalled bet ($0.04) returned to shingo594
shingo594 collected $0.05 from pot
shingo594: doesn't show hand 
Akrobat94 is disconnected 
*** SUMMARY ***
Total pot $0.05 | Rake $0 
Seat 1: shingo594 (button) collected ($0.05)
Seat 2: Sharabora (small blind) folded before Flop
Seat 3: Akrobat94 (big blind) folded before Flop
Seat 4: der Kater464 folded before Flop (didn't bet)
Seat 5: 77omsk folded before Flop (didn't bet)
Seat 6: Scaaalll folded before Flop (didn't bet)



PokerStars Zoom Hand #229229443048:  Hold'em No Limit ($0.01/$0.02) - 2021/08/21 21:01:18 CET [2021/08/21 15:01:18 ET]
Table 'Halley' 6-max Seat #1 is the button
Seat 1: klausC3 ($2.70 in chips) 
Seat 2: pavlo8855 ($2 in chips) 
Seat 3: nodtress ($2 in chips) 
Seat 4: Scaaalll ($2.23 in chips) 
Seat 5: billybob2009 ($0.94 in chips) 
Seat 6: JAQUEPOKER ($2.31 in chips) 
pavlo8855: posts small blind $0.01
nodtress: posts big blind $0.02
*** HOLE CARDS ***
Dealt to Scaaalll [5h 3c]
Scaaalll: folds 
billybob2009: folds 
JAQUEPOKER: folds 
klausC3: folds 
pavlo8855: raises $0.04 to $0.06
nodtress: folds 
Uncalled bet ($0.04) returned to pavlo8855
pavlo8855 collected $0.04 from pot
pavlo8855: doesn't show hand 
*** SUMMARY ***
Total pot $0.04 | Rake $0 
Seat 1: klausC3 (button) folded before Flop (didn't bet)
Seat 2: pavlo8855 (small blind) collected ($0.04)
Seat 3: nodtress (big blind) folded before Flop
Seat 4: Scaaalll folded before Flop (didn't bet)
Seat 5: billybob2009 folded before Flop (didn't bet)
Seat 6: JAQUEPOKER folded before Flop (didn't bet)



PokerStars Zoom Hand #229229445085:  Hold'em No Limit ($0.01/$0.02) - 2021/08/21 21:01:23 CET [2021/08/21 15:01:23 ET]
Table 'Halley' 6-max Seat #1 is the button
Seat 1: Zhyla95 ($2.03 in chips) 
Seat 2: Scaaalll ($2.23 in chips) 
Seat 3: FishOnPlate ($2 in chips) 
Seat 4: syndikkat ($2.28 in chips) 
Seat 5: 1_KoLizeI_1 ($2.46 in chips) 
Seat 6: Shadi8 ($2 in chips) 
Scaaalll: posts small blind $0.01
FishOnPlate: posts big blind $0.02
*** HOLE CARDS ***
Dealt to Scaaalll [8s 6s]
syndikkat: folds 
1_KoLizeI_1: folds 
Shadi8: folds 
Zhyla95: folds 
Scaaalll: raises $0.04 to $0.06
FishOnPlate: folds 
Uncalled bet ($0.04) returned to Scaaalll
Scaaalll collected $0.04 from pot
Scaaalll: doesn't show hand 
*** SUMMARY ***
Total pot $0.04 | Rake $0 
Seat 1: Zhyla95 (button) folded before Flop (didn't bet)
Seat 2: Scaaalll (small blind) collected ($0.04)
Seat 3: FishOnPlate (big blind) folded before Flop
Seat 4: syndikkat folded before Flop (didn't bet)
Seat 5: 1_KoLizeI_1 folded before Flop (didn't bet)
Seat 6: Shadi8 folded before Flop (didn't bet)



PokerStars Zoom Hand #229229450715:  Hold'em No Limit ($0.01/$0.02) - 2021/08/21 21:01:37 CET [2021/08/21 15:01:37 ET]
Table 'Halley' 6-max Seat #1 is the button
Seat 1: Scaaalll ($2.25 in chips) 
Seat 2: arsad725 ($3.83 in chips) 
Seat 3: pphit ($2 in chips) 
Seat 4: svire ($1.43 in chips) 
Seat 5: Sharabora ($0.82 in chips) 
Seat 6: HellNative ($3.42 in chips) 
arsad725: posts small blind $0.01
pphit: posts big blind $0.02
*** HOLE CARDS ***
Dealt to Scaaalll [2h 9d]
svire: folds 
Sharabora: folds 
HellNative: folds 
Scaaalll: folds 
arsad725: folds 
Uncalled bet ($0.01) returned to pphit
pphit collected $0.02 from pot
pphit: doesn't show hand 
*** SUMMARY ***
Total pot $0.02 | Rake $0 
Seat 1: Scaaalll (button) folded before Flop (didn't bet)
Seat 2: arsad725 (small blind) folded before Flop
Seat 3: pphit (big blind) collected ($0.02)
Seat 4: svire folded before Flop (didn't bet)
Seat 5: Sharabora folded before Flop (didn't bet)
Seat 6: HellNative folded before Flop (didn't bet)



PokerStars Zoom Hand #229229420323:  Hold'em No Limit ($0.01/$0.02) - 2021/08/21 21:00:21 CET [2021/08/21 15:00:21 ET]
Table 'Halley' 6-max Seat #1 is the button
Seat 1: olga3021221 ($2.23 in chips) 
Seat 2: Sul07 ($1.16 in chips) 
Seat 3: Salazar-MF ($2.27 in chips) 
Seat 4: Scaaalll ($2.25 in chips) 
Seat 5: danielschuel ($1.80 in chips) 
Seat 6: stealth_ua ($3.11 in chips) 
Sul07: posts small blind $0.01
Salazar-MF: posts big blind $0.02
*** HOLE CARDS ***
Dealt to Scaaalll [5d Kd]
Scaaalll has timed out
Scaaalll: folds 
danielschuel: folds 
stealth_ua: folds 
olga3021221: folds 
Sul07: raises $0.04 to $0.06
Salazar-MF: raises $0.12 to $0.18
Sul07: calls $0.12
*** FLOP *** [Td Ts 9h]
Sul07: checks 
Salazar-MF: bets $0.09
Sul07: calls $0.09
*** TURN *** [Td Ts 9h] [Ac]
Sul07: checks 
Salazar-MF: checks 
*** RIVER *** [Td Ts 9h Ac] [2d]
Sul07: bets $0.26
Salazar-MF: raises $1.74 to $2 and is all-in
Sul07: folds 
Uncalled bet ($1.74) returned to Salazar-MF
Salazar-MF collected $1.02 from pot
Salazar-MF: doesn't show hand 
*** SUMMARY ***
Total pot $1.06 | Rake $0.04 
Board [Td Ts 9h Ac 2d]
Seat 1: olga3021221 (button) folded before Flop (didn't bet)
Seat 2: Sul07 (small blind) folded on the River
Seat 3: Salazar-MF (big blind) collected ($1.02)
Seat 4: Scaaalll folded before Flop (didn't bet)
Seat 5: danielschuel folded before Flop (didn't bet)
Seat 6: stealth_ua folded before Flop (didn't bet)



PokerStars Zoom Hand #229229452188:  Hold'em No Limit ($0.01/$0.02) - 2021/08/21 21:01:41 CET [2021/08/21 15:01:41 ET]
Table 'Halley' 6-max Seat #1 is the button
Seat 1: svire ($1.43 in chips) 
Seat 2: aimar20006 ($3.12 in chips) 
Seat 3: Armando.Bordi ($2.19 in chips) 
Seat 4: Iv3rson18 ($2 in chips) 
Seat 5: Scaaalll ($2.25 in chips) 
Seat 6: svegnn ($4.01 in chips) 
aimar20006: posts small blind $0.01
Armando.Bordi: posts big blind $0.02
*** HOLE CARDS ***
Dealt to Scaaalll [9d Kd]
Iv3rson18: folds 
Scaaalll: raises $0.04 to $0.06
svegnn has timed out
svegnn: folds 
svire: folds 
aimar20006: folds 
svegnn is disconnected 
Armando.Bordi: calls $0.04
*** FLOP *** [5c 2h 4s]
Armando.Bordi: bets $0.07
Scaaalll: folds 
Uncalled bet ($0.07) returned to Armando.Bordi
Armando.Bordi collected $0.13 from pot
Armando.Bordi: doesn't show hand 
*** SUMMARY ***
Total pot $0.13 | Rake $0 
Board [5c 2h 4s]
Seat 1: svire (button) folded before Flop (didn't bet)
Seat 2: aimar20006 (small blind) folded before Flop
Seat 3: Armando.Bordi (big blind) collected ($0.13)
Seat 4: Iv3rson18 folded before Flop (didn't bet)
Seat 5: Scaaalll folded on the Flop
Seat 6: svegnn folded before Flop (didn't bet)



PokerStars Zoom Hand #229229469562:  Hold'em No Limit ($0.01/$0.02) - 2021/08/21 21:02:21 CET [2021/08/21 15:02:21 ET]
Table 'Halley' 6-max Seat #1 is the button
Seat 1: johniXL ($0.44 in chips) 
Seat 2: Natali172737 ($5.06 in chips) 
Seat 3: Scaaalll ($2.19 in chips) 
Seat 4: kahzura ($2 in chips) 
Seat 5: man070707 ($0.80 in chips) 
Seat 6: Sul07 ($0.63 in chips) 
Natali172737: posts small blind $0.01
Scaaalll: posts big blind $0.02
*** HOLE CARDS ***
Dealt to Scaaalll [5d 7h]
man070707 is disconnected 
kahzura: folds 
man070707: folds 
Sul07: folds 
johniXL: folds 
Natali172737: raises $0.03 to $0.05
Scaaalll: folds 
Uncalled bet ($0.03) returned to Natali172737
Natali172737 collected $0.04 from pot
Natali172737: doesn't show hand 
*** SUMMARY ***
Total pot $0.04 | Rake $0 
Seat 1: johniXL (button) folded before Flop (didn't bet)
Seat 2: Natali172737 (small blind) collected ($0.04)
Seat 3: Scaaalll (big blind) folded before Flop
Seat 4: kahzura folded before Flop (didn't bet)
Seat 5: man070707 folded before Flop (didn't bet)
Seat 6: Sul07 folded before Flop (didn't bet)



PokerStars Zoom Hand #229229480357:  Hold'em No Limit ($0.01/$0.02) - 2021/08/21 21:02:32 CET [2021/08/21 15:02:32 ET]
Table 'Halley' 6-max Seat #1 is the button
Seat 1: Grashüpferchen ($0.97 in chips) 
Seat 2: franquillooo ($2.91 in chips) 
Seat 3: VasquezSancho96 ($5.31 in chips) 
Seat 4: qpsq ($2.23 in chips) 
Seat 5: FishOnPlate ($2.05 in chips) 
Seat 6: Scaaalll ($2.17 in chips) 
franquillooo: posts small blind $0.01
VasquezSancho96: posts big blind $0.02
*** HOLE CARDS ***
Dealt to Scaaalll [3c Qc]
qpsq: folds 
FishOnPlate: folds 
Scaaalll: folds 
Grashüpferchen: folds 
franquillooo: folds 
Uncalled bet ($0.01) returned to VasquezSancho96
VasquezSancho96 collected $0.02 from pot
VasquezSancho96: doesn't show hand 
*** SUMMARY ***
Total pot $0.02 | Rake $0 
Seat 1: Grashüpferchen (button) folded before Flop (didn't bet)
Seat 2: franquillooo (small blind) folded before Flop
Seat 3: VasquezSancho96 (big blind) collected ($0.02)
Seat 4: qpsq folded before Flop (didn't bet)
Seat 5: FishOnPlate folded before Flop (didn't bet)
Seat 6: Scaaalll folded before Flop (didn't bet)



PokerStars Zoom Hand #229229482658:  Hold'em No Limit ($0.01/$0.02) - 2021/08/21 21:02:37 CET [2021/08/21 15:02:37 ET]
Table 'Halley' 6-max Seat #1 is the button
Seat 1: sigrivas ($4.05 in chips) 
Seat 2: PaddyPoland ($2 in chips) 
Seat 3: Xlavariable ($2.57 in chips) 
Seat 4: z3317111711 ($1.97 in chips) 
Seat 5: L00TS254 ($2.04 in chips) 
Seat 6: Scaaalll ($2.17 in chips) 
PaddyPoland: posts small blind $0.01
Xlavariable: posts big blind $0.02
*** HOLE CARDS ***
Dealt to Scaaalll [5h Qs]
z3317111711: folds 
L00TS254: folds 
Scaaalll: folds 
sigrivas: raises $0.08 to $0.10
PaddyPoland: folds 
Xlavariable: folds 
Uncalled bet ($0.08) returned to sigrivas
sigrivas collected $0.05 from pot
sigrivas: doesn't show hand 
*** SUMMARY ***
Total pot $0.05 | Rake $0 
Seat 1: sigrivas (button) collected ($0.05)
Seat 2: PaddyPoland (small blind) folded before Flop
Seat 3: Xlavariable (big blind) folded before Flop
Seat 4: z3317111711 folded before Flop (didn't bet)
Seat 5: L00TS254 folded before Flop (didn't bet)
Seat 6: Scaaalll folded before Flop (didn't bet)



PokerStars Zoom Hand #229229486269:  Hold'em No Limit ($0.01/$0.02) - 2021/08/21 21:02:46 CET [2021/08/21 15:02:46 ET]
Table 'Halley' 6-max Seat #1 is the button
Seat 1: SIGREX ($2 in chips) 
Seat 2: Tj741 ($4 in chips) 
Seat 3: Sul07 ($0.63 in chips) 
Seat 4: RoughRafff ($2.07 in chips) 
Seat 5: Scaaalll ($2.17 in chips) 
Seat 6: RoyaLLRus ($1.60 in chips) 
Tj741: posts small blind $0.01
Sul07: posts big blind $0.02
*** HOLE CARDS ***
Dealt to Scaaalll [3c Td]
RoughRafff: folds 
Scaaalll: folds 
RoyaLLRus: folds 
SIGREX: folds 
Tj741: folds 
Uncalled bet ($0.01) returned to Sul07
Sul07 collected $0.02 from pot
Sul07: doesn't show hand 
*** SUMMARY ***
Total pot $0.02 | Rake $0 
Seat 1: SIGREX (button) folded before Flop (didn't bet)
Seat 2: Tj741 (small blind) folded before Flop
Seat 3: Sul07 (big blind) collected ($0.02)
Seat 4: RoughRafff folded before Flop (didn't bet)
Seat 5: Scaaalll folded before Flop (didn't bet)
Seat 6: RoyaLLRus folded before Flop (didn't bet)



PokerStars Zoom Hand #229229487991:  Hold'em No Limit ($0.01/$0.02) - 2021/08/21 21:02:49 CET [2021/08/21 15:02:49 ET]
Table 'Halley' 6-max Seat #1 is the button
Seat 1: rassew ($4.07 in chips) 
Seat 2: Anan71 ($1.97 in chips) 
Seat 3: zeus11983 ($2.03 in chips) 
Seat 4: Scaaalll ($2.17 in chips) 
Seat 5: SideshowPen ($2.30 in chips) 
Seat 6: the.fire71 ($2.93 in chips) 
Anan71: posts small blind $0.01
zeus11983: posts big blind $0.02
*** HOLE CARDS ***
Dealt to Scaaalll [Th Ad]
Scaaalll: raises $0.04 to $0.06
SideshowPen: folds 
the.fire71: folds 
Anan71 is disconnected 
rassew: folds 
Anan71: folds 
zeus11983: folds 
Uncalled bet ($0.04) returned to Scaaalll
Scaaalll collected $0.05 from pot
Scaaalll: doesn't show hand 
*** SUMMARY ***
Total pot $0.05 | Rake $0 
Seat 1: rassew (button) folded before Flop (didn't bet)
Seat 2: Anan71 (small blind) folded before Flop
Seat 3: zeus11983 (big blind) folded before Flop
Seat 4: Scaaalll collected ($0.05)
Seat 5: SideshowPen folded before Flop (didn't bet)
Seat 6: the.fire71 folded before Flop (didn't bet)



PokerStars Zoom Hand #229229497082:  Hold'em No Limit ($0.01/$0.02) - 2021/08/21 21:03:10 CET [2021/08/21 15:03:10 ET]
Table 'Halley' 6-max Seat #1 is the button
Seat 1: jftd123 ($2.04 in chips) 
Seat 2: Scaaalll ($2.20 in chips) 
Seat 3: gugamoraes ($2 in chips) 
Seat 4: Victor151886 ($4.81 in chips) 
Seat 5: JDGGrinder ($2.03 in chips) 
Seat 6: picuur ($1.19 in chips) 
Scaaalll: posts small blind $0.01
gugamoraes: posts big blind $0.02
*** HOLE CARDS ***
Dealt to Scaaalll [8c 4h]
Victor151886: folds 
JDGGrinder: raises $0.02 to $0.04
picuur: folds 
jftd123: calls $0.04
Scaaalll: folds 
gugamoraes: folds 
*** FLOP *** [2c 2s 3c]
JDGGrinder: checks 
jftd123: bets $0.06
JDGGrinder: calls $0.06
*** TURN *** [2c 2s 3c] [Kh]
JDGGrinder: checks 
jftd123: bets $0.06
JDGGrinder: calls $0.06
*** RIVER *** [2c 2s 3c Kh] [7d]
JDGGrinder: bets $0.07
jftd123: calls $0.07
*** SHOW DOWN ***
JDGGrinder: shows [7c 6c] (two pair, Sevens and Deuces)
jftd123: shows [Qh Qd] (two pair, Queens and Deuces)
jftd123 collected $0.47 from pot
*** SUMMARY ***
Total pot $0.49 | Rake $0.02 
Board [2c 2s 3c Kh 7d]
Seat 1: jftd123 (button) showed [Qh Qd] and won ($0.47) with two pair, Queens and Deuces
Seat 2: Scaaalll (small blind) folded before Flop
Seat 3: gugamoraes (big blind) folded before Flop
Seat 4: Victor151886 folded before Flop (didn't bet)
Seat 5: JDGGrinder showed [7c 6c] and lost with two pair, Sevens and Deuces
Seat 6: picuur folded before Flop (didn't bet)



PokerStars Zoom Hand #229229498927:  Hold'em No Limit ($0.01/$0.02) - 2021/08/21 21:03:14 CET [2021/08/21 15:03:14 ET]
Table 'Halley' 6-max Seat #1 is the button
Seat 1: Scaaalll ($2.19 in chips) 
Seat 2: Shoxuzb ($7.84 in chips) 
Seat 3: kwant33 ($4.12 in chips) 
Seat 4: jaamonra ($4.03 in chips) 
Seat 5: Sparrovv ($2 in chips) 
Seat 6: Shadi8 ($2.13 in chips) 
Shoxuzb: posts small blind $0.01
kwant33: posts big blind $0.02
*** HOLE CARDS ***
Dealt to Scaaalll [Tc Kc]
jaamonra: folds 
Sparrovv: folds 
Shoxuzb is disconnected 
Shadi8: raises $0.04 to $0.06
Scaaalll: calls $0.06
Shoxuzb: folds 
kwant33: folds 
*** FLOP *** [3d 7d 4c]
Shadi8: checks 
Scaaalll: bets $0.08
Shadi8: calls $0.08
*** TURN *** [3d 7d 4c] [6d]
Shadi8: checks 
Scaaalll: checks 
*** RIVER *** [3d 7d 4c 6d] [Qd]
Shadi8: checks 
Scaaalll: checks 
*** SHOW DOWN ***
Shadi8: shows [Ah Qs] (a pair of Queens)
Scaaalll: mucks hand 
Shadi8 collected $0.30 from pot
*** SUMMARY ***
Total pot $0.31 | Rake $0.01 
Board [3d 7d 4c 6d Qd]
Seat 1: Scaaalll (button) mucked [Tc Kc]
Seat 2: Shoxuzb (small blind) folded before Flop
Seat 3: kwant33 (big blind) folded before Flop
Seat 4: jaamonra folded before Flop (didn't bet)
Seat 5: Sparrovv folded before Flop (didn't bet)
Seat 6: Shadi8 showed [Ah Qs] and won ($0.30) with a pair of Queens



PokerStars Zoom Hand #229229534800:  Hold'em No Limit ($0.01/$0.02) - 2021/08/21 21:04:35 CET [2021/08/21 15:04:35 ET]
Table 'Halley' 6-max Seat #1 is the button
Seat 1: Scaaalll ($2.03 in chips) 
Seat 2: AndreaBsAs ($2.15 in chips) 
Seat 3: S.B.O190 ($2.53 in chips) 
Seat 4: luckybadoo ($1.31 in chips) 
Seat 5: vindoffree ($1.52 in chips) 
Seat 6: HellNative ($2.57 in chips) 
AndreaBsAs: posts small blind $0.01
S.B.O190: posts big blind $0.02
*** HOLE CARDS ***
Dealt to Scaaalll [Tc 5h]
luckybadoo: folds 
vindoffree: raises $0.04 to $0.06
HellNative: folds 
Scaaalll: folds 
AndreaBsAs: folds 
S.B.O190: folds 
Uncalled bet ($0.04) returned to vindoffree
vindoffree collected $0.05 from pot
vindoffree: doesn't show hand 
*** SUMMARY ***
Total pot $0.05 | Rake $0 
Seat 1: Scaaalll (button) folded before Flop (didn't bet)
Seat 2: AndreaBsAs (small blind) folded before Flop
Seat 3: S.B.O190 (big blind) folded before Flop
Seat 4: luckybadoo folded before Flop (didn't bet)
Seat 5: vindoffree collected ($0.05)
Seat 6: HellNative folded before Flop (didn't bet)



PokerStars Zoom Hand #229229536538:  Hold'em No Limit ($0.01/$0.02) - 2021/08/21 21:04:39 CET [2021/08/21 15:04:39 ET]
Table 'Halley' 6-max Seat #1 is the button
Seat 1: RoughRafff ($2.11 in chips) 
Seat 2: Scaaalll ($2.03 in chips) 
Seat 3: AligatorsBlood ($2.90 in chips) 
Seat 4: bompi rafc ($2.06 in chips) 
Seat 5: ARTMVSLV ($2.08 in chips) 
Seat 6: mikiZGB ($2.06 in chips) 
Scaaalll: posts small blind $0.01
AligatorsBlood: posts big blind $0.02
*** HOLE CARDS ***
Dealt to Scaaalll [8c 9h]
bompi rafc: folds 
bompi rafc is disconnected 
ARTMVSLV: folds 
mikiZGB: folds 
RoughRafff: raises $0.04 to $0.06
Scaaalll: folds 
AligatorsBlood: folds 
Uncalled bet ($0.04) returned to RoughRafff
RoughRafff collected $0.05 from pot
RoughRafff: doesn't show hand 
*** SUMMARY ***
Total pot $0.05 | Rake $0 
Seat 1: RoughRafff (button) collected ($0.05)
Seat 2: Scaaalll (small blind) folded before Flop
Seat 3: AligatorsBlood (big blind) folded before Flop
Seat 4: bompi rafc folded before Flop (didn't bet)
Seat 5: ARTMVSLV folded before Flop (didn't bet)
Seat 6: mikiZGB folded before Flop (didn't bet)



PokerStars Zoom Hand #229229539183:  Hold'em No Limit ($0.01/$0.02) - 2021/08/21 21:04:45 CET [2021/08/21 15:04:45 ET]
Table 'Halley' 6-max Seat #1 is the button
Seat 1: Sergio14b ($2.37 in chips) 
Seat 2: yositoas ($5.46 in chips) 
Seat 3: Shadi8 ($2.32 in chips) 
Seat 4: johniXL ($0.98 in chips) 
Seat 5: gugamoraes ($2.03 in chips) 
Seat 6: Scaaalll ($2.02 in chips) 
yositoas: posts small blind $0.01
Shadi8: posts big blind $0.02
*** HOLE CARDS ***
Dealt to Scaaalll [4c 6s]
johniXL: folds 
gugamoraes: folds 
Scaaalll: folds 
Sergio14b: raises $0.04 to $0.06
yositoas: folds 
Shadi8: folds 
Uncalled bet ($0.04) returned to Sergio14b
Sergio14b collected $0.05 from pot
Sergio14b: doesn't show hand 
*** SUMMARY ***
Total pot $0.05 | Rake $0 
Seat 1: Sergio14b (button) collected ($0.05)
Seat 2: yositoas (small blind) folded before Flop
Seat 3: Shadi8 (big blind) folded before Flop
Seat 4: johniXL folded before Flop (didn't bet)
Seat 5: gugamoraes folded before Flop (didn't bet)
Seat 6: Scaaalll folded before Flop (didn't bet)



PokerStars Zoom Hand #229229526763:  Hold'em No Limit ($0.01/$0.02) - 2021/08/21 21:04:18 CET [2021/08/21 15:04:18 ET]
Table 'Halley' 6-max Seat #1 is the button
Seat 1: beber_1613 ($2.08 in chips) 
Seat 2: KRITAYA ($1.18 in chips) 
Seat 3: Scaaalll ($2.05 in chips) 
Seat 4: estelionat171 ($0.79 in chips) 
Seat 5: StAntoha ($2.91 in chips) 
Seat 6: Henry Chinasky ($17.34 in chips) 
KRITAYA: posts small blind $0.01
Scaaalll: posts big blind $0.02
*** HOLE CARDS ***
Dealt to Scaaalll [4h Kd]
estelionat171: folds 
StAntoha: folds 
Henry Chinasky: raises $0.04 to $0.06
beber_1613: raises $0.12 to $0.18
KRITAYA: folds 
Scaaalll: folds 
Henry Chinasky: calls $0.12
*** FLOP *** [9h 2c 6s]
Henry Chinasky: checks 
beber_1613: bets $0.26
Henry Chinasky: folds 
Uncalled bet ($0.26) returned to beber_1613
beber_1613 collected $0.38 from pot
beber_1613: doesn't show hand 
*** SUMMARY ***
Total pot $0.39 | Rake $0.01 
Board [9h 2c 6s]
Seat 1: beber_1613 (button) collected ($0.38)
Seat 2: KRITAYA (small blind) folded before Flop
Seat 3: Scaaalll (big blind) folded before Flop
Seat 4: estelionat171 folded before Flop (didn't bet)
Seat 5: StAntoha folded before Flop (didn't bet)
Seat 6: Henry Chinasky folded on the Flop



PokerStars Zoom Hand #229229547662:  Hold'em No Limit ($0.01/$0.02) - 2021/08/21 21:05:04 CET [2021/08/21 15:05:04 ET]
Table 'Halley' 6-max Seat #1 is the button
Seat 1: KoAlRy ($2 in chips) 
Seat 2: KKARMELO ($2.53 in chips) 
Seat 3: z3317111711 ($2.58 in chips) 
Seat 4: Goose Of Poker ($2.06 in chips) 
Seat 5: Scaaalll ($2 in chips) 
Seat 6: jftd123 ($2.22 in chips) 
KKARMELO: posts small blind $0.01
z3317111711: posts big blind $0.02
*** HOLE CARDS ***
Dealt to Scaaalll [4h As]
Goose Of Poker: folds 
Scaaalll: folds 
jftd123: folds 
KoAlRy: raises $0.02 to $0.04
KKARMELO: folds 
z3317111711: folds 
Uncalled bet ($0.02) returned to KoAlRy
KoAlRy collected $0.05 from pot
KoAlRy: doesn't show hand 
*** SUMMARY ***
Total pot $0.05 | Rake $0 
Seat 1: KoAlRy (button) collected ($0.05)
Seat 2: KKARMELO (small blind) folded before Flop
Seat 3: z3317111711 (big blind) folded before Flop
Seat 4: Goose Of Poker folded before Flop (didn't bet)
Seat 5: Scaaalll folded before Flop (didn't bet)
Seat 6: jftd123 folded before Flop (didn't bet)



PokerStars Zoom Hand #229229532579:  Hold'em No Limit ($0.01/$0.02) - 2021/08/21 21:04:30 CET [2021/08/21 15:04:30 ET]
Table 'Halley' 6-max Seat #1 is the button
Seat 1: Hsekir ($1.57 in chips) 
Seat 2: alecha11 ($2.83 in chips) 
Seat 3: CréééW!!! ($2.19 in chips) 
Seat 4: Scaaalll ($2.03 in chips) 
Seat 5: KRITAYA ($1.13 in chips) 
Seat 6: Zhyla95 ($2 in chips) 
alecha11: posts small blind $0.01
CréééW!!!: posts big blind $0.02
*** HOLE CARDS ***
Dealt to Scaaalll [9h 6c]
Scaaalll: folds 
KRITAYA: folds 
Zhyla95: raises $0.03 to $0.05
Hsekir: calls $0.05
alecha11: folds 
CréééW!!!: folds 
*** FLOP *** [Kd 8h As]
Zhyla95: checks 
Hsekir: bets $0.06
Zhyla95: raises $0.06 to $0.12
Hsekir: calls $0.06
*** TURN *** [Kd 8h As] [4c]
Zhyla95: checks 
Hsekir: bets $0.18
Zhyla95: raises $0.18 to $0.36
Hsekir: calls $0.18
*** RIVER *** [Kd 8h As 4c] [Ks]
Zhyla95: bets $1.05
Hsekir: calls $1.04 and is all-in
Uncalled bet ($0.01) returned to Zhyla95
*** SHOW DOWN ***
Zhyla95: shows [Ac Kh] (a full house, Kings full of Aces)
Hsekir: shows [Ah 8c] (two pair, Aces and Kings)
Zhyla95 collected $3.06 from pot
*** SUMMARY ***
Total pot $3.17 | Rake $0.11 
Board [Kd 8h As 4c Ks]
Seat 1: Hsekir (button) showed [Ah 8c] and lost with two pair, Aces and Kings
Seat 2: alecha11 (small blind) folded before Flop
Seat 3: CréééW!!! (big blind) folded before Flop
Seat 4: Scaaalll folded before Flop (didn't bet)
Seat 5: KRITAYA folded before Flop (didn't bet)
Seat 6: Zhyla95 showed [Ac Kh] and won ($3.06) with a full house, Kings full of Aces



PokerStars Zoom Hand #229229550003:  Hold'em No Limit ($0.01/$0.02) - 2021/08/21 21:05:09 CET [2021/08/21 15:05:09 ET]
Table 'Halley' 6-max Seat #1 is the button
Seat 1: thiagohbueno ($1.78 in chips) 
Seat 2: Kergie ($8.64 in chips) 
Seat 3: rodrigoasor ($1.83 in chips) 
Seat 4: Scaaalll ($2 in chips) 
Seat 5: beber_1613 ($2.33 in chips) 
Seat 6: lyapis75 ($2.07 in chips) 
Kergie: posts small blind $0.01
rodrigoasor: posts big blind $0.02
*** HOLE CARDS ***
Dealt to Scaaalll [8c Jc]
Scaaalll: folds 
beber_1613: folds 
lyapis75: folds 
thiagohbueno: folds 
Kergie: folds 
Uncalled bet ($0.01) returned to rodrigoasor
rodrigoasor collected $0.02 from pot
rodrigoasor: doesn't show hand 
*** SUMMARY ***
Total pot $0.02 | Rake $0 
Seat 1: thiagohbueno (button) folded before Flop (didn't bet)
Seat 2: Kergie (small blind) folded before Flop
Seat 3: rodrigoasor (big blind) collected ($0.02)
Seat 4: Scaaalll folded before Flop (didn't bet)
Seat 5: beber_1613 folded before Flop (didn't bet)
Seat 6: lyapis75 folded before Flop (didn't bet)



PokerStars Zoom Hand #229229540985:  Hold'em No Limit ($0.01/$0.02) - 2021/08/21 21:04:49 CET [2021/08/21 15:04:49 ET]
Table 'Halley' 6-max Seat #1 is the button
Seat 1: lyapis75 ($2.18 in chips) 
Seat 2: 01527368 ($2 in chips) 
Seat 3: Scaaalll ($2.02 in chips) 
Seat 4: maliniak75 ($1.39 in chips) 
Seat 5: Fanatspartak ($2.09 in chips) 
Seat 6: pavlo8855 ($2.09 in chips) 
01527368: posts small blind $0.01
Scaaalll: posts big blind $0.02
*** HOLE CARDS ***
Dealt to Scaaalll [3d 9c]
maliniak75: calls $0.02
Fanatspartak: folds 
pavlo8855: raises $0.06 to $0.08
lyapis75: folds 
01527368: folds 
Scaaalll: folds 
maliniak75: calls $0.06
*** FLOP *** [6d Qh 2d]
maliniak75: checks 
pavlo8855: bets $0.14
maliniak75: calls $0.14
*** TURN *** [6d Qh 2d] [Ac]
maliniak75: checks 
pavlo8855: bets $0.34
maliniak75: calls $0.34
*** RIVER *** [6d Qh 2d Ac] [9s]
maliniak75: checks 
pavlo8855: bets $0.83
maliniak75: folds 
Uncalled bet ($0.83) returned to pavlo8855
pavlo8855 collected $1.11 from pot
pavlo8855: doesn't show hand 
*** SUMMARY ***
Total pot $1.15 | Rake $0.04 
Board [6d Qh 2d Ac 9s]
Seat 1: lyapis75 (button) folded before Flop (didn't bet)
Seat 2: 01527368 (small blind) folded before Flop
Seat 3: Scaaalll (big blind) folded before Flop
Seat 4: maliniak75 folded on the River
Seat 5: Fanatspartak folded before Flop (didn't bet)
Seat 6: pavlo8855 collected ($1.11)



PokerStars Zoom Hand #229229553552:  Hold'em No Limit ($0.01/$0.02) - 2021/08/21 21:05:17 CET [2021/08/21 15:05:17 ET]
Table 'Halley' 6-max Seat #1 is the button
Seat 1: Scaaalll ($2 in chips) 
Seat 2: zeus11983 ($2.24 in chips) 
Seat 3: bompi rafc ($2.02 in chips) 
Seat 4: pphit ($2.38 in chips) 
Seat 5: Lapa2192 ($2.62 in chips) 
Seat 6: RoughRafff ($2.12 in chips) 
zeus11983: posts small blind $0.01
bompi rafc: posts big blind $0.02
*** HOLE CARDS ***
Dealt to Scaaalll [8h Kh]
pphit: folds 
Lapa2192: raises $0.02 to $0.04
RoughRafff: folds 
Scaaalll: calls $0.04
zeus11983: folds 
bompi rafc: calls $0.02
*** FLOP *** [Kd 7c Qc]
bompi rafc: checks 
Lapa2192: checks 
Scaaalll: bets $0.08
bompi rafc: calls $0.08
Lapa2192: folds 
*** TURN *** [Kd 7c Qc] [7h]
Lapa2192 is disconnected 
bompi rafc: checks 
Scaaalll: bets $0.19
bompi rafc: calls $0.19
*** RIVER *** [Kd 7c Qc 7h] [Ac]
bompi rafc: checks 
Scaaalll: checks 
*** SHOW DOWN ***
bompi rafc: shows [7s 7d] (four of a kind, Sevens)
Scaaalll: mucks hand 
bompi rafc collected $0.65 from pot
*** SUMMARY ***
Total pot $0.67 | Rake $0.02 
Board [Kd 7c Qc 7h Ac]
Seat 1: Scaaalll (button) mucked [8h Kh]
Seat 2: zeus11983 (small blind) folded before Flop
Seat 3: bompi rafc (big blind) showed [7s 7d] and won ($0.65) with four of a kind, Sevens
Seat 4: pphit folded before Flop (didn't bet)
Seat 5: Lapa2192 folded on the Flop
Seat 6: RoughRafff folded before Flop (didn't bet)



PokerStars Zoom Hand #229229578266:  Hold'em No Limit ($0.01/$0.02) - 2021/08/21 21:06:13 CET [2021/08/21 15:06:13 ET]
Table 'Halley' 6-max Seat #1 is the button
Seat 1: Luk Hander ($2.25 in chips) 
Seat 2: shingo594 ($2.33 in chips) 
Seat 3: D_S_S2804 ($0.78 in chips) 
Seat 4: vindoffree ($2.92 in chips) 
Seat 5: Scaaalll ($2 in chips) 
Seat 6: Djalmethedj ($1.94 in chips) 
shingo594: posts small blind $0.01
D_S_S2804: posts big blind $0.02
*** HOLE CARDS ***
Dealt to Scaaalll [3d 7c]
vindoffree: folds 
Scaaalll: folds 
Djalmethedj: folds 
Luk Hander: raises $0.03 to $0.05
D_S_S2804 is disconnected 
shingo594: raises $0.15 to $0.20
D_S_S2804: folds 
Luk Hander: folds 
Uncalled bet ($0.15) returned to shingo594
shingo594 collected $0.12 from pot
shingo594: doesn't show hand 
*** SUMMARY ***
Total pot $0.12 | Rake $0 
Seat 1: Luk Hander (button) folded before Flop
Seat 2: shingo594 (small blind) collected ($0.12)
Seat 3: D_S_S2804 (big blind) folded before Flop
Seat 4: vindoffree folded before Flop (didn't bet)
Seat 5: Scaaalll folded before Flop (didn't bet)
Seat 6: Djalmethedj folded before Flop (didn't bet)



PokerStars Zoom Hand #229229581055:  Hold'em No Limit ($0.01/$0.02) - 2021/08/21 21:06:18 CET [2021/08/21 15:06:18 ET]
Table 'Halley' 6-max Seat #1 is the button
Seat 1: danielschuel ($2 in chips) 
Seat 2: Scaaalll ($2 in chips) 
Seat 3: estelionat171 ($0.95 in chips) 
Seat 4: YPAXAPA555 ($2.47 in chips) 
Seat 5: Gremlipoo ($3.53 in chips) 
Seat 6: KKARMELO ($2.47 in chips) 
Scaaalll: posts small blind $0.01
estelionat171: posts big blind $0.02
*** HOLE CARDS ***
Dealt to Scaaalll [2s 4s]
Gremlipoo is disconnected 
YPAXAPA555: raises $0.04 to $0.06
Gremlipoo: folds 
KKARMELO: folds 
danielschuel: calls $0.06
Scaaalll: folds 
estelionat171: folds 
*** FLOP *** [7s 4h 5s]
YPAXAPA555: bets $0.06
danielschuel: raises $0.12 to $0.18
YPAXAPA555: folds 
Uncalled bet ($0.12) returned to danielschuel
danielschuel collected $0.26 from pot
danielschuel: doesn't show hand 
*** SUMMARY ***
Total pot $0.27 | Rake $0.01 
Board [7s 4h 5s]
Seat 1: danielschuel (button) collected ($0.26)
Seat 2: Scaaalll (small blind) folded before Flop
Seat 3: estelionat171 (big blind) folded before Flop
Seat 4: YPAXAPA555 folded on the Flop
Seat 5: Gremlipoo folded before Flop (didn't bet)
Seat 6: KKARMELO folded before Flop (didn't bet)



PokerStars Zoom Hand #229229588368:  Hold'em No Limit ($0.01/$0.02) - 2021/08/21 21:06:35 CET [2021/08/21 15:06:35 ET]
Table 'Halley' 6-max Seat #1 is the button
Seat 1: KRITAYA ($1.02 in chips) 
Seat 2: gepard35 ($4.69 in chips) 
Seat 3: Xlavariable ($2 in chips) 
Seat 4: Grashüpferchen ($0.95 in chips) 
Seat 5: Vit13150 ($1.78 in chips) 
Seat 6: Scaaalll ($2 in chips) 
gepard35: posts small blind $0.01
Xlavariable: posts big blind $0.02
*** HOLE CARDS ***
Dealt to Scaaalll [4d Jd]
Grashüpferchen: folds 
Vit13150: folds 
Scaaalll: folds 
KRITAYA: raises $0.04 to $0.06
gepard35: folds 
Xlavariable: folds 
Uncalled bet ($0.04) returned to KRITAYA
KRITAYA collected $0.05 from pot
KRITAYA: doesn't show hand 
*** SUMMARY ***
Total pot $0.05 | Rake $0 
Seat 1: KRITAYA (button) collected ($0.05)
Seat 2: gepard35 (small blind) folded before Flop
Seat 3: Xlavariable (big blind) folded before Flop
Seat 4: Grashüpferchen folded before Flop (didn't bet)
Seat 5: Vit13150 folded before Flop (didn't bet)
Seat 6: Scaaalll folded before Flop (didn't bet)



PokerStars Zoom Hand #229229594128:  Hold'em No Limit ($0.01/$0.02) - 2021/08/21 21:06:47 CET [2021/08/21 15:06:47 ET]
Table 'Halley' 6-max Seat #1 is the button
Seat 1: 77AHTOH777 ($1.70 in chips) 
Seat 2: Natali172737 ($2.98 in chips) 
Seat 3: Scaaalll ($2 in chips) 
Seat 4: Stormzilla ($2.09 in chips) 
Seat 5: PaddyPoland ($2.37 in chips) 
Seat 6: amario89 ($1.79 in chips) 
Natali172737: posts small blind $0.01
Scaaalll: posts big blind $0.02
*** HOLE CARDS ***
Dealt to Scaaalll [Qd Jc]
Stormzilla: folds 
PaddyPoland: raises $0.03 to $0.05
amario89: calls $0.05
77AHTOH777: folds 
Natali172737: folds 
Scaaalll: calls $0.03
*** FLOP *** [6s 9c 2d]
Scaaalll: checks 
PaddyPoland: checks 
amario89: checks 
*** TURN *** [6s 9c 2d] [6h]
Scaaalll: checks 
PaddyPoland: checks 
amario89: checks 
*** RIVER *** [6s 9c 2d 6h] [3s]
Scaaalll: checks 
PaddyPoland: bets $0.11
amario89: calls $0.11
Scaaalll: folds 
*** SHOW DOWN ***
PaddyPoland: shows [Kc Jh] (a pair of Sixes)
amario89: shows [5h 3h] (two pair, Sixes and Threes)
amario89 collected $0.37 from pot
*** SUMMARY ***
Total pot $0.38 | Rake $0.01 
Board [6s 9c 2d 6h 3s]
Seat 1: 77AHTOH777 (button) folded before Flop (didn't bet)
Seat 2: Natali172737 (small blind) folded before Flop
Seat 3: Scaaalll (big blind) folded on the River
Seat 4: Stormzilla folded before Flop (didn't bet)
Seat 5: PaddyPoland showed [Kc Jh] and lost with a pair of Sixes
Seat 6: amario89 showed [5h 3h] and won ($0.37) with two pair, Sixes and Threes



PokerStars Zoom Hand #229229616063:  Hold'em No Limit ($0.01/$0.02) - 2021/08/21 21:07:35 CET [2021/08/21 15:07:35 ET]
Table 'Halley' 6-max Seat #1 is the button
Seat 1: Scaaalll ($2 in chips) 
Seat 2: Shoxuzb ($8.68 in chips) 
Seat 3: adeoru88 ($2.51 in chips) 
Seat 4: SIGREX ($2.81 in chips) 
Seat 5: kodart ($1.47 in chips) 
Seat 6: fishh_play ($2.03 in chips) 
Shoxuzb: posts small blind $0.01
adeoru88: posts big blind $0.02
*** HOLE CARDS ***
Dealt to Scaaalll [9s 4s]
SIGREX: folds 
kodart: folds 
fishh_play: folds 
Scaaalll: folds 
Shoxuzb: raises $0.04 to $0.06
adeoru88: folds 
Uncalled bet ($0.04) returned to Shoxuzb
Shoxuzb collected $0.04 from pot
Shoxuzb: doesn't show hand 
*** SUMMARY ***
Total pot $0.04 | Rake $0 
Seat 1: Scaaalll (button) folded before Flop (didn't bet)
Seat 2: Shoxuzb (small blind) collected ($0.04)
Seat 3: adeoru88 (big blind) folded before Flop
Seat 4: SIGREX folded before Flop (didn't bet)
Seat 5: kodart folded before Flop (didn't bet)
Seat 6: fishh_play folded before Flop (didn't bet)



PokerStars Zoom Hand #229229627003:  Hold'em No Limit ($0.01/$0.02) - 2021/08/21 21:07:59 CET [2021/08/21 15:07:59 ET]
Table 'Halley' 6-max Seat #1 is the button
Seat 1: ggGoldenPunk ($1.68 in chips) 
Seat 2: Natali172737 ($2.09 in chips) 
Seat 3: Scaaalll ($2 in chips) 
Seat 4: sg.32rus ($0.95 in chips) 
Seat 5: kykareky32 ($2.03 in chips) 
Seat 6: igara tigara ($1.90 in chips) 
Natali172737: posts small blind $0.01
Scaaalll: posts big blind $0.02
*** HOLE CARDS ***
Dealt to Scaaalll [5d 2h]
sg.32rus: folds 
kykareky32: folds 
igara tigara: folds 
ggGoldenPunk: folds 
Natali172737: folds 
Uncalled bet ($0.01) returned to Scaaalll
Scaaalll collected $0.02 from pot
Scaaalll: doesn't show hand 
*** SUMMARY ***
Total pot $0.02 | Rake $0 
Seat 1: ggGoldenPunk (button) folded before Flop (didn't bet)
Seat 2: Natali172737 (small blind) folded before Flop
Seat 3: Scaaalll (big blind) collected ($0.02)
Seat 4: sg.32rus folded before Flop (didn't bet)
Seat 5: kykareky32 folded before Flop (didn't bet)
Seat 6: igara tigara folded before Flop (didn't bet)



PokerStars Zoom Hand #229229624688:  Hold'em No Limit ($0.01/$0.02) - 2021/08/21 21:07:54 CET [2021/08/21 15:07:54 ET]
Table 'Halley' 6-max Seat #1 is the button
Seat 1: Grama480 ($1.97 in chips) 
Seat 2: Scaaalll ($2 in chips) 
Seat 3: YPAXAPA555 ($2.45 in chips) 
Seat 4: ash1448 ($9.29 in chips) 
Seat 5: mikiZGB ($1.76 in chips) 
Seat 6: zeus11983 ($2.41 in chips) 
Scaaalll: posts small blind $0.01
YPAXAPA555: posts big blind $0.02
*** HOLE CARDS ***
Dealt to Scaaalll [Kd 9h]
ash1448 has timed out
ash1448: folds 
mikiZGB: raises $0.02 to $0.04
zeus11983: folds 
Grama480: folds 
Scaaalll: folds 
YPAXAPA555: folds 
Uncalled bet ($0.02) returned to mikiZGB
mikiZGB collected $0.05 from pot
mikiZGB: doesn't show hand 
*** SUMMARY ***
Total pot $0.05 | Rake $0 
Seat 1: Grama480 (button) folded before Flop (didn't bet)
Seat 2: Scaaalll (small blind) folded before Flop
Seat 3: YPAXAPA555 (big blind) folded before Flop
Seat 4: ash1448 folded before Flop (didn't bet)
Seat 5: mikiZGB collected ($0.05)
Seat 6: zeus11983 folded before Flop (didn't bet)



PokerStars Zoom Hand #229229630668:  Hold'em No Limit ($0.01/$0.02) - 2021/08/21 21:08:07 CET [2021/08/21 15:08:07 ET]
Table 'Halley' 6-max Seat #1 is the button
Seat 1: Scaaalll ($2.01 in chips) 
Seat 2: CASSIE21462 ($6.98 in chips) 
Seat 3: keldh ($2.06 in chips) 
Seat 4: zairyoku ($2.50 in chips) 
Seat 5: zergmiky ($2.06 in chips) 
Seat 6: z1z2z315 ($1 in chips) 
CASSIE21462: posts small blind $0.01
keldh: posts big blind $0.02
*** HOLE CARDS ***
Dealt to Scaaalll [Th 3c]
zairyoku: folds 
zergmiky: folds 
z1z2z315: folds 
Scaaalll: folds 
CASSIE21462: folds 
Uncalled bet ($0.01) returned to keldh
keldh collected $0.02 from pot
keldh: doesn't show hand 
*** SUMMARY ***
Total pot $0.02 | Rake $0 
Seat 1: Scaaalll (button) folded before Flop (didn't bet)
Seat 2: CASSIE21462 (small blind) folded before Flop
Seat 3: keldh (big blind) collected ($0.02)
Seat 4: zairyoku folded before Flop (didn't bet)
Seat 5: zergmiky folded before Flop (didn't bet)
Seat 6: z1z2z315 folded before Flop (didn't bet)



PokerStars Zoom Hand #229229617915:  Hold'em No Limit ($0.01/$0.02) - 2021/08/21 21:07:39 CET [2021/08/21 15:07:39 ET]
Table 'Halley' 6-max Seat #1 is the button
Seat 1: Vit13150 ($2.30 in chips) 
Seat 2: vladlen101 ($0.98 in chips) 
Seat 3: Pechorin.G ($2.30 in chips) 
Seat 4: Shadi8 ($3.32 in chips) 
Seat 5: Scaaalll ($2 in chips) 
Seat 6: luckybadoo ($1.01 in chips) 
vladlen101: posts small blind $0.01
Pechorin.G: posts big blind $0.02
*** HOLE CARDS ***
Dealt to Scaaalll [Jh 3c]
Shadi8: folds 
Scaaalll: folds 
luckybadoo: folds 
Vit13150: folds 
vladlen101: calls $0.01
Pechorin.G: checks 
*** FLOP *** [4s Ac Kc]
vladlen101: bets $0.02
Pechorin.G: calls $0.02
*** TURN *** [4s Ac Kc] [Qh]
vladlen101: bets $0.02
Pechorin.G: calls $0.02
*** RIVER *** [4s Ac Kc Qh] [Js]
vladlen101: bets $0.04
Pechorin.G: folds 
Uncalled bet ($0.04) returned to vladlen101
vladlen101 collected $0.12 from pot
vladlen101: doesn't show hand 
*** SUMMARY ***
Total pot $0.12 | Rake $0 
Board [4s Ac Kc Qh Js]
Seat 1: Vit13150 (button) folded before Flop (didn't bet)
Seat 2: vladlen101 (small blind) collected ($0.12)
Seat 3: Pechorin.G (big blind) folded on the River
Seat 4: Shadi8 folded before Flop (didn't bet)
Seat 5: Scaaalll folded before Flop (didn't bet)
Seat 6: luckybadoo folded before Flop (didn't bet)



PokerStars Zoom Hand #229229632977:  Hold'em No Limit ($0.01/$0.02) - 2021/08/21 21:08:12 CET [2021/08/21 15:08:12 ET]
Table 'Halley' 6-max Seat #1 is the button
Seat 1: 77AHTOH777 ($1.59 in chips) 
Seat 2: SIGREX ($2 in chips) 
Seat 3: Natali172737 ($5.35 in chips) 
Seat 4: iPitbull1 ($2.71 in chips) 
Seat 5: ARTMVSLV ($2.13 in chips) 
Seat 6: Scaaalll ($2.01 in chips) 
SIGREX: posts small blind $0.01
Natali172737: posts big blind $0.02
*** HOLE CARDS ***
Dealt to Scaaalll [3s 9d]
iPitbull1: folds 
ARTMVSLV: folds 
Scaaalll: folds 
77AHTOH777: folds 
SIGREX: folds 
Uncalled bet ($0.01) returned to Natali172737
Natali172737 collected $0.02 from pot
Natali172737: doesn't show hand 
*** SUMMARY ***
Total pot $0.02 | Rake $0 
Seat 1: 77AHTOH777 (button) folded before Flop (didn't bet)
Seat 2: SIGREX (small blind) folded before Flop
Seat 3: Natali172737 (big blind) collected ($0.02)
Seat 4: iPitbull1 folded before Flop (didn't bet)
Seat 5: ARTMVSLV folded before Flop (didn't bet)
Seat 6: Scaaalll folded before Flop (didn't bet)



PokerStars Zoom Hand #229229619629:  Hold'em No Limit ($0.01/$0.02) - 2021/08/21 21:07:43 CET [2021/08/21 15:07:43 ET]
Table 'Halley' 6-max Seat #1 is the button
Seat 1: Alexasha78 ($2.32 in chips) 
Seat 2: ponomarinho ($2.69 in chips) 
Seat 3: olga3021221 ($3 in chips) 
Seat 4: Scaaalll ($2 in chips) 
Seat 5: unior321 ($0.83 in chips) 
Seat 6: Jonub ($2 in chips) 
ponomarinho: posts small blind $0.01
olga3021221: posts big blind $0.02
*** HOLE CARDS ***
Dealt to Scaaalll [2h Kc]
unior321 is disconnected 
Alexasha78 is disconnected 
Scaaalll: folds 
unior321: folds 
Jonub: raises $0.03 to $0.05
Alexasha78: folds 
ponomarinho: folds 
olga3021221: calls $0.03
*** FLOP *** [4c 5c 9s]
olga3021221: checks 
Jonub: checks 
*** TURN *** [4c 5c 9s] [8h]
olga3021221: bets $0.11
Jonub: calls $0.11
*** RIVER *** [4c 5c 9s 8h] [2d]
olga3021221: bets $0.27
Jonub: calls $0.27
*** SHOW DOWN ***
olga3021221: shows [8s 8c] (three of a kind, Eights)
Jonub: mucks hand 
olga3021221 collected $0.84 from pot
*** SUMMARY ***
Total pot $0.87 | Rake $0.03 
Board [4c 5c 9s 8h 2d]
Seat 1: Alexasha78 (button) folded before Flop (didn't bet)
Seat 2: ponomarinho (small blind) folded before Flop
Seat 3: olga3021221 (big blind) showed [8s 8c] and won ($0.84) with three of a kind, Eights
Seat 4: Scaaalll folded before Flop (didn't bet)
Seat 5: unior321 folded before Flop (didn't bet)
Seat 6: Jonub mucked [7c 9c]



PokerStars Zoom Hand #229229635668:  Hold'em No Limit ($0.01/$0.02) - 2021/08/21 21:08:18 CET [2021/08/21 15:08:18 ET]
Table 'Halley' 6-max Seat #1 is the button
Seat 1: Pechorin.G ($2.57 in chips) 
Seat 2: texashenry2 ($2.31 in chips) 
Seat 3: Natali172737 ($2.08 in chips) 
Seat 4: 1_KoLizeI_1 ($2.50 in chips) 
Seat 5: KRITAYA ($1.09 in chips) 
Seat 6: Scaaalll ($2.01 in chips) 
texashenry2: posts small blind $0.01
Natali172737: posts big blind $0.02
*** HOLE CARDS ***
Dealt to Scaaalll [Qs 9s]
1_KoLizeI_1: folds 
KRITAYA: folds 
Scaaalll: raises $0.04 to $0.06
Pechorin.G: calls $0.06
texashenry2: calls $0.05
Natali172737: folds 
*** FLOP *** [Th Qh 2h]
texashenry2: checks 
Scaaalll: bets $0.13
Pechorin.G: raises $0.34 to $0.47
texashenry2: folds 
Scaaalll: folds 
Uncalled bet ($0.34) returned to Pechorin.G
Pechorin.G collected $0.44 from pot
Pechorin.G: doesn't show hand 
*** SUMMARY ***
Total pot $0.46 | Rake $0.02 
Board [Th Qh 2h]
Seat 1: Pechorin.G (button) collected ($0.44)
Seat 2: texashenry2 (small blind) folded on the Flop
Seat 3: Natali172737 (big blind) folded before Flop
Seat 4: 1_KoLizeI_1 folded before Flop (didn't bet)
Seat 5: KRITAYA folded before Flop (didn't bet)
Seat 6: Scaaalll folded on the Flop



PokerStars Zoom Hand #229229651224:  Hold'em No Limit ($0.01/$0.02) - 2021/08/21 21:08:52 CET [2021/08/21 15:08:52 ET]
Table 'Halley' 6-max Seat #1 is the button
Seat 1: HellNative ($2.97 in chips) 
Seat 2: Zhyla95 ($1.98 in chips) 
Seat 3: ash1448 ($2.11 in chips) 
Seat 4: Scaaalll ($2 in chips) 
Seat 5: pers_ikG ($2.26 in chips) 
Seat 6: sg.32rus ($0.89 in chips) 
Zhyla95: posts small blind $0.01
ash1448: posts big blind $0.02
*** HOLE CARDS ***
Dealt to Scaaalll [6d 8s]
Scaaalll: folds 
pers_ikG: raises $0.04 to $0.06
sg.32rus: folds 
HellNative: folds 
Zhyla95: folds 
ash1448: folds 
Uncalled bet ($0.04) returned to pers_ikG
pers_ikG collected $0.05 from pot
pers_ikG: doesn't show hand 
*** SUMMARY ***
Total pot $0.05 | Rake $0 
Seat 1: HellNative (button) folded before Flop (didn't bet)
Seat 2: Zhyla95 (small blind) folded before Flop
Seat 3: ash1448 (big blind) folded before Flop
Seat 4: Scaaalll folded before Flop (didn't bet)
Seat 5: pers_ikG collected ($0.05)
Seat 6: sg.32rus folded before Flop (didn't bet)



PokerStars Zoom Hand #229229652993:  Hold'em No Limit ($0.01/$0.02) - 2021/08/21 21:08:56 CET [2021/08/21 15:08:56 ET]
Table 'Halley' 6-max Seat #1 is the button
Seat 1: gugamoraes ($2.41 in chips) 
Seat 2: Scaaalll ($2 in chips) 
Seat 3: Pray_to_win ($2.33 in chips) 
Seat 4: LuckyLlama0 ($1.50 in chips) 
Seat 5: bananAAbandit ($2.14 in chips) 
Seat 6: LeoNik62 ($5.56 in chips) 
Scaaalll: posts small blind $0.01
Pray_to_win: posts big blind $0.02
*** HOLE CARDS ***
Dealt to Scaaalll [5s Ks]
LuckyLlama0: raises $0.02 to $0.04
Pray_to_win is disconnected 
bananAAbandit: folds 
LeoNik62: calls $0.04
gugamoraes: folds 
Scaaalll: folds 
Pray_to_win: folds 
*** FLOP *** [Th Qc 6s]
LuckyLlama0: bets $0.11
LeoNik62: folds 
Uncalled bet ($0.11) returned to LuckyLlama0
LuckyLlama0 collected $0.11 from pot
LuckyLlama0: doesn't show hand 
*** SUMMARY ***
Total pot $0.11 | Rake $0 
Board [Th Qc 6s]
Seat 1: gugamoraes (button) folded before Flop (didn't bet)
Seat 2: Scaaalll (small blind) folded before Flop
Seat 3: Pray_to_win (big blind) folded before Flop
Seat 4: LuckyLlama0 collected ($0.11)
Seat 5: bananAAbandit folded before Flop (didn't bet)
Seat 6: LeoNik62 folded on the Flop



PokerStars Zoom Hand #229229658914:  Hold'em No Limit ($0.01/$0.02) - 2021/08/21 21:09:10 CET [2021/08/21 15:09:10 ET]
Table 'Halley' 6-max Seat #1 is the button
Seat 1: PaddyPoland ($3.53 in chips) 
Seat 2: Allekccc ($1.98 in chips) 
Seat 3: Scaaalll ($2 in chips) 
Seat 4: der Kater464 ($3.48 in chips) 
Seat 5: nodtress ($2.06 in chips) 
Seat 6: Laonikos ($3.98 in chips) 
Allekccc: posts small blind $0.01
Scaaalll: posts big blind $0.02
*** HOLE CARDS ***
Dealt to Scaaalll [3d Ks]
der Kater464: folds 
nodtress: folds 
Laonikos: folds 
PaddyPoland: folds 
Allekccc: folds 
Uncalled bet ($0.01) returned to Scaaalll
Scaaalll collected $0.02 from pot
Scaaalll: doesn't show hand 
*** SUMMARY ***
Total pot $0.02 | Rake $0 
Seat 1: PaddyPoland (button) folded before Flop (didn't bet)
Seat 2: Allekccc (small blind) folded before Flop
Seat 3: Scaaalll (big blind) collected ($0.02)
Seat 4: der Kater464 folded before Flop (didn't bet)
Seat 5: nodtress folded before Flop (didn't bet)
Seat 6: Laonikos folded before Flop (didn't bet)



PokerStars Zoom Hand #229229662443:  Hold'em No Limit ($0.01/$0.02) - 2021/08/21 21:09:18 CET [2021/08/21 15:09:18 ET]
Table 'Halley' 6-max Seat #1 is the button
Seat 1: sg.32rus ($1.03 in chips) 
Seat 2: kahzura ($2.22 in chips) 
Seat 3: SpartanRace1 ($9.17 in chips) 
Seat 4: Scaaalll ($2.01 in chips) 
Seat 5: Flankeris ($3.09 in chips) 
Seat 6: Grama480 ($1.91 in chips) 
kahzura: posts small blind $0.01
SpartanRace1: posts big blind $0.02
*** HOLE CARDS ***
Dealt to Scaaalll [9d 7s]
Scaaalll: folds 
Flankeris: folds 
Grama480: folds 
sg.32rus: folds 
kahzura: folds 
Uncalled bet ($0.01) returned to SpartanRace1
SpartanRace1 collected $0.02 from pot
SpartanRace1: doesn't show hand 
*** SUMMARY ***
Total pot $0.02 | Rake $0 
Seat 1: sg.32rus (button) folded before Flop (didn't bet)
Seat 2: kahzura (small blind) folded before Flop
Seat 3: SpartanRace1 (big blind) collected ($0.02)
Seat 4: Scaaalll folded before Flop (didn't bet)
Seat 5: Flankeris folded before Flop (didn't bet)
Seat 6: Grama480 folded before Flop (didn't bet)



PokerStars Zoom Hand #229229656242:  Hold'em No Limit ($0.01/$0.02) - 2021/08/21 21:09:03 CET [2021/08/21 15:09:03 ET]
Table 'Halley' 6-max Seat #1 is the button
Seat 1: vps3 ($0.22 in chips) 
Seat 2: Roubyz ($1.86 in chips) 
Seat 3: CordiPS ($2 in chips) 
Seat 4: XHerrTUMNUSX ($6.65 in chips) 
Seat 5: Scaaalll ($2 in chips) 
Seat 6: sg.32rus ($0.91 in chips) 
Roubyz: posts small blind $0.01
CordiPS: posts big blind $0.02
*** HOLE CARDS ***
Dealt to Scaaalll [Td 4s]
Roubyz is disconnected 
XHerrTUMNUSX: raises $0.03 to $0.05
Scaaalll: folds 
vps3 is disconnected 
sg.32rus: folds 
vps3: folds 
Roubyz: folds 
CordiPS: calls $0.03
*** FLOP *** [Ts 7d 8h]
CordiPS: checks 
XHerrTUMNUSX: checks 
*** TURN *** [Ts 7d 8h] [4c]
CordiPS: bets $0.07
XHerrTUMNUSX: folds 
Uncalled bet ($0.07) returned to CordiPS
CordiPS collected $0.11 from pot
CordiPS: doesn't show hand 
*** SUMMARY ***
Total pot $0.11 | Rake $0 
Board [Ts 7d 8h 4c]
Seat 1: vps3 (button) folded before Flop (didn't bet)
Seat 2: Roubyz (small blind) folded before Flop
Seat 3: CordiPS (big blind) collected ($0.11)
Seat 4: XHerrTUMNUSX folded on the Turn
Seat 5: Scaaalll folded before Flop (didn't bet)
Seat 6: sg.32rus folded before Flop (didn't bet)



PokerStars Zoom Hand #229229665649:  Hold'em No Limit ($0.01/$0.02) - 2021/08/21 21:09:25 CET [2021/08/21 15:09:25 ET]
Table 'Halley' 6-max Seat #1 is the button
Seat 1: Scaaalll ($2.01 in chips) 
Seat 2: 78joniboy ($2.76 in chips) 
Seat 3: pavlo8855 ($3.35 in chips) 
Seat 4: Armando.Bordi ($3.04 in chips) 
Seat 5: no way yo ($1.23 in chips) 
Seat 6: japinhaguara ($1.98 in chips) 
78joniboy: posts small blind $0.01
pavlo8855: posts big blind $0.02
*** HOLE CARDS ***
Dealt to Scaaalll [Jd 7s]
Armando.Bordi: folds 
no way yo: folds 
japinhaguara: folds 
Scaaalll: raises $0.02 to $0.04
78joniboy: folds 
pavlo8855: folds 
Uncalled bet ($0.02) returned to Scaaalll
Scaaalll collected $0.05 from pot
Scaaalll: doesn't show hand 
*** SUMMARY ***
Total pot $0.05 | Rake $0 
Seat 1: Scaaalll (button) collected ($0.05)
Seat 2: 78joniboy (small blind) folded before Flop
Seat 3: pavlo8855 (big blind) folded before Flop
Seat 4: Armando.Bordi folded before Flop (didn't bet)
Seat 5: no way yo folded before Flop (didn't bet)
Seat 6: japinhaguara folded before Flop (didn't bet)



PokerStars Zoom Hand #229229671901:  Hold'em No Limit ($0.01/$0.02) - 2021/08/21 21:09:38 CET [2021/08/21 15:09:38 ET]
Table 'Halley' 6-max Seat #1 is the button
Seat 1: Kb013497 ($3.13 in chips) 
Seat 2: Scaaalll ($2.04 in chips) 
Seat 3: Gerar NB ($2.62 in chips) 
Seat 4: vladlen101 ($1.05 in chips) 
Seat 5: RoyaLLRus ($1.61 in chips) 
Seat 6: ignat-of 777 ($0.73 in chips) 
Scaaalll: posts small blind $0.01
Gerar NB: posts big blind $0.02
*** HOLE CARDS ***
Dealt to Scaaalll [9s 2c]
vladlen101: folds 
RoyaLLRus: folds 
ignat-of 777: folds 
Kb013497: folds 
Scaaalll: folds 
Uncalled bet ($0.01) returned to Gerar NB
Gerar NB collected $0.02 from pot
Gerar NB: doesn't show hand 
*** SUMMARY ***
Total pot $0.02 | Rake $0 
Seat 1: Kb013497 (button) folded before Flop (didn't bet)
Seat 2: Scaaalll (small blind) folded before Flop
Seat 3: Gerar NB (big blind) collected ($0.02)
Seat 4: vladlen101 folded before Flop (didn't bet)
Seat 5: RoyaLLRus folded before Flop (didn't bet)
Seat 6: ignat-of 777 folded before Flop (didn't bet)



PokerStars Zoom Hand #229229683513:  Hold'em No Limit ($0.01/$0.02) - 2021/08/21 21:10:04 CET [2021/08/21 15:10:04 ET]
Table 'Halley' 6-max Seat #1 is the button
Seat 1: S.B.O190 ($6.16 in chips) 
Seat 2: vaaaala ($4.99 in chips) 
Seat 3: Scaaalll ($2.03 in chips) 
Seat 4: BexleyBoy ($5.78 in chips) 
Seat 5: Prrrronya ($0.92 in chips) 
Seat 6: Han_Solo_71 ($0.98 in chips) 
vaaaala: posts small blind $0.01
Scaaalll: posts big blind $0.02
*** HOLE CARDS ***
Dealt to Scaaalll [Ks 4d]
Han_Solo_71 is disconnected 
BexleyBoy: folds 
Prrrronya: folds 
Han_Solo_71: folds 
S.B.O190: folds 
vaaaala: folds 
Uncalled bet ($0.01) returned to Scaaalll
Scaaalll collected $0.02 from pot
Scaaalll: doesn't show hand 
*** SUMMARY ***
Total pot $0.02 | Rake $0 
Seat 1: S.B.O190 (button) folded before Flop (didn't bet)
Seat 2: vaaaala (small blind) folded before Flop
Seat 3: Scaaalll (big blind) collected ($0.02)
Seat 4: BexleyBoy folded before Flop (didn't bet)
Seat 5: Prrrronya folded before Flop (didn't bet)
Seat 6: Han_Solo_71 folded before Flop (didn't bet)



PokerStars Zoom Hand #229229679614:  Hold'em No Limit ($0.01/$0.02) - 2021/08/21 21:09:56 CET [2021/08/21 15:09:56 ET]
Table 'Halley' 6-max Seat #1 is the button
Seat 1: Kb013497 ($3.35 in chips) 
Seat 2: CrazyyParis ($2.16 in chips) 
Seat 3: Sul07 ($1.25 in chips) 
Seat 4: Djalmethedj ($2.32 in chips) 
Seat 5: Scaaalll ($2.03 in chips) 
Seat 6: valua976 ($1.17 in chips) 
CrazyyParis: posts small blind $0.01
Sul07: posts big blind $0.02
*** HOLE CARDS ***
Dealt to Scaaalll [Js 7c]
Djalmethedj: folds 
Scaaalll: folds 
valua976: folds 
Kb013497: folds 
CrazyyParis: raises $0.04 to $0.06
Sul07: raises $0.12 to $0.18
CrazyyParis: folds 
Uncalled bet ($0.12) returned to Sul07
Sul07 collected $0.12 from pot
Sul07: doesn't show hand 
*** SUMMARY ***
Total pot $0.12 | Rake $0 
Seat 1: Kb013497 (button) folded before Flop (didn't bet)
Seat 2: CrazyyParis (small blind) folded before Flop
Seat 3: Sul07 (big blind) collected ($0.12)
Seat 4: Djalmethedj folded before Flop (didn't bet)
Seat 5: Scaaalll folded before Flop (didn't bet)
Seat 6: valua976 folded before Flop (didn't bet)



PokerStars Zoom Hand #229229676490:  Hold'em No Limit ($0.01/$0.02) - 2021/08/21 21:09:48 CET [2021/08/21 15:09:48 ET]
Table 'Halley' 6-max Seat #1 is the button
Seat 1: yositoas ($2.10 in chips) 
Seat 2: ugi-dugi ($2.03 in chips) 
Seat 3: feybys ($3.03 in chips) 
Seat 4: KIraMan ($2.94 in chips) 
Seat 5: greenthum33 ($3.42 in chips) 
Seat 6: Scaaalll ($2.03 in chips) 
ugi-dugi: posts small blind $0.01
feybys: posts big blind $0.02
*** HOLE CARDS ***
Dealt to Scaaalll [3d Kc]
KIraMan: folds 
greenthum33: raises $0.02 to $0.04
Scaaalll: folds 
yositoas: raises $0.10 to $0.14
ugi-dugi: folds 
feybys: calls $0.12
greenthum33: calls $0.10
*** FLOP *** [Td 6s 5d]
feybys: checks 
greenthum33: bets $0.21
yositoas: folds 
feybys: folds 
Uncalled bet ($0.21) returned to greenthum33
greenthum33 collected $0.41 from pot
greenthum33: doesn't show hand 
*** SUMMARY ***
Total pot $0.43 | Rake $0.02 
Board [Td 6s 5d]
Seat 1: yositoas (button) folded on the Flop
Seat 2: ugi-dugi (small blind) folded before Flop
Seat 3: feybys (big blind) folded on the Flop
Seat 4: KIraMan folded before Flop (didn't bet)
Seat 5: greenthum33 collected ($0.41)
Seat 6: Scaaalll folded before Flop (didn't bet)



PokerStars Zoom Hand #229229687165:  Hold'em No Limit ($0.01/$0.02) - 2021/08/21 21:10:12 CET [2021/08/21 15:10:12 ET]
Table 'Halley' 6-max Seat #1 is the button
Seat 1: Pechorin.G ($2.39 in chips) 
Seat 2: Hautkunst ($2.27 in chips) 
Seat 3: Syd Wright ($1.96 in chips) 
Seat 4: Laonikos ($3.65 in chips) 
Seat 5: Quad Jacks21 ($2.18 in chips) 
Seat 6: Scaaalll ($2.04 in chips) 
Hautkunst: posts small blind $0.01
Syd Wright: posts big blind $0.02
*** HOLE CARDS ***
Dealt to Scaaalll [4h 2h]
Laonikos: folds 
Quad Jacks21: folds 
Scaaalll: folds 
Pechorin.G: folds 
Hautkunst: folds 
Uncalled bet ($0.01) returned to Syd Wright
Syd Wright collected $0.02 from pot
Syd Wright: doesn't show hand 
Hautkunst is disconnected 
*** SUMMARY ***
Total pot $0.02 | Rake $0 
Seat 1: Pechorin.G (button) folded before Flop (didn't bet)
Seat 2: Hautkunst (small blind) folded before Flop
Seat 3: Syd Wright (big blind) collected ($0.02)
Seat 4: Laonikos folded before Flop (didn't bet)
Seat 5: Quad Jacks21 folded before Flop (didn't bet)
Seat 6: Scaaalll folded before Flop (didn't bet)



PokerStars Zoom Hand #229229681790:  Hold'em No Limit ($0.01/$0.02) - 2021/08/21 21:10:01 CET [2021/08/21 15:10:01 ET]
Table 'Halley' 6-max Seat #1 is the button
Seat 1: unior321 ($1.03 in chips) 
Seat 2: EchoMR ($2 in chips) 
Seat 3: zergmiky ($2.14 in chips) 
Seat 4: Xlavariable ($4.38 in chips) 
Seat 5: Scaaalll ($2.03 in chips) 
Seat 6: kahzura ($2 in chips) 
EchoMR: posts small blind $0.01
zergmiky: posts big blind $0.02
*** HOLE CARDS ***
Dealt to Scaaalll [2h 3d]
EchoMR is disconnected 
Xlavariable: folds 
Scaaalll: folds 
kahzura: raises $0.03 to $0.05
unior321: calls $0.05
EchoMR: folds 
zergmiky: folds 
*** FLOP *** [Jd 6c 4s]
kahzura: checks 
unior321: checks 
*** TURN *** [Jd 6c 4s] [Jc]
kahzura: checks 
unior321: checks 
*** RIVER *** [Jd 6c 4s Jc] [Js]
kahzura: checks 
unior321: checks 
*** SHOW DOWN ***
kahzura: shows [Kh Qd] (three of a kind, Jacks)
unior321: shows [Ad 8d] (three of a kind, Jacks - Ace kicker)
unior321 collected $0.13 from pot
*** SUMMARY ***
Total pot $0.13 | Rake $0 
Board [Jd 6c 4s Jc Js]
Seat 1: unior321 (button) showed [Ad 8d] and won ($0.13) with three of a kind, Jacks
Seat 2: EchoMR (small blind) folded before Flop
Seat 3: zergmiky (big blind) folded before Flop
Seat 4: Xlavariable folded before Flop (didn't bet)
Seat 5: Scaaalll folded before Flop (didn't bet)
Seat 6: kahzura showed [Kh Qd] and lost with three of a kind, Jacks



PokerStars Zoom Hand #229229688945:  Hold'em No Limit ($0.01/$0.02) - 2021/08/21 21:10:17 CET [2021/08/21 15:10:17 ET]
Table 'Halley' 6-max Seat #1 is the button
Seat 1: Scaaalll ($2.04 in chips) 
Seat 2: Kergie ($5.96 in chips) 
Seat 3: SideshowPen ($2 in chips) 
Seat 4: estelionat171 ($0.61 in chips) 
Seat 5: squidy4 ($1.35 in chips) 
Seat 6: Flankeris ($4.85 in chips) 
Kergie: posts small blind $0.01
SideshowPen: posts big blind $0.02
*** HOLE CARDS ***
Dealt to Scaaalll [8d Kc]
estelionat171: folds 
squidy4: folds 
Flankeris: folds 
Scaaalll: folds 
Kergie: raises $0.04 to $0.06
SideshowPen: folds 
Uncalled bet ($0.04) returned to Kergie
Kergie collected $0.04 from pot
Kergie: doesn't show hand 
*** SUMMARY ***
Total pot $0.04 | Rake $0 
Seat 1: Scaaalll (button) folded before Flop (didn't bet)
Seat 2: Kergie (small blind) collected ($0.04)
Seat 3: SideshowPen (big blind) folded before Flop
Seat 4: estelionat171 folded before Flop (didn't bet)
Seat 5: squidy4 folded before Flop (didn't bet)
Seat 6: Flankeris folded before Flop (didn't bet)



PokerStars Zoom Hand #229229693877:  Hold'em No Limit ($0.01/$0.02) - 2021/08/21 21:10:27 CET [2021/08/21 15:10:27 ET]
Table 'Halley' 6-max Seat #1 is the button
Seat 1: pavlo8855 ($2.37 in chips) 
Seat 2: Aroma Iceland ($2.66 in chips) 
Seat 3: Scaaalll ($2.04 in chips) 
Seat 4: NIK1973 23 ($2.50 in chips) 
Seat 5: Tj741 ($2.22 in chips) 
Seat 6: AndreyZ066 ($2.97 in chips) 
Aroma Iceland: posts small blind $0.01
Scaaalll: posts big blind $0.02
*** HOLE CARDS ***
Dealt to Scaaalll [Th Ks]
NIK1973 23: raises $0.04 to $0.06
Tj741: folds 
AndreyZ066: folds 
pavlo8855: folds 
Aroma Iceland: folds 
Scaaalll: folds 
Uncalled bet ($0.04) returned to NIK1973 23
NIK1973 23 collected $0.05 from pot
NIK1973 23: doesn't show hand 
*** SUMMARY ***
Total pot $0.05 | Rake $0 
Seat 1: pavlo8855 (button) folded before Flop (didn't bet)
Seat 2: Aroma Iceland (small blind) folded before Flop
Seat 3: Scaaalll (big blind) folded before Flop
Seat 4: NIK1973 23 collected ($0.05)
Seat 5: Tj741 folded before Flop (didn't bet)
Seat 6: AndreyZ066 folded before Flop (didn't bet)



PokerStars Zoom Hand #229229692073:  Hold'em No Limit ($0.01/$0.02) - 2021/08/21 21:10:23 CET [2021/08/21 15:10:23 ET]
Table 'Halley' 6-max Seat #1 is the button
Seat 1: AligatorsBlood ($2.59 in chips) 
Seat 2: MSD2006 ($1.79 in chips) 
Seat 3: 78joniboy ($3.08 in chips) 
Seat 4: Scaaalll ($2.04 in chips) 
Seat 5: yannikdaehne ($5.29 in chips) 
Seat 6: pers_ikG ($2.14 in chips) 
MSD2006: posts small blind $0.01
78joniboy: posts big blind $0.02
*** HOLE CARDS ***
Dealt to Scaaalll [Jh 7c]
Scaaalll: folds 
yannikdaehne: raises $0.03 to $0.05
pers_ikG: raises $0.11 to $0.16
AligatorsBlood: folds 
MSD2006: folds 
78joniboy: folds 
yannikdaehne: calls $0.11
*** FLOP *** [Ac 9h 2h]
yannikdaehne: checks 
pers_ikG: checks 
*** TURN *** [Ac 9h 2h] [Qh]
yannikdaehne: checks 
pers_ikG: bets $0.11
yannikdaehne: calls $0.11
*** RIVER *** [Ac 9h 2h Qh] [Kh]
yannikdaehne: checks 
pers_ikG: checks 
*** SHOW DOWN ***
yannikdaehne: shows [Td Ts] (a pair of Tens)
pers_ikG: shows [Js Jc] (a pair of Jacks)
pers_ikG collected $0.55 from pot
*** SUMMARY ***
Total pot $0.57 | Rake $0.02 
Board [Ac 9h 2h Qh Kh]
Seat 1: AligatorsBlood (button) folded before Flop (didn't bet)
Seat 2: MSD2006 (small blind) folded before Flop
Seat 3: 78joniboy (big blind) folded before Flop
Seat 4: Scaaalll folded before Flop (didn't bet)
Seat 5: yannikdaehne showed [Td Ts] and lost with a pair of Tens
Seat 6: pers_ikG showed [Js Jc] and won ($0.55) with a pair of Jacks



PokerStars Zoom Hand #229229707013:  Hold'em No Limit ($0.01/$0.02) - 2021/08/21 21:10:56 CET [2021/08/21 15:10:56 ET]
Table 'Halley' 6-max Seat #1 is the button
Seat 1: Scaaalll ($2.01 in chips) 
Seat 2: ignat-of 777 ($0.63 in chips) 
Seat 3: ARTMVSLV ($2.17 in chips) 
Seat 4: alecha11 ($3.17 in chips) 
Seat 5: vaaaala ($5.03 in chips) 
Seat 6: igara tigara ($1.98 in chips) 
ignat-of 777: posts small blind $0.01
ARTMVSLV: posts big blind $0.02
*** HOLE CARDS ***
Dealt to Scaaalll [Jd Ks]
alecha11: folds 
vaaaala: folds 
igara tigara: folds 
Scaaalll: raises $0.02 to $0.04
ignat-of 777: folds 
ARTMVSLV: folds 
Uncalled bet ($0.02) returned to Scaaalll
Scaaalll collected $0.05 from pot
Scaaalll: doesn't show hand 
*** SUMMARY ***
Total pot $0.05 | Rake $0 
Seat 1: Scaaalll (button) collected ($0.05)
Seat 2: ignat-of 777 (small blind) folded before Flop
Seat 3: ARTMVSLV (big blind) folded before Flop
Seat 4: alecha11 folded before Flop (didn't bet)
Seat 5: vaaaala folded before Flop (didn't bet)
Seat 6: igara tigara folded before Flop (didn't bet)



PokerStars Zoom Hand #229229702096:  Hold'em No Limit ($0.01/$0.02) - 2021/08/21 21:10:45 CET [2021/08/21 15:10:45 ET]
Table 'Halley' 6-max Seat #1 is the button
Seat 1: nemat_g ($2.12 in chips) 
Seat 2: Scaaalll ($2.02 in chips) 
Seat 3: egroj1700 ($2.06 in chips) 
Seat 4: pavlo8855 ($2 in chips) 
Seat 5: zergmiky ($2 in chips) 
Seat 6: majo_74 ($2.20 in chips) 
Scaaalll: posts small blind $0.01
egroj1700: posts big blind $0.02
*** HOLE CARDS ***
Dealt to Scaaalll [Td 3s]
pavlo8855: folds 
zergmiky: raises $0.03 to $0.05
majo_74: folds 
nemat_g: folds 
Scaaalll: folds 
egroj1700: calls $0.03
*** FLOP *** [4d 7d 2d]
egroj1700: checks 
zergmiky: bets $0.04
egroj1700: folds 
Uncalled bet ($0.04) returned to zergmiky
zergmiky collected $0.11 from pot
zergmiky: doesn't show hand 
*** SUMMARY ***
Total pot $0.11 | Rake $0 
Board [4d 7d 2d]
Seat 1: nemat_g (button) folded before Flop (didn't bet)
Seat 2: Scaaalll (small blind) folded before Flop
Seat 3: egroj1700 (big blind) folded on the Flop
Seat 4: pavlo8855 folded before Flop (didn't bet)
Seat 5: zergmiky collected ($0.11)
Seat 6: majo_74 folded before Flop (didn't bet)



PokerStars Zoom Hand #229229712817:  Hold'em No Limit ($0.01/$0.02) - 2021/08/21 21:11:09 CET [2021/08/21 15:11:09 ET]
Table 'Halley' 6-max Seat #1 is the button
Seat 1: 78joniboy ($3.05 in chips) 
Seat 2: DUFFTDOG ($1.48 in chips) 
Seat 3: HellNative ($2.50 in chips) 
Seat 4: Scaaalll ($2.04 in chips) 
Seat 5: miha.3108 ($1.32 in chips) 
Seat 6: derry,me ($1.93 in chips) 
DUFFTDOG: posts small blind $0.01
HellNative: posts big blind $0.02
*** HOLE CARDS ***
Dealt to Scaaalll [5s Jc]
Scaaalll: folds 
miha.3108: folds 
derry,me: folds 
derry,me is disconnected 
78joniboy: folds 
DUFFTDOG: raises $0.03 to $0.05
HellNative: folds 
Uncalled bet ($0.03) returned to DUFFTDOG
DUFFTDOG collected $0.04 from pot
DUFFTDOG: doesn't show hand 
*** SUMMARY ***
Total pot $0.04 | Rake $0 
Seat 1: 78joniboy (button) folded before Flop (didn't bet)
Seat 2: DUFFTDOG (small blind) collected ($0.04)
Seat 3: HellNative (big blind) folded before Flop
Seat 4: Scaaalll folded before Flop (didn't bet)
Seat 5: miha.3108 folded before Flop (didn't bet)
Seat 6: derry,me folded before Flop (didn't bet)



PokerStars Zoom Hand #229229714617:  Hold'em No Limit ($0.01/$0.02) - 2021/08/21 21:11:13 CET [2021/08/21 15:11:13 ET]
Table 'Halley' 6-max Seat #1 is the button
Seat 1: arsad725 ($7.18 in chips) 
Seat 2: Gerar NB ($2.93 in chips) 
Seat 3: EchoMR ($2 in chips) 
Seat 4: Loto70 ($2.83 in chips) 
Seat 5: beber_1613 ($2.04 in chips) 
Seat 6: Scaaalll ($2.04 in chips) 
Gerar NB: posts small blind $0.01
EchoMR: posts big blind $0.02
*** HOLE CARDS ***
Dealt to Scaaalll [Kh 8d]
Loto70: folds 
beber_1613: folds 
Scaaalll: folds 
arsad725: raises $0.03 to $0.05
EchoMR is disconnected 
Gerar NB: folds 
EchoMR: folds 
Uncalled bet ($0.03) returned to arsad725
arsad725 collected $0.05 from pot
arsad725: doesn't show hand 
*** SUMMARY ***
Total pot $0.05 | Rake $0 
Seat 1: arsad725 (button) collected ($0.05)
Seat 2: Gerar NB (small blind) folded before Flop
Seat 3: EchoMR (big blind) folded before Flop
Seat 4: Loto70 folded before Flop (didn't bet)
Seat 5: beber_1613 folded before Flop (didn't bet)
Seat 6: Scaaalll folded before Flop (didn't bet)



PokerStars Zoom Hand #229229716410:  Hold'em No Limit ($0.01/$0.02) - 2021/08/21 21:11:17 CET [2021/08/21 15:11:17 ET]
Table 'Halley' 6-max Seat #1 is the button
Seat 1: Sul07 ($1.30 in chips) 
Seat 2: FabOliveira9 ($2 in chips) 
Seat 3: RChinenov ($2.17 in chips) 
Seat 4: texashenry2 ($2.20 in chips) 
Seat 5: Scaaalll ($2.04 in chips) 
Seat 6: BATAL00001 ($1.96 in chips) 
FabOliveira9: posts small blind $0.01
RChinenov: posts big blind $0.02
*** HOLE CARDS ***
Dealt to Scaaalll [9h Ad]
texashenry2: folds 
Scaaalll: folds 
BATAL00001: calls $0.02
Sul07: folds 
FabOliveira9: calls $0.01
RChinenov: checks 
*** FLOP *** [Kc 3d 2d]
FabOliveira9: checks 
RChinenov: checks 
BATAL00001: bets $0.06
FabOliveira9: folds 
RChinenov: folds 
Uncalled bet ($0.06) returned to BATAL00001
BATAL00001 collected $0.06 from pot
BATAL00001: doesn't show hand 
*** SUMMARY ***
Total pot $0.06 | Rake $0 
Board [Kc 3d 2d]
Seat 1: Sul07 (button) folded before Flop (didn't bet)
Seat 2: FabOliveira9 (small blind) folded on the Flop
Seat 3: RChinenov (big blind) folded on the Flop
Seat 4: texashenry2 folded before Flop (didn't bet)
Seat 5: Scaaalll folded before Flop (didn't bet)
Seat 6: BATAL00001 collected ($0.06)



PokerStars Zoom Hand #229229748712:  Hold'em No Limit ($0.01/$0.02) - 2021/08/21 21:12:28 CET [2021/08/21 15:12:28 ET]
Table 'Halley' 6-max Seat #1 is the button
Seat 1: Scaaalll ($2 in chips) 
Seat 2: 2m4m4 ($0.94 in chips) 
Seat 3: MinimalFunkd ($3.98 in chips) 
Seat 4: Addon289174 ($2.22 in chips) 
Seat 5: Gabr Ribeiro ($2.18 in chips) 
Seat 6: agusdecarca ($4.97 in chips) 
2m4m4: posts small blind $0.01
MinimalFunkd: posts big blind $0.02
*** HOLE CARDS ***
Dealt to Scaaalll [Jd 5s]
Addon289174: folds 
Gabr Ribeiro: folds 
agusdecarca: folds 
Scaaalll: folds 
2m4m4: folds 
Uncalled bet ($0.01) returned to MinimalFunkd
MinimalFunkd collected $0.02 from pot
MinimalFunkd: doesn't show hand 
*** SUMMARY ***
Total pot $0.02 | Rake $0 
Seat 1: Scaaalll (button) folded before Flop (didn't bet)
Seat 2: 2m4m4 (small blind) folded before Flop
Seat 3: MinimalFunkd (big blind) collected ($0.02)
Seat 4: Addon289174 folded before Flop (didn't bet)
Seat 5: Gabr Ribeiro folded before Flop (didn't bet)
Seat 6: agusdecarca folded before Flop (didn't bet)



PokerStars Zoom Hand #229229721485:  Hold'em No Limit ($0.01/$0.02) - 2021/08/21 21:11:28 CET [2021/08/21 15:11:28 ET]
Table 'Halley' 6-max Seat #1 is the button
Seat 1: Xlavariable ($2 in chips) 
Seat 2: Scaaalll ($2.04 in chips) 
Seat 3: Shadi8 ($2.70 in chips) 
Seat 4: Wegezin ($3.35 in chips) 
Seat 5: JuninhoXapa ($2.35 in chips) 
Seat 6: ser313131 ($2.10 in chips) 
Scaaalll: posts small blind $0.01
Shadi8: posts big blind $0.02
*** HOLE CARDS ***
Dealt to Scaaalll [8c Ac]
Wegezin: folds 
JuninhoXapa: raises $0.03 to $0.05
ser313131: calls $0.05
Xlavariable: calls $0.05
Scaaalll: calls $0.04
Shadi8: folds 
*** FLOP *** [2d Kh 7c]
Scaaalll: checks 
JuninhoXapa: checks 
ser313131: checks 
Xlavariable: checks 
*** TURN *** [2d Kh 7c] [Ad]
Scaaalll: checks 
JuninhoXapa: bets $0.16
ser313131: calls $0.16
Xlavariable: folds 
Scaaalll: folds 
*** RIVER *** [2d Kh 7c Ad] [Qc]
JuninhoXapa: bets $0.36
ser313131: calls $0.36
*** SHOW DOWN ***
JuninhoXapa: shows [Ah Jc] (a pair of Aces)
ser313131: mucks hand 
JuninhoXapa collected $1.22 from pot
*** SUMMARY ***
Total pot $1.26 | Rake $0.04 
Board [2d Kh 7c Ad Qc]
Seat 1: Xlavariable (button) folded on the Turn
Seat 2: Scaaalll (small blind) folded on the Turn
Seat 3: Shadi8 (big blind) folded before Flop
Seat 4: Wegezin folded before Flop (didn't bet)
Seat 5: JuninhoXapa showed [Ah Jc] and won ($1.22) with a pair of Aces
Seat 6: ser313131 mucked [Tc As]



PokerStars Zoom Hand #229229753161:  Hold'em No Limit ($0.01/$0.02) - 2021/08/21 21:12:38 CET [2021/08/21 15:12:38 ET]
Table 'Halley' 6-max Seat #1 is the button
Seat 1: Superfish I ($2.56 in chips) 
Seat 2: Tj741 ($2.25 in chips) 
Seat 3: Scaaalll ($2 in chips) 
Seat 4: Murphy1693 ($2.24 in chips) 
Seat 5: Oprichnick90 ($2.76 in chips) 
Seat 6: kodart ($1.62 in chips) 
Tj741: posts small blind $0.01
Scaaalll: posts big blind $0.02
*** HOLE CARDS ***
Dealt to Scaaalll [9d Qd]
Murphy1693: folds 
Oprichnick90: folds 
kodart: folds 
Superfish I: folds 
Tj741: folds 
Uncalled bet ($0.01) returned to Scaaalll
Scaaalll collected $0.02 from pot
Scaaalll: doesn't show hand 
*** SUMMARY ***
Total pot $0.02 | Rake $0 
Seat 1: Superfish I (button) folded before Flop (didn't bet)
Seat 2: Tj741 (small blind) folded before Flop
Seat 3: Scaaalll (big blind) collected ($0.02)
Seat 4: Murphy1693 folded before Flop (didn't bet)
Seat 5: Oprichnick90 folded before Flop (didn't bet)
Seat 6: kodart folded before Flop (didn't bet)



PokerStars Zoom Hand #229229757807:  Hold'em No Limit ($0.01/$0.02) - 2021/08/21 21:12:48 CET [2021/08/21 15:12:48 ET]
Table 'Halley' 6-max Seat #1 is the button
Seat 1: Laonikos ($3.25 in chips) 
Seat 2: franquillooo ($4.48 in chips) 
Seat 3: CrazyyParis ($2.13 in chips) 
Seat 4: Scaaalll ($2.01 in chips) 
Seat 5: BATAL00001 ($2.12 in chips) 
Seat 6: TNTKM ($2.02 in chips) 
franquillooo: posts small blind $0.01
CrazyyParis: posts big blind $0.02
*** HOLE CARDS ***
Dealt to Scaaalll [4h 7s]
Scaaalll: folds 
BATAL00001: calls $0.02
TNTKM: folds 
TNTKM is disconnected 
Laonikos: raises $0.06 to $0.08
franquillooo: folds 
CrazyyParis: folds 
BATAL00001: folds 
Uncalled bet ($0.06) returned to Laonikos
BATAL00001 is disconnected 
Laonikos collected $0.07 from pot
Laonikos: doesn't show hand 
*** SUMMARY ***
Total pot $0.07 | Rake $0 
Seat 1: Laonikos (button) collected ($0.07)
Seat 2: franquillooo (small blind) folded before Flop
Seat 3: CrazyyParis (big blind) folded before Flop
Seat 4: Scaaalll folded before Flop (didn't bet)
Seat 5: BATAL00001 folded before Flop
Seat 6: TNTKM folded before Flop (didn't bet)



PokerStars Zoom Hand #229229763219:  Hold'em No Limit ($0.01/$0.02) - 2021/08/21 21:13:00 CET [2021/08/21 15:13:00 ET]
Table 'Halley' 6-max Seat #1 is the button
Seat 1: csmall14 ($2.83 in chips) 
Seat 2: Pechorin.G ($2.32 in chips) 
Seat 3: Sparrovv ($2 in chips) 
Seat 4: Scaaalll ($2.01 in chips) 
Seat 5: gasmar_29 ($3.37 in chips) 
Seat 6: Zhyla95 ($2 in chips) 
Pechorin.G: posts small blind $0.01
Sparrovv: posts big blind $0.02
*** HOLE CARDS ***
Dealt to Scaaalll [Ks 6c]
Scaaalll: folds 
gasmar_29: folds 
Zhyla95: folds 
csmall14: folds 
Pechorin.G: folds 
Uncalled bet ($0.01) returned to Sparrovv
Sparrovv collected $0.02 from pot
Sparrovv: doesn't show hand 
*** SUMMARY ***
Total pot $0.02 | Rake $0 
Seat 1: csmall14 (button) folded before Flop (didn't bet)
Seat 2: Pechorin.G (small blind) folded before Flop
Seat 3: Sparrovv (big blind) collected ($0.02)
Seat 4: Scaaalll folded before Flop (didn't bet)
Seat 5: gasmar_29 folded before Flop (didn't bet)
Seat 6: Zhyla95 folded before Flop (didn't bet)



PokerStars Zoom Hand #229229765010:  Hold'em No Limit ($0.01/$0.02) - 2021/08/21 21:13:04 CET [2021/08/21 15:13:04 ET]
Table 'Halley' 6-max Seat #1 is the button
Seat 1: zergmiky ($2.11 in chips) 
Seat 2: Scaaalll ($2.01 in chips) 
Seat 3: Victor151886 ($3.58 in chips) 
Seat 4: nodtress ($2 in chips) 
Seat 5: andreydgk ($4.43 in chips) 
Seat 6: VisjePaktJe ($5.03 in chips) 
Scaaalll: posts small blind $0.01
Victor151886: posts big blind $0.02
*** HOLE CARDS ***
Dealt to Scaaalll [Ah 6h]
nodtress: folds 
andreydgk: folds 
VisjePaktJe: folds 
zergmiky: folds 
Scaaalll: raises $0.04 to $0.06
Victor151886: folds 
Uncalled bet ($0.04) returned to Scaaalll
Scaaalll collected $0.04 from pot
Scaaalll: doesn't show hand 
*** SUMMARY ***
Total pot $0.04 | Rake $0 
Seat 1: zergmiky (button) folded before Flop (didn't bet)
Seat 2: Scaaalll (small blind) collected ($0.04)
Seat 3: Victor151886 (big blind) folded before Flop
Seat 4: nodtress folded before Flop (didn't bet)
Seat 5: andreydgk folded before Flop (didn't bet)
Seat 6: VisjePaktJe folded before Flop (didn't bet)



PokerStars Zoom Hand #229229760075:  Hold'em No Limit ($0.01/$0.02) - 2021/08/21 21:12:54 CET [2021/08/21 15:12:54 ET]
Table 'Halley' 6-max Seat #1 is the button
Seat 1: Shadi8 ($2.54 in chips) 
Seat 2: beber_1613 ($2.05 in chips) 
Seat 3: olga3021221 ($3.62 in chips) 
Seat 4: Clavis Noa ($2 in chips) 
Seat 5: HellNative ($2.29 in chips) 
Seat 6: Scaaalll ($2.01 in chips) 
beber_1613: posts small blind $0.01
olga3021221: posts big blind $0.02
*** HOLE CARDS ***
Dealt to Scaaalll [7c 5s]
Clavis Noa: raises $0.02 to $0.04
HellNative: calls $0.04
Scaaalll: folds 
Shadi8: folds 
beber_1613: folds 
olga3021221: folds 
*** FLOP *** [9h 6h As]
Clavis Noa: checks 
HellNative: checks 
*** TURN *** [9h 6h As] [3s]
Clavis Noa: checks 
HellNative: checks 
*** RIVER *** [9h 6h As 3s] [8s]
Clavis Noa: bets $0.11
HellNative: folds 
Uncalled bet ($0.11) returned to Clavis Noa
Clavis Noa collected $0.11 from pot
Clavis Noa: doesn't show hand 
*** SUMMARY ***
Total pot $0.11 | Rake $0 
Board [9h 6h As 3s 8s]
Seat 1: Shadi8 (button) folded before Flop (didn't bet)
Seat 2: beber_1613 (small blind) folded before Flop
Seat 3: olga3021221 (big blind) folded before Flop
Seat 4: Clavis Noa collected ($0.11)
Seat 5: HellNative folded on the River
Seat 6: Scaaalll folded before Flop (didn't bet)



PokerStars Zoom Hand #229229781023:  Hold'em No Limit ($0.01/$0.02) - 2021/08/21 21:13:39 CET [2021/08/21 15:13:39 ET]
Table 'Halley' 6-max Seat #1 is the button
Seat 1: Flankeris ($7.72 in chips) 
Seat 2: Koldun 2636 ($2 in chips) 
Seat 3: Scaaalll ($2.03 in chips) 
Seat 4: skatocharlie ($3.47 in chips) 
Seat 5: benubeção ($1.30 in chips) 
Seat 6: xxRoseIloveu ($2.33 in chips) 
Koldun 2636: posts small blind $0.01
Scaaalll: posts big blind $0.02
*** HOLE CARDS ***
Dealt to Scaaalll [Jh Qc]
skatocharlie: folds 
benubeção: folds 
xxRoseIloveu: folds 
Flankeris: folds 
Koldun 2636: folds 
Uncalled bet ($0.01) returned to Scaaalll
benubeção is disconnected 
Scaaalll collected $0.02 from pot
Scaaalll: doesn't show hand 
*** SUMMARY ***
Total pot $0.02 | Rake $0 
Seat 1: Flankeris (button) folded before Flop (didn't bet)
Seat 2: Koldun 2636 (small blind) folded before Flop
Seat 3: Scaaalll (big blind) collected ($0.02)
Seat 4: skatocharlie folded before Flop (didn't bet)
Seat 5: benubeção folded before Flop (didn't bet)
Seat 6: xxRoseIloveu folded before Flop (didn't bet)



PokerStars Zoom Hand #229229776993:  Hold'em No Limit ($0.01/$0.02) - 2021/08/21 21:13:30 CET [2021/08/21 15:13:30 ET]
Table 'Halley' 6-max Seat #1 is the button
Seat 1: Iluvatar922 ($4.11 in chips) 
Seat 2: KKARMELO ($2.58 in chips) 
Seat 3: Sinad1302 ($3.17 in chips) 
Seat 4: Ichverdammt ($1.44 in chips) 
Seat 5: Scaaalll ($2.03 in chips) 
Seat 6: xxVanquishxx ($2.25 in chips) 
KKARMELO: posts small blind $0.01
Sinad1302: posts big blind $0.02
*** HOLE CARDS ***
Dealt to Scaaalll [5h 7d]
Ichverdammt: folds 
Scaaalll: folds 
xxVanquishxx: folds 
Iluvatar922: raises $0.03 to $0.05
KKARMELO: folds 
Sinad1302: calls $0.03
*** FLOP *** [Kc 5s Qc]
Sinad1302: checks 
Iluvatar922: bets $0.06
Sinad1302: folds 
Uncalled bet ($0.06) returned to Iluvatar922
Iluvatar922 collected $0.11 from pot
Iluvatar922: doesn't show hand 
Sinad1302 is disconnected 
*** SUMMARY ***
Total pot $0.11 | Rake $0 
Board [Kc 5s Qc]
Seat 1: Iluvatar922 (button) collected ($0.11)
Seat 2: KKARMELO (small blind) folded before Flop
Seat 3: Sinad1302 (big blind) folded on the Flop
Seat 4: Ichverdammt folded before Flop (didn't bet)
Seat 5: Scaaalll folded before Flop (didn't bet)
Seat 6: xxVanquishxx folded before Flop (didn't bet)



PokerStars Zoom Hand #229229786538:  Hold'em No Limit ($0.01/$0.02) - 2021/08/21 21:13:51 CET [2021/08/21 15:13:51 ET]
Table 'Halley' 6-max Seat #1 is the button
Seat 1: Flavinho ;D ($1.97 in chips) 
Seat 2: Scaaalll ($2.04 in chips) 
Seat 3: jaamonra ($3.75 in chips) 
Seat 4: lena1977480 ($1.80 in chips) 
Seat 5: Syd Wright ($1.98 in chips) 
Seat 6: Saint_ANBU ($2.02 in chips) 
Scaaalll: posts small blind $0.01
jaamonra: posts big blind $0.02
*** HOLE CARDS ***
Dealt to Scaaalll [2d 8d]
lena1977480: folds 
Syd Wright: folds 
Saint_ANBU: raises $0.04 to $0.06
Flavinho ;D: folds 
Scaaalll: folds 
jaamonra: folds 
Uncalled bet ($0.04) returned to Saint_ANBU
Saint_ANBU collected $0.05 from pot
Saint_ANBU: doesn't show hand 
*** SUMMARY ***
Total pot $0.05 | Rake $0 
Seat 1: Flavinho ;D (button) folded before Flop (didn't bet)
Seat 2: Scaaalll (small blind) folded before Flop
Seat 3: jaamonra (big blind) folded before Flop
Seat 4: lena1977480 folded before Flop (didn't bet)
Seat 5: Syd Wright folded before Flop (didn't bet)
Seat 6: Saint_ANBU collected ($0.05)



PokerStars Zoom Hand #229229779256:  Hold'em No Limit ($0.01/$0.02) - 2021/08/21 21:13:35 CET [2021/08/21 15:13:35 ET]
Table 'Halley' 6-max Seat #1 is the button
Seat 1: rekopo203 ($1.92 in chips) 
Seat 2: iPitbull1 ($2.48 in chips) 
Seat 3: BO/\KODAB 22 ($1.58 in chips) 
Seat 4: Scaaalll ($2.03 in chips) 
Seat 5: zizu1014 ($2.28 in chips) 
Seat 6: Snegul ($0.55 in chips) 
iPitbull1: posts small blind $0.01
BO/\KODAB 22: posts big blind $0.02
*** HOLE CARDS ***
Dealt to Scaaalll [Ts 6d]
Scaaalll: folds 
zizu1014: folds 
Snegul: raises $0.03 to $0.05
rekopo203: calls $0.05
iPitbull1: folds 
BO/\KODAB 22: calls $0.03
*** FLOP *** [3d Qc 7d]
BO/\KODAB 22: bets $0.08
Snegul: folds 
rekopo203: calls $0.08
*** TURN *** [3d Qc 7d] [6s]
BO/\KODAB 22: bets $0.16
rekopo203: calls $0.16
*** RIVER *** [3d Qc 7d 6s] [7c]
BO/\KODAB 22: checks 
rekopo203: checks 
*** SHOW DOWN ***
BO/\KODAB 22: shows [9d 8d] (a pair of Sevens)
rekopo203: shows [Kc Qd] (two pair, Queens and Sevens)
rekopo203 collected $0.62 from pot
*** SUMMARY ***
Total pot $0.64 | Rake $0.02 
Board [3d Qc 7d 6s 7c]
Seat 1: rekopo203 (button) showed [Kc Qd] and won ($0.62) with two pair, Queens and Sevens
Seat 2: iPitbull1 (small blind) folded before Flop
Seat 3: BO/\KODAB 22 (big blind) showed [9d 8d] and lost with a pair of Sevens
Seat 4: Scaaalll folded before Flop (didn't bet)
Seat 5: zizu1014 folded before Flop (didn't bet)
Seat 6: Snegul folded on the Flop



PokerStars Zoom Hand #229229791579:  Hold'em No Limit ($0.01/$0.02) - 2021/08/21 21:14:02 CET [2021/08/21 15:14:02 ET]
Table 'Halley' 6-max Seat #1 is the button
Seat 1: Scaaalll ($2.03 in chips) 
Seat 2: L00TS254 ($2.27 in chips) 
Seat 3: MollyNW ($1.24 in chips) 
Seat 4: RonilsonCosta ($2.18 in chips) 
Seat 5: EchoMR ($2.20 in chips) 
Seat 6: Gerar NB ($2.06 in chips) 
L00TS254: posts small blind $0.01
MollyNW: posts big blind $0.02
*** HOLE CARDS ***
Dealt to Scaaalll [Th 2h]
EchoMR is disconnected 
RonilsonCosta: folds 
EchoMR: folds 
Gerar NB: folds 
Scaaalll: folds 
L00TS254: folds 
Uncalled bet ($0.01) returned to MollyNW
MollyNW collected $0.02 from pot
MollyNW: doesn't show hand 
*** SUMMARY ***
Total pot $0.02 | Rake $0 
Seat 1: Scaaalll (button) folded before Flop (didn't bet)
Seat 2: L00TS254 (small blind) folded before Flop
Seat 3: MollyNW (big blind) collected ($0.02)
Seat 4: RonilsonCosta folded before Flop (didn't bet)
Seat 5: EchoMR folded before Flop (didn't bet)
Seat 6: Gerar NB folded before Flop (didn't bet)



PokerStars Zoom Hand #229229797014:  Hold'em No Limit ($0.01/$0.02) - 2021/08/21 21:14:15 CET [2021/08/21 15:14:15 ET]
Table 'Halley' 6-max Seat #1 is the button
Seat 1: diegohgmelo ($1.96 in chips) 
Seat 2: kwant33 ($3.57 in chips) 
Seat 3: Ferr4r1430 ($2.06 in chips) 
Seat 4: NecromiconP ($2.10 in chips) 
Seat 5: Pechorin.G ($2 in chips) 
Seat 6: Scaaalll ($2.03 in chips) 
kwant33: posts small blind $0.01
Ferr4r1430: posts big blind $0.02
*** HOLE CARDS ***
Dealt to Scaaalll [8d 2s]
NecromiconP: folds 
Pechorin.G: folds 
Scaaalll: folds 
diegohgmelo: folds 
diegohgmelo is disconnected 
kwant33: raises $0.04 to $0.06
Ferr4r1430: folds 
Uncalled bet ($0.04) returned to kwant33
kwant33 collected $0.04 from pot
kwant33: doesn't show hand 
Ferr4r1430 is disconnected 
*** SUMMARY ***
Total pot $0.04 | Rake $0 
Seat 1: diegohgmelo (button) folded before Flop (didn't bet)
Seat 2: kwant33 (small blind) collected ($0.04)
Seat 3: Ferr4r1430 (big blind) folded before Flop
Seat 4: NecromiconP folded before Flop (didn't bet)
Seat 5: Pechorin.G folded before Flop (didn't bet)
Seat 6: Scaaalll folded before Flop (didn't bet)



PokerStars Zoom Hand #229229799260:  Hold'em No Limit ($0.01/$0.02) - 2021/08/21 21:14:19 CET [2021/08/21 15:14:19 ET]
Table 'Halley' 6-max Seat #1 is the button
Seat 1: Laonikos ($4.22 in chips) 
Seat 2: HellNative ($4.62 in chips) 
Seat 3: Scaaalll ($2.03 in chips) 
Seat 4: unior321 ($0.77 in chips) 
Seat 5: L00TS254 ($2.24 in chips) 
Seat 6: sg.32rus ($1.57 in chips) 
HellNative: posts small blind $0.01
Scaaalll: posts big blind $0.02
*** HOLE CARDS ***
Dealt to Scaaalll [7h 2s]
unior321: folds 
L00TS254: folds 
unior321 is disconnected 
sg.32rus: calls $0.02
Laonikos: folds 
HellNative: folds 
Scaaalll: checks 
*** FLOP *** [Ac 9c Th]
Scaaalll: checks 
sg.32rus: checks 
*** TURN *** [Ac 9c Th] [Jh]
Scaaalll: checks 
sg.32rus: checks 
*** RIVER *** [Ac 9c Th Jh] [Ts]
Scaaalll: checks 
sg.32rus: checks 
*** SHOW DOWN ***
Scaaalll: shows [7h 2s] (a pair of Tens)
sg.32rus: shows [6s 7s] (a pair of Tens)
Scaaalll collected $0.03 from pot
sg.32rus collected $0.02 from pot
*** SUMMARY ***
Total pot $0.05 | Rake $0 
Board [Ac 9c Th Jh Ts]
Seat 1: Laonikos (button) folded before Flop (didn't bet)
Seat 2: HellNative (small blind) folded before Flop
Seat 3: Scaaalll (big blind) showed [7h 2s] and won ($0.03) with a pair of Tens
Seat 4: unior321 folded before Flop (didn't bet)
Seat 5: L00TS254 folded before Flop (didn't bet)
Seat 6: sg.32rus showed [6s 7s] and won ($0.02) with a pair of Tens



PokerStars Zoom Hand #229229819298:  Hold'em No Limit ($0.01/$0.02) - 2021/08/21 21:15:03 CET [2021/08/21 15:15:03 ET]
Table 'Halley' 6-max Seat #1 is the button
Seat 1: sg.32rus ($1.57 in chips) 
Seat 2: german123839 ($1.98 in chips) 
Seat 3: Snegul ($0.06 in chips) 
Seat 4: Berti281 ($2.36 in chips) 
Seat 5: RonilsonCosta ($2.52 in chips) 
Seat 6: Scaaalll ($2.04 in chips) 
german123839: posts small blind $0.01
Snegul: posts big blind $0.02
*** HOLE CARDS ***
Dealt to Scaaalll [2h 3h]
Berti281: raises $0.04 to $0.06
german123839 is disconnected 
RonilsonCosta: folds 
Scaaalll: folds 
sg.32rus: folds 
german123839: folds 
Snegul: folds 
Uncalled bet ($0.04) returned to Berti281
Berti281 collected $0.05 from pot
Berti281: doesn't show hand 
*** SUMMARY ***
Total pot $0.05 | Rake $0 
Seat 1: sg.32rus (button) folded before Flop (didn't bet)
Seat 2: german123839 (small blind) folded before Flop
Seat 3: Snegul (big blind) folded before Flop
Seat 4: Berti281 collected ($0.05)
Seat 5: RonilsonCosta folded before Flop (didn't bet)
Seat 6: Scaaalll folded before Flop (didn't bet)



PokerStars Zoom Hand #229229821629:  Hold'em No Limit ($0.01/$0.02) - 2021/08/21 21:15:07 CET [2021/08/21 15:15:07 ET]
Table 'Halley' 6-max Seat #1 is the button
Seat 1: ARTMVSLV ($3.01 in chips) 
Seat 2: Stormzilla ($2.15 in chips) 
Seat 3: kykareky32 ($1.93 in chips) 
Seat 4: HARRY68rus ($1.87 in chips) 
Seat 5: Scaaalll ($2.04 in chips) 
Seat 6: NecromiconP ($2 in chips) 
Stormzilla: posts small blind $0.01
kykareky32: posts big blind $0.02
*** HOLE CARDS ***
Dealt to Scaaalll [3s Jc]
HARRY68rus: folds 
Scaaalll: folds 
NecromiconP: folds 
ARTMVSLV: folds 
Stormzilla: folds 
Uncalled bet ($0.01) returned to kykareky32
kykareky32 collected $0.02 from pot
kykareky32: doesn't show hand 
*** SUMMARY ***
Total pot $0.02 | Rake $0 
Seat 1: ARTMVSLV (button) folded before Flop (didn't bet)
Seat 2: Stormzilla (small blind) folded before Flop
Seat 3: kykareky32 (big blind) collected ($0.02)
Seat 4: HARRY68rus folded before Flop (didn't bet)
Seat 5: Scaaalll folded before Flop (didn't bet)
Seat 6: NecromiconP folded before Flop (didn't bet)



PokerStars Zoom Hand #229229823962:  Hold'em No Limit ($0.01/$0.02) - 2021/08/21 21:15:12 CET [2021/08/21 15:15:12 ET]
Table 'Halley' 6-max Seat #1 is the button
Seat 1: ggGoldenPunk ($2.68 in chips) 
Seat 2: xxVanquishxx ($2.23 in chips) 
Seat 3: takeatrip180 ($2.77 in chips) 
Seat 4: Scaaalll ($2.04 in chips) 
Seat 5: Xlavariable ($4.27 in chips) 
Seat 6: timasblemba ($4.91 in chips) 
xxVanquishxx: posts small blind $0.01
takeatrip180: posts big blind $0.02
*** HOLE CARDS ***
Dealt to Scaaalll [9c 5s]
Scaaalll: folds 
Xlavariable: folds 
timasblemba: folds 
ggGoldenPunk: folds 
xxVanquishxx: folds 
Uncalled bet ($0.01) returned to takeatrip180
takeatrip180 collected $0.02 from pot
takeatrip180: doesn't show hand 
*** SUMMARY ***
Total pot $0.02 | Rake $0 
Seat 1: ggGoldenPunk (button) folded before Flop (didn't bet)
Seat 2: xxVanquishxx (small blind) folded before Flop
Seat 3: takeatrip180 (big blind) collected ($0.02)
Seat 4: Scaaalll folded before Flop (didn't bet)
Seat 5: Xlavariable folded before Flop (didn't bet)
Seat 6: timasblemba folded before Flop (didn't bet)



PokerStars Zoom Hand #229229825816:  Hold'em No Limit ($0.01/$0.02) - 2021/08/21 21:15:16 CET [2021/08/21 15:15:16 ET]
Table 'Halley' 6-max Seat #1 is the button
Seat 1: 7LEV77 ($2 in chips) 
Seat 2: Scaaalll ($2.04 in chips) 
Seat 3: Zhyla95 ($2.08 in chips) 
Seat 4: Mr_gama2019 ($2.13 in chips) 
Seat 5: maliniak75 ($1.55 in chips) 
Seat 6: Finkey99 ($2.64 in chips) 
Scaaalll: posts small blind $0.01
Zhyla95: posts big blind $0.02
*** HOLE CARDS ***
Dealt to Scaaalll [3c Ah]
Mr_gama2019 has timed out
Mr_gama2019: folds 
Mr_gama2019 is disconnected 
maliniak75: folds 
Finkey99: folds 
7LEV77: folds 
Scaaalll: folds 
Uncalled bet ($0.01) returned to Zhyla95
Zhyla95 collected $0.02 from pot
Zhyla95: doesn't show hand 
*** SUMMARY ***
Total pot $0.02 | Rake $0 
Seat 1: 7LEV77 (button) folded before Flop (didn't bet)
Seat 2: Scaaalll (small blind) folded before Flop
Seat 3: Zhyla95 (big blind) collected ($0.02)
Seat 4: Mr_gama2019 folded before Flop (didn't bet)
Seat 5: maliniak75 folded before Flop (didn't bet)
Seat 6: Finkey99 folded before Flop (didn't bet)



PokerStars Zoom Hand #229229832672:  Hold'em No Limit ($0.01/$0.02) - 2021/08/21 21:15:31 CET [2021/08/21 15:15:31 ET]
Table 'Halley' 6-max Seat #1 is the button
Seat 1: Scaaalll ($2.03 in chips) 
Seat 2: kodart ($1.34 in chips) 
Seat 3: ser313131 ($2 in chips) 
Seat 4: Superfish I ($3.27 in chips) 
Seat 5: Syd Wright ($1.98 in chips) 
Seat 6: jaamonra ($3.72 in chips) 
kodart: posts small blind $0.01
ser313131: posts big blind $0.02
*** HOLE CARDS ***
Dealt to Scaaalll [2d 4d]
Superfish I: folds 
Syd Wright: folds 
jaamonra: folds 
Scaaalll has timed out
Scaaalll: folds 
kodart: raises $0.03 to $0.05
ser313131: folds 
Uncalled bet ($0.03) returned to kodart
kodart collected $0.04 from pot
kodart: doesn't show hand 
*** SUMMARY ***
Total pot $0.04 | Rake $0 
Seat 1: Scaaalll (button) folded before Flop (didn't bet)
Seat 2: kodart (small blind) collected ($0.04)
Seat 3: ser313131 (big blind) folded before Flop
Seat 4: Superfish I folded before Flop (didn't bet)
Seat 5: Syd Wright folded before Flop (didn't bet)
Seat 6: jaamonra folded before Flop (didn't bet)



PokerStars Zoom Hand #229229842849:  Hold'em No Limit ($0.01/$0.02) - 2021/08/21 21:15:53 CET [2021/08/21 15:15:53 ET]
Table 'Halley' 6-max Seat #1 is the button
Seat 1: KKARMELO ($3.42 in chips) 
Seat 2: someone0611 ($1.52 in chips) 
Seat 3: Gabr Ribeiro ($2.50 in chips) 
Seat 4: Ne0net ($2.63 in chips) 
Seat 5: Scaaalll ($2.03 in chips) 
Seat 6: lyapis75 ($2.04 in chips) 
someone0611: posts small blind $0.01
Gabr Ribeiro: posts big blind $0.02
*** HOLE CARDS ***
Dealt to Scaaalll [8c 7c]
Ne0net: folds 
Scaaalll: raises $0.04 to $0.06
lyapis75: folds 
KKARMELO: folds 
someone0611: calls $0.05
Gabr Ribeiro: folds 
*** FLOP *** [3c 5s 3h]
someone0611: bets $0.02
Scaaalll: raises $0.10 to $0.12
someone0611: calls $0.10
*** TURN *** [3c 5s 3h] [Ac]
someone0611: bets $0.02
Scaaalll: raises $0.22 to $0.24
someone0611: calls $0.22
*** RIVER *** [3c 5s 3h Ac] [Jc]
someone0611: checks 
Scaaalll: bets $0.61
someone0611: calls $0.61
*** SHOW DOWN ***
Scaaalll: shows [8c 7c] (a flush, Ace high)
someone0611: mucks hand 
Scaaalll collected $1.99 from pot
*** SUMMARY ***
Total pot $2.08 | Rake $0.09 
Board [3c 5s 3h Ac Jc]
Seat 1: KKARMELO (button) folded before Flop (didn't bet)
Seat 2: someone0611 (small blind) mucked [Ah 4h]
Seat 3: Gabr Ribeiro (big blind) folded before Flop
Seat 4: Ne0net folded before Flop (didn't bet)
Seat 5: Scaaalll showed [8c 7c] and won ($1.99) with a flush, Ace high
Seat 6: lyapis75 folded before Flop (didn't bet)



PokerStars Zoom Hand #229229877429:  Hold'em No Limit ($0.01/$0.02) - 2021/08/21 21:17:07 CET [2021/08/21 15:17:07 ET]
Table 'Halley' 6-max Seat #1 is the button
Seat 1: DURO.RIVAL ($2 in chips) 
Seat 2: Flankeris ($3.22 in chips) 
Seat 3: timasblemba ($4.93 in chips) 
Seat 4: dorro61966 ($0.90 in chips) 
Seat 5: Scaaalll ($2.99 in chips) 
Seat 6: japinhaguara ($2.35 in chips) 
Flankeris: posts small blind $0.01
timasblemba: posts big blind $0.02
*** HOLE CARDS ***
Dealt to Scaaalll [Th Ks]
dorro61966: folds 
Scaaalll: raises $0.04 to $0.06
japinhaguara: folds 
DURO.RIVAL: folds 
Flankeris: folds 
timasblemba: folds 
Uncalled bet ($0.04) returned to Scaaalll
Scaaalll collected $0.05 from pot
Scaaalll: doesn't show hand 
*** SUMMARY ***
Total pot $0.05 | Rake $0 
Seat 1: DURO.RIVAL (button) folded before Flop (didn't bet)
Seat 2: Flankeris (small blind) folded before Flop
Seat 3: timasblemba (big blind) folded before Flop
Seat 4: dorro61966 folded before Flop (didn't bet)
Seat 5: Scaaalll collected ($0.05)
Seat 6: japinhaguara folded before Flop (didn't bet)



PokerStars Zoom Hand #229229885328:  Hold'em No Limit ($0.01/$0.02) - 2021/08/21 21:17:24 CET [2021/08/21 15:17:24 ET]
Table 'Halley' 6-max Seat #1 is the button
Seat 1: Scaaalll ($3.02 in chips) 
Seat 2: flexitunes ($2.06 in chips) 
Seat 3: Fedor_Gar ($2.22 in chips) 
Seat 4: Saint_ANBU ($2.20 in chips) 
Seat 5: usenovm ($1.90 in chips) 
Seat 6: leedsrounder ($3.67 in chips) 
flexitunes: posts small blind $0.01
Fedor_Gar: posts big blind $0.02
*** HOLE CARDS ***
Dealt to Scaaalll [8h As]
Saint_ANBU: folds 
usenovm: calls $0.02
leedsrounder: folds 
Scaaalll: raises $0.06 to $0.08
flexitunes: folds 
Fedor_Gar: folds 
usenovm: calls $0.06
*** FLOP *** [Ks 3c Qd]
usenovm: bets $0.10
Scaaalll: folds 
Uncalled bet ($0.10) returned to usenovm
usenovm collected $0.18 from pot
usenovm: doesn't show hand 
*** SUMMARY ***
Total pot $0.19 | Rake $0.01 
Board [Ks 3c Qd]
Seat 1: Scaaalll (button) folded on the Flop
Seat 2: flexitunes (small blind) folded before Flop
Seat 3: Fedor_Gar (big blind) folded before Flop
Seat 4: Saint_ANBU folded before Flop (didn't bet)
Seat 5: usenovm collected ($0.18)
Seat 6: leedsrounder folded before Flop (didn't bet)



PokerStars Zoom Hand #229229899713:  Hold'em No Limit ($0.01/$0.02) - 2021/08/21 21:17:55 CET [2021/08/21 15:17:55 ET]
Table 'Halley' 6-max Seat #1 is the button
Seat 1: Sul07 ($1.22 in chips) 
Seat 2: py100ta ($2.08 in chips) 
Seat 3: Scaaalll ($2.94 in chips) 
Seat 4: zairyoku ($2.20 in chips) 
Seat 5: shingo594 ($2.60 in chips) 
Seat 6: furgalik ($2.88 in chips) 
py100ta: posts small blind $0.01
Scaaalll: posts big blind $0.02
*** HOLE CARDS ***
Dealt to Scaaalll [8d 8c]
zairyoku: folds 
shingo594: folds 
furgalik: folds 
shingo594 is disconnected 
Sul07: raises $0.04 to $0.06
py100ta: folds 
Scaaalll: calls $0.04
*** FLOP *** [Ad 9c 3s]
Scaaalll: checks 
Sul07: checks 
*** TURN *** [Ad 9c 3s] [2d]
Scaaalll: checks 
Sul07: checks 
*** RIVER *** [Ad 9c 3s 2d] [Kc]
Scaaalll: checks 
Sul07: bets $0.06
Scaaalll: folds 
Uncalled bet ($0.06) returned to Sul07
Sul07 collected $0.13 from pot
Sul07: doesn't show hand 
*** SUMMARY ***
Total pot $0.13 | Rake $0 
Board [Ad 9c 3s 2d Kc]
Seat 1: Sul07 (button) collected ($0.13)
Seat 2: py100ta (small blind) folded before Flop
Seat 3: Scaaalll (big blind) folded on the River
Seat 4: zairyoku folded before Flop (didn't bet)
Seat 5: shingo594 folded before Flop (didn't bet)
Seat 6: furgalik folded before Flop (didn't bet)



PokerStars Zoom Hand #229229932545:  Hold'em No Limit ($0.01/$0.02) - 2021/08/21 21:18:28 CET [2021/08/21 15:18:28 ET]
Table 'Halley' 6-max Seat #1 is the button
Seat 1: klausC3 ($5.97 in chips) 
Seat 2: yositoas ($3.52 in chips) 
Seat 3: E Z TAKEDOWN ($2.67 in chips) 
Seat 4: Scaaalll ($2.88 in chips) 
Seat 5: arsad725 ($7.08 in chips) 
Seat 6: PapiMik3 ($2.07 in chips) 
yositoas: posts small blind $0.01
E Z TAKEDOWN: posts big blind $0.02
*** HOLE CARDS ***
Dealt to Scaaalll [6d Js]
Scaaalll: folds 
arsad725: folds 
PapiMik3: raises $0.04 to $0.06
klausC3: calls $0.06
yositoas: folds 
E Z TAKEDOWN: folds 
*** FLOP *** [4c 9d Ah]
PapiMik3: bets $0.04
klausC3: folds 
Uncalled bet ($0.04) returned to PapiMik3
PapiMik3 collected $0.14 from pot
PapiMik3: doesn't show hand 
*** SUMMARY ***
Total pot $0.15 | Rake $0.01 
Board [4c 9d Ah]
Seat 1: klausC3 (button) folded on the Flop
Seat 2: yositoas (small blind) folded before Flop
Seat 3: E Z TAKEDOWN (big blind) folded before Flop
Seat 4: Scaaalll folded before Flop (didn't bet)
Seat 5: arsad725 folded before Flop (didn't bet)
Seat 6: PapiMik3 collected ($0.14)



PokerStars Zoom Hand #229229934388:  Hold'em No Limit ($0.01/$0.02) - 2021/08/21 21:18:32 CET [2021/08/21 15:18:32 ET]
Table 'Halley' 6-max Seat #1 is the button
Seat 1: 1_KoLizeI_1 ($4.68 in chips) 
Seat 2: Scaaalll ($2.88 in chips) 
Seat 3: Nihility77 ($2 in chips) 
Seat 4: maliniak75 ($1.81 in chips) 
Seat 5: Bufre ($2.34 in chips) 
Seat 6: Berti281 ($2.53 in chips) 
Scaaalll: posts small blind $0.01
Nihility77: posts big blind $0.02
*** HOLE CARDS ***
Dealt to Scaaalll [8c Tc]
maliniak75: folds 
Bufre: raises $0.03 to $0.05
Berti281: folds 
1_KoLizeI_1: folds 
Scaaalll: calls $0.04
Nihility77: folds 
*** FLOP *** [7h 8d Ks]
Scaaalll: checks 
Bufre: bets $0.04
Scaaalll: calls $0.04
*** TURN *** [7h 8d Ks] [Jc]
Scaaalll: checks 
Bufre: bets $0.10
Scaaalll: folds 
Uncalled bet ($0.10) returned to Bufre
Bufre collected $0.19 from pot
Bufre: doesn't show hand 
*** SUMMARY ***
Total pot $0.20 | Rake $0.01 
Board [7h 8d Ks Jc]
Seat 1: 1_KoLizeI_1 (button) folded before Flop (didn't bet)
Seat 2: Scaaalll (small blind) folded on the Turn
Seat 3: Nihility77 (big blind) folded before Flop
Seat 4: maliniak75 folded before Flop (didn't bet)
Seat 5: Bufre collected ($0.19)
Seat 6: Berti281 folded before Flop (didn't bet)



PokerStars Zoom Hand #229229956336:  Hold'em No Limit ($0.01/$0.02) - 2021/08/21 21:19:19 CET [2021/08/21 15:19:19 ET]
Table 'Halley' 6-max Seat #1 is the button
Seat 1: Fedor_Gar ($3.56 in chips) 
Seat 2: TESTGOSHI ($2.11 in chips) 
Seat 3: martuska88 ($2.16 in chips) 
Seat 4: RChinenov ($2 in chips) 
Seat 5: z3317111711 ($1.82 in chips) 
Seat 6: Scaaalll ($2.79 in chips) 
TESTGOSHI: posts small blind $0.01
martuska88: posts big blind $0.02
*** HOLE CARDS ***
Dealt to Scaaalll [Kh 3s]
RChinenov: folds 
z3317111711: folds 
Scaaalll: folds 
Fedor_Gar: folds 
TESTGOSHI: folds 
Uncalled bet ($0.01) returned to martuska88
martuska88 collected $0.02 from pot
martuska88: doesn't show hand 
*** SUMMARY ***
Total pot $0.02 | Rake $0 
Seat 1: Fedor_Gar (button) folded before Flop (didn't bet)
Seat 2: TESTGOSHI (small blind) folded before Flop
Seat 3: martuska88 (big blind) collected ($0.02)
Seat 4: RChinenov folded before Flop (didn't bet)
Seat 5: z3317111711 folded before Flop (didn't bet)
Seat 6: Scaaalll folded before Flop (didn't bet)



PokerStars Zoom Hand #229229960486:  Hold'em No Limit ($0.01/$0.02) - 2021/08/21 21:19:29 CET [2021/08/21 15:19:29 ET]
Table 'Halley' 6-max Seat #1 is the button
Seat 1: Zhyla95 ($1.99 in chips) 
Seat 2: SpartanRace1 ($11.79 in chips) 
Seat 3: Scaaalll ($2.79 in chips) 
Seat 4: martuska88 ($2.17 in chips) 
Seat 5: MinimalFunkd ($4.14 in chips) 
Seat 6: lsd paper ($0.83 in chips) 
SpartanRace1: posts small blind $0.01
Scaaalll: posts big blind $0.02
*** HOLE CARDS ***
Dealt to Scaaalll [6c 3s]
martuska88: folds 
lsd paper is disconnected 
MinimalFunkd: folds 
lsd paper: folds 
Zhyla95: folds 
SpartanRace1: raises $0.04 to $0.06
Scaaalll: folds 
Uncalled bet ($0.04) returned to SpartanRace1
SpartanRace1 collected $0.04 from pot
SpartanRace1: doesn't show hand 
*** SUMMARY ***
Total pot $0.04 | Rake $0 
Seat 1: Zhyla95 (button) folded before Flop (didn't bet)
Seat 2: SpartanRace1 (small blind) collected ($0.04)
Seat 3: Scaaalll (big blind) folded before Flop
Seat 4: martuska88 folded before Flop (didn't bet)
Seat 5: MinimalFunkd folded before Flop (didn't bet)
Seat 6: lsd paper folded before Flop (didn't bet)



PokerStars Zoom Hand #229229967815:  Hold'em No Limit ($0.01/$0.02) - 2021/08/21 21:19:44 CET [2021/08/21 15:19:44 ET]
Table 'Halley' 6-max Seat #1 is the button
Seat 1: Scaaalll ($2.77 in chips) 
Seat 2: skryg93 ($2.88 in chips) 
Seat 3: Gibsondelux ($1.55 in chips) 
Seat 4: Aleksanr2016 ($2 in chips) 
Seat 5: Slirey ($3.54 in chips) 
Seat 6: Benjani1412 ($2 in chips) 
skryg93: posts small blind $0.01
Gibsondelux: posts big blind $0.02
*** HOLE CARDS ***
Dealt to Scaaalll [3c Qh]
Aleksanr2016: folds 
Slirey: folds 
Benjani1412: folds 
Scaaalll: folds 
skryg93: folds 
Uncalled bet ($0.01) returned to Gibsondelux
Slirey is disconnected 
Gibsondelux collected $0.02 from pot
Gibsondelux: doesn't show hand 
*** SUMMARY ***
Total pot $0.02 | Rake $0 
Seat 1: Scaaalll (button) folded before Flop (didn't bet)
Seat 2: skryg93 (small blind) folded before Flop
Seat 3: Gibsondelux (big blind) collected ($0.02)
Seat 4: Aleksanr2016 folded before Flop (didn't bet)
Seat 5: Slirey folded before Flop (didn't bet)
Seat 6: Benjani1412 folded before Flop (didn't bet)



PokerStars Zoom Hand #229229958675:  Hold'em No Limit ($0.01/$0.02) - 2021/08/21 21:19:24 CET [2021/08/21 15:19:24 ET]
Table 'Halley' 6-max Seat #1 is the button
Seat 1: amergedon ($2.64 in chips) 
Seat 2: Gerar NB ($2.32 in chips) 
Seat 3: pushany2lol ($2 in chips) 
Seat 4: Scaaalll ($2.79 in chips) 
Seat 5: plaz v ($1.15 in chips) 
Seat 6: MinimalFunkd ($4.14 in chips) 
Gerar NB: posts small blind $0.01
pushany2lol: posts big blind $0.02
*** HOLE CARDS ***
Dealt to Scaaalll [9s Jd]
Scaaalll: folds 
amergedon is disconnected 
plaz v has timed out
plaz v: folds 
MinimalFunkd: folds 
amergedon: folds 
Gerar NB: raises $0.04 to $0.06
pushany2lol has timed out while disconnected
pushany2lol: folds 
Uncalled bet ($0.04) returned to Gerar NB
Gerar NB collected $0.04 from pot
Gerar NB: doesn't show hand 
*** SUMMARY ***
Total pot $0.04 | Rake $0 
Seat 1: amergedon (button) folded before Flop (didn't bet)
Seat 2: Gerar NB (small blind) collected ($0.04)
Seat 3: pushany2lol (big blind) folded before Flop
Seat 4: Scaaalll folded before Flop (didn't bet)
Seat 5: plaz v folded before Flop (didn't bet)
Seat 6: MinimalFunkd folded before Flop (didn't bet)



PokerStars Zoom Hand #229229970082:  Hold'em No Limit ($0.01/$0.02) - 2021/08/21 21:19:50 CET [2021/08/21 15:19:50 ET]
Table 'Halley' 6-max Seat #1 is the button
Seat 1: olga3021221 ($3.79 in chips) 
Seat 2: Scaaalll ($2.77 in chips) 
Seat 3: PapaWago888 ($11.45 in chips) 
Seat 4: bigthereal ($2.37 in chips) 
Seat 5: Pysgodyn ($2 in chips) 
Seat 6: zeus11983 ($2.32 in chips) 
Scaaalll: posts small blind $0.01
PapaWago888: posts big blind $0.02
*** HOLE CARDS ***
Dealt to Scaaalll [Ac Js]
bigthereal: folds 
Pysgodyn: folds 
zeus11983: raises $0.03 to $0.05
olga3021221: folds 
Scaaalll: calls $0.04
PapaWago888: calls $0.03
*** FLOP *** [2h Qd 5h]
Scaaalll: checks 
PapaWago888: checks 
zeus11983: bets $0.08
PapaWago888 is disconnected 
Scaaalll: folds 
PapaWago888: folds 
Uncalled bet ($0.08) returned to zeus11983
zeus11983 collected $0.14 from pot
zeus11983: doesn't show hand 
*** SUMMARY ***
Total pot $0.15 | Rake $0.01 
Board [2h Qd 5h]
Seat 1: olga3021221 (button) folded before Flop (didn't bet)
Seat 2: Scaaalll (small blind) folded on the Flop
Seat 3: PapaWago888 (big blind) folded on the Flop
Seat 4: bigthereal folded before Flop (didn't bet)
Seat 5: Pysgodyn folded before Flop (didn't bet)
Seat 6: zeus11983 collected ($0.14)



PokerStars Zoom Hand #229229988182:  Hold'em No Limit ($0.01/$0.02) - 2021/08/21 21:20:28 CET [2021/08/21 15:20:28 ET]
Table 'Halley' 6-max Seat #1 is the button
Seat 1: brummie0 ($1.84 in chips) 
Seat 2: lyapis75 ($2 in chips) 
Seat 3: Nihility77 ($2.03 in chips) 
Seat 4: py100ta ($11.34 in chips) 
Seat 5: L00TS254 ($3.11 in chips) 
Seat 6: Scaaalll ($2.72 in chips) 
lyapis75: posts small blind $0.01
Nihility77: posts big blind $0.02
*** HOLE CARDS ***
Dealt to Scaaalll [5s Kh]
py100ta: folds 
brummie0 is disconnected 
L00TS254: folds 
Scaaalll: folds 
brummie0: folds 
lyapis75: folds 
Uncalled bet ($0.01) returned to Nihility77
Nihility77 collected $0.02 from pot
Nihility77: doesn't show hand 
*** SUMMARY ***
Total pot $0.02 | Rake $0 
Seat 1: brummie0 (button) folded before Flop (didn't bet)
Seat 2: lyapis75 (small blind) folded before Flop
Seat 3: Nihility77 (big blind) collected ($0.02)
Seat 4: py100ta folded before Flop (didn't bet)
Seat 5: L00TS254 folded before Flop (didn't bet)
Seat 6: Scaaalll folded before Flop (didn't bet)



PokerStars Zoom Hand #229229990011:  Hold'em No Limit ($0.01/$0.02) - 2021/08/21 21:20:32 CET [2021/08/21 15:20:32 ET]
Table 'Halley' 6-max Seat #1 is the button
Seat 1: bananAAbandit ($3.92 in chips) 
Seat 2: Jackb9908 ($0.98 in chips) 
Seat 3: GoldenRabbit1 ($0.28 in chips) 
Seat 4: zbixxx ($2.57 in chips) 
Seat 5: Scaaalll ($2.72 in chips) 
Seat 6: Murphy1693 ($2.03 in chips) 
Jackb9908: posts small blind $0.01
GoldenRabbit1: posts big blind $0.02
*** HOLE CARDS ***
Dealt to Scaaalll [8d Ac]
zbixxx has timed out
zbixxx: folds 
Scaaalll: folds 
Murphy1693: folds 
bananAAbandit: folds 
Jackb9908: folds 
Uncalled bet ($0.01) returned to GoldenRabbit1
GoldenRabbit1 collected $0.02 from pot
GoldenRabbit1: doesn't show hand 
*** SUMMARY ***
Total pot $0.02 | Rake $0 
Seat 1: bananAAbandit (button) folded before Flop (didn't bet)
Seat 2: Jackb9908 (small blind) folded before Flop
Seat 3: GoldenRabbit1 (big blind) collected ($0.02)
Seat 4: zbixxx folded before Flop (didn't bet)
Seat 5: Scaaalll folded before Flop (didn't bet)
Seat 6: Murphy1693 folded before Flop (didn't bet)



PokerStars Zoom Hand #229229993430:  Hold'em No Limit ($0.01/$0.02) - 2021/08/21 21:20:39 CET [2021/08/21 15:20:39 ET]
Table 'Halley' 6-max Seat #1 is the button
Seat 1: Koldun 2636 ($2 in chips) 
Seat 2: pavlo590 ($2.02 in chips) 
Seat 3: Scaaalll ($2.72 in chips) 
Seat 4: Fen4ik59 ($0.91 in chips) 
Seat 5: Nihility77 ($2.04 in chips) 
Seat 6: franquillooo ($3.99 in chips) 
pavlo590: posts small blind $0.01
Scaaalll: posts big blind $0.02
*** HOLE CARDS ***
Dealt to Scaaalll [Ks 9c]
Fen4ik59: folds 
Nihility77: folds 
pavlo590 is disconnected 
franquillooo: folds 
Koldun 2636: folds 
pavlo590: folds 
Uncalled bet ($0.01) returned to Scaaalll
Scaaalll collected $0.02 from pot
Scaaalll: doesn't show hand 
*** SUMMARY ***
Total pot $0.02 | Rake $0 
Seat 1: Koldun 2636 (button) folded before Flop (didn't bet)
Seat 2: pavlo590 (small blind) folded before Flop
Seat 3: Scaaalll (big blind) collected ($0.02)
Seat 4: Fen4ik59 folded before Flop (didn't bet)
Seat 5: Nihility77 folded before Flop (didn't bet)
Seat 6: franquillooo folded before Flop (didn't bet)



PokerStars Zoom Hand #229229999866:  Hold'em No Limit ($0.01/$0.02) - 2021/08/21 21:20:53 CET [2021/08/21 15:20:53 ET]
Table 'Halley' 6-max Seat #1 is the button
Seat 1: Scaaalll ($2.73 in chips) 
Seat 2: ser313131 ($2 in chips) 
Seat 3: CrazyyParis ($2 in chips) 
Seat 4: nemat_g ($1.67 in chips) 
Seat 5: csmall14 ($2.40 in chips) 
Seat 6: ARTMVSLV ($2.22 in chips) 
ser313131: posts small blind $0.01
CrazyyParis: posts big blind $0.02
*** HOLE CARDS ***
Dealt to Scaaalll [9c 9h]
nemat_g: folds 
csmall14: folds 
ARTMVSLV: raises $0.02 to $0.04
Scaaalll: calls $0.04
ser313131: folds 
CrazyyParis: folds 
*** FLOP *** [5s 6h 8h]
ARTMVSLV: checks 
Scaaalll: bets $0.07
ARTMVSLV: folds 
Uncalled bet ($0.07) returned to Scaaalll
Scaaalll collected $0.11 from pot
Scaaalll: doesn't show hand 
*** SUMMARY ***
Total pot $0.11 | Rake $0 
Board [5s 6h 8h]
Seat 1: Scaaalll (button) collected ($0.11)
Seat 2: ser313131 (small blind) folded before Flop
Seat 3: CrazyyParis (big blind) folded before Flop
Seat 4: nemat_g folded before Flop (didn't bet)
Seat 5: csmall14 folded before Flop (didn't bet)
Seat 6: ARTMVSLV folded on the Flop



PokerStars Zoom Hand #229230017422:  Hold'em No Limit ($0.01/$0.02) - 2021/08/21 21:21:32 CET [2021/08/21 15:21:32 ET]
Table 'Halley' 6-max Seat #1 is the button
Seat 1: NecromiconP ($2.01 in chips) 
Seat 2: usenovm ($1.89 in chips) 
Seat 3: KKARMELO ($2.29 in chips) 
Seat 4: LuckyLlama0 ($0.55 in chips) 
Seat 5: Scaaalll ($2.80 in chips) 
Seat 6: arsad725 ($7.87 in chips) 
usenovm: posts small blind $0.01
KKARMELO: posts big blind $0.02
*** HOLE CARDS ***
Dealt to Scaaalll [8h 8s]
LuckyLlama0: raises $0.02 to $0.04
Scaaalll: calls $0.04
arsad725: folds 
NecromiconP: folds 
usenovm: folds 
KKARMELO: folds 
*** FLOP *** [Qh 7c 3d]
LuckyLlama0: bets $0.10
Scaaalll: calls $0.10
*** TURN *** [Qh 7c 3d] [Ac]
LuckyLlama0: bets $0.02
Scaaalll: calls $0.02
*** RIVER *** [Qh 7c 3d Ac] [7h]
LuckyLlama0: checks 
Scaaalll: checks 
*** SHOW DOWN ***
LuckyLlama0: shows [Ks Qc] (two pair, Queens and Sevens)
Scaaalll: mucks hand 
LuckyLlama0 collected $0.34 from pot
*** SUMMARY ***
Total pot $0.35 | Rake $0.01 
Board [Qh 7c 3d Ac 7h]
Seat 1: NecromiconP (button) folded before Flop (didn't bet)
Seat 2: usenovm (small blind) folded before Flop
Seat 3: KKARMELO (big blind) folded before Flop
Seat 4: LuckyLlama0 showed [Ks Qc] and won ($0.34) with two pair, Queens and Sevens
Seat 5: Scaaalll mucked [8h 8s]
Seat 6: arsad725 folded before Flop (didn't bet)



PokerStars Zoom Hand #229230035605:  Hold'em No Limit ($0.01/$0.02) - 2021/08/21 21:22:10 CET [2021/08/21 15:22:10 ET]
Table 'Halley' 6-max Seat #1 is the button
Seat 1: nodtress ($2.09 in chips) 
Seat 2: Fedor_Gar ($3.20 in chips) 
Seat 3: Scaaalll ($2.64 in chips) 
Seat 4: Grama480 ($1.44 in chips) 
Seat 5: qpsq ($4.79 in chips) 
Seat 6: maliniak75 ($1.96 in chips) 
Fedor_Gar: posts small blind $0.01
Scaaalll: posts big blind $0.02
*** HOLE CARDS ***
Dealt to Scaaalll [8h Kh]
Grama480: folds 
qpsq: raises $0.04 to $0.06
maliniak75: folds 
nodtress: folds 
Fedor_Gar: folds 
Scaaalll: folds 
Uncalled bet ($0.04) returned to qpsq
qpsq collected $0.05 from pot
qpsq: doesn't show hand 
*** SUMMARY ***
Total pot $0.05 | Rake $0 
Seat 1: nodtress (button) folded before Flop (didn't bet)
Seat 2: Fedor_Gar (small blind) folded before Flop
Seat 3: Scaaalll (big blind) folded before Flop
Seat 4: Grama480 folded before Flop (didn't bet)
Seat 5: qpsq collected ($0.05)
Seat 6: maliniak75 folded before Flop (didn't bet)



PokerStars Zoom Hand #229230046385:  Hold'em No Limit ($0.01/$0.02) - 2021/08/21 21:22:33 CET [2021/08/21 15:22:33 ET]
Table 'Halley' 6-max Seat #1 is the button
Seat 1: S.B.O190 ($7.06 in chips) 
Seat 2: HellNative ($3.30 in chips) 
Seat 3: loukon579 ($3.84 in chips) 
Seat 4: lucksuckdonk ($2.51 in chips) 
Seat 5: Shumayloff ($1.43 in chips) 
Seat 6: Scaaalll ($2.62 in chips) 
HellNative: posts small blind $0.01
loukon579: posts big blind $0.02
*** HOLE CARDS ***
Dealt to Scaaalll [4h Ts]
lucksuckdonk: folds 
Shumayloff: folds 
Scaaalll: folds 
S.B.O190: folds 
Shumayloff is disconnected 
HellNative: folds 
Uncalled bet ($0.01) returned to loukon579
loukon579 collected $0.02 from pot
loukon579: doesn't show hand 
*** SUMMARY ***
Total pot $0.02 | Rake $0 
Seat 1: S.B.O190 (button) folded before Flop (didn't bet)
Seat 2: HellNative (small blind) folded before Flop
Seat 3: loukon579 (big blind) collected ($0.02)
Seat 4: lucksuckdonk folded before Flop (didn't bet)
Seat 5: Shumayloff folded before Flop (didn't bet)
Seat 6: Scaaalll folded before Flop (didn't bet)



PokerStars Zoom Hand #229230048264:  Hold'em No Limit ($0.01/$0.02) - 2021/08/21 21:22:37 CET [2021/08/21 15:22:37 ET]
Table 'Halley' 6-max Seat #1 is the button
Seat 1: zergmiky ($2 in chips) 
Seat 2: Scaaalll ($2.62 in chips) 
Seat 3: 01527368 ($2.13 in chips) 
Seat 4: nippurkaunas ($1.14 in chips) 
Seat 5: xmaksimus ($5.15 in chips) 
Seat 6: zairyoku ($2.47 in chips) 
Scaaalll: posts small blind $0.01
01527368: posts big blind $0.02
*** HOLE CARDS ***
Dealt to Scaaalll [8s Qd]
nippurkaunas: folds 
xmaksimus: raises $0.04 to $0.06
zairyoku: folds 
zergmiky: folds 
Scaaalll: folds 
01527368: folds 
Uncalled bet ($0.04) returned to xmaksimus
xmaksimus collected $0.05 from pot
xmaksimus: doesn't show hand 
*** SUMMARY ***
Total pot $0.05 | Rake $0 
Seat 1: zergmiky (button) folded before Flop (didn't bet)
Seat 2: Scaaalll (small blind) folded before Flop
Seat 3: 01527368 (big blind) folded before Flop
Seat 4: nippurkaunas folded before Flop (didn't bet)
Seat 5: xmaksimus collected ($0.05)
Seat 6: zairyoku folded before Flop (didn't bet)



PokerStars Zoom Hand #229230054266:  Hold'em No Limit ($0.01/$0.02) - 2021/08/21 21:22:50 CET [2021/08/21 15:22:50 ET]
Table 'Halley' 6-max Seat #1 is the button
Seat 1: martuska88 ($2.76 in chips) 
Seat 2: fishh_play ($3.93 in chips) 
Seat 3: gugamoraes ($2 in chips) 
Seat 4: CordiPS ($3.01 in chips) 
Seat 5: Scaaalll ($2.61 in chips) 
Seat 6: Ferr4r1430 ($3.09 in chips) 
fishh_play: posts small blind $0.01
gugamoraes: posts big blind $0.02
*** HOLE CARDS ***
Dealt to Scaaalll [As 2h]
CordiPS: raises $0.04 to $0.06
Scaaalll: folds 
Ferr4r1430: raises $0.15 to $0.21
martuska88: folds 
fishh_play: calls $0.20
gugamoraes: folds 
CordiPS: calls $0.15
*** FLOP *** [Jh 8h 5h]
fishh_play: checks 
CordiPS: checks 
Ferr4r1430: bets $0.31
fishh_play: folds 
CordiPS: folds 
Uncalled bet ($0.31) returned to Ferr4r1430
Ferr4r1430 collected $0.63 from pot
Ferr4r1430: doesn't show hand 
*** SUMMARY ***
Total pot $0.65 | Rake $0.02 
Board [Jh 8h 5h]
Seat 1: martuska88 (button) folded before Flop (didn't bet)
Seat 2: fishh_play (small blind) folded on the Flop
Seat 3: gugamoraes (big blind) folded before Flop
Seat 4: CordiPS folded on the Flop
Seat 5: Scaaalll folded before Flop (didn't bet)
Seat 6: Ferr4r1430 collected ($0.63)



PokerStars Zoom Hand #229230058015:  Hold'em No Limit ($0.01/$0.02) - 2021/08/21 21:22:58 CET [2021/08/21 15:22:58 ET]
Table 'Halley' 6-max Seat #1 is the button
Seat 1: Dutchie509 ($2.12 in chips) 
Seat 2: Flankeris ($3.03 in chips) 
Seat 3: ottke88 ($2.14 in chips) 
Seat 4: Scaaalll ($2.61 in chips) 
Seat 5: BIITRU ($5.77 in chips) 
Seat 6: KRITAYA ($1.23 in chips) 
Flankeris: posts small blind $0.01
ottke88: posts big blind $0.02
*** HOLE CARDS ***
Dealt to Scaaalll [9d 9h]
Scaaalll: raises $0.04 to $0.06
BIITRU: folds 
KRITAYA: folds 
Dutchie509: calls $0.06
Flankeris: folds 
ottke88: calls $0.04
*** FLOP *** [2c 8d Ts]
ottke88: checks 
Scaaalll: checks 
Dutchie509: bets $0.02
ottke88: calls $0.02
Scaaalll: calls $0.02
*** TURN *** [2c 8d Ts] [5c]
ottke88: checks 
Scaaalll: checks 
Dutchie509: bets $0.05
ottke88: calls $0.05
Scaaalll: calls $0.05
*** RIVER *** [2c 8d Ts 5c] [4h]
ottke88: bets $0.20
Scaaalll: folds 
Dutchie509: folds 
Uncalled bet ($0.20) returned to ottke88
ottke88 collected $0.39 from pot
ottke88: doesn't show hand 
*** SUMMARY ***
Total pot $0.40 | Rake $0.01 
Board [2c 8d Ts 5c 4h]
Seat 1: Dutchie509 (button) folded on the River
Seat 2: Flankeris (small blind) folded before Flop
Seat 3: ottke88 (big blind) collected ($0.39)
Seat 4: Scaaalll folded on the River
Seat 5: BIITRU folded before Flop (didn't bet)
Seat 6: KRITAYA folded before Flop (didn't bet)



PokerStars Zoom Hand #229230096705:  Hold'em No Limit ($0.01/$0.02) - 2021/08/21 21:24:20 CET [2021/08/21 15:24:20 ET]
Table 'Halley' 6-max Seat #1 is the button
Seat 1: Scaaalll ($2.48 in chips) 
Seat 2: zairyoku ($2.50 in chips) 
Seat 3: 2m4m4 ($2.12 in chips) 
Seat 4: keldh ($2.40 in chips) 
Seat 5: Hug0Flavi0 ($1.89 in chips) 
Seat 6: PapiMik3 ($2.08 in chips) 
zairyoku: posts small blind $0.01
2m4m4: posts big blind $0.02
*** HOLE CARDS ***
Dealt to Scaaalll [Ah 3s]
keldh: folds 
Hug0Flavi0: calls $0.02
PapiMik3: folds 
Scaaalll: folds 
zairyoku: folds 
2m4m4: checks 
*** FLOP *** [8h Qc Jc]
2m4m4: checks 
Hug0Flavi0: bets $0.02
2m4m4: folds 
Uncalled bet ($0.02) returned to Hug0Flavi0
Hug0Flavi0 collected $0.05 from pot
Hug0Flavi0: doesn't show hand 
*** SUMMARY ***
Total pot $0.05 | Rake $0 
Board [8h Qc Jc]
Seat 1: Scaaalll (button) folded before Flop (didn't bet)
Seat 2: zairyoku (small blind) folded before Flop
Seat 3: 2m4m4 (big blind) folded on the Flop
Seat 4: keldh folded before Flop (didn't bet)
Seat 5: Hug0Flavi0 collected ($0.05)
Seat 6: PapiMik3 folded before Flop (didn't bet)



PokerStars Zoom Hand #229230104604:  Hold'em No Limit ($0.01/$0.02) - 2021/08/21 21:24:37 CET [2021/08/21 15:24:37 ET]
Table 'Halley' 6-max Seat #1 is the button
Seat 1: NecromiconP ($2.03 in chips) 
Seat 2: Scaaalll ($2.48 in chips) 
Seat 3: Koldun 2636 ($4.40 in chips) 
Seat 4: R4DiUS030 ($2.60 in chips) 
Seat 5: iPitbull1 ($2 in chips) 
Seat 6: puratiino ($1.51 in chips) 
Scaaalll: posts small blind $0.01
Koldun 2636: posts big blind $0.02
*** HOLE CARDS ***
Dealt to Scaaalll [8d Ks]
R4DiUS030: folds 
iPitbull1: folds 
puratiino: raises $0.02 to $0.04
NecromiconP: folds 
Scaaalll: folds 
Koldun 2636: folds 
Uncalled bet ($0.02) returned to puratiino
puratiino collected $0.05 from pot
puratiino: doesn't show hand 
*** SUMMARY ***
Total pot $0.05 | Rake $0 
Seat 1: NecromiconP (button) folded before Flop (didn't bet)
Seat 2: Scaaalll (small blind) folded before Flop
Seat 3: Koldun 2636 (big blind) folded before Flop
Seat 4: R4DiUS030 folded before Flop (didn't bet)
Seat 5: iPitbull1 folded before Flop (didn't bet)
Seat 6: puratiino collected ($0.05)



PokerStars Zoom Hand #229230123526:  Hold'em No Limit ($0.01/$0.02) - 2021/08/21 21:25:18 CET [2021/08/21 15:25:18 ET]
Table 'Halley' 6-max Seat #1 is the button
Seat 1: Fen4ik59 ($0.92 in chips) 
Seat 2: klausC3 ($5.84 in chips) 
Seat 3: Scaaalll ($2.47 in chips) 
Seat 4: S.B.O190 ($2.29 in chips) 
Seat 5: franquillooo ($2.90 in chips) 
Seat 6: sg.32rus ($1 in chips) 
klausC3: posts small blind $0.01
Scaaalll: posts big blind $0.02
*** HOLE CARDS ***
Dealt to Scaaalll [3d Qh]
S.B.O190: folds 
franquillooo: folds 
sg.32rus: folds 
Fen4ik59: folds 
klausC3: raises $0.04 to $0.06
Scaaalll: folds 
Uncalled bet ($0.04) returned to klausC3
klausC3 collected $0.04 from pot
klausC3: doesn't show hand 
*** SUMMARY ***
Total pot $0.04 | Rake $0 
Seat 1: Fen4ik59 (button) folded before Flop (didn't bet)
Seat 2: klausC3 (small blind) collected ($0.04)
Seat 3: Scaaalll (big blind) folded before Flop
Seat 4: S.B.O190 folded before Flop (didn't bet)
Seat 5: franquillooo folded before Flop (didn't bet)
Seat 6: sg.32rus folded before Flop (didn't bet)



PokerStars Zoom Hand #229230115449:  Hold'em No Limit ($0.01/$0.02) - 2021/08/21 21:25:00 CET [2021/08/21 15:25:00 ET]
Table 'Halley' 6-max Seat #1 is the button
Seat 1: pavel28918012 ($1.93 in chips) 
Seat 2: SpartanRace1 ($7.24 in chips) 
Seat 3: L00TS254 ($2 in chips) 
Seat 4: Xlavariable ($2.81 in chips) 
Seat 5: Scaaalll ($2.47 in chips) 
Seat 6: bossquaid ($5.51 in chips) 
SpartanRace1: posts small blind $0.01
L00TS254: posts big blind $0.02
*** HOLE CARDS ***
Dealt to Scaaalll [8d 9s]
Xlavariable: folds 
Scaaalll: folds 
bossquaid: folds 
pavel28918012: raises $0.04 to $0.06
SpartanRace1: folds 
L00TS254: calls $0.04
*** FLOP *** [5h Tc Ks]
L00TS254: checks 
pavel28918012: bets $0.07
L00TS254: calls $0.07
*** TURN *** [5h Tc Ks] [8h]
L00TS254: checks 
pavel28918012: bets $0.20
L00TS254: calls $0.20
*** RIVER *** [5h Tc Ks 8h] [5d]
L00TS254: checks 
pavel28918012: bets $0.21
L00TS254: calls $0.21
*** SHOW DOWN ***
pavel28918012: shows [Kc Js] (two pair, Kings and Fives)
L00TS254: mucks hand 
pavel28918012 collected $1.05 from pot
*** SUMMARY ***
Total pot $1.09 | Rake $0.04 
Board [5h Tc Ks 8h 5d]
Seat 1: pavel28918012 (button) showed [Kc Js] and won ($1.05) with two pair, Kings and Fives
Seat 2: SpartanRace1 (small blind) folded before Flop
Seat 3: L00TS254 (big blind) mucked [9h Kh]
Seat 4: Xlavariable folded before Flop (didn't bet)
Seat 5: Scaaalll folded before Flop (didn't bet)
Seat 6: bossquaid folded before Flop (didn't bet)



PokerStars Zoom Hand #229230111229:  Hold'em No Limit ($0.01/$0.02) - 2021/08/21 21:24:51 CET [2021/08/21 15:24:51 ET]
Table 'Halley' 6-max Seat #1 is the button
Seat 1: XHerrTUMNUSX ($5.69 in chips) 
Seat 2: AndreaBsAs ($2.36 in chips) 
Seat 3: so0love ($4.19 in chips) 
Seat 4: Scaaalll ($2.47 in chips) 
Seat 5: 6i3oH77 ($7.24 in chips) 
Seat 6: qpsq ($2 in chips) 
AndreaBsAs: posts small blind $0.01
so0love: posts big blind $0.02
*** HOLE CARDS ***
Dealt to Scaaalll [Td 9s]
Scaaalll: folds 
6i3oH77: calls $0.02
qpsq: folds 
XHerrTUMNUSX: folds 
AndreaBsAs: raises $0.03 to $0.05
so0love: folds 
6i3oH77: calls $0.03
*** FLOP *** [2c Th 3s]
AndreaBsAs: checks 
6i3oH77: checks 
*** TURN *** [2c Th 3s] [8h]
AndreaBsAs: bets $0.09
6i3oH77: calls $0.09
*** RIVER *** [2c Th 3s 8h] [6s]
AndreaBsAs: bets $0.10
6i3oH77: raises $0.25 to $0.35
AndreaBsAs: folds 
Uncalled bet ($0.25) returned to 6i3oH77
6i3oH77 collected $0.48 from pot
6i3oH77: doesn't show hand 
*** SUMMARY ***
Total pot $0.50 | Rake $0.02 
Board [2c Th 3s 8h 6s]
Seat 1: XHerrTUMNUSX (button) folded before Flop (didn't bet)
Seat 2: AndreaBsAs (small blind) folded on the River
Seat 3: so0love (big blind) folded before Flop
Seat 4: Scaaalll folded before Flop (didn't bet)
Seat 5: 6i3oH77 collected ($0.48)
Seat 6: qpsq folded before Flop (didn't bet)



PokerStars Zoom Hand #229230132400:  Hold'em No Limit ($0.01/$0.02) - 2021/08/21 21:25:36 CET [2021/08/21 15:25:36 ET]
Table 'Halley' 6-max Seat #1 is the button
Seat 1: Forest404 ($1.12 in chips) 
Seat 2: Koldun 2636 ($2.66 in chips) 
Seat 3: iLfly ($1.21 in chips) 
Seat 4: ARTMVSLV ($4.68 in chips) 
Seat 5: Scaaalll ($2.45 in chips) 
Seat 6: JCharrod ($4.65 in chips) 
Koldun 2636: posts small blind $0.01
iLfly: posts big blind $0.02
*** HOLE CARDS ***
Dealt to Scaaalll [6d 5d]
ARTMVSLV: folds 
Scaaalll has timed out
Scaaalll: folds 
JCharrod: folds 
Forest404: folds 
Koldun 2636: folds 
Uncalled bet ($0.01) returned to iLfly
iLfly collected $0.02 from pot
iLfly: doesn't show hand 
*** SUMMARY ***
Total pot $0.02 | Rake $0 
Seat 1: Forest404 (button) folded before Flop (didn't bet)
Seat 2: Koldun 2636 (small blind) folded before Flop
Seat 3: iLfly (big blind) collected ($0.02)
Seat 4: ARTMVSLV folded before Flop (didn't bet)
Seat 5: Scaaalll folded before Flop (didn't bet)
Seat 6: JCharrod folded before Flop (didn't bet)



PokerStars Zoom Hand #229230145460:  Hold'em No Limit ($0.01/$0.02) - 2021/08/21 21:25:56 CET [2021/08/21 15:25:56 ET]
Table 'Halley' 6-max Seat #1 is the button
Seat 1: kahzura ($2.12 in chips) 
Seat 2: Scaaalll ($2.45 in chips) 
Seat 3: Quad Jacks21 ($2.62 in chips) 
Seat 4: loukon579 ($4.15 in chips) 
Seat 5: Saint_ANBU ($3.45 in chips) 
Seat 6: 78joniboy ($3.38 in chips) 
Scaaalll: posts small blind $0.01
Quad Jacks21: posts big blind $0.02
*** HOLE CARDS ***
Dealt to Scaaalll [9d Qs]
loukon579: folds 
loukon579 is disconnected 
Saint_ANBU: folds 
78joniboy: folds 
kahzura: folds 
Scaaalll: raises $0.04 to $0.06
Quad Jacks21: calls $0.04
*** FLOP *** [6s 3s Ts]
Scaaalll: bets $0.08
Quad Jacks21: calls $0.08
*** TURN *** [6s 3s Ts] [5d]
Scaaalll: checks 
Quad Jacks21: bets $0.06
Scaaalll: calls $0.06
*** RIVER *** [6s 3s Ts 5d] [4d]
Scaaalll: checks 
Quad Jacks21: checks 
*** SHOW DOWN ***
Scaaalll: shows [9d Qs] (high card Queen)
Quad Jacks21: shows [Tc Qc] (a pair of Tens)
Quad Jacks21 collected $0.39 from pot
*** SUMMARY ***
Total pot $0.40 | Rake $0.01 
Board [6s 3s Ts 5d 4d]
Seat 1: kahzura (button) folded before Flop (didn't bet)
Seat 2: Scaaalll (small blind) showed [9d Qs] and lost with high card Queen
Seat 3: Quad Jacks21 (big blind) showed [Tc Qc] and won ($0.39) with a pair of Tens
Seat 4: loukon579 folded before Flop (didn't bet)
Seat 5: Saint_ANBU folded before Flop (didn't bet)
Seat 6: 78joniboy folded before Flop (didn't bet)



PokerStars Zoom Hand #229230130502:  Hold'em No Limit ($0.01/$0.02) - 2021/08/21 21:25:32 CET [2021/08/21 15:25:32 ET]
Table 'Halley' 6-max Seat #1 is the button
Seat 1: MirkoV224 ($2.47 in chips) 
Seat 2: gugamoraes ($2.04 in chips) 
Seat 3: vicctorlf ($2.85 in chips) 
Seat 4: KRandall12 ($0.88 in chips) 
Seat 5: ferx1989 ($2.22 in chips) 
Seat 6: Scaaalll ($2.45 in chips) 
gugamoraes: posts small blind $0.01
vicctorlf: posts big blind $0.02
*** HOLE CARDS ***
Dealt to Scaaalll [5s 6h]
KRandall12: raises $0.03 to $0.05
ferx1989: folds 
Scaaalll: folds 
MirkoV224: folds 
gugamoraes: calls $0.04
vicctorlf: raises $0.11 to $0.16
KRandall12: calls $0.11
gugamoraes: calls $0.11
*** FLOP *** [Ts Kd 3h]
gugamoraes: checks 
vicctorlf: checks 
KRandall12: bets $0.18
gugamoraes: calls $0.18
vicctorlf: folds 
*** TURN *** [Ts Kd 3h] [Ac]
gugamoraes: checks 
KRandall12: bets $0.54 and is all-in
gugamoraes: calls $0.54
*** RIVER *** [Ts Kd 3h Ac] [8s]
*** SHOW DOWN ***
gugamoraes: shows [Kh 8h] (two pair, Kings and Eights)
KRandall12: shows [Kc As] (two pair, Aces and Kings)
KRandall12 collected $1.85 from pot
*** SUMMARY ***
Total pot $1.92 | Rake $0.07 
Board [Ts Kd 3h Ac 8s]
Seat 1: MirkoV224 (button) folded before Flop (didn't bet)
Seat 2: gugamoraes (small blind) showed [Kh 8h] and lost with two pair, Kings and Eights
Seat 3: vicctorlf (big blind) folded on the Flop
Seat 4: KRandall12 showed [Kc As] and won ($1.85) with two pair, Aces and Kings
Seat 5: ferx1989 folded before Flop (didn't bet)
Seat 6: Scaaalll folded before Flop (didn't bet)



PokerStars Zoom Hand #229230165449:  Hold'em No Limit ($0.01/$0.02) - 2021/08/21 21:26:39 CET [2021/08/21 15:26:39 ET]
Table 'Halley' 6-max Seat #1 is the button
Seat 1: Scaaalll ($2.25 in chips) 
Seat 2: ARTMVSLV ($2.31 in chips) 
Seat 3: DaporteWins ($2 in chips) 
Seat 4: bigthereal ($3.82 in chips) 
Seat 5: Zelebobatyt ($1.88 in chips) 
Seat 6: Esskeetit420/69 ($3.65 in chips) 
ARTMVSLV: posts small blind $0.01
DaporteWins: posts big blind $0.02
*** HOLE CARDS ***
Dealt to Scaaalll [7h 9d]
bigthereal: folds 
Zelebobatyt: folds 
Esskeetit420/69: raises $0.02 to $0.04
Scaaalll: folds 
ARTMVSLV: raises $0.16 to $0.20
DaporteWins: folds 
Esskeetit420/69: folds 
Uncalled bet ($0.16) returned to ARTMVSLV
ARTMVSLV collected $0.10 from pot
ARTMVSLV: doesn't show hand 
*** SUMMARY ***
Total pot $0.10 | Rake $0 
Seat 1: Scaaalll (button) folded before Flop (didn't bet)
Seat 2: ARTMVSLV (small blind) collected ($0.10)
Seat 3: DaporteWins (big blind) folded before Flop
Seat 4: bigthereal folded before Flop (didn't bet)
Seat 5: Zelebobatyt folded before Flop (didn't bet)
Seat 6: Esskeetit420/69 folded before Flop



PokerStars Zoom Hand #229230168296:  Hold'em No Limit ($0.01/$0.02) - 2021/08/21 21:26:45 CET [2021/08/21 15:26:45 ET]
Table 'Halley' 6-max Seat #1 is the button
Seat 1: BexleyBoy ($5.05 in chips) 
Seat 2: snowy_96 ($2.01 in chips) 
Seat 3: WithMyWalker ($2.78 in chips) 
Seat 4: Jones278 ($2.21 in chips) 
Seat 5: ffffj ($3.43 in chips) 
Seat 6: Scaaalll ($2.25 in chips) 
snowy_96: posts small blind $0.01
WithMyWalker: posts big blind $0.02
*** HOLE CARDS ***
Dealt to Scaaalll [Qh Qd]
Jones278: folds 
ffffj: folds 
Scaaalll: raises $0.04 to $0.06
BexleyBoy: calls $0.06
snowy_96: folds 
WithMyWalker: folds 
*** FLOP *** [4s 8s 8c]
Scaaalll: bets $0.08
BexleyBoy: calls $0.08
*** TURN *** [4s 8s 8c] [6s]
Scaaalll: bets $0.21
BexleyBoy: calls $0.21
*** RIVER *** [4s 8s 8c 6s] [5h]
Scaaalll: checks 
BexleyBoy: checks 
*** SHOW DOWN ***
Scaaalll: shows [Qh Qd] (two pair, Queens and Eights)
BexleyBoy: mucks hand 
Scaaalll collected $0.69 from pot
*** SUMMARY ***
Total pot $0.73 | Rake $0.04 
Board [4s 8s 8c 6s 5h]
Seat 1: BexleyBoy (button) mucked [Ad Ks]
Seat 2: snowy_96 (small blind) folded before Flop
Seat 3: WithMyWalker (big blind) folded before Flop
Seat 4: Jones278 folded before Flop (didn't bet)
Seat 5: ffffj folded before Flop (didn't bet)
Seat 6: Scaaalll showed [Qh Qd] and won ($0.69) with two pair, Queens and Eights



PokerStars Zoom Hand #229230191038:  Hold'em No Limit ($0.01/$0.02) - 2021/08/21 21:27:34 CET [2021/08/21 15:27:34 ET]
Table 'Halley' 6-max Seat #1 is the button
Seat 1: ferx1989 ($2.02 in chips) 
Seat 2: Iluvatar922 ($8.12 in chips) 
Seat 3: Scaaalll ($2.59 in chips) 
Seat 4: sg.32rus ($1.16 in chips) 
Seat 5: lexus00174 ($8.17 in chips) 
Seat 6: ugi-dugi ($2 in chips) 
Iluvatar922: posts small blind $0.01
Scaaalll: posts big blind $0.02
*** HOLE CARDS ***
Dealt to Scaaalll [4s 5s]
sg.32rus has timed out
sg.32rus: folds 
lexus00174: folds 
ugi-dugi: raises $0.04 to $0.06
ferx1989: folds 
Iluvatar922: folds 
Scaaalll: calls $0.04
*** FLOP *** [Td Ac 3s]
Scaaalll: checks 
ugi-dugi: bets $0.07
Scaaalll: calls $0.07
*** TURN *** [Td Ac 3s] [3d]
Scaaalll: checks 
ugi-dugi: checks 
*** RIVER *** [Td Ac 3s 3d] [2c]
Scaaalll: bets $0.20
ugi-dugi: calls $0.20
*** SHOW DOWN ***
Scaaalll: shows [4s 5s] (a straight, Ace to Five)
ugi-dugi: mucks hand 
Scaaalll collected $0.65 from pot
*** SUMMARY ***
Total pot $0.67 | Rake $0.02 
Board [Td Ac 3s 3d 2c]
Seat 1: ferx1989 (button) folded before Flop (didn't bet)
Seat 2: Iluvatar922 (small blind) folded before Flop
Seat 3: Scaaalll (big blind) showed [4s 5s] and won ($0.65) with a straight, Ace to Five
Seat 4: sg.32rus folded before Flop (didn't bet)
Seat 5: lexus00174 folded before Flop (didn't bet)
Seat 6: ugi-dugi mucked [As 9s]



PokerStars Zoom Hand #229230215472:  Hold'em No Limit ($0.01/$0.02) - 2021/08/21 21:28:26 CET [2021/08/21 15:28:26 ET]
Table 'Halley' 6-max Seat #1 is the button
Seat 1: nippurkaunas ($2.14 in chips) 
Seat 2: jaamonra ($2.31 in chips) 
Seat 3: Kb013497 ($2.34 in chips) 
Seat 4: AligatorsBlood ($2.05 in chips) 
Seat 5: Scaaalll ($2.91 in chips) 
Seat 6: z3317111711 ($1.89 in chips) 
jaamonra: posts small blind $0.01
Kb013497: posts big blind $0.02
*** HOLE CARDS ***
Dealt to Scaaalll [4s Ah]
AligatorsBlood: folds 
Scaaalll: folds 
z3317111711: folds 
nippurkaunas: folds 
jaamonra: folds 
Uncalled bet ($0.01) returned to Kb013497
Kb013497 collected $0.02 from pot
Kb013497: doesn't show hand 
*** SUMMARY ***
Total pot $0.02 | Rake $0 
Seat 1: nippurkaunas (button) folded before Flop (didn't bet)
Seat 2: jaamonra (small blind) folded before Flop
Seat 3: Kb013497 (big blind) collected ($0.02)
Seat 4: AligatorsBlood folded before Flop (didn't bet)
Seat 5: Scaaalll folded before Flop (didn't bet)
Seat 6: z3317111711 folded before Flop (didn't bet)



PokerStars Zoom Hand #229230221544:  Hold'em No Limit ($0.01/$0.02) - 2021/08/21 21:28:39 CET [2021/08/21 15:28:39 ET]
Table 'Halley' 6-max Seat #1 is the button
Seat 1: garik301256 ($0.93 in chips) 
Seat 2: le_vlimeux ($5.12 in chips) 
Seat 3: vladlen101 ($0.31 in chips) 
Seat 4: Scaaalll ($2.91 in chips) 
Seat 5: maressen ($2.67 in chips) 
Seat 6: pavlo8855 ($2 in chips) 
le_vlimeux: posts small blind $0.01
vladlen101: posts big blind $0.02
*** HOLE CARDS ***
Dealt to Scaaalll [5c 2c]
Scaaalll: folds 
maressen: folds 
pavlo8855: folds 
garik301256: folds 
le_vlimeux: folds 
Uncalled bet ($0.01) returned to vladlen101
vladlen101 collected $0.02 from pot
vladlen101: doesn't show hand 
*** SUMMARY ***
Total pot $0.02 | Rake $0 
Seat 1: garik301256 (button) folded before Flop (didn't bet)
Seat 2: le_vlimeux (small blind) folded before Flop
Seat 3: vladlen101 (big blind) collected ($0.02)
Seat 4: Scaaalll folded before Flop (didn't bet)
Seat 5: maressen folded before Flop (didn't bet)
Seat 6: pavlo8855 folded before Flop (didn't bet)



PokerStars Zoom Hand #229230218276:  Hold'em No Limit ($0.01/$0.02) - 2021/08/21 21:28:32 CET [2021/08/21 15:28:32 ET]
Table 'Halley' 6-max Seat #1 is the button
Seat 1: Scaaalll ($2.91 in chips) 
Seat 2: no way yo ($3.33 in chips) 
Seat 3: fabor1303 ($2.49 in chips) 
Seat 4: skryg93 ($1.20 in chips) 
Seat 5: pavlo8855 ($2.26 in chips) 
Seat 6: superanton01 ($5.58 in chips) 
no way yo: posts small blind $0.01
fabor1303: posts big blind $0.02
*** HOLE CARDS ***
Dealt to Scaaalll [2h 4h]
skryg93: calls $0.02
pavlo8855: folds 
superanton01: calls $0.02
Scaaalll: folds 
no way yo: folds 
fabor1303: checks 
*** FLOP *** [Jh Ac Jd]
fabor1303: checks 
skryg93: checks 
superanton01: checks 
*** TURN *** [Jh Ac Jd] [6d]
fabor1303: checks 
skryg93: checks 
superanton01: checks 
*** RIVER *** [Jh Ac Jd 6d] [Ks]
fabor1303: checks 
skryg93: checks 
superanton01: bets $0.10
fabor1303: folds 
skryg93: folds 
Uncalled bet ($0.10) returned to superanton01
superanton01 collected $0.07 from pot
superanton01: doesn't show hand 
*** SUMMARY ***
Total pot $0.07 | Rake $0 
Board [Jh Ac Jd 6d Ks]
Seat 1: Scaaalll (button) folded before Flop (didn't bet)
Seat 2: no way yo (small blind) folded before Flop
Seat 3: fabor1303 (big blind) folded on the River
Seat 4: skryg93 folded on the River
Seat 5: pavlo8855 folded before Flop (didn't bet)
Seat 6: superanton01 collected ($0.07)



PokerStars Zoom Hand #229230223407:  Hold'em No Limit ($0.01/$0.02) - 2021/08/21 21:28:43 CET [2021/08/21 15:28:43 ET]
Table 'Halley' 6-max Seat #1 is the button
Seat 1: Ne0net ($2.44 in chips) 
Seat 2: Gerar NB ($2.27 in chips) 
Seat 3: Scaaalll ($2.91 in chips) 
Seat 4: trakiar ($8.08 in chips) 
Seat 5: EevAA190 ($2.03 in chips) 
Seat 6: Berti281 ($2.18 in chips) 
Gerar NB: posts small blind $0.01
Scaaalll: posts big blind $0.02
*** HOLE CARDS ***
Dealt to Scaaalll [5c 5d]
trakiar: folds 
trakiar is disconnected 
EevAA190: folds 
Berti281: raises $0.03 to $0.05
Ne0net: folds 
Gerar NB: calls $0.04
Scaaalll: calls $0.03
*** FLOP *** [Td 6d 8d]
Gerar NB: checks 
Scaaalll: checks 
Berti281: bets $0.11
Gerar NB: calls $0.11
Scaaalll: folds 
*** TURN *** [Td 6d 8d] [9h]
Gerar NB: checks 
Berti281: checks 
*** RIVER *** [Td 6d 8d 9h] [Jc]
Gerar NB: bets $0.18
Berti281: folds 
Uncalled bet ($0.18) returned to Gerar NB
Gerar NB collected $0.36 from pot
Gerar NB: doesn't show hand 
*** SUMMARY ***
Total pot $0.37 | Rake $0.01 
Board [Td 6d 8d 9h Jc]
Seat 1: Ne0net (button) folded before Flop (didn't bet)
Seat 2: Gerar NB (small blind) collected ($0.36)
Seat 3: Scaaalll (big blind) folded on the Flop
Seat 4: trakiar folded before Flop (didn't bet)
Seat 5: EevAA190 folded before Flop (didn't bet)
Seat 6: Berti281 folded on the River



PokerStars Zoom Hand #229230239017:  Hold'em No Limit ($0.01/$0.02) - 2021/08/21 21:29:17 CET [2021/08/21 15:29:17 ET]
Table 'Halley' 6-max Seat #1 is the button
Seat 1: Coldact ($2.14 in chips) 
Seat 2: Scaaalll ($2.86 in chips) 
Seat 3: KingsPoke185 ($1.06 in chips) 
Seat 4: ponomarinho ($2.10 in chips) 
Seat 5: laetschnbene ($2 in chips) 
Seat 6: AndreaBsAs ($2 in chips) 
Scaaalll: posts small blind $0.01
KingsPoke185: posts big blind $0.02
*** HOLE CARDS ***
Dealt to Scaaalll [Ts Tc]
ponomarinho: folds 
laetschnbene: folds 
AndreaBsAs: folds 
Coldact: raises $0.04 to $0.06
Scaaalll: calls $0.05
KingsPoke185: folds 
*** FLOP *** [7h Ad 6h]
Scaaalll: checks 
Coldact: bets $0.04
Scaaalll: calls $0.04
*** TURN *** [7h Ad 6h] [8d]
Scaaalll: checks 
Coldact: bets $0.10
Scaaalll: calls $0.10
*** RIVER *** [7h Ad 6h 8d] [Kc]
Scaaalll: checks 
Coldact: checks 
*** SHOW DOWN ***
Scaaalll: shows [Ts Tc] (a pair of Tens)
Coldact: mucks hand 
Scaaalll collected $0.41 from pot
*** SUMMARY ***
Total pot $0.42 | Rake $0.01 
Board [7h Ad 6h 8d Kc]
Seat 1: Coldact (button) mucked [5s 5d]
Seat 2: Scaaalll (small blind) showed [Ts Tc] and won ($0.41) with a pair of Tens
Seat 3: KingsPoke185 (big blind) folded before Flop
Seat 4: ponomarinho folded before Flop (didn't bet)
Seat 5: laetschnbene folded before Flop (didn't bet)
Seat 6: AndreaBsAs folded before Flop (didn't bet)



PokerStars Zoom Hand #229230267313:  Hold'em No Limit ($0.01/$0.02) - 2021/08/21 21:30:17 CET [2021/08/21 15:30:17 ET]
Table 'Halley' 6-max Seat #1 is the button
Seat 1: Appraiser73 ($1.06 in chips) 
Seat 2: Oprichnick90 ($2.15 in chips) 
Seat 3: elmex886 ($2 in chips) 
Seat 4: EevAA190 ($2.03 in chips) 
Seat 5: Stormzilla ($2 in chips) 
Seat 6: Scaaalll ($3.07 in chips) 
Oprichnick90: posts small blind $0.01
elmex886: posts big blind $0.02
*** HOLE CARDS ***
Dealt to Scaaalll [6h 7h]
EevAA190: folds 
Stormzilla: folds 
Scaaalll: raises $0.04 to $0.06
Appraiser73: folds 
Oprichnick90: raises $0.18 to $0.24
elmex886: folds 
Scaaalll: folds 
Uncalled bet ($0.18) returned to Oprichnick90
Oprichnick90 collected $0.14 from pot
Oprichnick90: doesn't show hand 
*** SUMMARY ***
Total pot $0.14 | Rake $0 
Seat 1: Appraiser73 (button) folded before Flop (didn't bet)
Seat 2: Oprichnick90 (small blind) collected ($0.14)
Seat 3: elmex886 (big blind) folded before Flop
Seat 4: EevAA190 folded before Flop (didn't bet)
Seat 5: Stormzilla folded before Flop (didn't bet)
Seat 6: Scaaalll folded before Flop



PokerStars Zoom Hand #229230295825:  Hold'em No Limit ($0.01/$0.02) - 2021/08/21 21:31:17 CET [2021/08/21 15:31:17 ET]
Table 'Halley' 6-max Seat #1 is the button
Seat 1: FishOnPlate ($2 in chips) 
Seat 2: bananAAbandit ($4.83 in chips) 
Seat 3: pavel28918012 ($1.26 in chips) 
Seat 4: Scaaalll ($3.01 in chips) 
Seat 5: Cid s2 ($1.80 in chips) 
Seat 6: man070707 ($1.23 in chips) 
bananAAbandit: posts small blind $0.01
pavel28918012: posts big blind $0.02
*** HOLE CARDS ***
Dealt to Scaaalll [Qs 7c]
man070707 is disconnected 
Scaaalll: folds 
Cid s2: folds 
man070707: folds 
FishOnPlate: raises $0.03 to $0.05
bananAAbandit: folds 
pavel28918012: raises $0.11 to $0.16
FishOnPlate: folds 
Uncalled bet ($0.11) returned to pavel28918012
pavel28918012 collected $0.11 from pot
pavel28918012: doesn't show hand 
*** SUMMARY ***
Total pot $0.11 | Rake $0 
Seat 1: FishOnPlate (button) folded before Flop
Seat 2: bananAAbandit (small blind) folded before Flop
Seat 3: pavel28918012 (big blind) collected ($0.11)
Seat 4: Scaaalll folded before Flop (didn't bet)
Seat 5: Cid s2 folded before Flop (didn't bet)
Seat 6: man070707 folded before Flop (didn't bet)



PokerStars Zoom Hand #229230291526:  Hold'em No Limit ($0.01/$0.02) - 2021/08/21 21:31:08 CET [2021/08/21 15:31:08 ET]
Table 'Halley' 6-max Seat #1 is the button
Seat 1: Scaaalll ($3.01 in chips) 
Seat 2: CASSIE21462 ($6.96 in chips) 
Seat 3: arrow17 ($2 in chips) 
Seat 4: amario89 ($2 in chips) 
Seat 5: arsad725 ($3.54 in chips) 
Seat 6: ctaceo ($2.17 in chips) 
CASSIE21462: posts small blind $0.01
arrow17: posts big blind $0.02
*** HOLE CARDS ***
Dealt to Scaaalll [3c Ah]
amario89: raises $0.04 to $0.06
arsad725: calls $0.06
ctaceo: folds 
Scaaalll: folds 
CASSIE21462: folds 
arrow17: folds 
*** FLOP *** [Js 9c 2s]
amario89: bets $0.06
arsad725: raises $0.13 to $0.19
amario89: calls $0.13
*** TURN *** [Js 9c 2s] [3s]
amario89: checks 
arsad725: checks 
*** RIVER *** [Js 9c 2s 3s] [4c]
amario89: bets $0.12
arsad725: calls $0.12
*** SHOW DOWN ***
amario89: shows [Ks Jd] (a pair of Jacks)
arsad725: shows [9h 9s] (three of a kind, Nines)
arsad725 collected $0.74 from pot
*** SUMMARY ***
Total pot $0.77 | Rake $0.03 
Board [Js 9c 2s 3s 4c]
Seat 1: Scaaalll (button) folded before Flop (didn't bet)
Seat 2: CASSIE21462 (small blind) folded before Flop
Seat 3: arrow17 (big blind) folded before Flop
Seat 4: amario89 showed [Ks Jd] and lost with a pair of Jacks
Seat 5: arsad725 showed [9h 9s] and won ($0.74) with three of a kind, Nines
Seat 6: ctaceo folded before Flop (didn't bet)



PokerStars Zoom Hand #229230297668:  Hold'em No Limit ($0.01/$0.02) - 2021/08/21 21:31:20 CET [2021/08/21 15:31:20 ET]
Table 'Halley' 6-max Seat #1 is the button
Seat 1: Lighio ($4.75 in chips) 
Seat 2: Ferr4r1430 ($3.54 in chips) 
Seat 3: Ebbelwoiexp ($2.03 in chips) 
Seat 4: Scaaalll ($3.01 in chips) 
Seat 5: ciucibaby ($4.41 in chips) 
Seat 6: sg.32rus ($1.01 in chips) 
Ferr4r1430: posts small blind $0.01
Ebbelwoiexp: posts big blind $0.02
*** HOLE CARDS ***
Dealt to Scaaalll [9h Kh]
Scaaalll: raises $0.04 to $0.06
ciucibaby: folds 
sg.32rus: folds 
Lighio: folds 
Ferr4r1430: folds 
Ferr4r1430 is disconnected 
Ebbelwoiexp: calls $0.04
*** FLOP *** [Ts 7d 8h]
Ebbelwoiexp: checks 
Scaaalll: bets $0.08
Ebbelwoiexp: calls $0.08
*** TURN *** [Ts 7d 8h] [4c]
Ebbelwoiexp: checks 
Scaaalll: bets $0.20
Ebbelwoiexp: calls $0.20
*** RIVER *** [Ts 7d 8h 4c] [4d]
Ebbelwoiexp: checks 
Scaaalll: checks 
*** SHOW DOWN ***
Ebbelwoiexp: shows [Jh Ad] (a pair of Fours)
Scaaalll: mucks hand 
Ebbelwoiexp collected $0.67 from pot
*** SUMMARY ***
Total pot $0.69 | Rake $0.02 
Board [Ts 7d 8h 4c 4d]
Seat 1: Lighio (button) folded before Flop (didn't bet)
Seat 2: Ferr4r1430 (small blind) folded before Flop
Seat 3: Ebbelwoiexp (big blind) showed [Jh Ad] and won ($0.67) with a pair of Fours
Seat 4: Scaaalll mucked [9h Kh]
Seat 5: ciucibaby folded before Flop (didn't bet)
Seat 6: sg.32rus folded before Flop (didn't bet)



PokerStars Zoom Hand #229230327311:  Hold'em No Limit ($0.01/$0.02) - 2021/08/21 21:32:23 CET [2021/08/21 15:32:23 ET]
Table 'Halley' 6-max Seat #1 is the button
Seat 1: IamFixxed ($2 in chips) 
Seat 2: zxJEKAxz ($0.97 in chips) 
Seat 3: lexus00174 ($8.54 in chips) 
Seat 4: shingo594 ($2 in chips) 
Seat 5: Scaaalll ($2.67 in chips) 
Seat 6: Gamer577 ($2.61 in chips) 
zxJEKAxz: posts small blind $0.01
lexus00174: posts big blind $0.02
*** HOLE CARDS ***
Dealt to Scaaalll [3d 7d]
shingo594: folds 
Scaaalll: folds 
Gamer577: folds 
shingo594 is disconnected 
IamFixxed: folds 
zxJEKAxz: raises $0.04 to $0.06
lexus00174: folds 
Uncalled bet ($0.04) returned to zxJEKAxz
zxJEKAxz collected $0.04 from pot
zxJEKAxz: doesn't show hand 
*** SUMMARY ***
Total pot $0.04 | Rake $0 
Seat 1: IamFixxed (button) folded before Flop (didn't bet)
Seat 2: zxJEKAxz (small blind) collected ($0.04)
Seat 3: lexus00174 (big blind) folded before Flop
Seat 4: shingo594 folded before Flop (didn't bet)
Seat 5: Scaaalll folded before Flop (didn't bet)
Seat 6: Gamer577 folded before Flop (didn't bet)



PokerStars Zoom Hand #229230331096:  Hold'em No Limit ($0.01/$0.02) - 2021/08/21 21:32:31 CET [2021/08/21 15:32:31 ET]
Table 'Halley' 6-max Seat #1 is the button
Seat 1: FCB-JW71 ($1.59 in chips) 
Seat 2: Baksit79 ($2.91 in chips) 
Seat 3: bAttery01 ($3.33 in chips) 
Seat 4: STE1NBERG ($2.15 in chips) 
Seat 5: felipeciji ($2.03 in chips) 
Seat 6: Scaaalll ($2.66 in chips) 
Baksit79: posts small blind $0.01
bAttery01: posts big blind $0.02
*** HOLE CARDS ***
Dealt to Scaaalll [9s Tc]
STE1NBERG: folds 
felipeciji: folds 
Scaaalll: folds 
FCB-JW71: folds 
Baksit79: raises $0.04 to $0.06
bAttery01: folds 
Uncalled bet ($0.04) returned to Baksit79
Baksit79 collected $0.04 from pot
Baksit79: doesn't show hand 
*** SUMMARY ***
Total pot $0.04 | Rake $0 
Seat 1: FCB-JW71 (button) folded before Flop (didn't bet)
Seat 2: Baksit79 (small blind) collected ($0.04)
Seat 3: bAttery01 (big blind) folded before Flop
Seat 4: STE1NBERG folded before Flop (didn't bet)
Seat 5: felipeciji folded before Flop (didn't bet)
Seat 6: Scaaalll folded before Flop (didn't bet)



PokerStars Zoom Hand #229230329201:  Hold'em No Limit ($0.01/$0.02) - 2021/08/21 21:32:27 CET [2021/08/21 15:32:27 ET]
Table 'Halley' 6-max Seat #1 is the button
Seat 1: qpsq ($2 in chips) 
Seat 2: Scaaalll ($2.67 in chips) 
Seat 3: Saint_ANBU ($3.39 in chips) 
Seat 4: TESTGOSHI ($2.83 in chips) 
Seat 5: greenthum33 ($3.87 in chips) 
Seat 6: ARTMVSLV ($4.48 in chips) 
Scaaalll: posts small blind $0.01
Saint_ANBU: posts big blind $0.02
*** HOLE CARDS ***
Dealt to Scaaalll [2h Qd]
TESTGOSHI: folds 
greenthum33: folds 
ARTMVSLV: folds 
qpsq: raises $0.04 to $0.06
Scaaalll: folds 
Saint_ANBU: calls $0.04
*** FLOP *** [9c 6s Kd]
Saint_ANBU: checks 
qpsq: bets $0.09
Saint_ANBU: calls $0.09
*** TURN *** [9c 6s Kd] [Jd]
Saint_ANBU: checks 
qpsq: checks 
*** RIVER *** [9c 6s Kd Jd] [3s]
Saint_ANBU: bets $0.36
qpsq: folds 
Uncalled bet ($0.36) returned to Saint_ANBU
Saint_ANBU collected $0.30 from pot
Saint_ANBU: doesn't show hand 
*** SUMMARY ***
Total pot $0.31 | Rake $0.01 
Board [9c 6s Kd Jd 3s]
Seat 1: qpsq (button) folded on the River
Seat 2: Scaaalll (small blind) folded before Flop
Seat 3: Saint_ANBU (big blind) collected ($0.30)
Seat 4: TESTGOSHI folded before Flop (didn't bet)
Seat 5: greenthum33 folded before Flop (didn't bet)
Seat 6: ARTMVSLV folded before Flop (didn't bet)



PokerStars Zoom Hand #229230343208:  Hold'em No Limit ($0.01/$0.02) - 2021/08/21 21:32:57 CET [2021/08/21 15:32:57 ET]
Table 'Halley' 6-max Seat #1 is the button
Seat 1: Scaaalll ($2.64 in chips) 
Seat 2: plmanuelpl ($0.73 in chips) 
Seat 3: MrRussia777 ($0.94 in chips) 
Seat 4: 78joniboy ($2 in chips) 
Seat 5: Dron4uk UA ($2.93 in chips) 
Seat 6: alecha11 ($2.43 in chips) 
plmanuelpl: posts small blind $0.01
MrRussia777: posts big blind $0.02
*** HOLE CARDS ***
Dealt to Scaaalll [9h 3h]
78joniboy: folds 
Dron4uk UA: folds 
alecha11: folds 
Scaaalll: folds 
plmanuelpl: calls $0.01
MrRussia777: checks 
*** FLOP *** [Qh 8h 5d]
plmanuelpl: bets $0.02
MrRussia777: folds 
Uncalled bet ($0.02) returned to plmanuelpl
plmanuelpl collected $0.04 from pot
plmanuelpl: doesn't show hand 
*** SUMMARY ***
Total pot $0.04 | Rake $0 
Board [Qh 8h 5d]
Seat 1: Scaaalll (button) folded before Flop (didn't bet)
Seat 2: plmanuelpl (small blind) collected ($0.04)
Seat 3: MrRussia777 (big blind) folded on the Flop
Seat 4: 78joniboy folded before Flop (didn't bet)
Seat 5: Dron4uk UA folded before Flop (didn't bet)
Seat 6: alecha11 folded before Flop (didn't bet)



PokerStars Zoom Hand #229230336304:  Hold'em No Limit ($0.01/$0.02) - 2021/08/21 21:32:42 CET [2021/08/21 15:32:42 ET]
Table 'Halley' 6-max Seat #1 is the button
Seat 1: Pray_to_win ($2.16 in chips) 
Seat 2: FishOnPlate ($2 in chips) 
Seat 3: Scaaalll ($2.66 in chips) 
Seat 4: brummie0 ($2.42 in chips) 
Seat 5: Pysgodyn ($2.46 in chips) 
Seat 6: KingsPoke185 ($1.01 in chips) 
FishOnPlate: posts small blind $0.01
Scaaalll: posts big blind $0.02
*** HOLE CARDS ***
Dealt to Scaaalll [Qc 7h]
brummie0: folds 
brummie0 is disconnected 
Pray_to_win is disconnected 
Pysgodyn: raises $0.03 to $0.05
KingsPoke185: calls $0.05
Pray_to_win: folds 
FishOnPlate: folds 
Scaaalll: folds 
*** FLOP *** [Kc 4c 8d]
Pysgodyn: bets $0.05
KingsPoke185: calls $0.05
*** TURN *** [Kc 4c 8d] [6h]
Pysgodyn: bets $0.14
KingsPoke185: folds 
Uncalled bet ($0.14) returned to Pysgodyn
Pysgodyn collected $0.22 from pot
Pysgodyn: doesn't show hand 
*** SUMMARY ***
Total pot $0.23 | Rake $0.01 
Board [Kc 4c 8d 6h]
Seat 1: Pray_to_win (button) folded before Flop (didn't bet)
Seat 2: FishOnPlate (small blind) folded before Flop
Seat 3: Scaaalll (big blind) folded before Flop
Seat 4: brummie0 folded before Flop (didn't bet)
Seat 5: Pysgodyn collected ($0.22)
Seat 6: KingsPoke185 folded on the Turn



PokerStars Zoom Hand #229230345601:  Hold'em No Limit ($0.01/$0.02) - 2021/08/21 21:33:02 CET [2021/08/21 15:33:02 ET]
Table 'Halley' 6-max Seat #1 is the button
Seat 1: Ne0net ($2.07 in chips) 
Seat 2: so0love ($4.34 in chips) 
Seat 3: amario89 ($2.37 in chips) 
Seat 4: Scaaalll ($2.64 in chips) 
Seat 5: feybys ($2.34 in chips) 
Seat 6: xxRoseIloveu ($2.21 in chips) 
so0love: posts small blind $0.01
amario89: posts big blind $0.02
*** HOLE CARDS ***
Dealt to Scaaalll [Th Tc]
Scaaalll: raises $0.04 to $0.06
feybys: calls $0.06
xxRoseIloveu: folds 
Ne0net: folds 
so0love: folds 
amario89: calls $0.04
*** FLOP *** [6h 2h 7h]
amario89: checks 
Scaaalll: bets $0.11
feybys: folds 
amario89: calls $0.11
*** TURN *** [6h 2h 7h] [7c]
amario89: checks 
Scaaalll: bets $0.23
amario89: raises $0.28 to $0.51
Scaaalll: folds 
Uncalled bet ($0.28) returned to amario89
amario89 collected $0.83 from pot
amario89: doesn't show hand 
*** SUMMARY ***
Total pot $0.87 | Rake $0.04 
Board [6h 2h 7h 7c]
Seat 1: Ne0net (button) folded before Flop (didn't bet)
Seat 2: so0love (small blind) folded before Flop
Seat 3: amario89 (big blind) collected ($0.83)
Seat 4: Scaaalll folded on the Turn
Seat 5: feybys folded on the Flop
Seat 6: xxRoseIloveu folded before Flop (didn't bet)



PokerStars Zoom Hand #229230365599:  Hold'em No Limit ($0.01/$0.02) - 2021/08/21 21:33:45 CET [2021/08/21 15:33:45 ET]
Table 'Halley' 6-max Seat #1 is the button
Seat 1: superstar1070 ($0.86 in chips) 
Seat 2: Alex Koshva1 ($0.60 in chips) 
Seat 3: LegendaryLRS ($2.28 in chips) 
Seat 4: Murileus ($2.82 in chips) 
Seat 5: Slirey ($3.12 in chips) 
Seat 6: Scaaalll ($2.24 in chips) 
Alex Koshva1: posts small blind $0.01
LegendaryLRS: posts big blind $0.02
*** HOLE CARDS ***
Dealt to Scaaalll [8h 7s]
Murileus: folds 
superstar1070 is disconnected 
Slirey: calls $0.02
Scaaalll: folds 
superstar1070: folds 
Alex Koshva1: folds 
LegendaryLRS: checks 
*** FLOP *** [Jh 9d 9s]
LegendaryLRS: checks 
Slirey: checks 
*** TURN *** [Jh 9d 9s] [Ad]
LegendaryLRS: checks 
Slirey: checks 
*** RIVER *** [Jh 9d 9s Ad] [Js]
LegendaryLRS: checks 
Slirey: checks 
*** SHOW DOWN ***
LegendaryLRS: shows [3s 8c] (two pair, Jacks and Nines)
Slirey: shows [3c 4c] (two pair, Jacks and Nines)
LegendaryLRS collected $0.03 from pot
Slirey collected $0.02 from pot
*** SUMMARY ***
Total pot $0.05 | Rake $0 
Board [Jh 9d 9s Ad Js]
Seat 1: superstar1070 (button) folded before Flop (didn't bet)
Seat 2: Alex Koshva1 (small blind) folded before Flop
Seat 3: LegendaryLRS (big blind) showed [3s 8c] and won ($0.03) with two pair, Jacks and Nines
Seat 4: Murileus folded before Flop (didn't bet)
Seat 5: Slirey showed [3c 4c] and won ($0.02) with two pair, Jacks and Nines
Seat 6: Scaaalll folded before Flop (didn't bet)



PokerStars Zoom Hand #229230367519:  Hold'em No Limit ($0.01/$0.02) - 2021/08/21 21:33:49 CET [2021/08/21 15:33:49 ET]
Table 'Halley' 6-max Seat #1 is the button
Seat 1: arrow17 ($2 in chips) 
Seat 2: Scaaalll ($2.24 in chips) 
Seat 3: kickBrain ($6.53 in chips) 
Seat 4: KoAlRy ($2 in chips) 
Seat 5: HDYD18 ($3.31 in chips) 
Seat 6: PlayPokerHappy1 ($2 in chips) 
Scaaalll: posts small blind $0.01
kickBrain: posts big blind $0.02
*** HOLE CARDS ***
Dealt to Scaaalll [4d 3c]
KoAlRy: folds 
HDYD18: folds 
PlayPokerHappy1: folds 
arrow17: raises $0.03 to $0.05
Scaaalll: folds 
kickBrain: folds 
Uncalled bet ($0.03) returned to arrow17
arrow17 collected $0.05 from pot
arrow17: doesn't show hand 
*** SUMMARY ***
Total pot $0.05 | Rake $0 
Seat 1: arrow17 (button) collected ($0.05)
Seat 2: Scaaalll (small blind) folded before Flop
Seat 3: kickBrain (big blind) folded before Flop
Seat 4: KoAlRy folded before Flop (didn't bet)
Seat 5: HDYD18 folded before Flop (didn't bet)
Seat 6: PlayPokerHappy1 folded before Flop (didn't bet)



PokerStars Zoom Hand #229230374511:  Hold'em No Limit ($0.01/$0.02) - 2021/08/21 21:34:04 CET [2021/08/21 15:34:04 ET]
Table 'Halley' 6-max Seat #1 is the button
Seat 1: KRandall12 ($0.96 in chips) 
Seat 2: G1olight ($2.11 in chips) 
Seat 3: Scaaalll ($2.23 in chips) 
Seat 4: CronZ86 ($0.70 in chips) 
Seat 5: Ne0net ($2.11 in chips) 
Seat 6: zergmiky ($2.26 in chips) 
G1olight: posts small blind $0.01
Scaaalll: posts big blind $0.02
*** HOLE CARDS ***
Dealt to Scaaalll [Jc 4s]
G1olight is disconnected 
CronZ86: calls $0.02
Ne0net: folds 
zergmiky: folds 
KRandall12: folds 
G1olight: folds 
Scaaalll: checks 
*** FLOP *** [6c 7c 2d]
Scaaalll: checks 
CronZ86: checks 
*** TURN *** [6c 7c 2d] [Jh]
Scaaalll: checks 
CronZ86: bets $0.05
Scaaalll: calls $0.05
*** RIVER *** [6c 7c 2d Jh] [Js]
Scaaalll: checks 
CronZ86: bets $0.07
Scaaalll: calls $0.07
*** SHOW DOWN ***
CronZ86: shows [Qs Kh] (a pair of Jacks)
Scaaalll: shows [Jc 4s] (three of a kind, Jacks)
Scaaalll collected $0.28 from pot
*** SUMMARY ***
Total pot $0.29 | Rake $0.01 
Board [6c 7c 2d Jh Js]
Seat 1: KRandall12 (button) folded before Flop (didn't bet)
Seat 2: G1olight (small blind) folded before Flop
Seat 3: Scaaalll (big blind) showed [Jc 4s] and won ($0.28) with three of a kind, Jacks
Seat 4: CronZ86 showed [Qs Kh] and lost with a pair of Jacks
Seat 5: Ne0net folded before Flop (didn't bet)
Seat 6: zergmiky folded before Flop (didn't bet)



PokerStars Zoom Hand #229230395490:  Hold'em No Limit ($0.01/$0.02) - 2021/08/21 21:34:49 CET [2021/08/21 15:34:49 ET]
Table 'Halley' 6-max Seat #1 is the button
Seat 1: lustranik ($4.71 in chips) 
Seat 2: causavera ($4.51 in chips) 
Seat 3: Koldun 2636 ($2.20 in chips) 
Seat 4: Salazar-MF ($2.25 in chips) 
Seat 5: Scaaalll ($2.37 in chips) 
Seat 6: nemat_g ($2.23 in chips) 
causavera: posts small blind $0.01
Koldun 2636: posts big blind $0.02
*** HOLE CARDS ***
Dealt to Scaaalll [Ks 7s]
Salazar-MF: folds 
Scaaalll: folds 
nemat_g: folds 
lustranik: folds 
causavera: folds 
Uncalled bet ($0.01) returned to Koldun 2636
Koldun 2636 collected $0.02 from pot
Koldun 2636: doesn't show hand 
*** SUMMARY ***
Total pot $0.02 | Rake $0 
Seat 1: lustranik (button) folded before Flop (didn't bet)
Seat 2: causavera (small blind) folded before Flop
Seat 3: Koldun 2636 (big blind) collected ($0.02)
Seat 4: Salazar-MF folded before Flop (didn't bet)
Seat 5: Scaaalll folded before Flop (didn't bet)
Seat 6: nemat_g folded before Flop (didn't bet)



PokerStars Zoom Hand #229230397274:  Hold'em No Limit ($0.01/$0.02) - 2021/08/21 21:34:53 CET [2021/08/21 15:34:53 ET]
Table 'Halley' 6-max Seat #1 is the button
Seat 1: Scaaalll ($2.37 in chips) 
Seat 2: PlayPokerHappy1 ($7.74 in chips) 
Seat 3: Murileus ($2.79 in chips) 
Seat 4: laetschnbene ($1.99 in chips) 
Seat 5: malandro733 ($2.05 in chips) 
Seat 6: Kuzmich_2502 ($3.81 in chips) 
PlayPokerHappy1: posts small blind $0.01
Murileus: posts big blind $0.02
*** HOLE CARDS ***
Dealt to Scaaalll [Kd Ac]
laetschnbene: raises $0.04 to $0.06
malandro733: folds 
Kuzmich_2502: folds 
Scaaalll: raises $0.12 to $0.18
PlayPokerHappy1: folds 
Murileus: folds 
laetschnbene: calls $0.12
*** FLOP *** [5c 4h 6c]
laetschnbene: checks 
Scaaalll: checks 
*** TURN *** [5c 4h 6c] [Td]
laetschnbene: checks 
Scaaalll: checks 
*** RIVER *** [5c 4h 6c Td] [Jd]
laetschnbene: checks 
Scaaalll: checks 
*** SHOW DOWN ***
laetschnbene: shows [3h 3d] (a pair of Threes)
Scaaalll: mucks hand 
laetschnbene collected $0.38 from pot
*** SUMMARY ***
Total pot $0.39 | Rake $0.01 
Board [5c 4h 6c Td Jd]
Seat 1: Scaaalll (button) mucked [Kd Ac]
Seat 2: PlayPokerHappy1 (small blind) folded before Flop
Seat 3: Murileus (big blind) folded before Flop
Seat 4: laetschnbene showed [3h 3d] and won ($0.38) with a pair of Threes
Seat 5: malandro733 folded before Flop (didn't bet)
Seat 6: Kuzmich_2502 folded before Flop (didn't bet)



PokerStars Zoom Hand #229230416303:  Hold'em No Limit ($0.01/$0.02) - 2021/08/21 21:35:35 CET [2021/08/21 15:35:35 ET]
Table 'Halley' 6-max Seat #1 is the button
Seat 1: Jujiluju ($1.98 in chips) 
Seat 2: puratiino ($1.28 in chips) 
Seat 3: ryancudmore ($2 in chips) 
Seat 4: MIT_PKR ($4.13 in chips) 
Seat 5: Shadi8 ($7.36 in chips) 
Seat 6: Scaaalll ($2.19 in chips) 
puratiino: posts small blind $0.01
ryancudmore: posts big blind $0.02
*** HOLE CARDS ***
Dealt to Scaaalll [Qd 4d]
MIT_PKR: folds 
Shadi8: folds 
Scaaalll: folds 
Jujiluju: folds 
puratiino: folds 
Uncalled bet ($0.01) returned to ryancudmore
ryancudmore collected $0.02 from pot
ryancudmore: doesn't show hand 
*** SUMMARY ***
Total pot $0.02 | Rake $0 
Seat 1: Jujiluju (button) folded before Flop (didn't bet)
Seat 2: puratiino (small blind) folded before Flop
Seat 3: ryancudmore (big blind) collected ($0.02)
Seat 4: MIT_PKR folded before Flop (didn't bet)
Seat 5: Shadi8 folded before Flop (didn't bet)
Seat 6: Scaaalll folded before Flop (didn't bet)



PokerStars Zoom Hand #229230419123:  Hold'em No Limit ($0.01/$0.02) - 2021/08/21 21:35:40 CET [2021/08/21 15:35:40 ET]
Table 'Halley' 6-max Seat #1 is the button
Seat 1: ARTMVSLV ($2.39 in chips) 
Seat 2: Scaaalll ($2.19 in chips) 
Seat 3: GiordanoBrn ($2 in chips) 
Seat 4: LalaBee21 ($1.80 in chips) 
Seat 5: lsd paper ($0.09 in chips) 
Seat 6: Fedor_Gar ($2.07 in chips) 
Scaaalll: posts small blind $0.01
GiordanoBrn: posts big blind $0.02
*** HOLE CARDS ***
Dealt to Scaaalll [Qc 3c]
LalaBee21: folds 
lsd paper: folds 
Fedor_Gar: folds 
lsd paper is disconnected 
ARTMVSLV: raises $0.02 to $0.04
Scaaalll: folds 
GiordanoBrn: calls $0.02
*** FLOP *** [9c 7d Kc]
GiordanoBrn: checks 
ARTMVSLV: bets $0.06
GiordanoBrn: calls $0.06
*** TURN *** [9c 7d Kc] [Th]
GiordanoBrn: checks 
ARTMVSLV: bets $0.07
GiordanoBrn: calls $0.07
*** RIVER *** [9c 7d Kc Th] [Jh]
GiordanoBrn: checks 
ARTMVSLV: checks 
*** SHOW DOWN ***
GiordanoBrn: shows [Jd Kd] (two pair, Kings and Jacks)
ARTMVSLV: mucks hand 
GiordanoBrn collected $0.34 from pot
*** SUMMARY ***
Total pot $0.35 | Rake $0.01 
Board [9c 7d Kc Th Jh]
Seat 1: ARTMVSLV (button) mucked [Ks 6c]
Seat 2: Scaaalll (small blind) folded before Flop
Seat 3: GiordanoBrn (big blind) showed [Jd Kd] and won ($0.34) with two pair, Kings and Jacks
Seat 4: LalaBee21 folded before Flop (didn't bet)
Seat 5: lsd paper folded before Flop (didn't bet)
Seat 6: Fedor_Gar folded before Flop (didn't bet)



PokerStars Zoom Hand #229230420963:  Hold'em No Limit ($0.01/$0.02) - 2021/08/21 21:35:44 CET [2021/08/21 15:35:44 ET]
Table 'Halley' 6-max Seat #1 is the button
Seat 1: Quantum771 ($2 in chips) 
Seat 2: Shcherbak252 ($2.34 in chips) 
Seat 3: Clavis Noa ($2.56 in chips) 
Seat 4: IamFixxed ($5.71 in chips) 
Seat 5: Scaaalll ($2.18 in chips) 
Seat 6: MrRussia777 ($0.87 in chips) 
Shcherbak252: posts small blind $0.01
Clavis Noa: posts big blind $0.02
*** HOLE CARDS ***
Dealt to Scaaalll [5d Kh]
IamFixxed: raises $0.02 to $0.04
Scaaalll: folds 
MrRussia777: folds 
Quantum771: folds 
Shcherbak252: calls $0.03
Clavis Noa: calls $0.02
*** FLOP *** [4h 3h 4s]
Shcherbak252: checks 
Clavis Noa: checks 
IamFixxed: bets $0.06
Shcherbak252: calls $0.06
Clavis Noa: folds 
*** TURN *** [4h 3h 4s] [7h]
Shcherbak252: checks 
IamFixxed: checks 
*** RIVER *** [4h 3h 4s 7h] [Qc]
Shcherbak252: bets $0.07
IamFixxed: folds 
Uncalled bet ($0.07) returned to Shcherbak252
Shcherbak252 collected $0.23 from pot
Shcherbak252: doesn't show hand 
*** SUMMARY ***
Total pot $0.24 | Rake $0.01 
Board [4h 3h 4s 7h Qc]
Seat 1: Quantum771 (button) folded before Flop (didn't bet)
Seat 2: Shcherbak252 (small blind) collected ($0.23)
Seat 3: Clavis Noa (big blind) folded on the Flop
Seat 4: IamFixxed folded on the River
Seat 5: Scaaalll folded before Flop (didn't bet)
Seat 6: MrRussia777 folded before Flop (didn't bet)



PokerStars Zoom Hand #229230424740:  Hold'em No Limit ($0.01/$0.02) - 2021/08/21 21:35:53 CET [2021/08/21 15:35:53 ET]
Table 'Halley' 6-max Seat #1 is the button
Seat 1: Sprot74 ($2.10 in chips) 
Seat 2: Nihility77 ($3.07 in chips) 
Seat 3: Scaaalll ($2.18 in chips) 
Seat 4: ferx1989 ($3.39 in chips) 
Seat 5: kykareky32 ($1.92 in chips) 
Seat 6: sorinysu ($0.65 in chips) 
Nihility77: posts small blind $0.01
Scaaalll: posts big blind $0.02
*** HOLE CARDS ***
Dealt to Scaaalll [6c Td]
ferx1989: raises $0.04 to $0.06
kykareky32: folds 
sorinysu: folds 
sorinysu is disconnected 
Sprot74: raises $2.04 to $2.10 and is all-in
Nihility77: folds 
Scaaalll: folds 
ferx1989: folds 
Uncalled bet ($2.04) returned to Sprot74
Sprot74 collected $0.15 from pot
Sprot74: doesn't show hand 
*** SUMMARY ***
Total pot $0.15 | Rake $0 
Seat 1: Sprot74 (button) collected ($0.15)
Seat 2: Nihility77 (small blind) folded before Flop
Seat 3: Scaaalll (big blind) folded before Flop
Seat 4: ferx1989 folded before Flop
Seat 5: kykareky32 folded before Flop (didn't bet)
Seat 6: sorinysu folded before Flop (didn't bet)



PokerStars Zoom Hand #229230427041:  Hold'em No Limit ($0.01/$0.02) - 2021/08/21 21:35:57 CET [2021/08/21 15:35:57 ET]
Table 'Halley' 6-max Seat #1 is the button
Seat 1: 1_KoLizeI_1 ($2.73 in chips) 
Seat 2: xxRoseIloveu ($5.26 in chips) 
Seat 3: CASSIE21462 ($6 in chips) 
Seat 4: Scaaalll ($2.16 in chips) 
Seat 5: martuska88 ($2.13 in chips) 
Seat 6: VITALIONICH626 ($1.73 in chips) 
xxRoseIloveu: posts small blind $0.01
CASSIE21462: posts big blind $0.02
*** HOLE CARDS ***
Dealt to Scaaalll [6s 5h]
Scaaalll: folds 
martuska88: folds 
VITALIONICH626: raises $0.02 to $0.04
1_KoLizeI_1: folds 
xxRoseIloveu: raises $0.10 to $0.14
CASSIE21462: calls $0.12
VITALIONICH626: raises $0.10 to $0.24
xxRoseIloveu: calls $0.10
CASSIE21462: calls $0.10
*** FLOP *** [Kc Td 7d]
xxRoseIloveu: checks 
CASSIE21462: checks 
VITALIONICH626: bets $0.69
xxRoseIloveu: folds 
CASSIE21462: calls $0.69
*** TURN *** [Kc Td 7d] [3s]
CASSIE21462: checks 
VITALIONICH626: bets $0.80 and is all-in
CASSIE21462: calls $0.80
*** RIVER *** [Kc Td 7d 3s] [Kd]
*** SHOW DOWN ***
CASSIE21462: shows [Js 9s] (a pair of Kings)
VITALIONICH626: shows [Ad Ah] (two pair, Aces and Kings)
VITALIONICH626 collected $3.57 from pot
CASSIE21462 cashed out the hand for $0.64 | Cash Out Fee $0.01
*** SUMMARY ***
Total pot $3.70 | Rake $0.13 
Board [Kc Td 7d 3s Kd]
Seat 1: 1_KoLizeI_1 (button) folded before Flop (didn't bet)
Seat 2: xxRoseIloveu (small blind) folded on the Flop
Seat 3: CASSIE21462 (big blind) showed [Js 9s] and lost with a pair of Kings (cashed out).
Seat 4: Scaaalll folded before Flop (didn't bet)
Seat 5: martuska88 folded before Flop (didn't bet)
Seat 6: VITALIONICH626 showed [Ad Ah] and won ($3.57) with two pair, Aces and Kings



PokerStars Zoom Hand #229230431678:  Hold'em No Limit ($0.01/$0.02) - 2021/08/21 21:36:08 CET [2021/08/21 15:36:08 ET]
Table 'Halley' 6-max Seat #1 is the button
Seat 1: Saint_ANBU ($2.96 in chips) 
Seat 2: Scaaalll ($2.16 in chips) 
Seat 3: JuRawany ($1.48 in chips) 
Seat 4: Toschi07 ($1.10 in chips) 
Seat 5: JCharrod ($5.74 in chips) 
Seat 6: lucksuckdonk ($5.25 in chips) 
Scaaalll: posts small blind $0.01
JuRawany: posts big blind $0.02
*** HOLE CARDS ***
Dealt to Scaaalll [Ac 3d]
Toschi07: folds 
JCharrod: folds 
lucksuckdonk: raises $0.04 to $0.06
Saint_ANBU: folds 
Scaaalll: folds 
JuRawany: raises $0.04 to $0.10
lucksuckdonk: calls $0.04
*** FLOP *** [As 8c 4h]
JuRawany: bets $0.10
lucksuckdonk: folds 
Uncalled bet ($0.10) returned to JuRawany
JuRawany collected $0.20 from pot
JuRawany: doesn't show hand 
*** SUMMARY ***
Total pot $0.21 | Rake $0.01 
Board [As 8c 4h]
Seat 1: Saint_ANBU (button) folded before Flop (didn't bet)
Seat 2: Scaaalll (small blind) folded before Flop
Seat 3: JuRawany (big blind) collected ($0.20)
Seat 4: Toschi07 folded before Flop (didn't bet)
Seat 5: JCharrod folded before Flop (didn't bet)
Seat 6: lucksuckdonk folded on the Flop



PokerStars Zoom Hand #229230443668:  Hold'em No Limit ($0.01/$0.02) - 2021/08/21 21:36:34 CET [2021/08/21 15:36:34 ET]
Table 'Halley' 6-max Seat #1 is the button
Seat 1: Scaaalll ($2.15 in chips) 
Seat 2: morjachok8888 ($5.58 in chips) 
Seat 3: SpartanRace1 ($8.41 in chips) 
Seat 4: vladlen101 ($1.14 in chips) 
Seat 5: nV6TR ($1.25 in chips) 
Seat 6: Shcherbak252 ($2.07 in chips) 
morjachok8888: posts small blind $0.01
SpartanRace1: posts big blind $0.02
*** HOLE CARDS ***
Dealt to Scaaalll [Kh Qh]
vladlen101: raises $0.02 to $0.04
morjachok8888 is disconnected 
nV6TR: calls $0.04
Shcherbak252: calls $0.04
Scaaalll: calls $0.04
morjachok8888: folds 
SpartanRace1: folds 
*** FLOP *** [6d 9h Th]
vladlen101: checks 
nV6TR: checks 
Shcherbak252: checks 
Scaaalll: bets $0.14
vladlen101: folds 
nV6TR: folds 
Shcherbak252: folds 
Uncalled bet ($0.14) returned to Scaaalll
Scaaalll collected $0.18 from pot
Scaaalll: doesn't show hand 
*** SUMMARY ***
Total pot $0.19 | Rake $0.01 
Board [6d 9h Th]
Seat 1: Scaaalll (button) collected ($0.18)
Seat 2: morjachok8888 (small blind) folded before Flop
Seat 3: SpartanRace1 (big blind) folded before Flop
Seat 4: vladlen101 folded on the Flop
Seat 5: nV6TR folded on the Flop
Seat 6: Shcherbak252 folded on the Flop



PokerStars Zoom Hand #229230460347:  Hold'em No Limit ($0.01/$0.02) - 2021/08/21 21:37:09 CET [2021/08/21 15:37:09 ET]
Table 'Halley' 6-max Seat #1 is the button
Seat 1: VoidEclipse ($2 in chips) 
Seat 2: Loto70 ($2 in chips) 
Seat 3: Scaaalll ($2.29 in chips) 
Seat 4: py100ta ($2.11 in chips) 
Seat 5: Koldun 2636 ($3.34 in chips) 
Seat 6: igara tigara ($2.40 in chips) 
Loto70: posts small blind $0.01
Scaaalll: posts big blind $0.02
*** HOLE CARDS ***
Dealt to Scaaalll [4d Qd]
py100ta: folds 
Koldun 2636: folds 
igara tigara: folds 
VoidEclipse: raises $0.03 to $0.05
Loto70: folds 
Scaaalll: folds 
Uncalled bet ($0.03) returned to VoidEclipse
VoidEclipse collected $0.05 from pot
VoidEclipse: doesn't show hand 
*** SUMMARY ***
Total pot $0.05 | Rake $0 
Seat 1: VoidEclipse (button) collected ($0.05)
Seat 2: Loto70 (small blind) folded before Flop
Seat 3: Scaaalll (big blind) folded before Flop
Seat 4: py100ta folded before Flop (didn't bet)
Seat 5: Koldun 2636 folded before Flop (didn't bet)
Seat 6: igara tigara folded before Flop (didn't bet)



PokerStars Zoom Hand #229230468777:  Hold'em No Limit ($0.01/$0.02) - 2021/08/21 21:37:28 CET [2021/08/21 15:37:28 ET]
Table 'Halley' 6-max Seat #1 is the button
Seat 1: KingsPoke185 ($0.67 in chips) 
Seat 2: Kb013497 ($2.92 in chips) 
Seat 3: someone0611 ($1.89 in chips) 
Seat 4: pphit ($2.40 in chips) 
Seat 5: olga3021221 ($4.78 in chips) 
Seat 6: Scaaalll ($2.27 in chips) 
Kb013497: posts small blind $0.01
someone0611: posts big blind $0.02
*** HOLE CARDS ***
Dealt to Scaaalll [Qh 3s]
pphit: raises $0.03 to $0.05
olga3021221: folds 
Scaaalll: folds 
KingsPoke185: folds 
Kb013497: folds 
someone0611: folds 
Uncalled bet ($0.03) returned to pphit
pphit collected $0.05 from pot
pphit: doesn't show hand 
*** SUMMARY ***
Total pot $0.05 | Rake $0 
Seat 1: KingsPoke185 (button) folded before Flop (didn't bet)
Seat 2: Kb013497 (small blind) folded before Flop
Seat 3: someone0611 (big blind) folded before Flop
Seat 4: pphit collected ($0.05)
Seat 5: olga3021221 folded before Flop (didn't bet)
Seat 6: Scaaalll folded before Flop (didn't bet)



PokerStars Zoom Hand #229230474385:  Hold'em No Limit ($0.01/$0.02) - 2021/08/21 21:37:40 CET [2021/08/21 15:37:40 ET]
Table 'Halley' 6-max Seat #1 is the button
Seat 1: Clavis Noa ($2.10 in chips) 
Seat 2: Nihility77 ($3.01 in chips) 
Seat 3: viktor2935 ($1.25 in chips) 
Seat 4: yannikdaehne ($7.80 in chips) 
Seat 5: Scaaalll ($2.27 in chips) 
Seat 6: snowy_96 ($2 in chips) 
Nihility77: posts small blind $0.01
viktor2935: posts big blind $0.02
*** HOLE CARDS ***
Dealt to Scaaalll [Kc 7d]
yannikdaehne: folds 
Scaaalll: folds 
snowy_96: folds 
Clavis Noa: folds 
Nihility77: folds 
Uncalled bet ($0.01) returned to viktor2935
viktor2935 collected $0.02 from pot
viktor2935: doesn't show hand 
*** SUMMARY ***
Total pot $0.02 | Rake $0 
Seat 1: Clavis Noa (button) folded before Flop (didn't bet)
Seat 2: Nihility77 (small blind) folded before Flop
Seat 3: viktor2935 (big blind) collected ($0.02)
Seat 4: yannikdaehne folded before Flop (didn't bet)
Seat 5: Scaaalll folded before Flop (didn't bet)
Seat 6: snowy_96 folded before Flop (didn't bet)



PokerStars Zoom Hand #229230472482:  Hold'em No Limit ($0.01/$0.02) - 2021/08/21 21:37:35 CET [2021/08/21 15:37:35 ET]
Table 'Halley' 6-max Seat #1 is the button
Seat 1: Scaaalll ($2.27 in chips) 
Seat 2: VITALIONICH626 ($3.43 in chips) 
Seat 3: HellNative ($2.33 in chips) 
Seat 4: keri1000 ($1.21 in chips) 
Seat 5: Cid s2 ($1.77 in chips) 
Seat 6: SpartanRace1 ($8.38 in chips) 
VITALIONICH626: posts small blind $0.01
HellNative: posts big blind $0.02
*** HOLE CARDS ***
Dealt to Scaaalll [9h 3h]
keri1000: folds 
keri1000 is disconnected 
Cid s2: folds 
SpartanRace1: folds 
Scaaalll: folds 
VITALIONICH626: calls $0.01
HellNative: checks 
*** FLOP *** [Jd 2c Jc]
VITALIONICH626: checks 
HellNative: checks 
*** TURN *** [Jd 2c Jc] [8d]
VITALIONICH626: checks 
HellNative: checks 
*** RIVER *** [Jd 2c Jc 8d] [Js]
VITALIONICH626: bets $0.02
HellNative: folds 
Uncalled bet ($0.02) returned to VITALIONICH626
VITALIONICH626 collected $0.04 from pot
VITALIONICH626: doesn't show hand 
*** SUMMARY ***
Total pot $0.04 | Rake $0 
Board [Jd 2c Jc 8d Js]
Seat 1: Scaaalll (button) folded before Flop (didn't bet)
Seat 2: VITALIONICH626 (small blind) collected ($0.04)
Seat 3: HellNative (big blind) folded on the River
Seat 4: keri1000 folded before Flop (didn't bet)
Seat 5: Cid s2 folded before Flop (didn't bet)
Seat 6: SpartanRace1 folded before Flop (didn't bet)



PokerStars Zoom Hand #229230477135:  Hold'em No Limit ($0.01/$0.02) - 2021/08/21 21:37:46 CET [2021/08/21 15:37:46 ET]
Table 'Halley' 6-max Seat #1 is the button
Seat 1: mity3333 ($2.78 in chips) 
Seat 2: miducontra ($0.87 in chips) 
Seat 3: mikiZGB ($1.58 in chips) 
Seat 4: klausC3 ($6.15 in chips) 
Seat 5: Amigo113 ($2.67 in chips) 
Seat 6: Scaaalll ($2.27 in chips) 
miducontra: posts small blind $0.01
mikiZGB: posts big blind $0.02
*** HOLE CARDS ***
Dealt to Scaaalll [Ah Ts]
klausC3: folds 
Amigo113: folds 
Scaaalll: raises $0.04 to $0.06
mity3333: folds 
miducontra: calls $0.05
mikiZGB: folds 
*** FLOP *** [3h 3c 5h]
miducontra: checks 
Scaaalll: bets $0.08
miducontra: calls $0.08
*** TURN *** [3h 3c 5h] [Ad]
miducontra: checks 
Scaaalll: bets $0.16
miducontra: raises $0.16 to $0.32
Scaaalll: folds 
Uncalled bet ($0.16) returned to miducontra
miducontra collected $0.60 from pot
miducontra: doesn't show hand 
*** SUMMARY ***
Total pot $0.62 | Rake $0.02 
Board [3h 3c 5h Ad]
Seat 1: mity3333 (button) folded before Flop (didn't bet)
Seat 2: miducontra (small blind) collected ($0.60)
Seat 3: mikiZGB (big blind) folded before Flop
Seat 4: klausC3 folded before Flop (didn't bet)
Seat 5: Amigo113 folded before Flop (didn't bet)
Seat 6: Scaaalll folded on the Turn



PokerStars Zoom Hand #229230506201:  Hold'em No Limit ($0.01/$0.02) - 2021/08/21 21:38:48 CET [2021/08/21 15:38:48 ET]
Table 'Halley' 6-max Seat #1 is the button
Seat 1: Victor151886 ($3.32 in chips) 
Seat 2: aptainSpliff ($2.07 in chips) 
Seat 3: amario89 ($2.29 in chips) 
Seat 4: Ookhmua13 ($2.45 in chips) 
Seat 5: Scaaalll ($2 in chips) 
Seat 6: feybys ($2.25 in chips) 
aptainSpliff: posts small blind $0.01
amario89: posts big blind $0.02
*** HOLE CARDS ***
Dealt to Scaaalll [2c As]
Ookhmua13: folds 
Ookhmua13 is disconnected 
aptainSpliff is disconnected 
Scaaalll: folds 
feybys: folds 
Victor151886: raises $0.04 to $0.06
aptainSpliff: folds 
amario89: raises $0.18 to $0.24
Victor151886: folds 
Uncalled bet ($0.18) returned to amario89
amario89 collected $0.13 from pot
amario89: doesn't show hand 
*** SUMMARY ***
Total pot $0.13 | Rake $0 
Seat 1: Victor151886 (button) folded before Flop
Seat 2: aptainSpliff (small blind) folded before Flop
Seat 3: amario89 (big blind) collected ($0.13)
Seat 4: Ookhmua13 folded before Flop (didn't bet)
Seat 5: Scaaalll folded before Flop (didn't bet)
Seat 6: feybys folded before Flop (didn't bet)



PokerStars Zoom Hand #229230495113:  Hold'em No Limit ($0.01/$0.02) - 2021/08/21 21:38:25 CET [2021/08/21 15:38:25 ET]
Table 'Halley' 6-max Seat #1 is the button
Seat 1: nodtress ($2.64 in chips) 
Seat 2: Fedor_Gar ($2.02 in chips) 
Seat 3: Scaaalll ($2 in chips) 
Seat 4: Saint_ANBU ($2.10 in chips) 
Seat 5: NecromiconP ($3.29 in chips) 
Seat 6: ugi-dugi ($2.15 in chips) 
Fedor_Gar: posts small blind $0.01
Scaaalll: posts big blind $0.02
*** HOLE CARDS ***
Dealt to Scaaalll [Qh 9s]
Saint_ANBU: raises $0.04 to $0.06
NecromiconP: folds 
ugi-dugi: calls $0.06
nodtress: folds 
Fedor_Gar: calls $0.05
Scaaalll: folds 
*** FLOP *** [5d 4c 7s]
Fedor_Gar: checks 
Saint_ANBU: bets $0.06
ugi-dugi: calls $0.06
Fedor_Gar: calls $0.06
*** TURN *** [5d 4c 7s] [2s]
Fedor_Gar: checks 
Saint_ANBU: bets $0.12
ugi-dugi: folds 
Fedor_Gar: calls $0.12
*** RIVER *** [5d 4c 7s 2s] [3c]
Fedor_Gar: checks 
Saint_ANBU: checks 
*** SHOW DOWN ***
Fedor_Gar: shows [Ts 8s] (high card Ten)
Saint_ANBU: shows [Js Jd] (a pair of Jacks)
Saint_ANBU collected $0.60 from pot
*** SUMMARY ***
Total pot $0.62 | Rake $0.02 
Board [5d 4c 7s 2s 3c]
Seat 1: nodtress (button) folded before Flop (didn't bet)
Seat 2: Fedor_Gar (small blind) showed [Ts 8s] and lost with high card Ten
Seat 3: Scaaalll (big blind) folded before Flop
Seat 4: Saint_ANBU showed [Js Jd] and won ($0.60) with a pair of Jacks
Seat 5: NecromiconP folded before Flop (didn't bet)
Seat 6: ugi-dugi folded on the Turn



PokerStars Zoom Hand #229230509881:  Hold'em No Limit ($0.01/$0.02) - 2021/08/21 21:38:56 CET [2021/08/21 15:38:56 ET]
Table 'Halley' 6-max Seat #1 is the button
Seat 1: tema87 ($2.42 in chips) 
Seat 2: Scaaalll ($2 in chips) 
Seat 3: PlayPokerHappy1 ($7.57 in chips) 
Seat 4: IamFixxed ($5.66 in chips) 
Seat 5: Jevgenij7 ($1.16 in chips) 
Seat 6: Nihility77 ($3.12 in chips) 
Scaaalll: posts small blind $0.01
PlayPokerHappy1: posts big blind $0.02
*** HOLE CARDS ***
Dealt to Scaaalll [Jd Ks]
tema87 is disconnected 
IamFixxed: folds 
Jevgenij7: calls $0.02
Nihility77: raises $0.06 to $0.08
tema87: folds 
Scaaalll: folds 
PlayPokerHappy1: folds 
Jevgenij7: calls $0.06
*** FLOP *** [Kc 4h 9s]
Jevgenij7: checks 
Nihility77: bets $0.10
Jevgenij7: calls $0.10
*** TURN *** [Kc 4h 9s] [7h]
Jevgenij7: checks 
Nihility77: checks 
*** RIVER *** [Kc 4h 9s 7h] [Jh]
Jevgenij7: checks 
Nihility77: checks 
*** SHOW DOWN ***
Jevgenij7: shows [Ad 9d] (a pair of Nines)
Nihility77: mucks hand 
Jevgenij7 collected $0.38 from pot
*** SUMMARY ***
Total pot $0.39 | Rake $0.01 
Board [Kc 4h 9s 7h Jh]
Seat 1: tema87 (button) folded before Flop (didn't bet)
Seat 2: Scaaalll (small blind) folded before Flop
Seat 3: PlayPokerHappy1 (big blind) folded before Flop
Seat 4: IamFixxed folded before Flop (didn't bet)
Seat 5: Jevgenij7 showed [Ad 9d] and won ($0.38) with a pair of Nines
Seat 6: Nihility77 mucked [Ah Ts]



PokerStars Zoom Hand #229230515491:  Hold'em No Limit ($0.01/$0.02) - 2021/08/21 21:39:09 CET [2021/08/21 15:39:09 ET]
Table 'Halley' 6-max Seat #1 is the button
Seat 1: kahzura ($2.11 in chips) 
Seat 2: Finkey99 ($5.25 in chips) 
Seat 3: pipecmolodec ($2.23 in chips) 
Seat 4: Artem00071000 ($8.07 in chips) 
Seat 5: Scaaalll ($2 in chips) 
Seat 6: Berti281 ($2 in chips) 
Finkey99: posts small blind $0.01
pipecmolodec: posts big blind $0.02
*** HOLE CARDS ***
Dealt to Scaaalll [4d Ks]
Artem00071000: folds 
Scaaalll: folds 
Artem00071000 is disconnected 
Berti281: raises $0.03 to $0.05
kahzura: folds 
Finkey99: folds 
pipecmolodec: raises $0.15 to $0.20
Berti281: calls $0.15
*** FLOP *** [2s 6d Ac]
pipecmolodec: bets $0.13
Berti281: folds 
Uncalled bet ($0.13) returned to pipecmolodec
pipecmolodec collected $0.40 from pot
pipecmolodec: doesn't show hand 
*** SUMMARY ***
Total pot $0.41 | Rake $0.01 
Board [2s 6d Ac]
Seat 1: kahzura (button) folded before Flop (didn't bet)
Seat 2: Finkey99 (small blind) folded before Flop
Seat 3: pipecmolodec (big blind) collected ($0.40)
Seat 4: Artem00071000 folded before Flop (didn't bet)
Seat 5: Scaaalll folded before Flop (didn't bet)
Seat 6: Berti281 folded on the Flop



PokerStars Zoom Hand #229230520975:  Hold'em No Limit ($0.01/$0.02) - 2021/08/21 21:39:20 CET [2021/08/21 15:39:20 ET]
Table 'Halley' 6-max Seat #1 is the button
Seat 1: sg.32rus ($1.55 in chips) 
Seat 2: Pysgodyn ($2 in chips) 
Seat 3: CrazyyParis ($2.07 in chips) 
Seat 4: Ruopolo1982 ($2.13 in chips) 
Seat 5: SICKDIRTY416 ($1.19 in chips) 
Seat 6: Scaaalll ($2 in chips) 
Pysgodyn: posts small blind $0.01
CrazyyParis: posts big blind $0.02
*** HOLE CARDS ***
Dealt to Scaaalll [7s Kc]
Ruopolo1982: folds 
SICKDIRTY416: folds 
Scaaalll: folds 
SICKDIRTY416 is disconnected 
sg.32rus: raises $0.18 to $0.20
Pysgodyn: folds 
CrazyyParis: folds 
Uncalled bet ($0.18) returned to sg.32rus
sg.32rus collected $0.05 from pot
sg.32rus: doesn't show hand 
*** SUMMARY ***
Total pot $0.05 | Rake $0 
Seat 1: sg.32rus (button) collected ($0.05)
Seat 2: Pysgodyn (small blind) folded before Flop
Seat 3: CrazyyParis (big blind) folded before Flop
Seat 4: Ruopolo1982 folded before Flop (didn't bet)
Seat 5: SICKDIRTY416 folded before Flop (didn't bet)
Seat 6: Scaaalll folded before Flop (didn't bet)



PokerStars Zoom Hand #229230518160:  Hold'em No Limit ($0.01/$0.02) - 2021/08/21 21:39:14 CET [2021/08/21 15:39:14 ET]
Table 'Halley' 6-max Seat #1 is the button
Seat 1: fishh_play ($2.66 in chips) 
Seat 2: Scaaalll ($2 in chips) 
Seat 3: TESTGOSHI ($1.63 in chips) 
Seat 4: Healthys07 ($4.06 in chips) 
Seat 5: iPitbull1 ($3.56 in chips) 
Seat 6: Saint_ANBU ($3.85 in chips) 
Scaaalll: posts small blind $0.01
TESTGOSHI: posts big blind $0.02
*** HOLE CARDS ***
Dealt to Scaaalll [Jh 8c]
Healthys07: folds 
iPitbull1: folds 
Saint_ANBU: folds 
fishh_play: raises $0.03 to $0.05
Scaaalll: folds 
TESTGOSHI: calls $0.03
*** FLOP *** [Tc Jc Qs]
TESTGOSHI: bets $0.02
fishh_play: raises $0.09 to $0.11
TESTGOSHI: folds 
Uncalled bet ($0.09) returned to fishh_play
fishh_play collected $0.14 from pot
fishh_play: doesn't show hand 
*** SUMMARY ***
Total pot $0.15 | Rake $0.01 
Board [Tc Jc Qs]
Seat 1: fishh_play (button) collected ($0.14)
Seat 2: Scaaalll (small blind) folded before Flop
Seat 3: TESTGOSHI (big blind) folded on the Flop
Seat 4: Healthys07 folded before Flop (didn't bet)
Seat 5: iPitbull1 folded before Flop (didn't bet)
Seat 6: Saint_ANBU folded before Flop (didn't bet)



PokerStars Zoom Hand #229230522814:  Hold'em No Limit ($0.01/$0.02) - 2021/08/21 21:39:25 CET [2021/08/21 15:39:25 ET]
Table 'Halley' 6-max Seat #1 is the button
Seat 1: Scaaalll ($2 in chips) 
Seat 2: Molineux2002 ($1.86 in chips) 
Seat 3: mizuchin ($2.09 in chips) 
Seat 4: felipeciji ($2.08 in chips) 
Seat 5: meikoz ($2.78 in chips) 
Seat 6: Dimitrijs348 ($2.32 in chips) 
Molineux2002: posts small blind $0.01
mizuchin: posts big blind $0.02
*** HOLE CARDS ***
Dealt to Scaaalll [2c Qd]
felipeciji: folds 
meikoz: raises $0.03 to $0.05
Dimitrijs348: calls $0.05
Scaaalll: folds 
Molineux2002: folds 
mizuchin: folds 
*** FLOP *** [Td Kc Ac]
mizuchin is disconnected 
meikoz: bets $0.09
Dimitrijs348: calls $0.09
*** TURN *** [Td Kc Ac] [3c]
meikoz: checks 
Dimitrijs348: bets $0.15
meikoz: folds 
Uncalled bet ($0.15) returned to Dimitrijs348
Dimitrijs348 collected $0.30 from pot
Dimitrijs348: doesn't show hand 
*** SUMMARY ***
Total pot $0.31 | Rake $0.01 
Board [Td Kc Ac 3c]
Seat 1: Scaaalll (button) folded before Flop (didn't bet)
Seat 2: Molineux2002 (small blind) folded before Flop
Seat 3: mizuchin (big blind) folded before Flop
Seat 4: felipeciji folded before Flop (didn't bet)
Seat 5: meikoz folded on the Turn
Seat 6: Dimitrijs348 collected ($0.30)



PokerStars Zoom Hand #229230531963:  Hold'em No Limit ($0.01/$0.02) - 2021/08/21 21:39:33 CET [2021/08/21 15:39:33 ET]
Table 'Halley' 6-max Seat #1 is the button
Seat 1: martuska88 ($2 in chips) 
Seat 2: gy67 ($3.35 in chips) 
Seat 3: VoidEclipse ($1.90 in chips) 
Seat 4: Scaaalll ($2 in chips) 
Seat 5: malandro733 ($3.07 in chips) 
Seat 6: CrazyyParis ($2 in chips) 
gy67: posts small blind $0.01
VoidEclipse: posts big blind $0.02
*** HOLE CARDS ***
Dealt to Scaaalll [9c 5c]
Scaaalll: folds 
malandro733: folds 
CrazyyParis: raises $0.03 to $0.05
martuska88: raises $0.10 to $0.15
gy67: folds 
VoidEclipse: folds 
CrazyyParis: folds 
Uncalled bet ($0.10) returned to martuska88
martuska88 collected $0.13 from pot
martuska88: doesn't show hand 
*** SUMMARY ***
Total pot $0.13 | Rake $0 
Seat 1: martuska88 (button) collected ($0.13)
Seat 2: gy67 (small blind) folded before Flop
Seat 3: VoidEclipse (big blind) folded before Flop
Seat 4: Scaaalll folded before Flop (didn't bet)
Seat 5: malandro733 folded before Flop (didn't bet)
Seat 6: CrazyyParis folded before Flop



PokerStars Zoom Hand #229230536233:  Hold'em No Limit ($0.01/$0.02) - 2021/08/21 21:39:43 CET [2021/08/21 15:39:43 ET]
Table 'Halley' 6-max Seat #1 is the button
Seat 1: malandro733 ($3.82 in chips) 
Seat 2: Saint_ANBU ($3.77 in chips) 
Seat 3: Scaaalll ($2 in chips) 
Seat 4: Gerar NB ($2.12 in chips) 
Seat 5: Jujiluju ($1.75 in chips) 
Seat 6: Ichverdammt ($1.41 in chips) 
Saint_ANBU: posts small blind $0.01
Scaaalll: posts big blind $0.02
*** HOLE CARDS ***
Dealt to Scaaalll [4s 8s]
Gerar NB: folds 
Jujiluju: calls $0.02
Ichverdammt: folds 
malandro733: folds 
Saint_ANBU: calls $0.01
Scaaalll: checks 
*** FLOP *** [6s 2h 9h]
Saint_ANBU: checks 
Scaaalll: checks 
Jujiluju: checks 
*** TURN *** [6s 2h 9h] [Kc]
Saint_ANBU: checks 
Scaaalll: checks 
Jujiluju: checks 
*** RIVER *** [6s 2h 9h Kc] [8h]
Saint_ANBU: checks 
Scaaalll: checks 
Jujiluju: checks 
*** SHOW DOWN ***
Saint_ANBU: shows [4c 4d] (a pair of Fours)
Scaaalll: shows [4s 8s] (a pair of Eights)
Jujiluju: mucks hand 
Scaaalll collected $0.06 from pot
*** SUMMARY ***
Total pot $0.06 | Rake $0 
Board [6s 2h 9h Kc 8h]
Seat 1: malandro733 (button) folded before Flop (didn't bet)
Seat 2: Saint_ANBU (small blind) showed [4c 4d] and lost with a pair of Fours
Seat 3: Scaaalll (big blind) showed [4s 8s] and won ($0.06) with a pair of Eights
Seat 4: Gerar NB folded before Flop (didn't bet)
Seat 5: Jujiluju mucked [Js Qh]
Seat 6: Ichverdammt folded before Flop (didn't bet)



PokerStars Zoom Hand #229230555573:  Hold'em No Limit ($0.01/$0.02) - 2021/08/21 21:40:24 CET [2021/08/21 15:40:24 ET]
Table 'Halley' 6-max Seat #1 is the button
Seat 1: 1_KoLizeI_1 ($2.78 in chips) 
Seat 2: zeus11983 ($2.24 in chips) 
Seat 3: boa juice ($1.61 in chips) 
Seat 4: H0mmer99 ($1.74 in chips) 
Seat 5: ADWish ($1.37 in chips) 
Seat 6: Scaaalll ($2.04 in chips) 
zeus11983: posts small blind $0.01
boa juice: posts big blind $0.02
*** HOLE CARDS ***
Dealt to Scaaalll [Qd 4h]
H0mmer99: folds 
ADWish: raises $0.04 to $0.06
Scaaalll: folds 
1_KoLizeI_1: folds 
zeus11983: folds 
boa juice: folds 
Uncalled bet ($0.04) returned to ADWish
ADWish collected $0.05 from pot
ADWish: doesn't show hand 
boa juice is disconnected 
*** SUMMARY ***
Total pot $0.05 | Rake $0 
Seat 1: 1_KoLizeI_1 (button) folded before Flop (didn't bet)
Seat 2: zeus11983 (small blind) folded before Flop
Seat 3: boa juice (big blind) folded before Flop
Seat 4: H0mmer99 folded before Flop (didn't bet)
Seat 5: ADWish collected ($0.05)
Seat 6: Scaaalll folded before Flop (didn't bet)



PokerStars Zoom Hand #229230557404:  Hold'em No Limit ($0.01/$0.02) - 2021/08/21 21:40:28 CET [2021/08/21 15:40:28 ET]
Table 'Halley' 6-max Seat #1 is the button
Seat 1: Scaaalll ($2.04 in chips) 
Seat 2: ferx1989 ($2.02 in chips) 
Seat 3: lukzmodric10 ($2.42 in chips) 
Seat 4: Bufre ($3.70 in chips) 
Seat 5: STE1NBERG ($3.32 in chips) 
Seat 6: thi_spe ($2.28 in chips) 
ferx1989: posts small blind $0.01
lukzmodric10: posts big blind $0.02
*** HOLE CARDS ***
Dealt to Scaaalll [2d Ts]
Bufre: folds 
STE1NBERG: folds 
thi_spe: raises $0.03 to $0.05
Scaaalll: folds 
ferx1989: folds 
lukzmodric10: calls $0.03
*** FLOP *** [4s 5c 4h]
lukzmodric10: checks 
thi_spe: bets $0.04
lukzmodric10: folds 
Uncalled bet ($0.04) returned to thi_spe
thi_spe collected $0.11 from pot
thi_spe: doesn't show hand 
*** SUMMARY ***
Total pot $0.11 | Rake $0 
Board [4s 5c 4h]
Seat 1: Scaaalll (button) folded before Flop (didn't bet)
Seat 2: ferx1989 (small blind) folded before Flop
Seat 3: lukzmodric10 (big blind) folded on the Flop
Seat 4: Bufre folded before Flop (didn't bet)
Seat 5: STE1NBERG folded before Flop (didn't bet)
Seat 6: thi_spe collected ($0.11)



PokerStars Zoom Hand #229230560174:  Hold'em No Limit ($0.01/$0.02) - 2021/08/21 21:40:34 CET [2021/08/21 15:40:34 ET]
Table 'Halley' 6-max Seat #1 is the button
Seat 1: malandro733 ($2 in chips) 
Seat 2: DaporteWins ($2.43 in chips) 
Seat 3: aenehev ($4.64 in chips) 
Seat 4: Scaaalll ($2.04 in chips) 
Seat 5: Koldun 2636 ($3.12 in chips) 
Seat 6: Tabitaji ($3.90 in chips) 
DaporteWins: posts small blind $0.01
aenehev: posts big blind $0.02
*** HOLE CARDS ***
Dealt to Scaaalll [Ah Qs]
Scaaalll: raises $0.04 to $0.06
Koldun 2636: folds 
Tabitaji: folds 
malandro733: calls $0.06
DaporteWins: calls $0.05
aenehev: folds 
*** FLOP *** [9h 2h Jd]
DaporteWins: checks 
Scaaalll: checks 
malandro733: bets $0.13
DaporteWins: folds 
Scaaalll: folds 
Uncalled bet ($0.13) returned to malandro733
malandro733 collected $0.19 from pot
malandro733: doesn't show hand 
*** SUMMARY ***
Total pot $0.20 | Rake $0.01 
Board [9h 2h Jd]
Seat 1: malandro733 (button) collected ($0.19)
Seat 2: DaporteWins (small blind) folded on the Flop
Seat 3: aenehev (big blind) folded before Flop
Seat 4: Scaaalll folded on the Flop
Seat 5: Koldun 2636 folded before Flop (didn't bet)
Seat 6: Tabitaji folded before Flop (didn't bet)



PokerStars Zoom Hand #229230575768:  Hold'em No Limit ($0.01/$0.02) - 2021/08/21 21:41:08 CET [2021/08/21 15:41:08 ET]
Table 'Halley' 6-max Seat #1 is the button
Seat 1: Fanatspartak ($0.96 in chips) 
Seat 2: Pulp Hands ($2.01 in chips) 
Seat 3: PapiMik3 ($2.15 in chips) 
Seat 4: Scaaalll ($2 in chips) 
Seat 5: fabor1303 ($2.02 in chips) 
Seat 6: malandro733 ($2.88 in chips) 
Pulp Hands: posts small blind $0.01
PapiMik3: posts big blind $0.02
*** HOLE CARDS ***
Dealt to Scaaalll [4h 5s]
Scaaalll: folds 
fabor1303: folds 
malandro733: folds 
Fanatspartak: raises $0.04 to $0.06
Pulp Hands: folds 
PapiMik3: folds 
Uncalled bet ($0.04) returned to Fanatspartak
Fanatspartak collected $0.05 from pot
Fanatspartak: doesn't show hand 
*** SUMMARY ***
Total pot $0.05 | Rake $0 
Seat 1: Fanatspartak (button) collected ($0.05)
Seat 2: Pulp Hands (small blind) folded before Flop
Seat 3: PapiMik3 (big blind) folded before Flop
Seat 4: Scaaalll folded before Flop (didn't bet)
Seat 5: fabor1303 folded before Flop (didn't bet)
Seat 6: malandro733 folded before Flop (didn't bet)



PokerStars Zoom Hand #229230579991:  Hold'em No Limit ($0.01/$0.02) - 2021/08/21 21:41:18 CET [2021/08/21 15:41:18 ET]
Table 'Halley' 6-max Seat #1 is the button
Seat 1: nagiloR ($2.03 in chips) 
Seat 2: sg.32rus ($1.07 in chips) 
Seat 3: Scaaalll ($2 in chips) 
Seat 4: CrazyyParis ($2 in chips) 
Seat 5: NecromiconP ($4.44 in chips) 
Seat 6: Kb013497 ($2.90 in chips) 
sg.32rus: posts small blind $0.01
Scaaalll: posts big blind $0.02
*** HOLE CARDS ***
Dealt to Scaaalll [As 6h]
CrazyyParis: folds 
NecromiconP: folds 
Kb013497: folds 
nagiloR: raises $0.04 to $0.06
sg.32rus: folds 
Scaaalll: folds 
Uncalled bet ($0.04) returned to nagiloR
nagiloR collected $0.05 from pot
nagiloR: doesn't show hand 
*** SUMMARY ***
Total pot $0.05 | Rake $0 
Seat 1: nagiloR (button) collected ($0.05)
Seat 2: sg.32rus (small blind) folded before Flop
Seat 3: Scaaalll (big blind) folded before Flop
Seat 4: CrazyyParis folded before Flop (didn't bet)
Seat 5: NecromiconP folded before Flop (didn't bet)
Seat 6: Kb013497 folded before Flop (didn't bet)



PokerStars Zoom Hand #229230578054:  Hold'em No Limit ($0.01/$0.02) - 2021/08/21 21:41:14 CET [2021/08/21 15:41:14 ET]
Table 'Halley' 6-max Seat #1 is the button
Seat 1: KingsPoke185 ($0.82 in chips) 
Seat 2: Ufiltreret ($2.26 in chips) 
Seat 3: staviko ($2.76 in chips) 
Seat 4: Scaaalll ($2 in chips) 
Seat 5: Lighio ($2 in chips) 
Seat 6: wstanula ($1.86 in chips) 
Ufiltreret: posts small blind $0.01
staviko: posts big blind $0.02
*** HOLE CARDS ***
Dealt to Scaaalll [Qh Js]
Scaaalll: folds 
Lighio: folds 
wstanula: folds 
KingsPoke185: calls $0.02
Ufiltreret: folds 
staviko: checks 
*** FLOP *** [5h 9s 5c]
staviko: checks 
KingsPoke185: checks 
*** TURN *** [5h 9s 5c] [6s]
staviko: checks 
KingsPoke185: checks 
*** RIVER *** [5h 9s 5c 6s] [3c]
staviko: checks 
KingsPoke185: checks 
*** SHOW DOWN ***
staviko: shows [Kc 4h] (a pair of Fives)
KingsPoke185: shows [Ts Ad] (a pair of Fives - Ace kicker)
KingsPoke185 collected $0.05 from pot
*** SUMMARY ***
Total pot $0.05 | Rake $0 
Board [5h 9s 5c 6s 3c]
Seat 1: KingsPoke185 (button) showed [Ts Ad] and won ($0.05) with a pair of Fives
Seat 2: Ufiltreret (small blind) folded before Flop
Seat 3: staviko (big blind) showed [Kc 4h] and lost with a pair of Fives
Seat 4: Scaaalll folded before Flop (didn't bet)
Seat 5: Lighio folded before Flop (didn't bet)
Seat 6: wstanula folded before Flop (didn't bet)



PokerStars Zoom Hand #229230587258:  Hold'em No Limit ($0.01/$0.02) - 2021/08/21 21:41:34 CET [2021/08/21 15:41:34 ET]
Table 'Halley' 6-max Seat #1 is the button
Seat 1: alecha11 ($2.17 in chips) 
Seat 2: Scaaalll ($2 in chips) 
Seat 3: Fanatspartak ($0.99 in chips) 
Seat 4: NecromiconP ($3.62 in chips) 
Seat 5: gasmar_29 ($3.50 in chips) 
Seat 6: Ne0net ($3.57 in chips) 
Scaaalll: posts small blind $0.01
Fanatspartak: posts big blind $0.02
*** HOLE CARDS ***
Dealt to Scaaalll [3h Ts]
NecromiconP: folds 
gasmar_29: folds 
Ne0net: folds 
alecha11: raises $0.03 to $0.05
Scaaalll: folds 
Fanatspartak: folds 
Uncalled bet ($0.03) returned to alecha11
alecha11 collected $0.05 from pot
alecha11: doesn't show hand 
*** SUMMARY ***
Total pot $0.05 | Rake $0 
Seat 1: alecha11 (button) collected ($0.05)
Seat 2: Scaaalll (small blind) folded before Flop
Seat 3: Fanatspartak (big blind) folded before Flop
Seat 4: NecromiconP folded before Flop (didn't bet)
Seat 5: gasmar_29 folded before Flop (didn't bet)
Seat 6: Ne0net folded before Flop (didn't bet)



PokerStars Zoom Hand #229230589158:  Hold'em No Limit ($0.01/$0.02) - 2021/08/21 21:41:38 CET [2021/08/21 15:41:38 ET]
Table 'Halley' 6-max Seat #1 is the button
Seat 1: boa juice ($1.58 in chips) 
Seat 2: Tabitaji ($2 in chips) 
Seat 3: VasquezSancho96 ($8.69 in chips) 
Seat 4: MsSuffolk ($2.34 in chips) 
Seat 5: Scaaalll ($2 in chips) 
Seat 6: emte1kaa ($2.62 in chips) 
Tabitaji: posts small blind $0.01
VasquezSancho96: posts big blind $0.02
*** HOLE CARDS ***
Dealt to Scaaalll [4c Ks]
MsSuffolk: folds 
Scaaalll: folds 
emte1kaa: folds 
boa juice: raises $0.04 to $0.06
Tabitaji: folds 
VasquezSancho96: folds 
Uncalled bet ($0.04) returned to boa juice
boa juice collected $0.05 from pot
boa juice: doesn't show hand 
*** SUMMARY ***
Total pot $0.05 | Rake $0 
Seat 1: boa juice (button) collected ($0.05)
Seat 2: Tabitaji (small blind) folded before Flop
Seat 3: VasquezSancho96 (big blind) folded before Flop
Seat 4: MsSuffolk folded before Flop (didn't bet)
Seat 5: Scaaalll folded before Flop (didn't bet)
Seat 6: emte1kaa folded before Flop (didn't bet)



PokerStars Zoom Hand #229230591017:  Hold'em No Limit ($0.01/$0.02) - 2021/08/21 21:41:42 CET [2021/08/21 15:41:42 ET]
Table 'Halley' 6-max Seat #1 is the button
Seat 1: SpartanRace1 ($11.05 in chips) 
Seat 2: LalaBee21 ($1.25 in chips) 
Seat 3: Bomb Mgl ($1.86 in chips) 
Seat 4: IWMTW ($0.82 in chips) 
Seat 5: Scaaalll ($2 in chips) 
Seat 6: EstiBan18 ($2.09 in chips) 
LalaBee21: posts small blind $0.01
Bomb Mgl: posts big blind $0.02
*** HOLE CARDS ***
Dealt to Scaaalll [3d Ad]
IWMTW: raises $0.04 to $0.06
Bomb Mgl is disconnected 
Scaaalll: folds 
EstiBan18: folds 
SpartanRace1: folds 
LalaBee21: folds 
Bomb Mgl: folds 
Uncalled bet ($0.04) returned to IWMTW
IWMTW collected $0.05 from pot
IWMTW: doesn't show hand 
*** SUMMARY ***
Total pot $0.05 | Rake $0 
Seat 1: SpartanRace1 (button) folded before Flop (didn't bet)
Seat 2: LalaBee21 (small blind) folded before Flop
Seat 3: Bomb Mgl (big blind) folded before Flop
Seat 4: IWMTW collected ($0.05)
Seat 5: Scaaalll folded before Flop (didn't bet)
Seat 6: EstiBan18 folded before Flop (didn't bet)



PokerStars Zoom Hand #229230599388:  Hold'em No Limit ($0.01/$0.02) - 2021/08/21 21:41:59 CET [2021/08/21 15:41:59 ET]
Table 'Halley' 6-max Seat #1 is the button
Seat 1: VoidEclipse ($2.09 in chips) 
Seat 2: laetschnbene ($0.55 in chips) 
Seat 3: RaulacateFolds ($2 in chips) 
Seat 4: snowy_96 ($2 in chips) 
Seat 5: Saint_ANBU ($2.53 in chips) 
Seat 6: Scaaalll ($2 in chips) 
laetschnbene: posts small blind $0.01
RaulacateFolds: posts big blind $0.02
*** HOLE CARDS ***
Dealt to Scaaalll [2c Ts]
snowy_96: folds 
Saint_ANBU: raises $0.04 to $0.06
Scaaalll: folds 
VoidEclipse: folds 
laetschnbene: folds 
RaulacateFolds: folds 
Uncalled bet ($0.04) returned to Saint_ANBU
Saint_ANBU collected $0.05 from pot
Saint_ANBU: doesn't show hand 
*** SUMMARY ***
Total pot $0.05 | Rake $0 
Seat 1: VoidEclipse (button) folded before Flop (didn't bet)
Seat 2: laetschnbene (small blind) folded before Flop
Seat 3: RaulacateFolds (big blind) folded before Flop
Seat 4: snowy_96 folded before Flop (didn't bet)
Seat 5: Saint_ANBU collected ($0.05)
Seat 6: Scaaalll folded before Flop (didn't bet)



PokerStars Zoom Hand #229230595684:  Hold'em No Limit ($0.01/$0.02) - 2021/08/21 21:41:52 CET [2021/08/21 15:41:52 ET]
Table 'Halley' 6-max Seat #1 is the button
Seat 1: Scaaalll ($2 in chips) 
Seat 2: CordiPS ($3.66 in chips) 
Seat 3: snowy_96 ($2 in chips) 
Seat 4: jaamonra ($3.93 in chips) 
Seat 5: JTbukowski ($0.99 in chips) 
Seat 6: AlexGTPS ($1.92 in chips) 
CordiPS: posts small blind $0.01
snowy_96: posts big blind $0.02
*** HOLE CARDS ***
Dealt to Scaaalll [Qs 4s]
jaamonra: folds 
JTbukowski: folds 
AlexGTPS: raises $0.03 to $0.05
Scaaalll: folds 
CordiPS: calls $0.04
snowy_96: folds 
*** FLOP *** [As 8s Ks]
CordiPS: checks 
AlexGTPS: checks 
*** TURN *** [As 8s Ks] [Td]
CordiPS: bets $0.08
AlexGTPS: folds 
Uncalled bet ($0.08) returned to CordiPS
CordiPS collected $0.12 from pot
CordiPS: doesn't show hand 
*** SUMMARY ***
Total pot $0.12 | Rake $0 
Board [As 8s Ks Td]
Seat 1: Scaaalll (button) folded before Flop (didn't bet)
Seat 2: CordiPS (small blind) collected ($0.12)
Seat 3: snowy_96 (big blind) folded before Flop
Seat 4: jaamonra folded before Flop (didn't bet)
Seat 5: JTbukowski folded before Flop (didn't bet)
Seat 6: AlexGTPS folded on the Turn



PokerStars Zoom Hand #229230601739:  Hold'em No Limit ($0.01/$0.02) - 2021/08/21 21:42:04 CET [2021/08/21 15:42:04 ET]
Table 'Halley' 6-max Seat #1 is the button
Seat 1: arsad725 ($3.88 in chips) 
Seat 2: AVGEV ($2.52 in chips) 
Seat 3: Scaaalll ($2 in chips) 
Seat 4: pavlo8855 ($2 in chips) 
Seat 5: FabOliveira9 ($4.55 in chips) 
Seat 6: herbas ($2.05 in chips) 
AVGEV: posts small blind $0.01
Scaaalll: posts big blind $0.02
*** HOLE CARDS ***
Dealt to Scaaalll [Js Ad]
AVGEV is disconnected 
pavlo8855: folds 
FabOliveira9: folds 
herbas: folds 
arsad725: raises $0.03 to $0.05
AVGEV: folds 
Scaaalll: calls $0.03
*** FLOP *** [5c 6h 9h]
Scaaalll: checks 
arsad725: checks 
*** TURN *** [5c 6h 9h] [6d]
Scaaalll: checks 
arsad725: checks 
*** RIVER *** [5c 6h 9h 6d] [Qh]
Scaaalll: checks 
arsad725: checks 
*** SHOW DOWN ***
Scaaalll: shows [Js Ad] (a pair of Sixes)
arsad725: shows [Kd Qs] (two pair, Queens and Sixes)
arsad725 collected $0.11 from pot
*** SUMMARY ***
Total pot $0.11 | Rake $0 
Board [5c 6h 9h 6d Qh]
Seat 1: arsad725 (button) showed [Kd Qs] and won ($0.11) with two pair, Queens and Sixes
Seat 2: AVGEV (small blind) folded before Flop
Seat 3: Scaaalll (big blind) showed [Js Ad] and lost with a pair of Sixes
Seat 4: pavlo8855 folded before Flop (didn't bet)
Seat 5: FabOliveira9 folded before Flop (didn't bet)
Seat 6: herbas folded before Flop (didn't bet)



PokerStars Zoom Hand #229230618780:  Hold'em No Limit ($0.01/$0.02) - 2021/08/21 21:42:41 CET [2021/08/21 15:42:41 ET]
Table 'Halley' 6-max Seat #1 is the button
Seat 1: elcuchu168 ($1.73 in chips) 
Seat 2: E Z TAKEDOWN ($5.99 in chips) 
Seat 3: kristina2760 ($1.57 in chips) 
Seat 4: tema87 ($2.18 in chips) 
Seat 5: Scaaalll ($2 in chips) 
Seat 6: stealth_ua ($3.25 in chips) 
E Z TAKEDOWN: posts small blind $0.01
kristina2760: posts big blind $0.02
*** HOLE CARDS ***
Dealt to Scaaalll [4d 9d]
tema87: folds 
tema87 is disconnected 
Scaaalll: folds 
stealth_ua: folds 
elcuchu168: folds 
E Z TAKEDOWN: folds 
Uncalled bet ($0.01) returned to kristina2760
kristina2760 collected $0.02 from pot
kristina2760: doesn't show hand 
*** SUMMARY ***
Total pot $0.02 | Rake $0 
Seat 1: elcuchu168 (button) folded before Flop (didn't bet)
Seat 2: E Z TAKEDOWN (small blind) folded before Flop
Seat 3: kristina2760 (big blind) collected ($0.02)
Seat 4: tema87 folded before Flop (didn't bet)
Seat 5: Scaaalll folded before Flop (didn't bet)
Seat 6: stealth_ua folded before Flop (didn't bet)



PokerStars Zoom Hand #229230621091:  Hold'em No Limit ($0.01/$0.02) - 2021/08/21 21:42:47 CET [2021/08/21 15:42:47 ET]
Table 'Halley' 6-max Seat #1 is the button
Seat 1: kcyxa ($2 in chips) 
Seat 2: Scaaalll ($2 in chips) 
Seat 3: LegendaryLRS ($3.08 in chips) 
Seat 4: BriceDo1917 ($3.22 in chips) 
Seat 5: Gamer577 ($2.07 in chips) 
Seat 6: elcuchu168 ($1.73 in chips) 
Scaaalll: posts small blind $0.01
LegendaryLRS: posts big blind $0.02
*** HOLE CARDS ***
Dealt to Scaaalll [5h Qs]
kcyxa is disconnected 
kcyxa is disconnected 
BriceDo1917: folds 
Gamer577: folds 
BriceDo1917 is disconnected 
elcuchu168: folds 
kcyxa: raises $0.04 to $0.06
Scaaalll: folds 
LegendaryLRS: raises $0.14 to $0.20
kcyxa is disconnected 
kcyxa: folds 
Uncalled bet ($0.14) returned to LegendaryLRS
LegendaryLRS collected $0.13 from pot
LegendaryLRS: doesn't show hand 
kcyxa is disconnected 
*** SUMMARY ***
Total pot $0.13 | Rake $0 
Seat 1: kcyxa (button) folded before Flop
Seat 2: Scaaalll (small blind) folded before Flop
Seat 3: LegendaryLRS (big blind) collected ($0.13)
Seat 4: BriceDo1917 folded before Flop (didn't bet)
Seat 5: Gamer577 folded before Flop (didn't bet)
Seat 6: elcuchu168 folded before Flop (didn't bet)



PokerStars Zoom Hand #229230625287:  Hold'em No Limit ($0.01/$0.02) - 2021/08/21 21:42:56 CET [2021/08/21 15:42:56 ET]
Table 'Halley' 6-max Seat #1 is the button
Seat 1: Scaaalll ($2 in chips) 
Seat 2: 2hoesonmydick ($2.99 in chips) 
Seat 3: Guii-FPOLIS ($1.94 in chips) 
Seat 4: 77omsk ($8.48 in chips) 
Seat 5: meikoz ($2.58 in chips) 
Seat 6: RonilsonCosta ($2 in chips) 
2hoesonmydick: posts small blind $0.01
Guii-FPOLIS: posts big blind $0.02
*** HOLE CARDS ***
Dealt to Scaaalll [As 7s]
2hoesonmydick is disconnected 
77omsk: folds 
meikoz: folds 
RonilsonCosta: raises $0.03 to $0.05
Scaaalll: raises $0.11 to $0.16
2hoesonmydick: folds 
Guii-FPOLIS: folds 
RonilsonCosta: folds 
Uncalled bet ($0.11) returned to Scaaalll
Scaaalll collected $0.13 from pot
Scaaalll: doesn't show hand 
*** SUMMARY ***
Total pot $0.13 | Rake $0 
Seat 1: Scaaalll (button) collected ($0.13)
Seat 2: 2hoesonmydick (small blind) folded before Flop
Seat 3: Guii-FPOLIS (big blind) folded before Flop
Seat 4: 77omsk folded before Flop (didn't bet)
Seat 5: meikoz folded before Flop (didn't bet)
Seat 6: RonilsonCosta folded before Flop



PokerStars Zoom Hand #229230640125:  Hold'em No Limit ($0.01/$0.02) - 2021/08/21 21:43:28 CET [2021/08/21 15:43:28 ET]
Table 'Halley' 6-max Seat #1 is the button
Seat 1: TESTGOSHI ($1.36 in chips) 
Seat 2: Murileus ($3.08 in chips) 
Seat 3: 77omsk ($3.10 in chips) 
Seat 4: EstiBan18 ($2.17 in chips) 
Seat 5: ME-262-XX ($0.96 in chips) 
Seat 6: Scaaalll ($2.08 in chips) 
Murileus: posts small blind $0.01
77omsk: posts big blind $0.02
*** HOLE CARDS ***
Dealt to Scaaalll [2h Jd]
EstiBan18: folds 
ME-262-XX: folds 
Scaaalll: folds 
TESTGOSHI: raises $0.04 to $0.06
Murileus: folds 
77omsk: folds 
Uncalled bet ($0.04) returned to TESTGOSHI
TESTGOSHI collected $0.05 from pot
TESTGOSHI: doesn't show hand 
*** SUMMARY ***
Total pot $0.05 | Rake $0 
Seat 1: TESTGOSHI (button) collected ($0.05)
Seat 2: Murileus (small blind) folded before Flop
Seat 3: 77omsk (big blind) folded before Flop
Seat 4: EstiBan18 folded before Flop (didn't bet)
Seat 5: ME-262-XX folded before Flop (didn't bet)
Seat 6: Scaaalll folded before Flop (didn't bet)



PokerStars Zoom Hand #229230642320:  Hold'em No Limit ($0.01/$0.02) - 2021/08/21 21:43:32 CET [2021/08/21 15:43:32 ET]
Table 'Halley' 6-max Seat #1 is the button
Seat 1: djewlz ($1.49 in chips) 
Seat 2: Scaaalll ($2.08 in chips) 
Seat 3: Quad Jacks21 ($2.55 in chips) 
Seat 4: juraa14 ($2.34 in chips) 
Seat 5: ramalhorod ($4.48 in chips) 
Seat 6: HellNative ($2.54 in chips) 
Scaaalll: posts small blind $0.01
Quad Jacks21: posts big blind $0.02
*** HOLE CARDS ***
Dealt to Scaaalll [5s 6s]
juraa14: folds 
ramalhorod: folds 
HellNative: folds 
ramalhorod is disconnected 
djewlz: raises $0.04 to $0.06
Scaaalll: folds 
Quad Jacks21: folds 
Uncalled bet ($0.04) returned to djewlz
djewlz collected $0.05 from pot
djewlz: doesn't show hand 
*** SUMMARY ***
Total pot $0.05 | Rake $0 
Seat 1: djewlz (button) collected ($0.05)
Seat 2: Scaaalll (small blind) folded before Flop
Seat 3: Quad Jacks21 (big blind) folded before Flop
Seat 4: juraa14 folded before Flop (didn't bet)
Seat 5: ramalhorod folded before Flop (didn't bet)
Seat 6: HellNative folded before Flop (didn't bet)



PokerStars Zoom Hand #229230649120:  Hold'em No Limit ($0.01/$0.02) - 2021/08/21 21:43:48 CET [2021/08/21 15:43:48 ET]
Table 'Halley' 6-max Seat #1 is the button
Seat 1: EstiBan18 ($2.20 in chips) 
Seat 2: ramalhorod ($4.48 in chips) 
Seat 3: Scaaalll ($2.07 in chips) 
Seat 4: olga3021221 ($4.61 in chips) 
Seat 5: MrK_Leuven ($3.58 in chips) 
Seat 6: zbixxx ($2.24 in chips) 
ramalhorod: posts small blind $0.01
Scaaalll: posts big blind $0.02
*** HOLE CARDS ***
Dealt to Scaaalll [4d Kh]
olga3021221: folds 
MrK_Leuven: folds 
zbixxx: folds 
EstiBan18: folds 
ramalhorod: calls $0.01
Scaaalll: checks 
*** FLOP *** [2h 6c 2d]
ramalhorod: bets $0.02
Scaaalll: folds 
Uncalled bet ($0.02) returned to ramalhorod
ramalhorod collected $0.04 from pot
ramalhorod: doesn't show hand 
*** SUMMARY ***
Total pot $0.04 | Rake $0 
Board [2h 6c 2d]
Seat 1: EstiBan18 (button) folded before Flop (didn't bet)
Seat 2: ramalhorod (small blind) collected ($0.04)
Seat 3: Scaaalll (big blind) folded on the Flop
Seat 4: olga3021221 folded before Flop (didn't bet)
Seat 5: MrK_Leuven folded before Flop (didn't bet)
Seat 6: zbixxx folded before Flop (didn't bet)



PokerStars Zoom Hand #229230664639:  Hold'em No Limit ($0.01/$0.02) - 2021/08/21 21:44:22 CET [2021/08/21 15:44:22 ET]
Table 'Halley' 6-max Seat #1 is the button
Seat 1: jaamonra ($4.86 in chips) 
Seat 2: maliniak75 ($1.98 in chips) 
Seat 3: arrow17 ($2.64 in chips) 
Seat 4: samn102 ($2.35 in chips) 
Seat 5: gwr85 ($1.75 in chips) 
Seat 6: Scaaalll ($2.05 in chips) 
maliniak75: posts small blind $0.01
arrow17: posts big blind $0.02
*** HOLE CARDS ***
Dealt to Scaaalll [Kd Tc]
samn102: folds 
gwr85: folds 
samn102 is disconnected 
Scaaalll: raises $0.04 to $0.06
jaamonra: folds 
maliniak75: folds 
arrow17: folds 
Uncalled bet ($0.04) returned to Scaaalll
Scaaalll collected $0.05 from pot
Scaaalll: doesn't show hand 
*** SUMMARY ***
Total pot $0.05 | Rake $0 
Seat 1: jaamonra (button) folded before Flop (didn't bet)
Seat 2: maliniak75 (small blind) folded before Flop
Seat 3: arrow17 (big blind) folded before Flop
Seat 4: samn102 folded before Flop (didn't bet)
Seat 5: gwr85 folded before Flop (didn't bet)
Seat 6: Scaaalll collected ($0.05)



PokerStars Zoom Hand #229230662757:  Hold'em No Limit ($0.01/$0.02) - 2021/08/21 21:44:18 CET [2021/08/21 15:44:18 ET]
Table 'Halley' 6-max Seat #1 is the button
Seat 1: Jevgenij7 ($0.85 in chips) 
Seat 2: NecromiconP ($3.15 in chips) 
Seat 3: AshoT#001 ($1.93 in chips) 
Seat 4: Scaaalll ($2.05 in chips) 
Seat 5: Irorek6643 ($1.83 in chips) 
Seat 6: BIITRU ($5.45 in chips) 
NecromiconP: posts small blind $0.01
AshoT#001: posts big blind $0.02
*** HOLE CARDS ***
Dealt to Scaaalll [Td Qh]
Scaaalll: folds 
Irorek6643: folds 
Irorek6643 is disconnected 
BIITRU: folds 
Jevgenij7: calls $0.02
NecromiconP: raises $0.12 to $0.14
AshoT#001: folds 
AshoT#001 is disconnected 
Jevgenij7: calls $0.12
*** FLOP *** [4d 5h Kd]
NecromiconP: bets $0.16
Jevgenij7: folds 
Uncalled bet ($0.16) returned to NecromiconP
NecromiconP collected $0.29 from pot
NecromiconP: doesn't show hand 
Jevgenij7 is disconnected 
*** SUMMARY ***
Total pot $0.30 | Rake $0.01 
Board [4d 5h Kd]
Seat 1: Jevgenij7 (button) folded on the Flop
Seat 2: NecromiconP (small blind) collected ($0.29)
Seat 3: AshoT#001 (big blind) folded before Flop
Seat 4: Scaaalll folded before Flop (didn't bet)
Seat 5: Irorek6643 folded before Flop (didn't bet)
Seat 6: BIITRU folded before Flop (didn't bet)



PokerStars Zoom Hand #229230659120:  Hold'em No Limit ($0.01/$0.02) - 2021/08/21 21:44:10 CET [2021/08/21 15:44:10 ET]
Table 'Halley' 6-max Seat #1 is the button
Seat 1: Quad Jacks21 ($2.80 in chips) 
Seat 2: *88VIC88* ($1.82 in chips) 
Seat 3: zergmiky ($2.85 in chips) 
Seat 4: laetschnbene ($1.83 in chips) 
Seat 5: Scaaalll ($2.05 in chips) 
Seat 6: Ruopolo1982 ($2.07 in chips) 
*88VIC88*: posts small blind $0.01
zergmiky: posts big blind $0.02
*** HOLE CARDS ***
Dealt to Scaaalll [9h Js]
laetschnbene: folds 
Scaaalll: folds 
Ruopolo1982: folds 
Quad Jacks21: raises $0.03 to $0.05
*88VIC88*: calls $0.04
zergmiky: folds 
*** FLOP *** [4d 5s 6c]
*88VIC88*: checks 
Quad Jacks21: checks 
*** TURN *** [4d 5s 6c] [Ks]
*88VIC88*: checks 
Quad Jacks21: checks 
*** RIVER *** [4d 5s 6c Ks] [3d]
*88VIC88*: checks 
Quad Jacks21: bets $0.09
*88VIC88*: folds 
Uncalled bet ($0.09) returned to Quad Jacks21
Quad Jacks21 collected $0.12 from pot
Quad Jacks21: doesn't show hand 
*** SUMMARY ***
Total pot $0.12 | Rake $0 
Board [4d 5s 6c Ks 3d]
Seat 1: Quad Jacks21 (button) collected ($0.12)
Seat 2: *88VIC88* (small blind) folded on the River
Seat 3: zergmiky (big blind) folded before Flop
Seat 4: laetschnbene folded before Flop (didn't bet)
Seat 5: Scaaalll folded before Flop (didn't bet)
Seat 6: Ruopolo1982 folded before Flop (didn't bet)



PokerStars Zoom Hand #229230670229:  Hold'em No Limit ($0.01/$0.02) - 2021/08/21 21:44:33 CET [2021/08/21 15:44:33 ET]
Table 'Halley' 6-max Seat #1 is the button
Seat 1: Scaaalll ($2.08 in chips) 
Seat 2: ash1448 ($11.17 in chips) 
Seat 3: Youtube96 ($1.79 in chips) 
Seat 4: jaamonra ($2.08 in chips) 
Seat 5: kpower ($1.83 in chips) 
Seat 6: 1_KoLizeI_1 ($2.86 in chips) 
ash1448: posts small blind $0.01
Youtube96: posts big blind $0.02
*** HOLE CARDS ***
Dealt to Scaaalll [3c 2d]
jaamonra: folds 
kpower: raises $0.03 to $0.05
1_KoLizeI_1: folds 
Scaaalll: folds 
ash1448: folds 
Youtube96: folds 
Uncalled bet ($0.03) returned to kpower
kpower collected $0.05 from pot
kpower: doesn't show hand 
*** SUMMARY ***
Total pot $0.05 | Rake $0 
Seat 1: Scaaalll (button) folded before Flop (didn't bet)
Seat 2: ash1448 (small blind) folded before Flop
Seat 3: Youtube96 (big blind) folded before Flop
Seat 4: jaamonra folded before Flop (didn't bet)
Seat 5: kpower collected ($0.05)
Seat 6: 1_KoLizeI_1 folded before Flop (didn't bet)



PokerStars Zoom Hand #229230673753:  Hold'em No Limit ($0.01/$0.02) - 2021/08/21 21:44:41 CET [2021/08/21 15:44:41 ET]
Table 'Halley' 6-max Seat #1 is the button
Seat 1: kahzura ($5.80 in chips) 
Seat 2: pipecmolodec ($2.06 in chips) 
Seat 3: LuckyCheewey ($4.50 in chips) 
Seat 4: Scaaalll ($2.08 in chips) 
Seat 5: IWMTW ($0.31 in chips) 
Seat 6: NecromiconP ($2.74 in chips) 
pipecmolodec: posts small blind $0.01
LuckyCheewey: posts big blind $0.02
*** HOLE CARDS ***
Dealt to Scaaalll [Kh 8h]
Scaaalll: folds 
IWMTW: folds 
NecromiconP: raises $0.04 to $0.06
kahzura: folds 
pipecmolodec: folds 
LuckyCheewey: folds 
Uncalled bet ($0.04) returned to NecromiconP
NecromiconP collected $0.05 from pot
NecromiconP: doesn't show hand 
*** SUMMARY ***
Total pot $0.05 | Rake $0 
Seat 1: kahzura (button) folded before Flop (didn't bet)
Seat 2: pipecmolodec (small blind) folded before Flop
Seat 3: LuckyCheewey (big blind) folded before Flop
Seat 4: Scaaalll folded before Flop (didn't bet)
Seat 5: IWMTW folded before Flop (didn't bet)
Seat 6: NecromiconP collected ($0.05)



PokerStars Zoom Hand #229230676035:  Hold'em No Limit ($0.01/$0.02) - 2021/08/21 21:44:47 CET [2021/08/21 15:44:47 ET]
Table 'Halley' 6-max Seat #1 is the button
Seat 1: BIITRU ($5.43 in chips) 
Seat 2: Na4a1nika ($1.98 in chips) 
Seat 3: LalaBee21 ($2.05 in chips) 
Seat 4: Scaaalll ($2.08 in chips) 
Seat 5: alecha11 ($3.61 in chips) 
Seat 6: bmnev ($1.22 in chips) 
Na4a1nika: posts small blind $0.01
LalaBee21: posts big blind $0.02
*** HOLE CARDS ***
Dealt to Scaaalll [Jd 8s]
Scaaalll: folds 
alecha11: folds 
bmnev: calls $0.02
BIITRU: folds 
Na4a1nika: folds 
LalaBee21: checks 
*** FLOP *** [Js Ah 7h]
LalaBee21: checks 
bmnev: bets $0.05
LalaBee21: folds 
Uncalled bet ($0.05) returned to bmnev
bmnev collected $0.05 from pot
bmnev: doesn't show hand 
*** SUMMARY ***
Total pot $0.05 | Rake $0 
Board [Js Ah 7h]
Seat 1: BIITRU (button) folded before Flop (didn't bet)
Seat 2: Na4a1nika (small blind) folded before Flop
Seat 3: LalaBee21 (big blind) folded on the Flop
Seat 4: Scaaalll folded before Flop (didn't bet)
Seat 5: alecha11 folded before Flop (didn't bet)
Seat 6: bmnev collected ($0.05)



PokerStars Zoom Hand #229230678259:  Hold'em No Limit ($0.01/$0.02) - 2021/08/21 21:44:51 CET [2021/08/21 15:44:51 ET]
Table 'Halley' 6-max Seat #1 is the button
Seat 1: IamFixxed ($4.25 in chips) 
Seat 2: fabor1303 ($2.62 in chips) 
Seat 3: Scaaalll ($2.08 in chips) 
Seat 4: Grama480 ($3.04 in chips) 
Seat 5: nippurkaunas ($0.72 in chips) 
Seat 6: ser313131 ($2.19 in chips) 
fabor1303: posts small blind $0.01
Scaaalll: posts big blind $0.02
*** HOLE CARDS ***
Dealt to Scaaalll [Kh Kc]
Grama480: folds 
nippurkaunas: raises $0.02 to $0.04
ser313131: folds 
IamFixxed: calls $0.04
fabor1303: raises $0.14 to $0.18
Scaaalll: calls $0.16
nippurkaunas: calls $0.14
IamFixxed: folds 
*** FLOP *** [5s 9h 5c]
fabor1303: checks 
Scaaalll: checks 
nippurkaunas: bets $0.54 and is all-in
fabor1303: folds 
Scaaalll: calls $0.54
*** TURN *** [5s 9h 5c] [Th]
*** RIVER *** [5s 9h 5c Th] [7s]
*** SHOW DOWN ***
Scaaalll: shows [Kh Kc] (two pair, Kings and Fives)
nippurkaunas: shows [Jd Js] (two pair, Jacks and Fives)
Scaaalll collected $1.58 from pot
*** SUMMARY ***
Total pot $1.66 | Rake $0.08 
Board [5s 9h 5c Th 7s]
Seat 1: IamFixxed (button) folded before Flop
Seat 2: fabor1303 (small blind) folded on the Flop
Seat 3: Scaaalll (big blind) showed [Kh Kc] and won ($1.58) with two pair, Kings and Fives
Seat 4: Grama480 folded before Flop (didn't bet)
Seat 5: nippurkaunas showed [Jd Js] and lost with two pair, Jacks and Fives
Seat 6: ser313131 folded before Flop (didn't bet)



PokerStars Zoom Hand #229230709606:  Hold'em No Limit ($0.01/$0.02) - 2021/08/21 21:46:00 CET [2021/08/21 15:46:00 ET]
Table 'Halley' 6-max Seat #1 is the button
Seat 1: valdemar@v8 ($1.49 in chips) 
Seat 2: Scaaalll ($2.94 in chips) 
Seat 3: olga3021221 ($2 in chips) 
Seat 4: E Z TAKEDOWN ($6.19 in chips) 
Seat 5: bigbaddaddy9 ($5.56 in chips) 
Seat 6: Ruopolo1982 ($2.28 in chips) 
Scaaalll: posts small blind $0.01
olga3021221: posts big blind $0.02
*** HOLE CARDS ***
Dealt to Scaaalll [7s Jd]
E Z TAKEDOWN: raises $0.03 to $0.05
bigbaddaddy9: folds 
Ruopolo1982: folds 
valdemar@v8 has timed out
valdemar@v8: folds 
Scaaalll: folds 
olga3021221: folds 
Uncalled bet ($0.03) returned to E Z TAKEDOWN
valdemar@v8 is disconnected 
E Z TAKEDOWN collected $0.05 from pot
E Z TAKEDOWN: doesn't show hand 
*** SUMMARY ***
Total pot $0.05 | Rake $0 
Seat 1: valdemar@v8 (button) folded before Flop (didn't bet)
Seat 2: Scaaalll (small blind) folded before Flop
Seat 3: olga3021221 (big blind) folded before Flop
Seat 4: E Z TAKEDOWN collected ($0.05)
Seat 5: bigbaddaddy9 folded before Flop (didn't bet)
Seat 6: Ruopolo1982 folded before Flop (didn't bet)



PokerStars Zoom Hand #229230716358:  Hold'em No Limit ($0.01/$0.02) - 2021/08/21 21:46:16 CET [2021/08/21 15:46:16 ET]
Table 'Halley' 6-max Seat #1 is the button
Seat 1: bober2702 ($3.60 in chips) 
Seat 2: uniicecube ($2.03 in chips) 
Seat 3: ARTMVSLV ($2 in chips) 
Seat 4: Gamer577 ($3.87 in chips) 
Seat 5: Ogni ($4.50 in chips) 
Seat 6: Scaaalll ($2.93 in chips) 
uniicecube: posts small blind $0.01
ARTMVSLV: posts big blind $0.02
*** HOLE CARDS ***
Dealt to Scaaalll [7s Th]
Gamer577: folds 
Ogni: folds 
Scaaalll: folds 
bober2702: raises $0.03 to $0.05
uniicecube: folds 
ARTMVSLV: folds 
Uncalled bet ($0.03) returned to bober2702
bober2702 collected $0.05 from pot
bober2702: doesn't show hand 
*** SUMMARY ***
Total pot $0.05 | Rake $0 
Seat 1: bober2702 (button) collected ($0.05)
Seat 2: uniicecube (small blind) folded before Flop
Seat 3: ARTMVSLV (big blind) folded before Flop
Seat 4: Gamer577 folded before Flop (didn't bet)
Seat 5: Ogni folded before Flop (didn't bet)
Seat 6: Scaaalll folded before Flop (didn't bet)



PokerStars Zoom Hand #229230730035:  Hold'em No Limit ($0.01/$0.02) - 2021/08/21 21:46:45 CET [2021/08/21 15:46:45 ET]
Table 'Halley' 6-max Seat #1 is the button
Seat 1: pavlo590 ($1.89 in chips) 
Seat 2: HellNative ($3.19 in chips) 
Seat 3: RaulacateFolds ($2.39 in chips) 
Seat 4: JessieEnjoy ($3.86 in chips) 
Seat 5: Scaaalll ($2.93 in chips) 
Seat 6: *88VIC88* ($1.75 in chips) 
HellNative: posts small blind $0.01
RaulacateFolds: posts big blind $0.02
*** HOLE CARDS ***
Dealt to Scaaalll [Kd 8d]
JessieEnjoy: folds 
Scaaalll: folds 
*88VIC88*: folds 
pavlo590: folds 
HellNative: folds 
Uncalled bet ($0.01) returned to RaulacateFolds
pavlo590 is disconnected 
RaulacateFolds collected $0.02 from pot
RaulacateFolds: doesn't show hand 
*** SUMMARY ***
Total pot $0.02 | Rake $0 
Seat 1: pavlo590 (button) folded before Flop (didn't bet)
Seat 2: HellNative (small blind) folded before Flop
Seat 3: RaulacateFolds (big blind) collected ($0.02)
Seat 4: JessieEnjoy folded before Flop (didn't bet)
Seat 5: Scaaalll folded before Flop (didn't bet)
Seat 6: *88VIC88* folded before Flop (didn't bet)



PokerStars Zoom Hand #229230718658:  Hold'em No Limit ($0.01/$0.02) - 2021/08/21 21:46:21 CET [2021/08/21 15:46:21 ET]
Table 'Halley' 6-max Seat #1 is the button
Seat 1: Scaaalll ($2.93 in chips) 
Seat 2: KRandall12 ($1 in chips) 
Seat 3: EstiBan18 ($2.13 in chips) 
Seat 4: AlexGTPS ($1.96 in chips) 
Seat 5: EevAA190 ($2.01 in chips) 
Seat 6: ferx1989 ($3.48 in chips) 
KRandall12: posts small blind $0.01
EstiBan18: posts big blind $0.02
*** HOLE CARDS ***
Dealt to Scaaalll [8s As]
AlexGTPS: raises $0.03 to $0.05
EevAA190: folds 
ferx1989: folds 
Scaaalll has timed out
Scaaalll: folds 
KRandall12: folds 
EstiBan18: raises $0.13 to $0.18
AlexGTPS: calls $0.13
*** FLOP *** [9d Js Jd]
EstiBan18: bets $0.18
AlexGTPS: raises $0.36 to $0.54
EstiBan18: calls $0.36
*** TURN *** [9d Js Jd] [Jh]
EstiBan18: checks 
AlexGTPS: checks 
*** RIVER *** [9d Js Jd Jh] [Ah]
EstiBan18: checks 
AlexGTPS: checks 
*** SHOW DOWN ***
EstiBan18: shows [Kc Kd] (a full house, Jacks full of Kings)
AlexGTPS: mucks hand 
EstiBan18 collected $1.40 from pot
*** SUMMARY ***
Total pot $1.45 | Rake $0.05 
Board [9d Js Jd Jh Ah]
Seat 1: Scaaalll (button) folded before Flop (didn't bet)
Seat 2: KRandall12 (small blind) folded before Flop
Seat 3: EstiBan18 (big blind) showed [Kc Kd] and won ($1.40) with a full house, Jacks full of Kings
Seat 4: AlexGTPS mucked [9c 9h]
Seat 5: EevAA190 folded before Flop (didn't bet)
Seat 6: ferx1989 folded before Flop (didn't bet)



PokerStars Zoom Hand #229230735166:  Hold'em No Limit ($0.01/$0.02) - 2021/08/21 21:46:57 CET [2021/08/21 15:46:57 ET]
Table 'Halley' 6-max Seat #1 is the button
Seat 1: moirl55 ($2.09 in chips) 
Seat 2: klausC3 ($5.70 in chips) 
Seat 3: Scaaalll ($2.93 in chips) 
Seat 4: ugi-dugi ($2.95 in chips) 
Seat 5: furgalik ($1.71 in chips) 
Seat 6: Gerar NB ($2.18 in chips) 
klausC3: posts small blind $0.01
Scaaalll: posts big blind $0.02
*** HOLE CARDS ***
Dealt to Scaaalll [6s 6d]
ugi-dugi: folds 
furgalik: folds 
moirl55 is disconnected 
Gerar NB: raises $0.04 to $0.06
moirl55: folds 
klausC3: folds 
Scaaalll: calls $0.04
*** FLOP *** [4s Kh 7d]
Scaaalll: checks 
Gerar NB: checks 
*** TURN *** [4s Kh 7d] [3d]
Scaaalll: bets $0.08
Gerar NB: calls $0.08
*** RIVER *** [4s Kh 7d 3d] [4c]
Scaaalll: checks 
Gerar NB: checks 
*** SHOW DOWN ***
Scaaalll: shows [6s 6d] (two pair, Sixes and Fours)
Gerar NB: mucks hand 
Scaaalll collected $0.28 from pot
*** SUMMARY ***
Total pot $0.29 | Rake $0.01 
Board [4s Kh 7d 3d 4c]
Seat 1: moirl55 (button) folded before Flop (didn't bet)
Seat 2: klausC3 (small blind) folded before Flop
Seat 3: Scaaalll (big blind) showed [6s 6d] and won ($0.28) with two pair, Sixes and Fours
Seat 4: ugi-dugi folded before Flop (didn't bet)
Seat 5: furgalik folded before Flop (didn't bet)
Seat 6: Gerar NB mucked [5c 5s]



PokerStars Zoom Hand #229230752511:  Hold'em No Limit ($0.01/$0.02) - 2021/08/21 21:47:35 CET [2021/08/21 15:47:35 ET]
Table 'Halley' 6-max Seat #1 is the button
Seat 1: vladlen101 ($0.78 in chips) 
Seat 2: malandro733 ($3.41 in chips) 
Seat 3: z1z2z315 ($0.83 in chips) 
Seat 4: Scaaalll ($3.07 in chips) 
Seat 5: ser313131 ($2.30 in chips) 
Seat 6: meikoz ($2.69 in chips) 
malandro733: posts small blind $0.01
z1z2z315: posts big blind $0.02
*** HOLE CARDS ***
Dealt to Scaaalll [Td 2d]
Scaaalll: folds 
ser313131: folds 
meikoz: folds 
vladlen101: folds 
malandro733: folds 
Uncalled bet ($0.01) returned to z1z2z315
z1z2z315 collected $0.02 from pot
z1z2z315: doesn't show hand 
*** SUMMARY ***
Total pot $0.02 | Rake $0 
Seat 1: vladlen101 (button) folded before Flop (didn't bet)
Seat 2: malandro733 (small blind) folded before Flop
Seat 3: z1z2z315 (big blind) collected ($0.02)
Seat 4: Scaaalll folded before Flop (didn't bet)
Seat 5: ser313131 folded before Flop (didn't bet)
Seat 6: meikoz folded before Flop (didn't bet)



PokerStars Zoom Hand #229230758294:  Hold'em No Limit ($0.01/$0.02) - 2021/08/21 21:47:48 CET [2021/08/21 15:47:48 ET]
Table 'Halley' 6-max Seat #1 is the button
Seat 1: arrow17 ($2 in chips) 
Seat 2: LuckyCheewey ($6.42 in chips) 
Seat 3: WithMyWalker ($2.05 in chips) 
Seat 4: Gamer577 ($2 in chips) 
Seat 5: pipecmolodec ($2 in chips) 
Seat 6: Scaaalll ($3.06 in chips) 
LuckyCheewey: posts small blind $0.01
WithMyWalker: posts big blind $0.02
*** HOLE CARDS ***
Dealt to Scaaalll [Jh 7d]
Gamer577: raises $0.04 to $0.06
pipecmolodec: folds 
Scaaalll: folds 
arrow17: folds 
LuckyCheewey: folds 
WithMyWalker: folds 
Uncalled bet ($0.04) returned to Gamer577
Gamer577 collected $0.05 from pot
Gamer577: doesn't show hand 
*** SUMMARY ***
Total pot $0.05 | Rake $0 
Seat 1: arrow17 (button) folded before Flop (didn't bet)
Seat 2: LuckyCheewey (small blind) folded before Flop
Seat 3: WithMyWalker (big blind) folded before Flop
Seat 4: Gamer577 collected ($0.05)
Seat 5: pipecmolodec folded before Flop (didn't bet)
Seat 6: Scaaalll folded before Flop (didn't bet)



PokerStars Zoom Hand #229230754298:  Hold'em No Limit ($0.01/$0.02) - 2021/08/21 21:47:39 CET [2021/08/21 15:47:39 ET]
Table 'Halley' 6-max Seat #1 is the button
Seat 1: gwr85 ($2.04 in chips) 
Seat 2: Scaaalll ($3.07 in chips) 
Seat 3: orang_dragon ($2.47 in chips) 
Seat 4: Slirey ($2.77 in chips) 
Seat 5: ciucibaby ($3.75 in chips) 
Seat 6: Iluvatar922 ($9.69 in chips) 
Scaaalll: posts small blind $0.01
orang_dragon: posts big blind $0.02
*** HOLE CARDS ***
Dealt to Scaaalll [7s 8d]
Slirey: folds 
Slirey is disconnected 
ciucibaby: folds 
Iluvatar922: folds 
gwr85: calls $0.02
Scaaalll: folds 
orang_dragon: checks 
*** FLOP *** [Kd Ad 9s]
orang_dragon: checks 
gwr85: bets $0.03
orang_dragon: calls $0.03
*** TURN *** [Kd Ad 9s] [8c]
orang_dragon: checks 
gwr85: bets $0.06
orang_dragon: folds 
Uncalled bet ($0.06) returned to gwr85
gwr85 collected $0.11 from pot
gwr85: doesn't show hand 
*** SUMMARY ***
Total pot $0.11 | Rake $0 
Board [Kd Ad 9s 8c]
Seat 1: gwr85 (button) collected ($0.11)
Seat 2: Scaaalll (small blind) folded before Flop
Seat 3: orang_dragon (big blind) folded on the Turn
Seat 4: Slirey folded before Flop (didn't bet)
Seat 5: ciucibaby folded before Flop (didn't bet)
Seat 6: Iluvatar922 folded before Flop (didn't bet)



PokerStars Zoom Hand #229230760104:  Hold'em No Limit ($0.01/$0.02) - 2021/08/21 21:47:52 CET [2021/08/21 15:47:52 ET]
Table 'Halley' 6-max Seat #1 is the button
Seat 1: Fanatspartak ($0.39 in chips) 
Seat 2: fabor1303 ($9.05 in chips) 
Seat 3: feybys ($2.58 in chips) 
Seat 4: Flankeris ($5.60 in chips) 
Seat 5: Scaaalll ($3.06 in chips) 
Seat 6: pavlo8855 ($2 in chips) 
fabor1303: posts small blind $0.01
feybys: posts big blind $0.02
*** HOLE CARDS ***
Dealt to Scaaalll [8c 8d]
Flankeris: raises $0.04 to $0.06
Scaaalll: calls $0.06
pavlo8855: folds 
Fanatspartak: folds 
fabor1303: folds 
feybys: folds 
*** FLOP *** [6d 3s 4h]
Flankeris: bets $0.09
Scaaalll: calls $0.09
*** TURN *** [6d 3s 4h] [6h]
Flankeris: bets $0.21
Scaaalll: calls $0.21
*** RIVER *** [6d 3s 4h 6h] [Js]
Flankeris: checks 
Scaaalll: checks 
*** SHOW DOWN ***
Flankeris: shows [Th 9h] (a pair of Sixes)
Scaaalll: shows [8c 8d] (two pair, Eights and Sixes)
Scaaalll collected $0.71 from pot
*** SUMMARY ***
Total pot $0.75 | Rake $0.04 
Board [6d 3s 4h 6h Js]
Seat 1: Fanatspartak (button) folded before Flop (didn't bet)
Seat 2: fabor1303 (small blind) folded before Flop
Seat 3: feybys (big blind) folded before Flop
Seat 4: Flankeris showed [Th 9h] and lost with a pair of Sixes
Seat 5: Scaaalll showed [8c 8d] and won ($0.71) with two pair, Eights and Sixes
Seat 6: pavlo8855 folded before Flop (didn't bet)



PokerStars Zoom Hand #229230781603:  Hold'em No Limit ($0.01/$0.02) - 2021/08/21 21:48:39 CET [2021/08/21 15:48:39 ET]
Table 'Halley' 6-max Seat #1 is the button
Seat 1: meps88 ($2.40 in chips) 
Seat 2: S.P.S...99 ($0.92 in chips) 
Seat 3: smileakafray ($2 in chips) 
Seat 4: szajm ($0.78 in chips) 
Seat 5: Gibsondelux ($2.72 in chips) 
Seat 6: Scaaalll ($3.41 in chips) 
S.P.S...99: posts small blind $0.01
smileakafray: posts big blind $0.02
*** HOLE CARDS ***
Dealt to Scaaalll [8s 6h]
S.P.S...99 is disconnected 
szajm: raises $0.05 to $0.07
Gibsondelux: calls $0.07
Scaaalll: folds 
meps88: folds 
S.P.S...99: folds 
smileakafray: folds 
*** FLOP *** [4c 5s Td]
szajm: bets $0.16
Gibsondelux: folds 
Uncalled bet ($0.16) returned to szajm
szajm collected $0.16 from pot
szajm: doesn't show hand 
Gibsondelux is disconnected 
*** SUMMARY ***
Total pot $0.17 | Rake $0.01 
Board [4c 5s Td]
Seat 1: meps88 (button) folded before Flop (didn't bet)
Seat 2: S.P.S...99 (small blind) folded before Flop
Seat 3: smileakafray (big blind) folded before Flop
Seat 4: szajm collected ($0.16)
Seat 5: Gibsondelux folded on the Flop
Seat 6: Scaaalll folded before Flop (didn't bet)



PokerStars Zoom Hand #229230784342:  Hold'em No Limit ($0.01/$0.02) - 2021/08/21 21:48:44 CET [2021/08/21 15:48:44 ET]
Table 'Halley' 6-max Seat #1 is the button
Seat 1: felipeciji ($2 in chips) 
Seat 2: samn102 ($2.21 in chips) 
Seat 3: Scaaalll ($3.41 in chips) 
Seat 4: Finkey99 ($4.85 in chips) 
Seat 5: RoughRafff ($2.02 in chips) 
Seat 6: py100ta ($13.77 in chips) 
samn102: posts small blind $0.01
Scaaalll: posts big blind $0.02
*** HOLE CARDS ***
Dealt to Scaaalll [2s Qd]
Finkey99: folds 
RoughRafff: folds 
py100ta: folds 
felipeciji: raises $0.03 to $0.05
samn102: folds 
Scaaalll: folds 
Uncalled bet ($0.03) returned to felipeciji
samn102 is disconnected 
felipeciji collected $0.05 from pot
felipeciji: doesn't show hand 
*** SUMMARY ***
Total pot $0.05 | Rake $0 
Seat 1: felipeciji (button) collected ($0.05)
Seat 2: samn102 (small blind) folded before Flop
Seat 3: Scaaalll (big blind) folded before Flop
Seat 4: Finkey99 folded before Flop (didn't bet)
Seat 5: RoughRafff folded before Flop (didn't bet)
Seat 6: py100ta folded before Flop (didn't bet)



PokerStars Zoom Hand #229230790707:  Hold'em No Limit ($0.01/$0.02) - 2021/08/21 21:48:59 CET [2021/08/21 15:48:59 ET]
Table 'Halley' 6-max Seat #1 is the button
Seat 1: jaamonra ($2.08 in chips) 
Seat 2: Scaaalll ($3.39 in chips) 
Seat 3: Clavis Noa ($3.06 in chips) 
Seat 4: Jujiluju ($1.41 in chips) 
Seat 5: olga3021221 ($3.48 in chips) 
Seat 6: boa juice ($1.29 in chips) 
Scaaalll: posts small blind $0.01
Clavis Noa: posts big blind $0.02
*** HOLE CARDS ***
Dealt to Scaaalll [5h 3c]
Jujiluju: folds 
olga3021221: folds 
boa juice: folds 
jaamonra: folds 
boa juice is disconnected 
Scaaalll: folds 
Uncalled bet ($0.01) returned to Clavis Noa
Clavis Noa collected $0.02 from pot
Clavis Noa: doesn't show hand 
*** SUMMARY ***
Total pot $0.02 | Rake $0 
Seat 1: jaamonra (button) folded before Flop (didn't bet)
Seat 2: Scaaalll (small blind) folded before Flop
Seat 3: Clavis Noa (big blind) collected ($0.02)
Seat 4: Jujiluju folded before Flop (didn't bet)
Seat 5: olga3021221 folded before Flop (didn't bet)
Seat 6: boa juice folded before Flop (didn't bet)



PokerStars Zoom Hand #229230777968:  Hold'em No Limit ($0.01/$0.02) - 2021/08/21 21:48:31 CET [2021/08/21 15:48:31 ET]
Table 'Halley' 6-max Seat #1 is the button
Seat 1: Scaaalll ($3.41 in chips) 
Seat 2: Artur1987PL ($0.79 in chips) 
Seat 3: BigTestIcicle ($1.84 in chips) 
Seat 4: 48159348 ($1.42 in chips) 
Seat 5: satti1337 ($2 in chips) 
Seat 6: zergmiky ($2 in chips) 
Artur1987PL: posts small blind $0.01
BigTestIcicle: posts big blind $0.02
*** HOLE CARDS ***
Dealt to Scaaalll [3c Qh]
Artur1987PL is disconnected 
48159348: raises $0.04 to $0.06
satti1337: folds 
zergmiky: folds 
Scaaalll: folds 
Artur1987PL: folds 
BigTestIcicle: calls $0.04
*** FLOP *** [9c 5d 5h]
BigTestIcicle: checks 
48159348: checks 
*** TURN *** [9c 5d 5h] [5c]
BigTestIcicle: checks 
48159348: bets $0.07
BigTestIcicle: calls $0.07
*** RIVER *** [9c 5d 5h 5c] [Kh]
BigTestIcicle: bets $0.13
48159348: calls $0.13
*** SHOW DOWN ***
BigTestIcicle: shows [8s Kc] (a full house, Fives full of Kings)
48159348: mucks hand 
BigTestIcicle collected $0.51 from pot
*** SUMMARY ***
Total pot $0.53 | Rake $0.02 
Board [9c 5d 5h 5c Kh]
Seat 1: Scaaalll (button) folded before Flop (didn't bet)
Seat 2: Artur1987PL (small blind) folded before Flop
Seat 3: BigTestIcicle (big blind) showed [8s Kc] and won ($0.51) with a full house, Fives full of Kings
Seat 4: 48159348 mucked [9s Qd]
Seat 5: satti1337 folded before Flop (didn't bet)
Seat 6: zergmiky folded before Flop (didn't bet)



PokerStars Zoom Hand #229230802859:  Hold'em No Limit ($0.01/$0.02) - 2021/08/21 21:49:25 CET [2021/08/21 15:49:25 ET]
Table 'Halley' 6-max Seat #1 is the button
Seat 1: Scaaalll ($3.38 in chips) 
Seat 2: Gyapszi958 ($2.06 in chips) 
Seat 3: jftd123 ($3.48 in chips) 
Seat 4: Sv1ch ($0.80 in chips) 
Seat 5: kahzura ($2 in chips) 
Seat 6: bober2702 ($3.84 in chips) 
Gyapszi958: posts small blind $0.01
jftd123: posts big blind $0.02
*** HOLE CARDS ***
Dealt to Scaaalll [3c 5c]
Sv1ch: raises $0.05 to $0.07
kahzura: folds 
bober2702: folds 
Scaaalll: folds 
Gyapszi958: folds 
jftd123: folds 
Uncalled bet ($0.05) returned to Sv1ch
Sv1ch collected $0.05 from pot
Sv1ch: doesn't show hand 
*** SUMMARY ***
Total pot $0.05 | Rake $0 
Seat 1: Scaaalll (button) folded before Flop (didn't bet)
Seat 2: Gyapszi958 (small blind) folded before Flop
Seat 3: jftd123 (big blind) folded before Flop
Seat 4: Sv1ch collected ($0.05)
Seat 5: kahzura folded before Flop (didn't bet)
Seat 6: bober2702 folded before Flop (didn't bet)



PokerStars Zoom Hand #229230812375:  Hold'em No Limit ($0.01/$0.02) - 2021/08/21 21:49:46 CET [2021/08/21 15:49:46 ET]
Table 'Halley' 6-max Seat #1 is the button
Seat 1: GamblersDream ($2 in chips) 
Seat 2: siebens777 ($2.01 in chips) 
Seat 3: arrow17 ($2 in chips) 
Seat 4: Scaaalll ($3.38 in chips) 
Seat 5: Nihility77 ($2.04 in chips) 
Seat 6: kboskov123 ($1.65 in chips) 
siebens777: posts small blind $0.01
arrow17: posts big blind $0.02
*** HOLE CARDS ***
Dealt to Scaaalll [3s Ad]
Scaaalll has timed out
Scaaalll: folds 
Nihility77: folds 
kboskov123: folds 
GamblersDream: folds 
siebens777: folds 
Uncalled bet ($0.01) returned to arrow17
arrow17 collected $0.02 from pot
arrow17: doesn't show hand 
*** SUMMARY ***
Total pot $0.02 | Rake $0 
Seat 1: GamblersDream (button) folded before Flop (didn't bet)
Seat 2: siebens777 (small blind) folded before Flop
Seat 3: arrow17 (big blind) collected ($0.02)
Seat 4: Scaaalll folded before Flop (didn't bet)
Seat 5: Nihility77 folded before Flop (didn't bet)
Seat 6: kboskov123 folded before Flop (didn't bet)



PokerStars Zoom Hand #229230797047:  Hold'em No Limit ($0.01/$0.02) - 2021/08/21 21:49:12 CET [2021/08/21 15:49:12 ET]
Table 'Halley' 6-max Seat #1 is the button
Seat 1: sorinysu ($0.31 in chips) 
Seat 2: nV6TR ($3.27 in chips) 
Seat 3: Gerar NB ($2.17 in chips) 
Seat 4: Fedor_Gar ($2 in chips) 
Seat 5: Scaaalll ($3.38 in chips) 
Seat 6: Feliciano16 ($2 in chips) 
nV6TR: posts small blind $0.01
Gerar NB: posts big blind $0.02
*** HOLE CARDS ***
Dealt to Scaaalll [Qs 4c]
Fedor_Gar: folds 
Scaaalll: folds 
Feliciano16: raises $0.04 to $0.06
sorinysu: calls $0.06
nV6TR: calls $0.05
Gerar NB: folds 
*** FLOP *** [8h 5h 5c]
nV6TR: checks 
Feliciano16: checks 
sorinysu: checks 
*** TURN *** [8h 5h 5c] [Qc]
nV6TR: checks 
Feliciano16: checks 
sorinysu: bets $0.09
nV6TR: folds 
Feliciano16: folds 
Uncalled bet ($0.09) returned to sorinysu
sorinysu collected $0.19 from pot
sorinysu: doesn't show hand 
*** SUMMARY ***
Total pot $0.20 | Rake $0.01 
Board [8h 5h 5c Qc]
Seat 1: sorinysu (button) collected ($0.19)
Seat 2: nV6TR (small blind) folded on the Turn
Seat 3: Gerar NB (big blind) folded before Flop
Seat 4: Fedor_Gar folded before Flop (didn't bet)
Seat 5: Scaaalll folded before Flop (didn't bet)
Seat 6: Feliciano16 folded on the Turn



PokerStars Zoom Hand #229230810079:  Hold'em No Limit ($0.01/$0.02) - 2021/08/21 21:49:41 CET [2021/08/21 15:49:41 ET]
Table 'Halley' 6-max Seat #1 is the button
Seat 1: gwr85 ($1.96 in chips) 
Seat 2: viktor2935 ($0.96 in chips) 
Seat 3: Lamro50 ($2 in chips) 
Seat 4: zergmiky ($2.70 in chips) 
Seat 5: feybys ($1.88 in chips) 
Seat 6: Scaaalll ($3.38 in chips) 
viktor2935: posts small blind $0.01
Lamro50: posts big blind $0.02
*** HOLE CARDS ***
Dealt to Scaaalll [3h 9c]
zergmiky has timed out
zergmiky: folds 
feybys: folds 
Scaaalll: folds 
gwr85: calls $0.02
viktor2935: folds 
Lamro50: raises $0.04 to $0.06
gwr85: calls $0.04
*** FLOP *** [4c Js 4d]
Lamro50: bets $0.07
gwr85: raises $0.07 to $0.14
Lamro50: calls $0.07
*** TURN *** [4c Js 4d] [Ts]
Lamro50: bets $0.20
gwr85: calls $0.20
*** RIVER *** [4c Js 4d Ts] [8c]
Lamro50: bets $0.39
gwr85: calls $0.39
*** SHOW DOWN ***
Lamro50: shows [Ks Jc] (two pair, Jacks and Fours)
gwr85: shows [Jd Ah] (two pair, Jacks and Fours - Ace kicker)
gwr85 collected $1.53 from pot
*** SUMMARY ***
Total pot $1.59 | Rake $0.06 
Board [4c Js 4d Ts 8c]
Seat 1: gwr85 (button) showed [Jd Ah] and won ($1.53) with two pair, Jacks and Fours
Seat 2: viktor2935 (small blind) folded before Flop
Seat 3: Lamro50 (big blind) showed [Ks Jc] and lost with two pair, Jacks and Fours
Seat 4: zergmiky folded before Flop (didn't bet)
Seat 5: feybys folded before Flop (didn't bet)
Seat 6: Scaaalll folded before Flop (didn't bet)



PokerStars Zoom Hand #229230824654:  Hold'em No Limit ($0.01/$0.02) - 2021/08/21 21:50:14 CET [2021/08/21 15:50:14 ET]
Table 'Halley' 6-max Seat #1 is the button
Seat 1: felipeciji ($2 in chips) 
Seat 2: lucksuckdonk ($4.17 in chips) 
Seat 3: Scaaalll ($3.37 in chips) 
Seat 4: BIITRU ($5.32 in chips) 
Seat 5: Laonikos ($8.15 in chips) 
Seat 6: dkno77 ($1.90 in chips) 
lucksuckdonk: posts small blind $0.01
Scaaalll: posts big blind $0.02
*** HOLE CARDS ***
Dealt to Scaaalll [7c 3s]
BIITRU: folds 
Laonikos: raises $0.03 to $0.05
dkno77: folds 
felipeciji: folds 
lucksuckdonk: folds 
Scaaalll: folds 
Uncalled bet ($0.03) returned to Laonikos
Laonikos collected $0.05 from pot
Laonikos: doesn't show hand 
*** SUMMARY ***
Total pot $0.05 | Rake $0 
Seat 1: felipeciji (button) folded before Flop (didn't bet)
Seat 2: lucksuckdonk (small blind) folded before Flop
Seat 3: Scaaalll (big blind) folded before Flop
Seat 4: BIITRU folded before Flop (didn't bet)
Seat 5: Laonikos collected ($0.05)
Seat 6: dkno77 folded before Flop (didn't bet)



PokerStars Zoom Hand #229230832306:  Hold'em No Limit ($0.01/$0.02) - 2021/08/21 21:50:31 CET [2021/08/21 15:50:31 ET]
Table 'Halley' 6-max Seat #1 is the button
Seat 1: RATAKEY41673 ($3.22 in chips) 
Seat 2: MIT_PKR ($3.02 in chips) 
Seat 3: Shcherbak252 ($2.46 in chips) 
Seat 4: Henry Chinasky ($18.98 in chips) 
Seat 5: Scaaalll ($3.35 in chips) 
Seat 6: ChowMangao ($3.99 in chips) 
MIT_PKR: posts small blind $0.01
Shcherbak252: posts big blind $0.02
*** HOLE CARDS ***
Dealt to Scaaalll [Td 6h]
Henry Chinasky: folds 
Scaaalll: folds 
ChowMangao: folds 
RATAKEY41673: folds 
MIT_PKR: folds 
Uncalled bet ($0.01) returned to Shcherbak252
Shcherbak252 collected $0.02 from pot
Shcherbak252: doesn't show hand 
*** SUMMARY ***
Total pot $0.02 | Rake $0 
Seat 1: RATAKEY41673 (button) folded before Flop (didn't bet)
Seat 2: MIT_PKR (small blind) folded before Flop
Seat 3: Shcherbak252 (big blind) collected ($0.02)
Seat 4: Henry Chinasky folded before Flop (didn't bet)
Seat 5: Scaaalll folded before Flop (didn't bet)
Seat 6: ChowMangao folded before Flop (didn't bet)



PokerStars Zoom Hand #229230819303:  Hold'em No Limit ($0.01/$0.02) - 2021/08/21 21:50:02 CET [2021/08/21 15:50:02 ET]
Table 'Halley' 6-max Seat #1 is the button
Seat 1: SIGREX ($2.18 in chips) 
Seat 2: Scaaalll ($3.38 in chips) 
Seat 3: mity3333 ($4.10 in chips) 
Seat 4: zeus11983 ($2 in chips) 
Seat 5: Amigo113 ($2.35 in chips) 
Seat 6: feybys ($2.28 in chips) 
Scaaalll: posts small blind $0.01
mity3333: posts big blind $0.02
*** HOLE CARDS ***
Dealt to Scaaalll [Kh 3s]
zeus11983: folds 
Amigo113: folds 
feybys: raises $0.04 to $0.06
SIGREX: folds 
Scaaalll: folds 
mity3333: calls $0.04
*** FLOP *** [Ks 3h 9s]
mity3333: checks 
feybys: bets $0.11
mity3333: calls $0.11
*** TURN *** [Ks 3h 9s] [Ac]
mity3333: checks 
feybys: checks 
*** RIVER *** [Ks 3h 9s Ac] [7d]
mity3333: bets $0.34
feybys: folds 
Uncalled bet ($0.34) returned to mity3333
mity3333 collected $0.34 from pot
mity3333: doesn't show hand 
*** SUMMARY ***
Total pot $0.35 | Rake $0.01 
Board [Ks 3h 9s Ac 7d]
Seat 1: SIGREX (button) folded before Flop (didn't bet)
Seat 2: Scaaalll (small blind) folded before Flop
Seat 3: mity3333 (big blind) collected ($0.34)
Seat 4: zeus11983 folded before Flop (didn't bet)
Seat 5: Amigo113 folded before Flop (didn't bet)
Seat 6: feybys folded on the River



PokerStars Zoom Hand #229230834123:  Hold'em No Limit ($0.01/$0.02) - 2021/08/21 21:50:34 CET [2021/08/21 15:50:34 ET]
Table 'Halley' 6-max Seat #1 is the button
Seat 1: Scaaalll ($3.35 in chips) 
Seat 2: Sinad1302 ($2.90 in chips) 
Seat 3: KoAlRy ($2 in chips) 
Seat 4: boa juice ($1.93 in chips) 
Seat 5: bigbaddaddy9 ($6.76 in chips) 
Seat 6: alexissp12345 ($1.09 in chips) 
Sinad1302: posts small blind $0.01
KoAlRy: posts big blind $0.02
*** HOLE CARDS ***
Dealt to Scaaalll [Qs Ks]
boa juice: folds 
bigbaddaddy9: folds 
Sinad1302 is disconnected 
boa juice is disconnected 
alexissp12345: raises $0.02 to $0.04
Scaaalll: calls $0.04
Sinad1302: folds 
KoAlRy: folds 
*** FLOP *** [Tc 9c 3d]
alexissp12345: bets $0.11
Scaaalll: calls $0.11
*** TURN *** [Tc 9c 3d] [7h]
alexissp12345: checks 
Scaaalll: bets $0.21
alexissp12345: folds 
Uncalled bet ($0.21) returned to Scaaalll
Scaaalll collected $0.32 from pot
Scaaalll: doesn't show hand 
*** SUMMARY ***
Total pot $0.33 | Rake $0.01 
Board [Tc 9c 3d 7h]
Seat 1: Scaaalll (button) collected ($0.32)
Seat 2: Sinad1302 (small blind) folded before Flop
Seat 3: KoAlRy (big blind) folded before Flop
Seat 4: boa juice folded before Flop (didn't bet)
Seat 5: bigbaddaddy9 folded before Flop (didn't bet)
Seat 6: alexissp12345 folded on the Turn



PokerStars Zoom Hand #229230853160:  Hold'em No Limit ($0.01/$0.02) - 2021/08/21 21:51:16 CET [2021/08/21 15:51:16 ET]
Table 'Halley' 6-max Seat #1 is the button
Seat 1: Bufre ($3.69 in chips) 
Seat 2: 21041956 ($1.89 in chips) 
Seat 3: HellNative ($2.25 in chips) 
Seat 4: tviskas ($3.32 in chips) 
Seat 5: wstanula ($3.16 in chips) 
Seat 6: Scaaalll ($3.52 in chips) 
21041956: posts small blind $0.01
HellNative: posts big blind $0.02
*** HOLE CARDS ***
Dealt to Scaaalll [5d Jc]
tviskas: folds 
tviskas is disconnected 
wstanula: raises $0.02 to $0.04
Scaaalll: folds 
Bufre: folds 
21041956: folds 
HellNative: folds 
Uncalled bet ($0.02) returned to wstanula
wstanula collected $0.05 from pot
wstanula: doesn't show hand 
*** SUMMARY ***
Total pot $0.05 | Rake $0 
Seat 1: Bufre (button) folded before Flop (didn't bet)
Seat 2: 21041956 (small blind) folded before Flop
Seat 3: HellNative (big blind) folded before Flop
Seat 4: tviskas folded before Flop (didn't bet)
Seat 5: wstanula collected ($0.05)
Seat 6: Scaaalll folded before Flop (didn't bet)



PokerStars Zoom Hand #229230859491:  Hold'em No Limit ($0.01/$0.02) - 2021/08/21 21:51:30 CET [2021/08/21 15:51:30 ET]
Table 'Halley' 6-max Seat #1 is the button
Seat 1: nippurkaunas ($1.25 in chips) 
Seat 2: irie-singer ($4.66 in chips) 
Seat 3: Aho1337 ($2.86 in chips) 
Seat 4: Scaaalll ($3.52 in chips) 
Seat 5: melklim ($2 in chips) 
Seat 6: fishh_play ($3.88 in chips) 
irie-singer: posts small blind $0.01
Aho1337: posts big blind $0.02
*** HOLE CARDS ***
Dealt to Scaaalll [Kc Ac]
Scaaalll: raises $0.04 to $0.06
melklim: folds 
fishh_play: folds 
nippurkaunas: folds 
irie-singer: folds 
Aho1337: folds 
Uncalled bet ($0.04) returned to Scaaalll
Scaaalll collected $0.05 from pot
Scaaalll: doesn't show hand 
*** SUMMARY ***
Total pot $0.05 | Rake $0 
Seat 1: nippurkaunas (button) folded before Flop (didn't bet)
Seat 2: irie-singer (small blind) folded before Flop
Seat 3: Aho1337 (big blind) folded before Flop
Seat 4: Scaaalll collected ($0.05)
Seat 5: melklim folded before Flop (didn't bet)
Seat 6: fishh_play folded before Flop (didn't bet)



PokerStars Zoom Hand #229230867621:  Hold'em No Limit ($0.01/$0.02) - 2021/08/21 21:51:49 CET [2021/08/21 15:51:49 ET]
Table 'Halley' 6-max Seat #1 is the button
Seat 1: gds2003 ($1.04 in chips) 
Seat 2: Scaaalll ($3.55 in chips) 
Seat 3: Gamer577 ($3.89 in chips) 
Seat 4: Shcherbak252 ($2.34 in chips) 
Seat 5: meikoz ($2.54 in chips) 
Seat 6: SKV_1985 ($2.74 in chips) 
Scaaalll: posts small blind $0.01
Gamer577: posts big blind $0.02
*** HOLE CARDS ***
Dealt to Scaaalll [9d 8h]
Shcherbak252: folds 
meikoz: raises $0.03 to $0.05
SKV_1985: folds 
gds2003: folds 
Scaaalll: folds 
Gamer577: folds 
Uncalled bet ($0.03) returned to meikoz
meikoz collected $0.05 from pot
meikoz: doesn't show hand 
*** SUMMARY ***
Total pot $0.05 | Rake $0 
Seat 1: gds2003 (button) folded before Flop (didn't bet)
Seat 2: Scaaalll (small blind) folded before Flop
Seat 3: Gamer577 (big blind) folded before Flop
Seat 4: Shcherbak252 folded before Flop (didn't bet)
Seat 5: meikoz collected ($0.05)
Seat 6: SKV_1985 folded before Flop (didn't bet)



PokerStars Zoom Hand #229230882829:  Hold'em No Limit ($0.01/$0.02) - 2021/08/21 21:52:23 CET [2021/08/21 15:52:23 ET]
Table 'Halley' 6-max Seat #1 is the button
Seat 1: Scaaalll ($3.52 in chips) 
Seat 2: Murileus ($2 in chips) 
Seat 3: Victor151886 ($2.16 in chips) 
Seat 4: Emilmoller1 ($1.51 in chips) 
Seat 5: G1olight ($3.94 in chips) 
Seat 6: arrow17 ($2.01 in chips) 
Murileus: posts small blind $0.01
Victor151886: posts big blind $0.02
*** HOLE CARDS ***
Dealt to Scaaalll [6c 8c]
Emilmoller1: raises $0.02 to $0.04
G1olight: folds 
G1olight is disconnected 
arrow17: folds 
Scaaalll: folds 
Murileus: folds 
Victor151886: folds 
Uncalled bet ($0.02) returned to Emilmoller1
Emilmoller1 collected $0.05 from pot
Emilmoller1: doesn't show hand 
*** SUMMARY ***
Total pot $0.05 | Rake $0 
Seat 1: Scaaalll (button) folded before Flop (didn't bet)
Seat 2: Murileus (small blind) folded before Flop
Seat 3: Victor151886 (big blind) folded before Flop
Seat 4: Emilmoller1 collected ($0.05)
Seat 5: G1olight folded before Flop (didn't bet)
Seat 6: arrow17 folded before Flop (didn't bet)



PokerStars Zoom Hand #229230873897:  Hold'em No Limit ($0.01/$0.02) - 2021/08/21 21:52:03 CET [2021/08/21 15:52:03 ET]
Table 'Halley' 6-max Seat #1 is the button
Seat 1: CrazyyParis ($2.28 in chips) 
Seat 2: Grama480 ($3.18 in chips) 
Seat 3: Scaaalll ($3.54 in chips) 
Seat 4: z3317111711 ($3.01 in chips) 
Seat 5: AlexGTPS ($2.09 in chips) 
Seat 6: inquisitor666 ($2.10 in chips) 
Grama480: posts small blind $0.01
Scaaalll: posts big blind $0.02
*** HOLE CARDS ***
Dealt to Scaaalll [Ah 8s]
z3317111711: raises $0.03 to $0.05
AlexGTPS: calls $0.05
inquisitor666: raises $0.03 to $0.08
CrazyyParis: folds 
Grama480: folds 
Scaaalll: folds 
z3317111711: calls $0.03
AlexGTPS: calls $0.03
*** FLOP *** [As 5h 8d]
z3317111711: checks 
AlexGTPS: checks 
inquisitor666: bets $0.02
z3317111711: folds 
AlexGTPS: calls $0.02
*** TURN *** [As 5h 8d] [3s]
AlexGTPS: checks 
inquisitor666: bets $2 and is all-in
AlexGTPS: folds 
Uncalled bet ($2) returned to inquisitor666
inquisitor666 collected $0.30 from pot
inquisitor666: doesn't show hand 
*** SUMMARY ***
Total pot $0.31 | Rake $0.01 
Board [As 5h 8d 3s]
Seat 1: CrazyyParis (button) folded before Flop (didn't bet)
Seat 2: Grama480 (small blind) folded before Flop
Seat 3: Scaaalll (big blind) folded before Flop
Seat 4: z3317111711 folded on the Flop
Seat 5: AlexGTPS folded on the Turn
Seat 6: inquisitor666 collected ($0.30)



PokerStars Zoom Hand #229230894433:  Hold'em No Limit ($0.01/$0.02) - 2021/08/21 21:52:37 CET [2021/08/21 15:52:37 ET]
Table 'Halley' 6-max Seat #1 is the button
Seat 1: ctaceo ($2.14 in chips) 
Seat 2: RoughRafff ($2.09 in chips) 
Seat 3: tomsa01 ($0.97 in chips) 
Seat 4: Scaaalll ($3.52 in chips) 
Seat 5: CrazyyParis ($2 in chips) 
Seat 6: meikoz ($2.29 in chips) 
RoughRafff: posts small blind $0.01
tomsa01: posts big blind $0.02
*** HOLE CARDS ***
Dealt to Scaaalll [4s 9c]
Scaaalll: folds 
CrazyyParis: folds 
meikoz: folds 
ctaceo: folds 
RoughRafff: raises $0.16 to $0.18
tomsa01: folds 
Uncalled bet ($0.16) returned to RoughRafff
RoughRafff collected $0.04 from pot
RoughRafff: doesn't show hand 
tomsa01 is disconnected 
*** SUMMARY ***
Total pot $0.04 | Rake $0 
Seat 1: ctaceo (button) folded before Flop (didn't bet)
Seat 2: RoughRafff (small blind) collected ($0.04)
Seat 3: tomsa01 (big blind) folded before Flop
Seat 4: Scaaalll folded before Flop (didn't bet)
Seat 5: CrazyyParis folded before Flop (didn't bet)
Seat 6: meikoz folded before Flop (didn't bet)



PokerStars Zoom Hand #229230898306:  Hold'em No Limit ($0.01/$0.02) - 2021/08/21 21:52:46 CET [2021/08/21 15:52:46 ET]
Table 'Halley' 6-max Seat #1 is the button
Seat 1: G1olight ($3.92 in chips) 
Seat 2: SKV_1985 ($2.16 in chips) 
Seat 3: HellNative ($3.25 in chips) 
Seat 4: KIraMan ($7.31 in chips) 
Seat 5: Scaaalll ($3.52 in chips) 
Seat 6: SICKDIRTY416 ($5.11 in chips) 
SKV_1985: posts small blind $0.01
HellNative: posts big blind $0.02
*** HOLE CARDS ***
Dealt to Scaaalll [Kh 6d]
KIraMan: folds 
SICKDIRTY416 is disconnected 
Scaaalll: folds 
SICKDIRTY416: folds 
G1olight: raises $0.04 to $0.06
SKV_1985: folds 
HellNative: folds 
Uncalled bet ($0.04) returned to G1olight
G1olight collected $0.05 from pot
G1olight: doesn't show hand 
*** SUMMARY ***
Total pot $0.05 | Rake $0 
Seat 1: G1olight (button) collected ($0.05)
Seat 2: SKV_1985 (small blind) folded before Flop
Seat 3: HellNative (big blind) folded before Flop
Seat 4: KIraMan folded before Flop (didn't bet)
Seat 5: Scaaalll folded before Flop (didn't bet)
Seat 6: SICKDIRTY416 folded before Flop (didn't bet)



PokerStars Zoom Hand #229230900254:  Hold'em No Limit ($0.01/$0.02) - 2021/08/21 21:52:50 CET [2021/08/21 15:52:50 ET]
Table 'Halley' 6-max Seat #1 is the button
Seat 1: pavlo8855 ($2 in chips) 
Seat 2: Scaaalll ($3.52 in chips) 
Seat 3: IWMTW ($0.86 in chips) 
Seat 4: ppluiaule ($2 in chips) 
Seat 5: JessieEnjoy ($3.80 in chips) 
Seat 6: aenehev ($4.52 in chips) 
Scaaalll: posts small blind $0.01
IWMTW: posts big blind $0.02
*** HOLE CARDS ***
Dealt to Scaaalll [As Ac]
ppluiaule: folds 
JessieEnjoy: folds 
aenehev: raises $0.05 to $0.07
pavlo8855: folds 
Scaaalll: raises $0.15 to $0.22
IWMTW: folds 
aenehev: calls $0.15
*** FLOP *** [8s 7h 9s]
Scaaalll: bets $0.24
aenehev: calls $0.24
*** TURN *** [8s 7h 9s] [Qh]
Scaaalll: checks 
aenehev: checks 
*** RIVER *** [8s 7h 9s Qh] [7c]
Scaaalll: bets $0.55
aenehev: raises $0.55 to $1.10
Scaaalll: calls $0.55
*** SHOW DOWN ***
aenehev: shows [7d Td] (three of a kind, Sevens)
Scaaalll: mucks hand 
aenehev collected $3.03 from pot
*** SUMMARY ***
Total pot $3.14 | Rake $0.11 
Board [8s 7h 9s Qh 7c]
Seat 1: pavlo8855 (button) folded before Flop (didn't bet)
Seat 2: Scaaalll (small blind) mucked [As Ac]
Seat 3: IWMTW (big blind) folded before Flop
Seat 4: ppluiaule folded before Flop (didn't bet)
Seat 5: JessieEnjoy folded before Flop (didn't bet)
Seat 6: aenehev showed [7d Td] and won ($3.03) with three of a kind, Sevens



PokerStars Zoom Hand #229230936979:  Hold'em No Limit ($0.01/$0.02) - 2021/08/21 21:54:12 CET [2021/08/21 15:54:12 ET]
Table 'Halley' 6-max Seat #1 is the button
Seat 1: BIITRU ($3.64 in chips) 
Seat 2: Adekvat.ua ($4.13 in chips) 
Seat 3: Scaaalll ($2 in chips) 
Seat 4: JustÁnotherGuy ($2.05 in chips) 
Seat 5: skatocharlie ($2.08 in chips) 
Seat 6: Reipinguimm ($2.10 in chips) 
Adekvat.ua: posts small blind $0.01
Scaaalll: posts big blind $0.02
*** HOLE CARDS ***
Dealt to Scaaalll [Jh 3c]
JustÁnotherGuy: folds 
skatocharlie: folds 
Reipinguimm: raises $0.03 to $0.05
BIITRU: folds 
Adekvat.ua: folds 
Scaaalll: folds 
Uncalled bet ($0.03) returned to Reipinguimm
Reipinguimm collected $0.05 from pot
Reipinguimm: doesn't show hand 
*** SUMMARY ***
Total pot $0.05 | Rake $0 
Seat 1: BIITRU (button) folded before Flop (didn't bet)
Seat 2: Adekvat.ua (small blind) folded before Flop
Seat 3: Scaaalll (big blind) folded before Flop
Seat 4: JustÁnotherGuy folded before Flop (didn't bet)
Seat 5: skatocharlie folded before Flop (didn't bet)
Seat 6: Reipinguimm collected ($0.05)



PokerStars Zoom Hand #229230929729:  Hold'em No Limit ($0.01/$0.02) - 2021/08/21 21:53:56 CET [2021/08/21 15:53:56 ET]
Table 'Halley' 6-max Seat #1 is the button
Seat 1: MIT_PKR ($2.32 in chips) 
Seat 2: Syberya ($1.76 in chips) 
Seat 3: FabOliveira9 ($4.80 in chips) 
Seat 4: fishh_play ($4.11 in chips) 
Seat 5: Jujiluju ($2.74 in chips) 
Seat 6: Scaaalll ($2 in chips) 
Syberya: posts small blind $0.01
FabOliveira9: posts big blind $0.02
*** HOLE CARDS ***
Dealt to Scaaalll [8d 5h]
fishh_play: folds 
Jujiluju: folds 
Scaaalll: folds 
MIT_PKR: raises $0.03 to $0.05
Syberya: raises $0.11 to $0.16
FabOliveira9: folds 
MIT_PKR: folds 
Uncalled bet ($0.11) returned to Syberya
Syberya collected $0.12 from pot
Syberya: doesn't show hand 
*** SUMMARY ***
Total pot $0.12 | Rake $0 
Seat 1: MIT_PKR (button) folded before Flop
Seat 2: Syberya (small blind) collected ($0.12)
Seat 3: FabOliveira9 (big blind) folded before Flop
Seat 4: fishh_play folded before Flop (didn't bet)
Seat 5: Jujiluju folded before Flop (didn't bet)
Seat 6: Scaaalll folded before Flop (didn't bet)



PokerStars Zoom Hand #229230942302:  Hold'em No Limit ($0.01/$0.02) - 2021/08/21 21:54:24 CET [2021/08/21 15:54:24 ET]
Table 'Halley' 6-max Seat #1 is the button
Seat 1: ctaceo ($2.20 in chips) 
Seat 2: SKV_1985 ($2 in chips) 
Seat 3: senornamsen ($1.97 in chips) 
Seat 4: Koldun 2636 ($2.67 in chips) 
Seat 5: Scaaalll ($2 in chips) 
Seat 6: LuckyCheewey ($6.89 in chips) 
SKV_1985: posts small blind $0.01
senornamsen: posts big blind $0.02
*** HOLE CARDS ***
Dealt to Scaaalll [Ac 3c]
Koldun 2636: folds 
Scaaalll: raises $0.04 to $0.06
LuckyCheewey: folds 
ctaceo: folds 
SKV_1985: calls $0.05
senornamsen: folds 
*** FLOP *** [9h Jd 2h]
senornamsen is disconnected 
SKV_1985: checks 
Scaaalll: bets $0.08
SKV_1985: folds 
Uncalled bet ($0.08) returned to Scaaalll
Scaaalll collected $0.14 from pot
Scaaalll: doesn't show hand 
*** SUMMARY ***
Total pot $0.14 | Rake $0 
Board [9h Jd 2h]
Seat 1: ctaceo (button) folded before Flop (didn't bet)
Seat 2: SKV_1985 (small blind) folded on the Flop
Seat 3: senornamsen (big blind) folded before Flop
Seat 4: Koldun 2636 folded before Flop (didn't bet)
Seat 5: Scaaalll collected ($0.14)
Seat 6: LuckyCheewey folded before Flop (didn't bet)



PokerStars Zoom Hand #229230960637:  Hold'em No Limit ($0.01/$0.02) - 2021/08/21 21:55:06 CET [2021/08/21 15:55:06 ET]
Table 'Halley' 6-max Seat #1 is the button
Seat 1: Scaaalll ($2.08 in chips) 
Seat 2: RATAKEY41673 ($4.03 in chips) 
Seat 3: CowboyNicky ($2.07 in chips) 
Seat 4: VasquezSancho96 ($8.30 in chips) 
Seat 5: WithMyWalker ($2.34 in chips) 
Seat 6: boa juice ($2.12 in chips) 
RATAKEY41673: posts small blind $0.01
CowboyNicky: posts big blind $0.02
*** HOLE CARDS ***
Dealt to Scaaalll [7d Ah]
boa juice is disconnected 
VasquezSancho96: raises $0.05 to $0.07
WithMyWalker: folds 
boa juice: folds 
Scaaalll: folds 
RATAKEY41673: folds 
CowboyNicky: calls $0.05
*** FLOP *** [Qd 4d Jd]
CowboyNicky: checks 
VasquezSancho96: bets $0.07
CowboyNicky: folds 
Uncalled bet ($0.07) returned to VasquezSancho96
VasquezSancho96 collected $0.14 from pot
VasquezSancho96: doesn't show hand 
CowboyNicky is disconnected 
*** SUMMARY ***
Total pot $0.15 | Rake $0.01 
Board [Qd 4d Jd]
Seat 1: Scaaalll (button) folded before Flop (didn't bet)
Seat 2: RATAKEY41673 (small blind) folded before Flop
Seat 3: CowboyNicky (big blind) folded on the Flop
Seat 4: VasquezSancho96 collected ($0.14)
Seat 5: WithMyWalker folded before Flop (didn't bet)
Seat 6: boa juice folded before Flop (didn't bet)



PokerStars Zoom Hand #229230966545:  Hold'em No Limit ($0.01/$0.02) - 2021/08/21 21:55:25 CET [2021/08/21 15:55:25 ET]
Table 'Halley' 6-max Seat #1 is the button
Seat 1: 21041956 ($1.84 in chips) 
Seat 2: Scaaalll ($2.08 in chips) 
Seat 3: MSD2006 ($1.98 in chips) 
Seat 4: BexleyBoy ($2.32 in chips) 
Seat 5: SaRCh_Ale ($1.43 in chips) 
Seat 6: Gamer577 ($3.82 in chips) 
Scaaalll: posts small blind $0.01
MSD2006: posts big blind $0.02
*** HOLE CARDS ***
Dealt to Scaaalll [Qd 6c]
BexleyBoy: folds 
SaRCh_Ale: folds 
Gamer577: folds 
21041956: folds 
Scaaalll: folds 
Uncalled bet ($0.01) returned to MSD2006
MSD2006 collected $0.02 from pot
MSD2006: doesn't show hand 
*** SUMMARY ***
Total pot $0.02 | Rake $0 
Seat 1: 21041956 (button) folded before Flop (didn't bet)
Seat 2: Scaaalll (small blind) folded before Flop
Seat 3: MSD2006 (big blind) collected ($0.02)
Seat 4: BexleyBoy folded before Flop (didn't bet)
Seat 5: SaRCh_Ale folded before Flop (didn't bet)
Seat 6: Gamer577 folded before Flop (didn't bet)



PokerStars Zoom Hand #229230963465:  Hold'em No Limit ($0.01/$0.02) - 2021/08/21 21:55:15 CET [2021/08/21 15:55:15 ET]
Table 'Halley' 6-max Seat #1 is the button
Seat 1: IamScald ($2.06 in chips) 
Seat 2: Saint_ANBU ($3.83 in chips) 
Seat 3: melklim ($2.11 in chips) 
Seat 4: Scaaalll ($2.08 in chips) 
Seat 5: ARTMVSLV ($3.77 in chips) 
Seat 6: senornamsen ($1.94 in chips) 
Saint_ANBU: posts small blind $0.01
melklim: posts big blind $0.02
*** HOLE CARDS ***
Dealt to Scaaalll [2h 5c]
Scaaalll: folds 
ARTMVSLV: folds 
senornamsen has timed out
senornamsen: folds 
senornamsen is disconnected 
IamScald: raises $0.04 to $0.06
Saint_ANBU: folds 
melklim: folds 
Uncalled bet ($0.04) returned to IamScald
IamScald collected $0.05 from pot
IamScald: doesn't show hand 
*** SUMMARY ***
Total pot $0.05 | Rake $0 
Seat 1: IamScald (button) collected ($0.05)
Seat 2: Saint_ANBU (small blind) folded before Flop
Seat 3: melklim (big blind) folded before Flop
Seat 4: Scaaalll folded before Flop (didn't bet)
Seat 5: ARTMVSLV folded before Flop (didn't bet)
Seat 6: senornamsen folded before Flop (didn't bet)



PokerStars Zoom Hand #229230967696:  Hold'em No Limit ($0.01/$0.02) - 2021/08/21 21:55:29 CET [2021/08/21 15:55:29 ET]
Table 'Halley' 6-max Seat #1 is the button
Seat 1: EstiBan18 ($2.53 in chips) 
Seat 2: Maximiashka ($1.25 in chips) 
Seat 3: olliejaydee ($2 in chips) 
Seat 4: teutonknight ($2.45 in chips) 
Seat 5: Kreodont1987 ($2 in chips) 
Seat 6: Scaaalll ($2.07 in chips) 
Maximiashka: posts small blind $0.01
olliejaydee: posts big blind $0.02
*** HOLE CARDS ***
Dealt to Scaaalll [3s Th]
teutonknight: raises $0.05 to $0.07
Kreodont1987: folds 
Scaaalll: folds 
EstiBan18: folds 
Maximiashka: folds 
olliejaydee: calls $0.05
*** FLOP *** [Kd 9h 4s]
olliejaydee: checks 
teutonknight: checks 
*** TURN *** [Kd 9h 4s] [9d]
olliejaydee: bets $0.09
teutonknight: calls $0.09
*** RIVER *** [Kd 9h 4s 9d] [5s]
olliejaydee: bets $0.21
teutonknight: calls $0.21
*** SHOW DOWN ***
olliejaydee: shows [2h Ah] (a pair of Nines)
teutonknight: shows [Qh Qd] (two pair, Queens and Nines)
teutonknight collected $0.72 from pot
*** SUMMARY ***
Total pot $0.75 | Rake $0.03 
Board [Kd 9h 4s 9d 5s]
Seat 1: EstiBan18 (button) folded before Flop (didn't bet)
Seat 2: Maximiashka (small blind) folded before Flop
Seat 3: olliejaydee (big blind) showed [2h Ah] and lost with a pair of Nines
Seat 4: teutonknight showed [Qh Qd] and won ($0.72) with two pair, Queens and Nines
Seat 5: Kreodont1987 folded before Flop (didn't bet)
Seat 6: Scaaalll folded before Flop (didn't bet)



PokerStars Zoom Hand #229230973633:  Hold'em No Limit ($0.01/$0.02) - 2021/08/21 21:55:48 CET [2021/08/21 15:55:48 ET]
Table 'Halley' 6-max Seat #1 is the button
Seat 1: Scaaalll ($2.05 in chips) 
Seat 2: zielony ($2.09 in chips) 
Seat 3: AndreaBsAs ($2.72 in chips) 
Seat 4: Gamer577 ($3.02 in chips) 
Seat 5: Iluvatar922 ($9.65 in chips) 
Seat 6: IamScald ($2.09 in chips) 
zielony: posts small blind $0.01
AndreaBsAs: posts big blind $0.02
*** HOLE CARDS ***
Dealt to Scaaalll [Ks 3s]
Gamer577: folds 
Iluvatar922: folds 
IamScald: folds 
IamScald is disconnected 
Scaaalll has timed out
Scaaalll: folds 
zielony: folds 
Uncalled bet ($0.01) returned to AndreaBsAs
AndreaBsAs collected $0.02 from pot
AndreaBsAs: doesn't show hand 
*** SUMMARY ***
Total pot $0.02 | Rake $0 
Seat 1: Scaaalll (button) folded before Flop (didn't bet)
Seat 2: zielony (small blind) folded before Flop
Seat 3: AndreaBsAs (big blind) collected ($0.02)
Seat 4: Gamer577 folded before Flop (didn't bet)
Seat 5: Iluvatar922 folded before Flop (didn't bet)
Seat 6: IamScald folded before Flop (didn't bet)



PokerStars Zoom Hand #229230968925:  Hold'em No Limit ($0.01/$0.02) - 2021/08/21 21:55:32 CET [2021/08/21 15:55:32 ET]
Table 'Halley' 6-max Seat #1 is the button
Seat 1: Kreodont1987 ($5.65 in chips) 
Seat 2: Pechorin.G ($2 in chips) 
Seat 3: Scaaalll ($2.07 in chips) 
Seat 4: IamFixxed ($6.73 in chips) 
Seat 5: ramalhorod ($1.72 in chips) 
Seat 6: kiril688 ($1.39 in chips) 
Pechorin.G: posts small blind $0.01
Scaaalll: posts big blind $0.02
*** HOLE CARDS ***
Dealt to Scaaalll [Qs 7c]
IamFixxed: folds 
ramalhorod: calls $0.02
kiril688: raises $0.05 to $0.07
Kreodont1987: calls $0.07
Pechorin.G: calls $0.06
Scaaalll: folds 
ramalhorod: raises $0.05 to $0.12
kiril688: calls $0.05
Kreodont1987: calls $0.05
Pechorin.G: calls $0.05
*** FLOP *** [Ac Qh 7s]
Pechorin.G: checks 
ramalhorod: checks 
kiril688: checks 
Kreodont1987: bets $0.28
Pechorin.G: folds 
kiril688 is disconnected 
ramalhorod: raises $0.28 to $0.56
kiril688: folds 
Kreodont1987: folds 
Uncalled bet ($0.28) returned to ramalhorod
ramalhorod collected $1.02 from pot
ramalhorod: doesn't show hand 
*** SUMMARY ***
Total pot $1.06 | Rake $0.04 
Board [Ac Qh 7s]
Seat 1: Kreodont1987 (button) folded on the Flop
Seat 2: Pechorin.G (small blind) folded on the Flop
Seat 3: Scaaalll (big blind) folded before Flop
Seat 4: IamFixxed folded before Flop (didn't bet)
Seat 5: ramalhorod collected ($1.02)
Seat 6: kiril688 folded on the Flop



PokerStars Zoom Hand #229230989727:  Hold'em No Limit ($0.01/$0.02) - 2021/08/21 21:56:40 CET [2021/08/21 15:56:40 ET]
Table 'Halley' 6-max Seat #1 is the button
Seat 1: anakondda ($0.94 in chips) 
Seat 2: rodrigoasor ($0.80 in chips) 
Seat 3: alecha11 ($2.39 in chips) 
Seat 4: Clavis Noa ($2.47 in chips) 
Seat 5: Mikmaq Caper ($1.23 in chips) 
Seat 6: Scaaalll ($2.05 in chips) 
rodrigoasor: posts small blind $0.01
alecha11: posts big blind $0.02
*** HOLE CARDS ***
Dealt to Scaaalll [3d 4s]
Mikmaq Caper is disconnected 
Clavis Noa: folds 
Mikmaq Caper: folds 
Scaaalll: folds 
anakondda: folds 
rodrigoasor: folds 
Uncalled bet ($0.01) returned to alecha11
alecha11 collected $0.02 from pot
alecha11: doesn't show hand 
*** SUMMARY ***
Total pot $0.02 | Rake $0 
Seat 1: anakondda (button) folded before Flop (didn't bet)
Seat 2: rodrigoasor (small blind) folded before Flop
Seat 3: alecha11 (big blind) collected ($0.02)
Seat 4: Clavis Noa folded before Flop (didn't bet)
Seat 5: Mikmaq Caper folded before Flop (didn't bet)
Seat 6: Scaaalll folded before Flop (didn't bet)



PokerStars Zoom Hand #229230990970:  Hold'em No Limit ($0.01/$0.02) - 2021/08/21 21:56:44 CET [2021/08/21 15:56:44 ET]
Table 'Halley' 6-max Seat #1 is the button
Seat 1: kiril688 ($1.29 in chips) 
Seat 2: Scaaalll ($2.05 in chips) 
Seat 3: Befinski_K2 ($1.87 in chips) 
Seat 4: ximik D V ($2.56 in chips) 
Seat 5: zinho_83 ($0.93 in chips) 
Seat 6: so0love ($2 in chips) 
Scaaalll: posts small blind $0.01
Befinski_K2: posts big blind $0.02
*** HOLE CARDS ***
Dealt to Scaaalll [7c 7s]
zinho_83 is disconnected 
ximik D V: raises $0.04 to $0.06
zinho_83: folds 
so0love: folds 
kiril688 is disconnected 
kiril688 has timed out while disconnected
kiril688: folds 
Scaaalll: calls $0.05
Befinski_K2: calls $0.04
*** FLOP *** [2s Jd 7h]
Scaaalll: bets $0.12
Befinski_K2: folds 
Befinski_K2 is disconnected 
ximik D V: folds 
Uncalled bet ($0.12) returned to Scaaalll
Scaaalll collected $0.17 from pot
Scaaalll: doesn't show hand 
*** SUMMARY ***
Total pot $0.18 | Rake $0.01 
Board [2s Jd 7h]
Seat 1: kiril688 (button) folded before Flop (didn't bet)
Seat 2: Scaaalll (small blind) collected ($0.17)
Seat 3: Befinski_K2 (big blind) folded on the Flop
Seat 4: ximik D V folded on the Flop
Seat 5: zinho_83 folded before Flop (didn't bet)
Seat 6: so0love folded before Flop (didn't bet)



PokerStars Zoom Hand #229231005691:  Hold'em No Limit ($0.01/$0.02) - 2021/08/21 21:57:31 CET [2021/08/21 15:57:31 ET]
Table 'Halley' 6-max Seat #1 is the button
Seat 1: Nihility77 ($3.05 in chips) 
Seat 2: arrow17 ($2 in chips) 
Seat 3: Richaud ($1.75 in chips) 
Seat 4: igara tigara ($4.92 in chips) 
Seat 5: Scaaalll ($2.16 in chips) 
Seat 6: olga3021221 ($3.81 in chips) 
arrow17: posts small blind $0.01
Richaud: posts big blind $0.02
*** HOLE CARDS ***
Dealt to Scaaalll [8d 8s]
igara tigara: folds 
Scaaalll: raises $0.04 to $0.06
olga3021221: folds 
Nihility77: folds 
arrow17: folds 
Richaud: folds 
Uncalled bet ($0.04) returned to Scaaalll
Scaaalll collected $0.05 from pot
Scaaalll: doesn't show hand 
*** SUMMARY ***
Total pot $0.05 | Rake $0 
Seat 1: Nihility77 (button) folded before Flop (didn't bet)
Seat 2: arrow17 (small blind) folded before Flop
Seat 3: Richaud (big blind) folded before Flop
Seat 4: igara tigara folded before Flop (didn't bet)
Seat 5: Scaaalll collected ($0.05)
Seat 6: olga3021221 folded before Flop (didn't bet)



PokerStars Zoom Hand #229231014226:  Hold'em No Limit ($0.01/$0.02) - 2021/08/21 21:57:58 CET [2021/08/21 15:57:58 ET]
Table 'Halley' 6-max Seat #1 is the button
Seat 1: zbixxx ($2.10 in chips) 
Seat 2: lucksuckdonk ($3.90 in chips) 
Seat 3: A.luckebeggr ($2 in chips) 
Seat 4: GiordanoBrn ($2 in chips) 
Seat 5: Scaaalll ($2.19 in chips) 
Seat 6: SIGREX ($2.05 in chips) 
lucksuckdonk: posts small blind $0.01
A.luckebeggr: posts big blind $0.02
*** HOLE CARDS ***
Dealt to Scaaalll [6h Qc]
GiordanoBrn: folds 
GiordanoBrn is disconnected 
Scaaalll: folds 
SIGREX: folds 
zbixxx: folds 
lucksuckdonk: folds 
Uncalled bet ($0.01) returned to A.luckebeggr
A.luckebeggr collected $0.02 from pot
A.luckebeggr: doesn't show hand 
*** SUMMARY ***
Total pot $0.02 | Rake $0 
Seat 1: zbixxx (button) folded before Flop (didn't bet)
Seat 2: lucksuckdonk (small blind) folded before Flop
Seat 3: A.luckebeggr (big blind) collected ($0.02)
Seat 4: GiordanoBrn folded before Flop (didn't bet)
Seat 5: Scaaalll folded before Flop (didn't bet)
Seat 6: SIGREX folded before Flop (didn't bet)



PokerStars Zoom Hand #229231010398:  Hold'em No Limit ($0.01/$0.02) - 2021/08/21 21:57:46 CET [2021/08/21 15:57:46 ET]
Table 'Halley' 6-max Seat #1 is the button
Seat 1: Scaaalll ($2.19 in chips) 
Seat 2: dicey bear72 ($2.38 in chips) 
Seat 3: gy67 ($2 in chips) 
Seat 4: HDYD18 ($6.48 in chips) 
Seat 5: ximik D V ($2.48 in chips) 
Seat 6: ser313131 ($4.04 in chips) 
dicey bear72: posts small blind $0.01
gy67: posts big blind $0.02
*** HOLE CARDS ***
Dealt to Scaaalll [2h 9d]
HDYD18: folds 
ximik D V: folds 
ser313131: folds 
Scaaalll: folds 
dicey bear72: calls $0.01
gy67: checks 
*** FLOP *** [Ks Qh Jh]
dicey bear72: checks 
gy67: bets $0.06
dicey bear72: calls $0.06
*** TURN *** [Ks Qh Jh] [2c]
dicey bear72: checks 
gy67: bets $0.06
dicey bear72: folds 
Uncalled bet ($0.06) returned to gy67
gy67 collected $0.15 from pot
gy67: doesn't show hand 
dicey bear72 is disconnected 
*** SUMMARY ***
Total pot $0.16 | Rake $0.01 
Board [Ks Qh Jh 2c]
Seat 1: Scaaalll (button) folded before Flop (didn't bet)
Seat 2: dicey bear72 (small blind) folded on the Turn
Seat 3: gy67 (big blind) collected ($0.15)
Seat 4: HDYD18 folded before Flop (didn't bet)
Seat 5: ximik D V folded before Flop (didn't bet)
Seat 6: ser313131 folded before Flop (didn't bet)



PokerStars Zoom Hand #229231016408:  Hold'em No Limit ($0.01/$0.02) - 2021/08/21 21:58:05 CET [2021/08/21 15:58:05 ET]
Table 'Halley' 6-max Seat #1 is the button
Seat 1: belbo888 ($3.32 in chips) 
Seat 2: JCharrod ($3.16 in chips) 
Seat 3: Scaaalll ($2.19 in chips) 
Seat 4: SIGREX ($3.24 in chips) 
Seat 5: JTbukowski ($1.34 in chips) 
Seat 6: rodrigoaduar ($0.88 in chips) 
JCharrod: posts small blind $0.01
Scaaalll: posts big blind $0.02
*** HOLE CARDS ***
Dealt to Scaaalll [3d Jd]
SIGREX: folds 
JTbukowski: calls $0.02
rodrigoaduar is disconnected 
rodrigoaduar: folds 
rodrigoaduar is disconnected 
belbo888: raises $0.06 to $0.08
JCharrod: raises $0.26 to $0.34
Scaaalll: folds 
JTbukowski: calls $0.32
belbo888: calls $0.26
*** FLOP *** [7d 7h 2h]
JCharrod: bets $2.82 and is all-in
JTbukowski: folds 
belbo888: folds 
Uncalled bet ($2.82) returned to JCharrod
JCharrod collected $1 from pot
JCharrod: doesn't show hand 
*** SUMMARY ***
Total pot $1.04 | Rake $0.04 
Board [7d 7h 2h]
Seat 1: belbo888 (button) folded on the Flop
Seat 2: JCharrod (small blind) collected ($1)
Seat 3: Scaaalll (big blind) folded before Flop
Seat 4: SIGREX folded before Flop (didn't bet)
Seat 5: JTbukowski folded on the Flop
Seat 6: rodrigoaduar folded before Flop (didn't bet)



PokerStars Zoom Hand #229231032785:  Hold'em No Limit ($0.01/$0.02) - 2021/08/21 21:58:57 CET [2021/08/21 15:58:57 ET]
Table 'Halley' 6-max Seat #1 is the button
Seat 1: djMegagirl ($1.79 in chips) 
Seat 2: belbo888 ($2.98 in chips) 
Seat 3: hubertott ($2.11 in chips) 
Seat 4: Scaaalll ($2.17 in chips) 
Seat 5: ugi-dugi ($2.06 in chips) 
Seat 6: FabOliveira9 ($3.11 in chips) 
belbo888: posts small blind $0.01
hubertott: posts big blind $0.02
*** HOLE CARDS ***
Dealt to Scaaalll [5h 7h]
Scaaalll: folds 
ugi-dugi: folds 
FabOliveira9: folds 
djMegagirl: folds 
belbo888: folds 
Uncalled bet ($0.01) returned to hubertott
hubertott collected $0.02 from pot
hubertott: doesn't show hand 
*** SUMMARY ***
Total pot $0.02 | Rake $0 
Seat 1: djMegagirl (button) folded before Flop (didn't bet)
Seat 2: belbo888 (small blind) folded before Flop
Seat 3: hubertott (big blind) collected ($0.02)
Seat 4: Scaaalll folded before Flop (didn't bet)
Seat 5: ugi-dugi folded before Flop (didn't bet)
Seat 6: FabOliveira9 folded before Flop (didn't bet)



PokerStars Zoom Hand #229231034015:  Hold'em No Limit ($0.01/$0.02) - 2021/08/21 21:59:01 CET [2021/08/21 15:59:01 ET]
Table 'Halley' 6-max Seat #1 is the button
Seat 1: ARTMVSLV ($2.48 in chips) 
Seat 2: Scaaalll ($2.17 in chips) 
Seat 3: Tietz1990 ($9.35 in chips) 
Seat 4: olga3021221 ($2 in chips) 
Seat 5: Reipinguimm ($2.08 in chips) 
Seat 6: Gerar NB ($2.02 in chips) 
Scaaalll: posts small blind $0.01
Tietz1990: posts big blind $0.02
*** HOLE CARDS ***
Dealt to Scaaalll [9c 2c]
olga3021221: folds 
Reipinguimm: folds 
Gerar NB: folds 
ARTMVSLV: folds 
Scaaalll: folds 
Uncalled bet ($0.01) returned to Tietz1990
Tietz1990 collected $0.02 from pot
Tietz1990: doesn't show hand 
*** SUMMARY ***
Total pot $0.02 | Rake $0 
Seat 1: ARTMVSLV (button) folded before Flop (didn't bet)
Seat 2: Scaaalll (small blind) folded before Flop
Seat 3: Tietz1990 (big blind) collected ($0.02)
Seat 4: olga3021221 folded before Flop (didn't bet)
Seat 5: Reipinguimm folded before Flop (didn't bet)
Seat 6: Gerar NB folded before Flop (didn't bet)



PokerStars Zoom Hand #229231028715:  Hold'em No Limit ($0.01/$0.02) - 2021/08/21 21:58:44 CET [2021/08/21 15:58:44 ET]
Table 'Halley' 6-max Seat #1 is the button
Seat 1: trasi1e ($0.30 in chips) 
Seat 2: amario89 ($2.36 in chips) 
Seat 3: Nihility77 ($2.99 in chips) 
Seat 4: HDYD18 ($6.11 in chips) 
Seat 5: AlexGTPS ($3.09 in chips) 
Seat 6: Scaaalll ($2.17 in chips) 
amario89: posts small blind $0.01
Nihility77: posts big blind $0.02
*** HOLE CARDS ***
Dealt to Scaaalll [9s 5d]
HDYD18: folds 
AlexGTPS: raises $0.03 to $0.05
Scaaalll: folds 
trasi1e: calls $0.05
amario89: folds 
Nihility77: folds 
*** FLOP *** [2h 7s Jd]
AlexGTPS: bets $0.07
trasi1e: calls $0.07
*** TURN *** [2h 7s Jd] [5h]
AlexGTPS: checks 
trasi1e: checks 
*** RIVER *** [2h 7s Jd 5h] [7d]
AlexGTPS: checks 
trasi1e: checks 
*** SHOW DOWN ***
AlexGTPS: shows [As Qd] (a pair of Sevens)
trasi1e: mucks hand 
AlexGTPS collected $0.26 from pot
*** SUMMARY ***
Total pot $0.27 | Rake $0.01 
Board [2h 7s Jd 5h 7d]
Seat 1: trasi1e (button) mucked [9h 6c]
Seat 2: amario89 (small blind) folded before Flop
Seat 3: Nihility77 (big blind) folded before Flop
Seat 4: HDYD18 folded before Flop (didn't bet)
Seat 5: AlexGTPS showed [As Qd] and won ($0.26) with a pair of Sevens
Seat 6: Scaaalll folded before Flop (didn't bet)



PokerStars Zoom Hand #229231031234:  Hold'em No Limit ($0.01/$0.02) - 2021/08/21 21:58:52 CET [2021/08/21 15:58:52 ET]
Table 'Halley' 6-max Seat #1 is the button
Seat 1: tomsa01 ($1.09 in chips) 
Seat 2: anakondda ($0.83 in chips) 
Seat 3: Draat505 ($2.85 in chips) 
Seat 4: Player XVII ($2.03 in chips) 
Seat 5: Scaaalll ($2.17 in chips) 
Seat 6: fishh_play ($5.71 in chips) 
anakondda: posts small blind $0.01
Draat505: posts big blind $0.02
*** HOLE CARDS ***
Dealt to Scaaalll [Qd 7s]
tomsa01 is disconnected 
Player XVII: folds 
Scaaalll: folds 
fishh_play: folds 
tomsa01: folds 
anakondda: calls $0.01
Draat505: raises $0.06 to $0.08
anakondda: calls $0.06
*** FLOP *** [Ad Jd Qs]
anakondda: checks 
Draat505: bets $0.11
anakondda: calls $0.11
*** TURN *** [Ad Jd Qs] [7h]
anakondda: checks 
Draat505: bets $0.64
anakondda: folds 
Uncalled bet ($0.64) returned to Draat505
Draat505 collected $0.37 from pot
Draat505: doesn't show hand 
*** SUMMARY ***
Total pot $0.38 | Rake $0.01 
Board [Ad Jd Qs 7h]
Seat 1: tomsa01 (button) folded before Flop (didn't bet)
Seat 2: anakondda (small blind) folded on the Turn
Seat 3: Draat505 (big blind) collected ($0.37)
Seat 4: Player XVII folded before Flop (didn't bet)
Seat 5: Scaaalll folded before Flop (didn't bet)
Seat 6: fishh_play folded before Flop (didn't bet)



PokerStars Zoom Hand #229231026843:  Hold'em No Limit ($0.01/$0.02) - 2021/08/21 21:58:38 CET [2021/08/21 15:58:38 ET]
Table 'Halley' 6-max Seat #1 is the button
Seat 1: Blaackie ($2.06 in chips) 
Seat 2: Tomiclashgolf ($1.98 in chips) 
Seat 3: skatocharlie ($2.76 in chips) 
Seat 4: Scaaalll ($2.17 in chips) 
Seat 5: dcd113 ($2.87 in chips) 
Seat 6: hubertott ($2.49 in chips) 
Tomiclashgolf: posts small blind $0.01
skatocharlie: posts big blind $0.02
*** HOLE CARDS ***
Dealt to Scaaalll [Kc 7s]
Scaaalll: folds 
dcd113: folds 
hubertott: folds 
Blaackie: raises $0.02 to $0.04
Tomiclashgolf: folds 
skatocharlie: calls $0.02
*** FLOP *** [Jd 3h 3s]
skatocharlie: checks 
Blaackie: bets $0.03
skatocharlie: calls $0.03
*** TURN *** [Jd 3h 3s] [Ah]
skatocharlie: checks 
Blaackie: checks 
*** RIVER *** [Jd 3h 3s Ah] [Jc]
skatocharlie: checks 
Blaackie: checks 
*** SHOW DOWN ***
skatocharlie: shows [Ad Th] (two pair, Aces and Jacks)
Blaackie: mucks hand 
skatocharlie collected $0.14 from pot
*** SUMMARY ***
Total pot $0.15 | Rake $0.01 
Board [Jd 3h 3s Ah Jc]
Seat 1: Blaackie (button) mucked [4c 4d]
Seat 2: Tomiclashgolf (small blind) folded before Flop
Seat 3: skatocharlie (big blind) showed [Ad Th] and won ($0.14) with two pair, Aces and Jacks
Seat 4: Scaaalll folded before Flop (didn't bet)
Seat 5: dcd113 folded before Flop (didn't bet)
Seat 6: hubertott folded before Flop (didn't bet)



PokerStars Zoom Hand #229231035584:  Hold'em No Limit ($0.01/$0.02) - 2021/08/21 21:59:06 CET [2021/08/21 15:59:06 ET]
Table 'Halley' 6-max Seat #1 is the button
Seat 1: Scaaalll ($2.16 in chips) 
Seat 2: Plmax94 ($1.36 in chips) 
Seat 3: melklim ($2 in chips) 
Seat 4: kahzura ($2.03 in chips) 
Seat 5: Sinad1302 ($2.45 in chips) 
Seat 6: Nihility77 ($4.78 in chips) 
Plmax94: posts small blind $0.01
melklim: posts big blind $0.02
*** HOLE CARDS ***
Dealt to Scaaalll [Jh Th]
kahzura: folds 
Sinad1302 has timed out
Sinad1302: folds 
Sinad1302 is disconnected 
Nihility77: raises $0.03 to $0.05
Scaaalll: calls $0.05
Plmax94: folds 
melklim: calls $0.03
*** FLOP *** [Ts Qd Ah]
melklim: checks 
Nihility77: checks 
Scaaalll: checks 
*** TURN *** [Ts Qd Ah] [Td]
melklim: checks 
Nihility77: checks 
Scaaalll: bets $0.10
melklim: folds 
Nihility77: folds 
Uncalled bet ($0.10) returned to Scaaalll
Scaaalll collected $0.15 from pot
Scaaalll: doesn't show hand 
*** SUMMARY ***
Total pot $0.16 | Rake $0.01 
Board [Ts Qd Ah Td]
Seat 1: Scaaalll (button) collected ($0.15)
Seat 2: Plmax94 (small blind) folded before Flop
Seat 3: melklim (big blind) folded on the Turn
Seat 4: kahzura folded before Flop (didn't bet)
Seat 5: Sinad1302 folded before Flop (didn't bet)
Seat 6: Nihility77 folded on the Turn



PokerStars Zoom Hand #229231051805:  Hold'em No Limit ($0.01/$0.02) - 2021/08/21 21:59:58 CET [2021/08/21 15:59:58 ET]
Table 'Halley' 6-max Seat #1 is the button
Seat 1: Wegezin ($2.59 in chips) 
Seat 2: maliniak75 ($1.26 in chips) 
Seat 3: Scaaalll ($2.26 in chips) 
Seat 4: DaporteWins ($2.21 in chips) 
Seat 5: Koldun 2636 ($4.66 in chips) 
Seat 6: Reipinguimm ($2 in chips) 
maliniak75: posts small blind $0.01
Scaaalll: posts big blind $0.02
*** HOLE CARDS ***
Dealt to Scaaalll [Kc Ac]
DaporteWins: folds 
Koldun 2636: folds 
Reipinguimm: folds 
Wegezin: folds 
maliniak75: folds 
Uncalled bet ($0.01) returned to Scaaalll
Scaaalll collected $0.02 from pot
Scaaalll: doesn't show hand 
*** SUMMARY ***
Total pot $0.02 | Rake $0 
Seat 1: Wegezin (button) folded before Flop (didn't bet)
Seat 2: maliniak75 (small blind) folded before Flop
Seat 3: Scaaalll (big blind) collected ($0.02)
Seat 4: DaporteWins folded before Flop (didn't bet)
Seat 5: Koldun 2636 folded before Flop (didn't bet)
Seat 6: Reipinguimm folded before Flop (didn't bet)



PokerStars Zoom Hand #229231055669:  Hold'em No Limit ($0.01/$0.02) - 2021/08/21 22:00:09 CET [2021/08/21 16:00:09 ET]
Table 'Halley' 6-max Seat #1 is the button
Seat 1: Pechorin.G ($2.22 in chips) 
Seat 2: G1olight ($5 in chips) 
Seat 3: artbiart ($0.64 in chips) 
Seat 4: pipecmolodec ($2.05 in chips) 
Seat 5: Scaaalll ($2.27 in chips) 
Seat 6: snowy_96 ($2 in chips) 
G1olight: posts small blind $0.01
artbiart: posts big blind $0.02
*** HOLE CARDS ***
Dealt to Scaaalll [6d 3h]
G1olight is disconnected 
pipecmolodec: folds 
Scaaalll: folds 
snowy_96: folds 
Pechorin.G: folds 
G1olight: folds 
Uncalled bet ($0.01) returned to artbiart
artbiart collected $0.02 from pot
artbiart: doesn't show hand 
*** SUMMARY ***
Total pot $0.02 | Rake $0 
Seat 1: Pechorin.G (button) folded before Flop (didn't bet)
Seat 2: G1olight (small blind) folded before Flop
Seat 3: artbiart (big blind) collected ($0.02)
Seat 4: pipecmolodec folded before Flop (didn't bet)
Seat 5: Scaaalll folded before Flop (didn't bet)
Seat 6: snowy_96 folded before Flop (didn't bet)



PokerStars Zoom Hand #229231058940:  Hold'em No Limit ($0.01/$0.02) - 2021/08/21 22:00:19 CET [2021/08/21 16:00:19 ET]
Table 'Halley' 6-max Seat #1 is the button
Seat 1: JTbukowski ($1.10 in chips) 
Seat 2: Scaaalll ($2.27 in chips) 
Seat 3: KoAlRy ($2.13 in chips) 
Seat 4: Iluvatar922 ($9.27 in chips) 
Seat 5: Amigo113 ($2.18 in chips) 
Seat 6: maaitee ($2.15 in chips) 
Scaaalll: posts small blind $0.01
KoAlRy: posts big blind $0.02
*** HOLE CARDS ***
Dealt to Scaaalll [Ah 4s]
Iluvatar922: folds 
Amigo113: folds 
maaitee: folds 
JTbukowski: folds 
Scaaalll: folds 
Uncalled bet ($0.01) returned to KoAlRy
KoAlRy collected $0.02 from pot
KoAlRy: doesn't show hand 
*** SUMMARY ***
Total pot $0.02 | Rake $0 
Seat 1: JTbukowski (button) folded before Flop (didn't bet)
Seat 2: Scaaalll (small blind) folded before Flop
Seat 3: KoAlRy (big blind) collected ($0.02)
Seat 4: Iluvatar922 folded before Flop (didn't bet)
Seat 5: Amigo113 folded before Flop (didn't bet)
Seat 6: maaitee folded before Flop (didn't bet)



PokerStars Zoom Hand #229231066271:  Hold'em No Limit ($0.01/$0.02) - 2021/08/21 22:00:40 CET [2021/08/21 16:00:40 ET]
Table 'Halley' 6-max Seat #1 is the button
Seat 1: kboskov123 ($1.79 in chips) 
Seat 2: xmaksimus ($2.06 in chips) 
Seat 3: JannikSPoker ($2.21 in chips) 
Seat 4: A.luckebeggr ($2.77 in chips) 
Seat 5: SKV_1985 ($2.73 in chips) 
Seat 6: Scaaalll ($2.26 in chips) 
xmaksimus: posts small blind $0.01
JannikSPoker: posts big blind $0.02
*** HOLE CARDS ***
Dealt to Scaaalll [Qc 6s]
A.luckebeggr: raises $0.02 to $0.04
SKV_1985: folds 
Scaaalll: folds 
kboskov123: folds 
JannikSPoker is disconnected 
xmaksimus: folds 
JannikSPoker: folds 
Uncalled bet ($0.02) returned to A.luckebeggr
A.luckebeggr collected $0.05 from pot
A.luckebeggr: doesn't show hand 
*** SUMMARY ***
Total pot $0.05 | Rake $0 
Seat 1: kboskov123 (button) folded before Flop (didn't bet)
Seat 2: xmaksimus (small blind) folded before Flop
Seat 3: JannikSPoker (big blind) folded before Flop
Seat 4: A.luckebeggr collected ($0.05)
Seat 5: SKV_1985 folded before Flop (didn't bet)
Seat 6: Scaaalll folded before Flop (didn't bet)



PokerStars Zoom Hand #229231064126:  Hold'em No Limit ($0.01/$0.02) - 2021/08/21 22:00:34 CET [2021/08/21 16:00:34 ET]
Table 'Halley' 6-max Seat #1 is the button
Seat 1: pavlo8855 ($2.23 in chips) 
Seat 2: JustGums ($0.87 in chips) 
Seat 3: Aho1337 ($3.44 in chips) 
Seat 4: Scaaalll ($2.26 in chips) 
Seat 5: usenovm ($3.30 in chips) 
Seat 6: kresooo ($1.56 in chips) 
JustGums: posts small blind $0.01
Aho1337: posts big blind $0.02
*** HOLE CARDS ***
Dealt to Scaaalll [4c Td]
Scaaalll: folds 
usenovm: folds 
kresooo: folds 
pavlo8855: raises $0.03 to $0.05
JustGums: calls $0.04
Aho1337: calls $0.03
*** FLOP *** [Th Qh 7c]
JustGums: bets $0.02
Aho1337: calls $0.02
pavlo8855: calls $0.02
*** TURN *** [Th Qh 7c] [Ad]
JustGums: bets $0.04
Aho1337: folds 
pavlo8855: calls $0.04
*** RIVER *** [Th Qh 7c Ad] [Js]
JustGums: bets $0.06
pavlo8855: calls $0.06
*** SHOW DOWN ***
JustGums: shows [Qd 8s] (a pair of Queens)
pavlo8855: shows [6d Ah] (a pair of Aces)
pavlo8855 collected $0.40 from pot
*** SUMMARY ***
Total pot $0.41 | Rake $0.01 
Board [Th Qh 7c Ad Js]
Seat 1: pavlo8855 (button) showed [6d Ah] and won ($0.40) with a pair of Aces
Seat 2: JustGums (small blind) showed [Qd 8s] and lost with a pair of Queens
Seat 3: Aho1337 (big blind) folded on the Turn
Seat 4: Scaaalll folded before Flop (didn't bet)
Seat 5: usenovm folded before Flop (didn't bet)
Seat 6: kresooo folded before Flop (didn't bet)



PokerStars Zoom Hand #229231068487:  Hold'em No Limit ($0.01/$0.02) - 2021/08/21 22:00:46 CET [2021/08/21 16:00:46 ET]
Table 'Halley' 6-max Seat #1 is the button
Seat 1: Scaaalll ($2.26 in chips) 
Seat 2: ppluiaule ($3.88 in chips) 
Seat 3: Gyapszi958 ($1.64 in chips) 
Seat 4: Koldun 2636 ($2.64 in chips) 
Seat 5: maliniak75 ($1.17 in chips) 
Seat 6: nodtress ($2.47 in chips) 
ppluiaule: posts small blind $0.01
Gyapszi958: posts big blind $0.02
*** HOLE CARDS ***
Dealt to Scaaalll [4d Ks]
Koldun 2636: folds 
maliniak75: calls $0.02
nodtress: raises $0.04 to $0.06
Scaaalll: folds 
ppluiaule: folds 
Gyapszi958: folds 
maliniak75: calls $0.04
*** FLOP *** [6h Kd Kc]
maliniak75: checks 
nodtress: bets $0.05
maliniak75: folds 
Uncalled bet ($0.05) returned to nodtress
nodtress collected $0.14 from pot
nodtress: doesn't show hand 
*** SUMMARY ***
Total pot $0.15 | Rake $0.01 
Board [6h Kd Kc]
Seat 1: Scaaalll (button) folded before Flop (didn't bet)
Seat 2: ppluiaule (small blind) folded before Flop
Seat 3: Gyapszi958 (big blind) folded before Flop
Seat 4: Koldun 2636 folded before Flop (didn't bet)
Seat 5: maliniak75 folded on the Flop
Seat 6: nodtress collected ($0.14)



PokerStars Zoom Hand #229231087809:  Hold'em No Limit ($0.01/$0.02) - 2021/08/21 22:01:27 CET [2021/08/21 16:01:27 ET]
Table 'Halley' 6-max Seat #1 is the button
Seat 1: BlackhawKK's ($3.26 in chips) 
Seat 2: Scaaalll ($2.24 in chips) 
Seat 3: lucksuckdonk ($4.19 in chips) 
Seat 4: RrriotGrrrl ($9.72 in chips) 
Seat 5: tolstii906 ($3.58 in chips) 
Seat 6: LuckyCheewey ($7.01 in chips) 
Scaaalll: posts small blind $0.01
lucksuckdonk: posts big blind $0.02
*** HOLE CARDS ***
Dealt to Scaaalll [2d Qs]
RrriotGrrrl: folds 
tolstii906: raises $0.02 to $0.04
LuckyCheewey: folds 
BlackhawKK's: folds 
Scaaalll: folds 
lucksuckdonk: folds 
Uncalled bet ($0.02) returned to tolstii906
tolstii906 collected $0.05 from pot
tolstii906: doesn't show hand 
*** SUMMARY ***
Total pot $0.05 | Rake $0 
Seat 1: BlackhawKK's (button) folded before Flop (didn't bet)
Seat 2: Scaaalll (small blind) folded before Flop
Seat 3: lucksuckdonk (big blind) folded before Flop
Seat 4: RrriotGrrrl folded before Flop (didn't bet)
Seat 5: tolstii906 collected ($0.05)
Seat 6: LuckyCheewey folded before Flop (didn't bet)



PokerStars Zoom Hand #229231085712:  Hold'em No Limit ($0.01/$0.02) - 2021/08/21 22:01:22 CET [2021/08/21 16:01:22 ET]
Table 'Halley' 6-max Seat #1 is the button
Seat 1: Alex Koshva1 ($2.36 in chips) 
Seat 2: Irorek6643 ($1.36 in chips) 
Seat 3: Hantsirg ($0.63 in chips) 
Seat 4: maaitee ($2.77 in chips) 
Seat 5: hubertott ($2.23 in chips) 
Seat 6: Scaaalll ($2.24 in chips) 
Irorek6643: posts small blind $0.01
Hantsirg: posts big blind $0.02
*** HOLE CARDS ***
Dealt to Scaaalll [6c Js]
maaitee: raises $0.04 to $0.06
hubertott: folds 
Scaaalll: folds 
Alex Koshva1: folds 
Hantsirg is disconnected 
Irorek6643: calls $0.05
Hantsirg: folds 
*** FLOP *** [5s 4h Jc]
Irorek6643: checks 
maaitee: bets $0.11
Irorek6643: folds 
Uncalled bet ($0.11) returned to maaitee
maaitee collected $0.14 from pot
maaitee: doesn't show hand 
Irorek6643 is disconnected 
*** SUMMARY ***
Total pot $0.14 | Rake $0 
Board [5s 4h Jc]
Seat 1: Alex Koshva1 (button) folded before Flop (didn't bet)
Seat 2: Irorek6643 (small blind) folded on the Flop
Seat 3: Hantsirg (big blind) folded before Flop
Seat 4: maaitee collected ($0.14)
Seat 5: hubertott folded before Flop (didn't bet)
Seat 6: Scaaalll folded before Flop (didn't bet)



PokerStars Zoom Hand #229231073091:  Hold'em No Limit ($0.01/$0.02) - 2021/08/21 22:00:58 CET [2021/08/21 16:00:58 ET]
Table 'Halley' 6-max Seat #1 is the button
Seat 1: Henry Chinasky ($5.45 in chips) 
Seat 2: wieksi9845 ($0.64 in chips) 
Seat 3: Scaaalll ($2.26 in chips) 
Seat 4: Mikeloko182 ($2.17 in chips) 
Seat 5: LyahovIvan ($0.37 in chips) 
Seat 6: olliejaydee ($3.53 in chips) 
wieksi9845: posts small blind $0.01
Scaaalll: posts big blind $0.02
*** HOLE CARDS ***
Dealt to Scaaalll [7d 6h]
Mikeloko182: folds 
LyahovIvan: folds 
olliejaydee: raises $0.03 to $0.05
Henry Chinasky: folds 
wieksi9845: calls $0.04
Scaaalll: folds 
*** FLOP *** [3s 4c 3c]
wieksi9845: checks 
olliejaydee: bets $0.06
wieksi9845: folds 
Uncalled bet ($0.06) returned to olliejaydee
olliejaydee collected $0.12 from pot
olliejaydee: doesn't show hand 
wieksi9845 is disconnected 
*** SUMMARY ***
Total pot $0.12 | Rake $0 
Board [3s 4c 3c]
Seat 1: Henry Chinasky (button) folded before Flop (didn't bet)
Seat 2: wieksi9845 (small blind) folded on the Flop
Seat 3: Scaaalll (big blind) folded before Flop
Seat 4: Mikeloko182 folded before Flop (didn't bet)
Seat 5: LyahovIvan folded before Flop (didn't bet)
Seat 6: olliejaydee collected ($0.12)



PokerStars Zoom Hand #229231091165:  Hold'em No Limit ($0.01/$0.02) - 2021/08/21 22:01:35 CET [2021/08/21 16:01:35 ET]
Table 'Halley' 6-max Seat #1 is the button
Seat 1: Scaaalll ($2.23 in chips) 
Seat 2: Emilmoller1 ($2.01 in chips) 
Seat 3: AlexGTPS ($1.86 in chips) 
Seat 4: HDYD18 ($6.04 in chips) 
Seat 5: ADWish ($1.83 in chips) 
Seat 6: 365p2eva ($2.11 in chips) 
Emilmoller1: posts small blind $0.01
AlexGTPS: posts big blind $0.02
*** HOLE CARDS ***
Dealt to Scaaalll [3c Qd]
HDYD18: folds 
ADWish: folds 
365p2eva: folds 
Scaaalll: folds 
Emilmoller1: raises $0.02 to $0.04
AlexGTPS: folds 
Uncalled bet ($0.02) returned to Emilmoller1
Emilmoller1 collected $0.04 from pot
Emilmoller1: doesn't show hand 
*** SUMMARY ***
Total pot $0.04 | Rake $0 
Seat 1: Scaaalll (button) folded before Flop (didn't bet)
Seat 2: Emilmoller1 (small blind) collected ($0.04)
Seat 3: AlexGTPS (big blind) folded before Flop
Seat 4: HDYD18 folded before Flop (didn't bet)
Seat 5: ADWish folded before Flop (didn't bet)
Seat 6: 365p2eva folded before Flop (didn't bet)



PokerStars Zoom Hand #229231092720:  Hold'em No Limit ($0.01/$0.02) - 2021/08/21 22:01:39 CET [2021/08/21 16:01:39 ET]
Table 'Halley' 6-max Seat #1 is the button
Seat 1: gugamoraes ($2 in chips) 
Seat 2: SKV_1985 ($2.21 in chips) 
Seat 3: Scaaalll ($2.23 in chips) 
Seat 4: 365p2eva ($2.11 in chips) 
Seat 5: rpycmbEM ($2.31 in chips) 
Seat 6: EmperorKurr ($2.44 in chips) 
SKV_1985: posts small blind $0.01
Scaaalll: posts big blind $0.02
*** HOLE CARDS ***
Dealt to Scaaalll [2s Td]
365p2eva: folds 
rpycmbEM: folds 
EmperorKurr: raises $0.04 to $0.06
gugamoraes: folds 
SKV_1985: raises $0.18 to $0.24
Scaaalll: folds 
EmperorKurr: folds 
Uncalled bet ($0.18) returned to SKV_1985
SKV_1985 collected $0.14 from pot
SKV_1985: doesn't show hand 
*** SUMMARY ***
Total pot $0.14 | Rake $0 
Seat 1: gugamoraes (button) folded before Flop (didn't bet)
Seat 2: SKV_1985 (small blind) collected ($0.14)
Seat 3: Scaaalll (big blind) folded before Flop
Seat 4: 365p2eva folded before Flop (didn't bet)
Seat 5: rpycmbEM folded before Flop (didn't bet)
Seat 6: EmperorKurr folded before Flop



PokerStars Zoom Hand #229231083268:  Hold'em No Limit ($0.01/$0.02) - 2021/08/21 22:01:16 CET [2021/08/21 16:01:16 ET]
Table 'Halley' 6-max Seat #1 is the button
Seat 1: bananAAbandit ($2.91 in chips) 
Seat 2: malandro733 ($4.87 in chips) 
Seat 3: Fanatspartak ($1.77 in chips) 
Seat 4: Koldun 2636 ($2.31 in chips) 
Seat 5: Scaaalll ($2.24 in chips) 
Seat 6: thekidisnuts ($4.19 in chips) 
malandro733: posts small blind $0.01
Fanatspartak: posts big blind $0.02
*** HOLE CARDS ***
Dealt to Scaaalll [4d Jd]
Koldun 2636: folds 
Scaaalll: folds 
thekidisnuts: folds 
bananAAbandit: raises $0.04 to $0.06
malandro733: folds 
Fanatspartak: calls $0.04
*** FLOP *** [2d 4h 9s]
Fanatspartak: bets $0.07
bananAAbandit: folds 
Uncalled bet ($0.07) returned to Fanatspartak
Fanatspartak collected $0.13 from pot
Fanatspartak: doesn't show hand 
*** SUMMARY ***
Total pot $0.13 | Rake $0 
Board [2d 4h 9s]
Seat 1: bananAAbandit (button) folded on the Flop
Seat 2: malandro733 (small blind) folded before Flop
Seat 3: Fanatspartak (big blind) collected ($0.13)
Seat 4: Koldun 2636 folded before Flop (didn't bet)
Seat 5: Scaaalll folded before Flop (didn't bet)
Seat 6: thekidisnuts folded before Flop (didn't bet)



PokerStars Zoom Hand #229231099064:  Hold'em No Limit ($0.01/$0.02) - 2021/08/21 22:01:54 CET [2021/08/21 16:01:54 ET]
Table 'Halley' 6-max Seat #1 is the button
Seat 1: nippurkaunas ($1.10 in chips) 
Seat 2: HellNative ($2.21 in chips) 
Seat 3: pavlo590 ($1.64 in chips) 
Seat 4: Matias Jesus N ($0.88 in chips) 
Seat 5: Luben_76 ($1.80 in chips) 
Seat 6: Scaaalll ($2.21 in chips) 
HellNative: posts small blind $0.01
pavlo590: posts big blind $0.02
*** HOLE CARDS ***
Dealt to Scaaalll [Jd 8c]
Matias Jesus N: folds 
Luben_76: folds 
Scaaalll: folds 
nippurkaunas: folds 
HellNative: folds 
Uncalled bet ($0.01) returned to pavlo590
pavlo590 collected $0.02 from pot
pavlo590: doesn't show hand 
*** SUMMARY ***
Total pot $0.02 | Rake $0 
Seat 1: nippurkaunas (button) folded before Flop (didn't bet)
Seat 2: HellNative (small blind) folded before Flop
Seat 3: pavlo590 (big blind) collected ($0.02)
Seat 4: Matias Jesus N folded before Flop (didn't bet)
Seat 5: Luben_76 folded before Flop (didn't bet)
Seat 6: Scaaalll folded before Flop (didn't bet)



PokerStars Zoom Hand #229231103522:  Hold'em No Limit ($0.01/$0.02) - 2021/08/21 22:02:04 CET [2021/08/21 16:02:04 ET]
Table 'Halley' 6-max Seat #1 is the button
Seat 1: Ufiltreret ($5.61 in chips) 
Seat 2: Scaaalll ($2.21 in chips) 
Seat 3: gds2003 ($1.53 in chips) 
Seat 4: valet_hai ($1.15 in chips) 
Seat 5: EevAA190 ($2.22 in chips) 
Seat 6: Mikmaq Caper ($0.95 in chips) 
Scaaalll: posts small blind $0.01
gds2003: posts big blind $0.02
*** HOLE CARDS ***
Dealt to Scaaalll [2s 5s]
valet_hai: calls $0.02
Mikmaq Caper is disconnected 
EevAA190: folds 
Mikmaq Caper: folds 
Ufiltreret: folds 
Scaaalll: folds 
gds2003: checks 
*** FLOP *** [5h 2c 2d]
gds2003: checks 
valet_hai: checks 
*** TURN *** [5h 2c 2d] [3d]
gds2003: bets $0.02
valet_hai: calls $0.02
*** RIVER *** [5h 2c 2d 3d] [Ts]
gds2003: bets $0.02
valet_hai: raises $0.02 to $0.04
gds2003: calls $0.02
*** SHOW DOWN ***
valet_hai: shows [Qd Kc] (a pair of Deuces)
gds2003: shows [3s 8h] (two pair, Threes and Deuces)
gds2003 collected $0.16 from pot
*** SUMMARY ***
Total pot $0.17 | Rake $0.01 
Board [5h 2c 2d 3d Ts]
Seat 1: Ufiltreret (button) folded before Flop (didn't bet)
Seat 2: Scaaalll (small blind) folded before Flop
Seat 3: gds2003 (big blind) showed [3s 8h] and won ($0.16) with two pair, Threes and Deuces
Seat 4: valet_hai showed [Qd Kc] and lost with a pair of Deuces
Seat 5: EevAA190 folded before Flop (didn't bet)
Seat 6: Mikmaq Caper folded before Flop (didn't bet)



PokerStars Zoom Hand #229231110315:  Hold'em No Limit ($0.01/$0.02) - 2021/08/21 22:02:19 CET [2021/08/21 16:02:19 ET]
Table 'Halley' 6-max Seat #1 is the button
Seat 1: Scaaalll ($2.20 in chips) 
Seat 2: Nihility77 ($4.36 in chips) 
Seat 3: gugamoraes ($2 in chips) 
Seat 4: Aho1337 ($2.24 in chips) 
Seat 5: keldh ($5.40 in chips) 
Seat 6: Mikeloko182 ($2.13 in chips) 
Nihility77: posts small blind $0.01
gugamoraes: posts big blind $0.02
*** HOLE CARDS ***
Dealt to Scaaalll [Kh 9c]
Aho1337: folds 
keldh: folds 
Mikeloko182: folds 
Scaaalll: raises $0.02 to $0.04
Nihility77: folds 
gugamoraes: folds 
Uncalled bet ($0.02) returned to Scaaalll
Scaaalll collected $0.05 from pot
Scaaalll: doesn't show hand 
*** SUMMARY ***
Total pot $0.05 | Rake $0 
Seat 1: Scaaalll (button) collected ($0.05)
Seat 2: Nihility77 (small blind) folded before Flop
Seat 3: gugamoraes (big blind) folded before Flop
Seat 4: Aho1337 folded before Flop (didn't bet)
Seat 5: keldh folded before Flop (didn't bet)
Seat 6: Mikeloko182 folded before Flop (didn't bet)



PokerStars Zoom Hand #229231118073:  Hold'em No Limit ($0.01/$0.02) - 2021/08/21 22:02:37 CET [2021/08/21 16:02:37 ET]
Table 'Halley' 6-max Seat #1 is the button
Seat 1: CowboyNicky ($1.48 in chips) 
Seat 2: thekidisnuts ($2.07 in chips) 
Seat 3: rekopo203 ($2 in chips) 
Seat 4: DPQQ335 ($2.73 in chips) 
Seat 5: Sergant20081 ($2.14 in chips) 
Seat 6: Scaaalll ($2.23 in chips) 
thekidisnuts: posts small blind $0.01
rekopo203: posts big blind $0.02
*** HOLE CARDS ***
Dealt to Scaaalll [Js 6h]
CowboyNicky is disconnected 
DPQQ335: folds 
Sergant20081: folds 
Scaaalll: folds 
CowboyNicky: folds 
thekidisnuts: raises $0.04 to $0.06
rekopo203: folds 
Uncalled bet ($0.04) returned to thekidisnuts
thekidisnuts collected $0.04 from pot
thekidisnuts: doesn't show hand 
*** SUMMARY ***
Total pot $0.04 | Rake $0 
Seat 1: CowboyNicky (button) folded before Flop (didn't bet)
Seat 2: thekidisnuts (small blind) collected ($0.04)
Seat 3: rekopo203 (big blind) folded before Flop
Seat 4: DPQQ335 folded before Flop (didn't bet)
Seat 5: Sergant20081 folded before Flop (didn't bet)
Seat 6: Scaaalll folded before Flop (didn't bet)



PokerStars Zoom Hand #229231120618:  Hold'em No Limit ($0.01/$0.02) - 2021/08/21 22:02:43 CET [2021/08/21 16:02:43 ET]
Table 'Halley' 6-max Seat #1 is the button
Seat 1: PapiMik3 ($6.75 in chips) 
Seat 2: fishh_play ($5.21 in chips) 
Seat 3: Scaaalll ($2.23 in chips) 
Seat 4: olliejaydee ($3.51 in chips) 
Seat 5: BexleyBoy ($2.94 in chips) 
Seat 6: Feliciano16 ($4.92 in chips) 
fishh_play: posts small blind $0.01
Scaaalll: posts big blind $0.02
*** HOLE CARDS ***
Dealt to Scaaalll [3h 3d]
olliejaydee: folds 
BexleyBoy: folds 
Feliciano16: folds 
PapiMik3: folds 
fishh_play: folds 
Uncalled bet ($0.01) returned to Scaaalll
Scaaalll collected $0.02 from pot
Scaaalll: doesn't show hand 
*** SUMMARY ***
Total pot $0.02 | Rake $0 
Seat 1: PapiMik3 (button) folded before Flop (didn't bet)
Seat 2: fishh_play (small blind) folded before Flop
Seat 3: Scaaalll (big blind) collected ($0.02)
Seat 4: olliejaydee folded before Flop (didn't bet)
Seat 5: BexleyBoy folded before Flop (didn't bet)
Seat 6: Feliciano16 folded before Flop (didn't bet)



PokerStars Zoom Hand #229231108442:  Hold'em No Limit ($0.01/$0.02) - 2021/08/21 22:02:15 CET [2021/08/21 16:02:15 ET]
Table 'Halley' 6-max Seat #1 is the button
Seat 1: Mikalai M. ($0.15 in chips) 
Seat 2: Wegezin ($1.71 in chips) 
Seat 3: Atiszon ($3.89 in chips) 
Seat 4: Scaaalll ($2.20 in chips) 
Seat 5: M1muro ($2 in chips) 
Seat 6: GiordanoBrn ($2.42 in chips) 
Wegezin: posts small blind $0.01
Atiszon: posts big blind $0.02
*** HOLE CARDS ***
Dealt to Scaaalll [Tc 8h]
Scaaalll: folds 
GiordanoBrn is disconnected 
M1muro: folds 
GiordanoBrn: folds 
Mikalai M.: calls $0.02
Wegezin: raises $0.04 to $0.06
Atiszon: calls $0.04
Mikalai M.: calls $0.04
*** FLOP *** [Ad 5d Jd]
Wegezin: checks 
Atiszon: bets $0.09
Mikalai M.: calls $0.09 and is all-in
Wegezin: folds 
*** TURN *** [Ad 5d Jd] [2s]
*** RIVER *** [Ad 5d Jd 2s] [3d]
*** SHOW DOWN ***
Atiszon: shows [Jc Ts] (a pair of Jacks)
Mikalai M.: shows [7h Ah] (a pair of Aces)
Mikalai M. collected $0.35 from pot
*** SUMMARY ***
Total pot $0.36 | Rake $0.01 
Board [Ad 5d Jd 2s 3d]
Seat 1: Mikalai M. (button) showed [7h Ah] and won ($0.35) with a pair of Aces
Seat 2: Wegezin (small blind) folded on the Flop
Seat 3: Atiszon (big blind) showed [Jc Ts] and lost with a pair of Jacks
Seat 4: Scaaalll folded before Flop (didn't bet)
Seat 5: M1muro folded before Flop (didn't bet)
Seat 6: GiordanoBrn folded before Flop (didn't bet)



PokerStars Zoom Hand #229231125269:  Hold'em No Limit ($0.01/$0.02) - 2021/08/21 22:02:54 CET [2021/08/21 16:02:54 ET]
Table 'Halley' 6-max Seat #1 is the button
Seat 1: Reipinguimm ($2.08 in chips) 
Seat 2: z3317111711 ($5.02 in chips) 
Seat 3: HDYD18 ($6.91 in chips) 
Seat 4: Scaaalll ($2.24 in chips) 
Seat 5: causavera ($4.34 in chips) 
Seat 6: AndreaBsAs ($2.83 in chips) 
z3317111711: posts small blind $0.01
HDYD18: posts big blind $0.02
*** HOLE CARDS ***
Dealt to Scaaalll [Jd Ad]
Scaaalll: raises $0.04 to $0.06
causavera: folds 
AndreaBsAs: folds 
Reipinguimm: folds 
z3317111711: folds 
HDYD18: folds 
Uncalled bet ($0.04) returned to Scaaalll
Scaaalll collected $0.05 from pot
Scaaalll: doesn't show hand 
*** SUMMARY ***
Total pot $0.05 | Rake $0 
Seat 1: Reipinguimm (button) folded before Flop (didn't bet)
Seat 2: z3317111711 (small blind) folded before Flop
Seat 3: HDYD18 (big blind) folded before Flop
Seat 4: Scaaalll collected ($0.05)
Seat 5: causavera folded before Flop (didn't bet)
Seat 6: AndreaBsAs folded before Flop (didn't bet)



PokerStars Zoom Hand #229231115930:  Hold'em No Limit ($0.01/$0.02) - 2021/08/21 22:02:32 CET [2021/08/21 16:02:32 ET]
Table 'Halley' 6-max Seat #1 is the button
Seat 1: davidalejag ($2.21 in chips) 
Seat 2: Ne0net ($2.42 in chips) 
Seat 3: Jujiluju ($2 in chips) 
Seat 4: smileakafray ($3.01 in chips) 
Seat 5: Scaaalll ($2.23 in chips) 
Seat 6: pipecmolodec ($2.12 in chips) 
Ne0net: posts small blind $0.01
Jujiluju: posts big blind $0.02
*** HOLE CARDS ***
Dealt to Scaaalll [Ad 2c]
smileakafray: calls $0.02
Scaaalll: folds 
pipecmolodec: folds 
davidalejag: folds 
Ne0net: folds 
Jujiluju: checks 
*** FLOP *** [8s Qs 9h]
Jujiluju: bets $0.05
smileakafray: calls $0.05
*** TURN *** [8s Qs 9h] [5h]
Jujiluju: bets $0.14
smileakafray: folds 
Uncalled bet ($0.14) returned to Jujiluju
Jujiluju collected $0.14 from pot
Jujiluju: doesn't show hand 
*** SUMMARY ***
Total pot $0.15 | Rake $0.01 
Board [8s Qs 9h 5h]
Seat 1: davidalejag (button) folded before Flop (didn't bet)
Seat 2: Ne0net (small blind) folded before Flop
Seat 3: Jujiluju (big blind) collected ($0.14)
Seat 4: smileakafray folded on the Turn
Seat 5: Scaaalll folded before Flop (didn't bet)
Seat 6: pipecmolodec folded before Flop (didn't bet)



PokerStars Zoom Hand #229231131810:  Hold'em No Limit ($0.01/$0.02) - 2021/08/21 22:03:09 CET [2021/08/21 16:03:09 ET]
Table 'Halley' 6-max Seat #1 is the button
Seat 1: Dron4uk UA ($3.73 in chips) 
Seat 2: Gerar NB ($3.11 in chips) 
Seat 3: EmperorKurr ($2.42 in chips) 
Seat 4: parrotman991 ($1.95 in chips) 
Seat 5: Scaaalll ($2.27 in chips) 
Seat 6: Larson_mfk ($0.71 in chips) 
Gerar NB: posts small blind $0.01
EmperorKurr: posts big blind $0.02
*** HOLE CARDS ***
Dealt to Scaaalll [6d 2d]
parrotman991: calls $0.02
Larson_mfk is disconnected 
Scaaalll: folds 
Larson_mfk: folds 
Dron4uk UA: folds 
Gerar NB: folds 
EmperorKurr: checks 
*** FLOP *** [5d 7h 9h]
EmperorKurr: checks 
parrotman991: checks 
*** TURN *** [5d 7h 9h] [Ts]
EmperorKurr: checks 
parrotman991: checks 
*** RIVER *** [5d 7h 9h Ts] [5h]
EmperorKurr: bets $0.05
parrotman991: folds 
Uncalled bet ($0.05) returned to EmperorKurr
EmperorKurr collected $0.05 from pot
EmperorKurr: doesn't show hand 
*** SUMMARY ***
Total pot $0.05 | Rake $0 
Board [5d 7h 9h Ts 5h]
Seat 1: Dron4uk UA (button) folded before Flop (didn't bet)
Seat 2: Gerar NB (small blind) folded before Flop
Seat 3: EmperorKurr (big blind) collected ($0.05)
Seat 4: parrotman991 folded on the River
Seat 5: Scaaalll folded before Flop (didn't bet)
Seat 6: Larson_mfk folded before Flop (didn't bet)



PokerStars Zoom Hand #229231135689:  Hold'em No Limit ($0.01/$0.02) - 2021/08/21 22:03:18 CET [2021/08/21 16:03:18 ET]
Table 'Halley' 6-max Seat #1 is the button
Seat 1: fishh_play ($5.64 in chips) 
Seat 2: Scaaalll ($2.27 in chips) 
Seat 3: lexus00174 ($2.28 in chips) 
Seat 4: gds2003 ($1.57 in chips) 
Seat 5: BlackhawKK's ($2.36 in chips) 
Seat 6: Koldun 2636 ($4.66 in chips) 
Scaaalll: posts small blind $0.01
lexus00174: posts big blind $0.02
*** HOLE CARDS ***
Dealt to Scaaalll [Qc Jc]
gds2003: folds 
BlackhawKK's: folds 
Koldun 2636: folds 
fishh_play: folds 
Scaaalll: raises $0.04 to $0.06
lexus00174: calls $0.04
*** FLOP *** [4h 7h 9h]
Scaaalll: checks 
lexus00174: bets $0.06
Scaaalll: folds 
Uncalled bet ($0.06) returned to lexus00174
lexus00174 collected $0.12 from pot
lexus00174: doesn't show hand 
*** SUMMARY ***
Total pot $0.12 | Rake $0 
Board [4h 7h 9h]
Seat 1: fishh_play (button) folded before Flop (didn't bet)
Seat 2: Scaaalll (small blind) folded on the Flop
Seat 3: lexus00174 (big blind) collected ($0.12)
Seat 4: gds2003 folded before Flop (didn't bet)
Seat 5: BlackhawKK's folded before Flop (didn't bet)
Seat 6: Koldun 2636 folded before Flop (didn't bet)



PokerStars Zoom Hand #229231150551:  Hold'em No Limit ($0.01/$0.02) - 2021/08/21 22:03:51 CET [2021/08/21 16:03:51 ET]
Table 'Halley' 6-max Seat #1 is the button
Seat 1: WellWell57 ($1.35 in chips) 
Seat 2: hubertott ($2.34 in chips) 
Seat 3: Draat505 ($2.93 in chips) 
Seat 4: zielony ($2.62 in chips) 
Seat 5: Scaaalll ($2.21 in chips) 
Seat 6: Mikmaq Caper ($0.83 in chips) 
hubertott: posts small blind $0.01
Draat505: posts big blind $0.02
*** HOLE CARDS ***
Dealt to Scaaalll [7c As]
zielony: folds 
Scaaalll: folds 
Mikmaq Caper has timed out
Mikmaq Caper: folds 
WellWell57: folds 
hubertott: folds 
Uncalled bet ($0.01) returned to Draat505
Mikmaq Caper is disconnected 
Draat505 collected $0.02 from pot
Draat505: doesn't show hand 
*** SUMMARY ***
Total pot $0.02 | Rake $0 
Seat 1: WellWell57 (button) folded before Flop (didn't bet)
Seat 2: hubertott (small blind) folded before Flop
Seat 3: Draat505 (big blind) collected ($0.02)
Seat 4: zielony folded before Flop (didn't bet)
Seat 5: Scaaalll folded before Flop (didn't bet)
Seat 6: Mikmaq Caper folded before Flop (didn't bet)



PokerStars Zoom Hand #229231146998:  Hold'em No Limit ($0.01/$0.02) - 2021/08/21 22:03:43 CET [2021/08/21 16:03:43 ET]
Table 'Halley' 6-max Seat #1 is the button
Seat 1: martinob11 ($1.19 in chips) 
Seat 2: amario89 ($5.14 in chips) 
Seat 3: ADWish ($1.72 in chips) 
Seat 4: Scaaalll ($2.21 in chips) 
Seat 5: LuckyCheewey ($2.17 in chips) 
Seat 6: Begon505 ($1.19 in chips) 
amario89: posts small blind $0.01
ADWish: posts big blind $0.02
*** HOLE CARDS ***
Dealt to Scaaalll [3s 2d]
Scaaalll: folds 
LuckyCheewey: raises $0.05 to $0.07
Begon505: folds 
martinob11: folds 
amario89: folds 
ADWish: calls $0.05
*** FLOP *** [7s 6s 4c]
ADWish: checks 
LuckyCheewey: bets $0.07
ADWish: calls $0.07
*** TURN *** [7s 6s 4c] [Kh]
ADWish: checks 
LuckyCheewey: bets $0.14
ADWish: calls $0.14
*** RIVER *** [7s 6s 4c Kh] [Kc]
ADWish: checks 
LuckyCheewey: bets $0.28
ADWish: folds 
Uncalled bet ($0.28) returned to LuckyCheewey
LuckyCheewey collected $0.55 from pot
LuckyCheewey: doesn't show hand 
*** SUMMARY ***
Total pot $0.57 | Rake $0.02 
Board [7s 6s 4c Kh Kc]
Seat 1: martinob11 (button) folded before Flop (didn't bet)
Seat 2: amario89 (small blind) folded before Flop
Seat 3: ADWish (big blind) folded on the River
Seat 4: Scaaalll folded before Flop (didn't bet)
Seat 5: LuckyCheewey collected ($0.55)
Seat 6: Begon505 folded before Flop (didn't bet)



PokerStars Zoom Hand #229231152821:  Hold'em No Limit ($0.01/$0.02) - 2021/08/21 22:03:56 CET [2021/08/21 16:03:56 ET]
Table 'Halley' 6-max Seat #1 is the button
Seat 1: Scaaalll ($2.21 in chips) 
Seat 2: TheJunta ($2 in chips) 
Seat 3: alexxandr ($1.64 in chips) 
Seat 4: zielony ($3.06 in chips) 
Seat 5: KIBA7660 ($0.88 in chips) 
Seat 6: gugamoraes ($2.33 in chips) 
TheJunta: posts small blind $0.01
alexxandr: posts big blind $0.02
*** HOLE CARDS ***
Dealt to Scaaalll [Kc Qh]
zielony: folds 
KIBA7660: folds 
KIBA7660 is disconnected 
gugamoraes: folds 
Scaaalll: raises $0.02 to $0.04
TheJunta: folds 
alexxandr: folds 
Uncalled bet ($0.02) returned to Scaaalll
Scaaalll collected $0.05 from pot
Scaaalll: doesn't show hand 
*** SUMMARY ***
Total pot $0.05 | Rake $0 
Seat 1: Scaaalll (button) collected ($0.05)
Seat 2: TheJunta (small blind) folded before Flop
Seat 3: alexxandr (big blind) folded before Flop
Seat 4: zielony folded before Flop (didn't bet)
Seat 5: KIBA7660 folded before Flop (didn't bet)
Seat 6: gugamoraes folded before Flop (didn't bet)



PokerStars Zoom Hand #229231164008:  Hold'em No Limit ($0.01/$0.02) - 2021/08/21 22:04:21 CET [2021/08/21 16:04:21 ET]
Table 'Halley' 6-max Seat #1 is the button
Seat 1: Blaackie ($2.28 in chips) 
Seat 2: HDYD18 ($6.86 in chips) 
Seat 3: Scaaalll ($2.24 in chips) 
Seat 4: kingchaos79 ($2.68 in chips) 
Seat 5: Osetrov.A.A ($2.43 in chips) 
Seat 6: Demidov V.S. ($2.49 in chips) 
HDYD18: posts small blind $0.01
Scaaalll: posts big blind $0.02
*** HOLE CARDS ***
Dealt to Scaaalll [5h 7s]
Demidov V.S. is disconnected 
kingchaos79: folds 
Osetrov.A.A: raises $0.02 to $0.04
Demidov V.S.: folds 
Blaackie: folds 
HDYD18: folds 
Scaaalll: folds 
Uncalled bet ($0.02) returned to Osetrov.A.A
Osetrov.A.A collected $0.05 from pot
Osetrov.A.A: doesn't show hand 
*** SUMMARY ***
Total pot $0.05 | Rake $0 
Seat 1: Blaackie (button) folded before Flop (didn't bet)
Seat 2: HDYD18 (small blind) folded before Flop
Seat 3: Scaaalll (big blind) folded before Flop
Seat 4: kingchaos79 folded before Flop (didn't bet)
Seat 5: Osetrov.A.A collected ($0.05)
Seat 6: Demidov V.S. folded before Flop (didn't bet)



PokerStars Zoom Hand #229231174169:  Hold'em No Limit ($0.01/$0.02) - 2021/08/21 22:04:44 CET [2021/08/21 16:04:44 ET]
Table 'Halley' 6-max Seat #1 is the button
Seat 1: Nihility77 ($4.73 in chips) 
Seat 2: pavlo8855 ($2.11 in chips) 
Seat 3: maliniak75 ($2.22 in chips) 
Seat 4: yannikdaehne ($8.08 in chips) 
Seat 5: Pechorin.G ($2.38 in chips) 
Seat 6: Scaaalll ($2.22 in chips) 
pavlo8855: posts small blind $0.01
maliniak75: posts big blind $0.02
*** HOLE CARDS ***
Dealt to Scaaalll [Jh 4s]
yannikdaehne: folds 
Pechorin.G: folds 
Scaaalll: folds 
Nihility77: folds 
pavlo8855: raises $0.04 to $0.06
maliniak75: folds 
Uncalled bet ($0.04) returned to pavlo8855
pavlo8855 collected $0.04 from pot
pavlo8855: doesn't show hand 
*** SUMMARY ***
Total pot $0.04 | Rake $0 
Seat 1: Nihility77 (button) folded before Flop (didn't bet)
Seat 2: pavlo8855 (small blind) collected ($0.04)
Seat 3: maliniak75 (big blind) folded before Flop
Seat 4: yannikdaehne folded before Flop (didn't bet)
Seat 5: Pechorin.G folded before Flop (didn't bet)
Seat 6: Scaaalll folded before Flop (didn't bet)



PokerStars Zoom Hand #229231182427:  Hold'em No Limit ($0.01/$0.02) - 2021/08/21 22:05:02 CET [2021/08/21 16:05:02 ET]
Table 'Halley' 6-max Seat #1 is the button
Seat 1: queen830 ($8.59 in chips) 
Seat 2: Scaaalll ($2.22 in chips) 
Seat 3: SIGREX ($2.57 in chips) 
Seat 4: gy67 ($2.46 in chips) 
Seat 5: pavlo8855 ($2.14 in chips) 
Seat 6: Emilmoller1 ($2.21 in chips) 
Scaaalll: posts small blind $0.01
SIGREX: posts big blind $0.02
*** HOLE CARDS ***
Dealt to Scaaalll [9s Js]
gy67: calls $0.02
pavlo8855: raises $0.06 to $0.08
Emilmoller1: folds 
queen830: folds 
Scaaalll: folds 
SIGREX: folds 
gy67: folds 
Uncalled bet ($0.06) returned to pavlo8855
pavlo8855 collected $0.07 from pot
pavlo8855: doesn't show hand 
*** SUMMARY ***
Total pot $0.07 | Rake $0 
Seat 1: queen830 (button) folded before Flop (didn't bet)
Seat 2: Scaaalll (small blind) folded before Flop
Seat 3: SIGREX (big blind) folded before Flop
Seat 4: gy67 folded before Flop
Seat 5: pavlo8855 collected ($0.07)
Seat 6: Emilmoller1 folded before Flop (didn't bet)



PokerStars Zoom Hand #229231188809:  Hold'em No Limit ($0.01/$0.02) - 2021/08/21 22:05:17 CET [2021/08/21 16:05:17 ET]
Table 'Halley' 6-max Seat #1 is the button
Seat 1: Scaaalll ($2.21 in chips) 
Seat 2: meps88 ($4.18 in chips) 
Seat 3: Begon505 ($1 in chips) 
Seat 4: pokershevela ($1.86 in chips) 
Seat 5: Simotsouli24 ($1.21 in chips) 
Seat 6: SIGREX ($3.09 in chips) 
meps88: posts small blind $0.01
Begon505: posts big blind $0.02
*** HOLE CARDS ***
Dealt to Scaaalll [6d 7d]
Simotsouli24 is disconnected 
pokershevela: folds 
Simotsouli24: folds 
pokershevela is disconnected 
SIGREX: raises $0.02 to $0.04
Scaaalll: raises $0.12 to $0.16
meps88: folds 
Begon505: folds 
SIGREX: folds 
Uncalled bet ($0.12) returned to Scaaalll
Scaaalll collected $0.11 from pot
Scaaalll: doesn't show hand 
*** SUMMARY ***
Total pot $0.11 | Rake $0 
Seat 1: Scaaalll (button) collected ($0.11)
Seat 2: meps88 (small blind) folded before Flop
Seat 3: Begon505 (big blind) folded before Flop
Seat 4: pokershevela folded before Flop (didn't bet)
Seat 5: Simotsouli24 folded before Flop (didn't bet)
Seat 6: SIGREX folded before Flop



PokerStars Zoom Hand #229231180286:  Hold'em No Limit ($0.01/$0.02) - 2021/08/21 22:04:58 CET [2021/08/21 16:04:58 ET]
Table 'Halley' 6-max Seat #1 is the button
Seat 1: Fanatspartak ($1.30 in chips) 
Seat 2: lucksuckdonk ($4.02 in chips) 
Seat 3: BlackhawKK's ($3.21 in chips) 
Seat 4: Scaaalll ($2.22 in chips) 
Seat 5: Pepek9480 ($2.53 in chips) 
Seat 6: kahzura ($2.03 in chips) 
lucksuckdonk: posts small blind $0.01
BlackhawKK's: posts big blind $0.02
*** HOLE CARDS ***
Dealt to Scaaalll [8h 4d]
Scaaalll: folds 
Pepek9480: folds 
kahzura: folds 
Fanatspartak: folds 
lucksuckdonk: raises $0.04 to $0.06
BlackhawKK's: calls $0.04
*** FLOP *** [Ah Kd 5s]
lucksuckdonk: checks 
BlackhawKK's: checks 
*** TURN *** [Ah Kd 5s] [Js]
lucksuckdonk: bets $0.08
BlackhawKK's: raises $0.16 to $0.24
lucksuckdonk: calls $0.16
*** RIVER *** [Ah Kd 5s Js] [4c]
lucksuckdonk: checks 
BlackhawKK's: bets $0.73
lucksuckdonk: calls $0.73
*** SHOW DOWN ***
BlackhawKK's: shows [Th Qc] (a straight, Ten to Ace)
lucksuckdonk: mucks hand 
BlackhawKK's collected $1.99 from pot
*** SUMMARY ***
Total pot $2.06 | Rake $0.07 
Board [Ah Kd 5s Js 4c]
Seat 1: Fanatspartak (button) folded before Flop (didn't bet)
Seat 2: lucksuckdonk (small blind) mucked [5h Kh]
Seat 3: BlackhawKK's (big blind) showed [Th Qc] and won ($1.99) with a straight, Ten to Ace
Seat 4: Scaaalll folded before Flop (didn't bet)
Seat 5: Pepek9480 folded before Flop (didn't bet)
Seat 6: kahzura folded before Flop (didn't bet)



PokerStars Zoom Hand #229231196732:  Hold'em No Limit ($0.01/$0.02) - 2021/08/21 22:05:35 CET [2021/08/21 16:05:35 ET]
Table 'Halley' 6-max Seat #1 is the button
Seat 1: Thaleshs ($2 in chips) 
Seat 2: Murileus ($2 in chips) 
Seat 3: stipe 31 ($2.05 in chips) 
Seat 4: PapiMik3 ($6.60 in chips) 
Seat 5: PokemonK5 ($1.03 in chips) 
Seat 6: Scaaalll ($2.28 in chips) 
Murileus: posts small blind $0.01
stipe 31: posts big blind $0.02
*** HOLE CARDS ***
Dealt to Scaaalll [4h 2d]
PapiMik3: folds 
PokemonK5: folds 
PokemonK5 is disconnected 
Scaaalll: folds 
Thaleshs: folds 
Murileus: raises $0.04 to $0.06
stipe 31: folds 
Uncalled bet ($0.04) returned to Murileus
Murileus collected $0.04 from pot
Murileus: doesn't show hand 
*** SUMMARY ***
Total pot $0.04 | Rake $0 
Seat 1: Thaleshs (button) folded before Flop (didn't bet)
Seat 2: Murileus (small blind) collected ($0.04)
Seat 3: stipe 31 (big blind) folded before Flop
Seat 4: PapiMik3 folded before Flop (didn't bet)
Seat 5: PokemonK5 folded before Flop (didn't bet)
Seat 6: Scaaalll folded before Flop (didn't bet)



PokerStars Zoom Hand #229231201612:  Hold'em No Limit ($0.01/$0.02) - 2021/08/21 22:05:46 CET [2021/08/21 16:05:46 ET]
Table 'Halley' 6-max Seat #1 is the button
Seat 1: arrow17 ($2.14 in chips) 
Seat 2: EstiBan18 ($2.56 in chips) 
Seat 3: Scaaalll ($2.28 in chips) 
Seat 4: CATAPUTA ($2.51 in chips) 
Seat 5: SIGREX ($2.54 in chips) 
Seat 6: DaporteWins ($2 in chips) 
EstiBan18: posts small blind $0.01
Scaaalll: posts big blind $0.02
*** HOLE CARDS ***
Dealt to Scaaalll [Ac 9d]
CATAPUTA: folds 
SIGREX: folds 
DaporteWins: folds 
CATAPUTA is disconnected 
arrow17: raises $0.03 to $0.05
EstiBan18: folds 
Scaaalll: folds 
Uncalled bet ($0.03) returned to arrow17
arrow17 collected $0.05 from pot
arrow17: doesn't show hand 
*** SUMMARY ***
Total pot $0.05 | Rake $0 
Seat 1: arrow17 (button) collected ($0.05)
Seat 2: EstiBan18 (small blind) folded before Flop
Seat 3: Scaaalll (big blind) folded before Flop
Seat 4: CATAPUTA folded before Flop (didn't bet)
Seat 5: SIGREX folded before Flop (didn't bet)
Seat 6: DaporteWins folded before Flop (didn't bet)



PokerStars Zoom Hand #229231210934:  Hold'em No Limit ($0.01/$0.02) - 2021/08/21 22:06:07 CET [2021/08/21 16:06:07 ET]
Table 'Halley' 6-max Seat #1 is the button
Seat 1: Mokkavit ($2.08 in chips) 
Seat 2: xmaksimus ($2 in chips) 
Seat 3: Murileus ($2.02 in chips) 
Seat 4: Scaaalll ($2.26 in chips) 
Seat 5: hubertott ($3.07 in chips) 
Seat 6: Clavis Noa ($1.98 in chips) 
xmaksimus: posts small blind $0.01
Murileus: posts big blind $0.02
*** HOLE CARDS ***
Dealt to Scaaalll [Qd 8c]
Scaaalll: folds 
hubertott: folds 
Clavis Noa: folds 
Mokkavit: folds 
xmaksimus: folds 
Uncalled bet ($0.01) returned to Murileus
Murileus collected $0.02 from pot
Murileus: doesn't show hand 
*** SUMMARY ***
Total pot $0.02 | Rake $0 
Seat 1: Mokkavit (button) folded before Flop (didn't bet)
Seat 2: xmaksimus (small blind) folded before Flop
Seat 3: Murileus (big blind) collected ($0.02)
Seat 4: Scaaalll folded before Flop (didn't bet)
Seat 5: hubertott folded before Flop (didn't bet)
Seat 6: Clavis Noa folded before Flop (didn't bet)



PokerStars Zoom Hand #229231213217:  Hold'em No Limit ($0.01/$0.02) - 2021/08/21 22:06:12 CET [2021/08/21 16:06:12 ET]
Table 'Halley' 6-max Seat #1 is the button
Seat 1: IamFixxed ($2.58 in chips) 
Seat 2: zielony ($2.23 in chips) 
Seat 3: ME-262-XX ($1.07 in chips) 
Seat 4: Scaaalll ($2.26 in chips) 
Seat 5: Draat505 ($2.18 in chips) 
Seat 6: Kojak34 ($6 in chips) 
zielony: posts small blind $0.01
ME-262-XX: posts big blind $0.02
*** HOLE CARDS ***
Dealt to Scaaalll [9d Qh]
Scaaalll: folds 
Draat505: folds 
Kojak34: raises $0.05 to $0.07
IamFixxed: folds 
zielony: folds 
ME-262-XX: folds 
Uncalled bet ($0.05) returned to Kojak34
Kojak34 collected $0.05 from pot
Kojak34: doesn't show hand 
*** SUMMARY ***
Total pot $0.05 | Rake $0 
Seat 1: IamFixxed (button) folded before Flop (didn't bet)
Seat 2: zielony (small blind) folded before Flop
Seat 3: ME-262-XX (big blind) folded before Flop
Seat 4: Scaaalll folded before Flop (didn't bet)
Seat 5: Draat505 folded before Flop (didn't bet)
Seat 6: Kojak34 collected ($0.05)



PokerStars Zoom Hand #229231223883:  Hold'em No Limit ($0.01/$0.02) - 2021/08/21 22:06:36 CET [2021/08/21 16:06:36 ET]
Table 'Halley' 6-max Seat #1 is the button
Seat 1: snowy_96 ($2.03 in chips) 
Seat 2: SICKDIRTY416 ($4.63 in chips) 
Seat 3: AlStFish ($1.02 in chips) 
Seat 4: Healthys07 ($2.71 in chips) 
Seat 5: Scaaalll ($2.25 in chips) 
Seat 6: PapiMik3 ($2.32 in chips) 
SICKDIRTY416: posts small blind $0.01
AlStFish: posts big blind $0.02
*** HOLE CARDS ***
Dealt to Scaaalll [9d 2h]
Healthys07: folds 
Scaaalll: folds 
PapiMik3: folds 
snowy_96: raises $0.04 to $0.06
SICKDIRTY416: folds 
SICKDIRTY416 is disconnected 
AlStFish: raises $0.14 to $0.20
snowy_96: folds 
Uncalled bet ($0.14) returned to AlStFish
AlStFish collected $0.13 from pot
AlStFish: doesn't show hand 
*** SUMMARY ***
Total pot $0.13 | Rake $0 
Seat 1: snowy_96 (button) folded before Flop
Seat 2: SICKDIRTY416 (small blind) folded before Flop
Seat 3: AlStFish (big blind) collected ($0.13)
Seat 4: Healthys07 folded before Flop (didn't bet)
Seat 5: Scaaalll folded before Flop (didn't bet)
Seat 6: PapiMik3 folded before Flop (didn't bet)



PokerStars Zoom Hand #229231215426:  Hold'em No Limit ($0.01/$0.02) - 2021/08/21 22:06:17 CET [2021/08/21 16:06:17 ET]
Table 'Halley' 6-max Seat #1 is the button
Seat 1: felipeciji ($2.08 in chips) 
Seat 2: Scaaalll ($2.26 in chips) 
Seat 3: Nihility77 ($2.14 in chips) 
Seat 4: Capitaine Pat ($2.46 in chips) 
Seat 5: HubertFroh ($2 in chips) 
Seat 6: jerl22 ($2.31 in chips) 
Scaaalll: posts small blind $0.01
Nihility77: posts big blind $0.02
*** HOLE CARDS ***
Dealt to Scaaalll [3s Th]
Capitaine Pat: folds 
HubertFroh: folds 
jerl22: calls $0.02
felipeciji: folds 
Scaaalll: folds 
Nihility77: checks 
*** FLOP *** [Kd Td Tc]
Nihility77: checks 
jerl22: checks 
*** TURN *** [Kd Td Tc] [Ah]
Nihility77: checks 
jerl22: checks 
*** RIVER *** [Kd Td Tc Ah] [3h]
Nihility77: checks 
jerl22: checks 
*** SHOW DOWN ***
Nihility77: shows [Qd 6c] (a pair of Tens)
jerl22: mucks hand 
Nihility77 collected $0.05 from pot
*** SUMMARY ***
Total pot $0.05 | Rake $0 
Board [Kd Td Tc Ah 3h]
Seat 1: felipeciji (button) folded before Flop (didn't bet)
Seat 2: Scaaalll (small blind) folded before Flop
Seat 3: Nihility77 (big blind) showed [Qd 6c] and won ($0.05) with a pair of Tens
Seat 4: Capitaine Pat folded before Flop (didn't bet)
Seat 5: HubertFroh folded before Flop (didn't bet)
Seat 6: jerl22 mucked [8s 9s]



PokerStars Zoom Hand #229231225715:  Hold'em No Limit ($0.01/$0.02) - 2021/08/21 22:06:40 CET [2021/08/21 16:06:40 ET]
Table 'Halley' 6-max Seat #1 is the button
Seat 1: Scaaalll ($2.25 in chips) 
Seat 2: VaanKroenen ($0.21 in chips) 
Seat 3: Tj741 ($2 in chips) 
Seat 4: jftd123 ($3.42 in chips) 
Seat 5: Chapaev136 ($3.75 in chips) 
Seat 6: NoLuckLeck ($2.14 in chips) 
VaanKroenen: posts small blind $0.01
Tj741: posts big blind $0.02
*** HOLE CARDS ***
Dealt to Scaaalll [7s 8c]
jftd123: folds 
Chapaev136: raises $0.04 to $0.06
NoLuckLeck: calls $0.06
Scaaalll: folds 
VaanKroenen: folds 
Tj741: calls $0.04
*** FLOP *** [2s 2c Jh]
Tj741: bets $0.05
Chapaev136: folds 
NoLuckLeck: raises $0.15 to $0.20
Tj741: calls $0.15
*** TURN *** [2s 2c Jh] [Kc]
Tj741: checks 
NoLuckLeck: checks 
*** RIVER *** [2s 2c Jh Kc] [4h]
Tj741: bets $0.17
NoLuckLeck: folds 
Uncalled bet ($0.17) returned to Tj741
Tj741 collected $0.57 from pot
Tj741: doesn't show hand 
*** SUMMARY ***
Total pot $0.59 | Rake $0.02 
Board [2s 2c Jh Kc 4h]
Seat 1: Scaaalll (button) folded before Flop (didn't bet)
Seat 2: VaanKroenen (small blind) folded before Flop
Seat 3: Tj741 (big blind) collected ($0.57)
Seat 4: jftd123 folded before Flop (didn't bet)
Seat 5: Chapaev136 folded on the Flop
Seat 6: NoLuckLeck folded on the River



PokerStars Zoom Hand #229231230951:  Hold'em No Limit ($0.01/$0.02) - 2021/08/21 22:06:52 CET [2021/08/21 16:06:52 ET]
Table 'Halley' 6-max Seat #1 is the button
Seat 1: blillad ($2.03 in chips) 
Seat 2: romul795 ($0.35 in chips) 
Seat 3: Scaaalll ($2.25 in chips) 
Seat 4: pavlo590 ($1.76 in chips) 
Seat 5: Kojak34 ($6.02 in chips) 
Seat 6: SICKDIRTY416 ($4.62 in chips) 
romul795: posts small blind $0.01
Scaaalll: posts big blind $0.02
*** HOLE CARDS ***
Dealt to Scaaalll [5c 6s]
pavlo590: folds 
Kojak34: folds 
pavlo590 is disconnected 
SICKDIRTY416: calls $0.02
blillad: folds 
romul795: folds 
romul795 is disconnected 
Scaaalll: checks 
*** FLOP *** [Jh 9d 7c]
Scaaalll: checks 
SICKDIRTY416: checks 
*** TURN *** [Jh 9d 7c] [4s]
Scaaalll: checks 
SICKDIRTY416: bets $0.02
Scaaalll: calls $0.02
*** RIVER *** [Jh 9d 7c 4s] [3d]
Scaaalll: checks 
SICKDIRTY416: bets $0.04
Scaaalll: raises $0.12 to $0.16
SICKDIRTY416: calls $0.12
*** SHOW DOWN ***
Scaaalll: shows [5c 6s] (a straight, Three to Seven)
SICKDIRTY416: mucks hand 
Scaaalll collected $0.40 from pot
*** SUMMARY ***
Total pot $0.41 | Rake $0.01 
Board [Jh 9d 7c 4s 3d]
Seat 1: blillad (button) folded before Flop (didn't bet)
Seat 2: romul795 (small blind) folded before Flop
Seat 3: Scaaalll (big blind) showed [5c 6s] and won ($0.40) with a straight, Three to Seven
Seat 4: pavlo590 folded before Flop (didn't bet)
Seat 5: Kojak34 folded before Flop (didn't bet)
Seat 6: SICKDIRTY416 mucked [Js Ad]



PokerStars Zoom Hand #229231250440:  Hold'em No Limit ($0.01/$0.02) - 2021/08/21 22:07:36 CET [2021/08/21 16:07:36 ET]
Table 'Halley' 6-max Seat #1 is the button
Seat 1: Capitaine Pat ($2.49 in chips) 
Seat 2: Shoxuzb ($5.09 in chips) 
Seat 3: Oprichnick90 ($4.26 in chips) 
Seat 4: Scaaalll ($2.45 in chips) 
Seat 5: polymorhp ($2.04 in chips) 
Seat 6: LucasG155 ($2.67 in chips) 
Shoxuzb: posts small blind $0.01
Oprichnick90: posts big blind $0.02
*** HOLE CARDS ***
Dealt to Scaaalll [4d 8d]
Shoxuzb is disconnected 
Scaaalll: folds 
polymorhp: folds 
LucasG155: folds 
Capitaine Pat: folds 
Shoxuzb: folds 
Uncalled bet ($0.01) returned to Oprichnick90
Oprichnick90 collected $0.02 from pot
Oprichnick90: doesn't show hand 
*** SUMMARY ***
Total pot $0.02 | Rake $0 
Seat 1: Capitaine Pat (button) folded before Flop (didn't bet)
Seat 2: Shoxuzb (small blind) folded before Flop
Seat 3: Oprichnick90 (big blind) collected ($0.02)
Seat 4: Scaaalll folded before Flop (didn't bet)
Seat 5: polymorhp folded before Flop (didn't bet)
Seat 6: LucasG155 folded before Flop (didn't bet)



PokerStars Zoom Hand #229231253531:  Hold'em No Limit ($0.01/$0.02) - 2021/08/21 22:07:43 CET [2021/08/21 16:07:43 ET]
Table 'Halley' 6-max Seat #1 is the button
Seat 1: rpycmbEM ($4.27 in chips) 
Seat 2: Scaaalll ($2.45 in chips) 
Seat 3: PapiMik3 ($3.02 in chips) 
Seat 4: Laonikos ($6.01 in chips) 
Seat 5: Aho1337 ($2.37 in chips) 
Seat 6: KingsPoke185 ($0.68 in chips) 
Scaaalll: posts small blind $0.01
PapiMik3: posts big blind $0.02
*** HOLE CARDS ***
Dealt to Scaaalll [9s 4h]
Laonikos: folds 
Aho1337: folds 
KingsPoke185: folds 
rpycmbEM: folds 
Scaaalll: folds 
Uncalled bet ($0.01) returned to PapiMik3
PapiMik3 collected $0.02 from pot
PapiMik3: doesn't show hand 
*** SUMMARY ***
Total pot $0.02 | Rake $0 
Seat 1: rpycmbEM (button) folded before Flop (didn't bet)
Seat 2: Scaaalll (small blind) folded before Flop
Seat 3: PapiMik3 (big blind) collected ($0.02)
Seat 4: Laonikos folded before Flop (didn't bet)
Seat 5: Aho1337 folded before Flop (didn't bet)
Seat 6: KingsPoke185 folded before Flop (didn't bet)



PokerStars Zoom Hand #229231258509:  Hold'em No Limit ($0.01/$0.02) - 2021/08/21 22:07:54 CET [2021/08/21 16:07:54 ET]
Table 'Halley' 6-max Seat #1 is the button
Seat 1: Scaaalll ($2.44 in chips) 
Seat 2: gugamoraes ($2.37 in chips) 
Seat 3: CRODeny ($2.50 in chips) 
Seat 4: Dero_AM ($3.02 in chips) 
Seat 5: BigTestIcicle ($5.58 in chips) 
Seat 6: Thaleshs ($2.01 in chips) 
gugamoraes: posts small blind $0.01
CRODeny: posts big blind $0.02
*** HOLE CARDS ***
Dealt to Scaaalll [8c 6h]
Dero_AM: folds 
Dero_AM is disconnected 
BigTestIcicle: folds 
Thaleshs: folds 
Scaaalll: folds 
gugamoraes: folds 
Uncalled bet ($0.01) returned to CRODeny
CRODeny collected $0.02 from pot
CRODeny: doesn't show hand 
*** SUMMARY ***
Total pot $0.02 | Rake $0 
Seat 1: Scaaalll (button) folded before Flop (didn't bet)
Seat 2: gugamoraes (small blind) folded before Flop
Seat 3: CRODeny (big blind) collected ($0.02)
Seat 4: Dero_AM folded before Flop (didn't bet)
Seat 5: BigTestIcicle folded before Flop (didn't bet)
Seat 6: Thaleshs folded before Flop (didn't bet)



PokerStars Zoom Hand #229231260216:  Hold'em No Limit ($0.01/$0.02) - 2021/08/21 22:07:58 CET [2021/08/21 16:07:58 ET]
Table 'Halley' 6-max Seat #1 is the button
Seat 1: dcd113 ($4.51 in chips) 
Seat 2: ZorroZoltan ($1.98 in chips) 
Seat 3: Scaaalll ($2.44 in chips) 
Seat 4: ash1448 ($3.20 in chips) 
Seat 5: boa juice ($1.09 in chips) 
Seat 6: bober2702 ($3.72 in chips) 
ZorroZoltan: posts small blind $0.01
Scaaalll: posts big blind $0.02
*** HOLE CARDS ***
Dealt to Scaaalll [3s 8c]
ash1448: folds 
boa juice: folds 
bober2702: folds 
boa juice is disconnected 
dcd113: folds 
ZorroZoltan: folds 
Uncalled bet ($0.01) returned to Scaaalll
Scaaalll collected $0.02 from pot
Scaaalll: doesn't show hand 
*** SUMMARY ***
Total pot $0.02 | Rake $0 
Seat 1: dcd113 (button) folded before Flop (didn't bet)
Seat 2: ZorroZoltan (small blind) folded before Flop
Seat 3: Scaaalll (big blind) collected ($0.02)
Seat 4: ash1448 folded before Flop (didn't bet)
Seat 5: boa juice folded before Flop (didn't bet)
Seat 6: bober2702 folded before Flop (didn't bet)



PokerStars Zoom Hand #229231246946:  Hold'em No Limit ($0.01/$0.02) - 2021/08/21 22:07:28 CET [2021/08/21 16:07:28 ET]
Table 'Halley' 6-max Seat #1 is the button
Seat 1: EDJF1999 ($1.23 in chips) 
Seat 2: ash1448 ($10.36 in chips) 
Seat 3: rekopo203 ($3.80 in chips) 
Seat 4: Gullsnyta ($4.12 in chips) 
Seat 5: fishh_play ($5.13 in chips) 
Seat 6: Scaaalll ($2.45 in chips) 
ash1448: posts small blind $0.01
rekopo203: posts big blind $0.02
*** HOLE CARDS ***
Dealt to Scaaalll [5c Kh]
Gullsnyta: calls $0.02
fishh_play: folds 
Scaaalll: folds 
EDJF1999: calls $0.02
ash1448: folds 
rekopo203: checks 
*** FLOP *** [Td Ks 2s]
rekopo203: checks 
Gullsnyta: bets $0.07
EDJF1999: calls $0.07
rekopo203: folds 
*** TURN *** [Td Ks 2s] [Qh]
Gullsnyta: bets $0.02
EDJF1999: calls $0.02
*** RIVER *** [Td Ks 2s Qh] [3c]
Gullsnyta: checks 
EDJF1999: checks 
*** SHOW DOWN ***
Gullsnyta: shows [Kd Jc] (a pair of Kings)
EDJF1999: mucks hand 
Gullsnyta collected $0.24 from pot
*** SUMMARY ***
Total pot $0.25 | Rake $0.01 
Board [Td Ks 2s Qh 3c]
Seat 1: EDJF1999 (button) mucked [Ad 8h]
Seat 2: ash1448 (small blind) folded before Flop
Seat 3: rekopo203 (big blind) folded on the Flop
Seat 4: Gullsnyta showed [Kd Jc] and won ($0.24) with a pair of Kings
Seat 5: fishh_play folded before Flop (didn't bet)
Seat 6: Scaaalll folded before Flop (didn't bet)



PokerStars Zoom Hand #229231269056:  Hold'em No Limit ($0.01/$0.02) - 2021/08/21 22:08:18 CET [2021/08/21 16:08:18 ET]
Table 'Halley' 6-max Seat #1 is the button
Seat 1: Blaackie ($2.82 in chips) 
Seat 2: T-saitama ($2 in chips) 
Seat 3: Kb013497 ($3.10 in chips) 
Seat 4: Scaaalll ($2.45 in chips) 
Seat 5: lucksuckdonk ($5.30 in chips) 
Seat 6: Vanekakqj ($2.42 in chips) 
T-saitama: posts small blind $0.01
Kb013497: posts big blind $0.02
*** HOLE CARDS ***
Dealt to Scaaalll [8s Qd]
Scaaalll: folds 
lucksuckdonk: folds 
Vanekakqj: raises $0.04 to $0.06
Blaackie: folds 
T-saitama: folds 
Kb013497: folds 
Uncalled bet ($0.04) returned to Vanekakqj
Vanekakqj collected $0.05 from pot
Vanekakqj: doesn't show hand 
*** SUMMARY ***
Total pot $0.05 | Rake $0 
Seat 1: Blaackie (button) folded before Flop (didn't bet)
Seat 2: T-saitama (small blind) folded before Flop
Seat 3: Kb013497 (big blind) folded before Flop
Seat 4: Scaaalll folded before Flop (didn't bet)
Seat 5: lucksuckdonk folded before Flop (didn't bet)
Seat 6: Vanekakqj collected ($0.05)



PokerStars Zoom Hand #229231274348:  Hold'em No Limit ($0.01/$0.02) - 2021/08/21 22:08:30 CET [2021/08/21 16:08:30 ET]
Table 'Halley' 6-max Seat #1 is the button
Seat 1: vovo4kapooh ($2 in chips) 
Seat 2: Scaaalll ($2.45 in chips) 
Seat 3: dcd113 ($4.61 in chips) 
Seat 4: BaronMax ($2.24 in chips) 
Seat 5: RrriotGrrrl ($10.09 in chips) 
Seat 6: maaitee ($2.36 in chips) 
Scaaalll: posts small blind $0.01
dcd113: posts big blind $0.02
*** HOLE CARDS ***
Dealt to Scaaalll [Ks Jd]
BaronMax: folds 
RrriotGrrrl: folds 
maaitee: folds 
vovo4kapooh: folds 
Scaaalll: raises $0.04 to $0.06
dcd113: calls $0.04
*** FLOP *** [Kd Tc 3s]
Scaaalll: bets $0.08
dcd113: folds 
Uncalled bet ($0.08) returned to Scaaalll
Scaaalll collected $0.12 from pot
Scaaalll: doesn't show hand 
*** SUMMARY ***
Total pot $0.12 | Rake $0 
Board [Kd Tc 3s]
Seat 1: vovo4kapooh (button) folded before Flop (didn't bet)
Seat 2: Scaaalll (small blind) collected ($0.12)
Seat 3: dcd113 (big blind) folded on the Flop
Seat 4: BaronMax folded before Flop (didn't bet)
Seat 5: RrriotGrrrl folded before Flop (didn't bet)
Seat 6: maaitee folded before Flop (didn't bet)



PokerStars Zoom Hand #229231271245:  Hold'em No Limit ($0.01/$0.02) - 2021/08/21 22:08:23 CET [2021/08/21 16:08:23 ET]
Table 'Halley' 6-max Seat #1 is the button
Seat 1: AtZ3899 ($1.39 in chips) 
Seat 2: Nancy_88 ($2 in chips) 
Seat 3: Reipinguimm ($2.09 in chips) 
Seat 4: Scaaalll ($2.45 in chips) 
Seat 5: BlackhawKK's ($3.30 in chips) 
Seat 6: T-saitama ($2 in chips) 
Nancy_88: posts small blind $0.01
Reipinguimm: posts big blind $0.02
*** HOLE CARDS ***
Dealt to Scaaalll [8d Jc]
Nancy_88 is disconnected 
Scaaalll: folds 
BlackhawKK's: folds 
T-saitama: folds 
AtZ3899: raises $0.02 to $0.04
Nancy_88: folds 
Reipinguimm: calls $0.02
*** FLOP *** [9c Qh Td]
Reipinguimm: checks 
AtZ3899: bets $0.05
Reipinguimm: folds 
Uncalled bet ($0.05) returned to AtZ3899
AtZ3899 collected $0.09 from pot
AtZ3899: doesn't show hand 
*** SUMMARY ***
Total pot $0.09 | Rake $0 
Board [9c Qh Td]
Seat 1: AtZ3899 (button) collected ($0.09)
Seat 2: Nancy_88 (small blind) folded before Flop
Seat 3: Reipinguimm (big blind) folded on the Flop
Seat 4: Scaaalll folded before Flop (didn't bet)
Seat 5: BlackhawKK's folded before Flop (didn't bet)
Seat 6: T-saitama folded before Flop (didn't bet)



PokerStars Zoom Hand #229231283127:  Hold'em No Limit ($0.01/$0.02) - 2021/08/21 22:08:50 CET [2021/08/21 16:08:50 ET]
Table 'Halley' 6-max Seat #1 is the button
Seat 1: Scaaalll ($2.51 in chips) 
Seat 2: pavlo8855 ($2 in chips) 
Seat 3: usenovm ($3.82 in chips) 
Seat 4: Russian MA ($0.94 in chips) 
Seat 5: skitai555 ($2 in chips) 
Seat 6: smileakafray ($4.25 in chips) 
pavlo8855: posts small blind $0.01
usenovm: posts big blind $0.02
*** HOLE CARDS ***
Dealt to Scaaalll [7c Jh]
Russian MA: folds 
skitai555: folds 
smileakafray: folds 
Russian MA is disconnected 
Scaaalll: raises $0.02 to $0.04
pavlo8855: folds 
usenovm: folds 
Uncalled bet ($0.02) returned to Scaaalll
Scaaalll collected $0.05 from pot
Scaaalll: doesn't show hand 
*** SUMMARY ***
Total pot $0.05 | Rake $0 
Seat 1: Scaaalll (button) collected ($0.05)
Seat 2: pavlo8855 (small blind) folded before Flop
Seat 3: usenovm (big blind) folded before Flop
Seat 4: Russian MA folded before Flop (didn't bet)
Seat 5: skitai555 folded before Flop (didn't bet)
Seat 6: smileakafray folded before Flop (didn't bet)



PokerStars Zoom Hand #229231267258:  Hold'em No Limit ($0.01/$0.02) - 2021/08/21 22:08:14 CET [2021/08/21 16:08:14 ET]
Table 'Halley' 6-max Seat #1 is the button
Seat 1: vovo4kapooh ($2 in chips) 
Seat 2: ca$hmeoutsid ($2.01 in chips) 
Seat 3: Gerar NB ($2.10 in chips) 
Seat 4: Canoinhas37 ($3.07 in chips) 
Seat 5: Scaaalll ($2.45 in chips) 
Seat 6: Jujiluju ($2.15 in chips) 
ca$hmeoutsid: posts small blind $0.01
Gerar NB: posts big blind $0.02
*** HOLE CARDS ***
Dealt to Scaaalll [2h 6h]
Canoinhas37: folds 
Scaaalll: folds 
Jujiluju: raises $0.05 to $0.07
vovo4kapooh: folds 
ca$hmeoutsid: folds 
Gerar NB: raises $0.15 to $0.22
Jujiluju: calls $0.15
*** FLOP *** [Jc Qs 8s]
Gerar NB: checks 
Jujiluju: bets $0.22
Gerar NB: calls $0.22
*** TURN *** [Jc Qs 8s] [Js]
Gerar NB: checks 
Jujiluju: checks 
*** RIVER *** [Jc Qs 8s Js] [3c]
Gerar NB: checks 
Jujiluju: bets $0.86
Gerar NB: folds 
Uncalled bet ($0.86) returned to Jujiluju
Jujiluju collected $0.86 from pot
Jujiluju: doesn't show hand 
*** SUMMARY ***
Total pot $0.89 | Rake $0.03 
Board [Jc Qs 8s Js 3c]
Seat 1: vovo4kapooh (button) folded before Flop (didn't bet)
Seat 2: ca$hmeoutsid (small blind) folded before Flop
Seat 3: Gerar NB (big blind) folded on the River
Seat 4: Canoinhas37 folded before Flop (didn't bet)
Seat 5: Scaaalll folded before Flop (didn't bet)
Seat 6: Jujiluju collected ($0.86)



PokerStars Zoom Hand #229231265033:  Hold'em No Limit ($0.01/$0.02) - 2021/08/21 22:08:09 CET [2021/08/21 16:08:09 ET]
Table 'Halley' 6-max Seat #1 is the button
Seat 1: skitai555 ($2.05 in chips) 
Seat 2: byakuda ($4.27 in chips) 
Seat 3: Hantsirg ($0.55 in chips) 
Seat 4: Gerar NB ($2.10 in chips) 
Seat 5: guntren.ps ($2.12 in chips) 
Seat 6: Scaaalll ($2.45 in chips) 
byakuda: posts small blind $0.01
Hantsirg: posts big blind $0.02
*** HOLE CARDS ***
Dealt to Scaaalll [9h 7c]
Gerar NB: folds 
guntren.ps: raises $0.03 to $0.05
Scaaalll: folds 
Hantsirg is disconnected 
skitai555: calls $0.05
byakuda: calls $0.04
Hantsirg: folds 
*** FLOP *** [7s Ts 9c]
byakuda: checks 
guntren.ps: checks 
skitai555: checks 
*** TURN *** [7s Ts 9c] [5s]
byakuda: checks 
guntren.ps: bets $0.12
skitai555: folds 
byakuda: raises $0.20 to $0.32
guntren.ps: folds 
Uncalled bet ($0.20) returned to byakuda
byakuda collected $0.40 from pot
byakuda: doesn't show hand 
*** SUMMARY ***
Total pot $0.41 | Rake $0.01 
Board [7s Ts 9c 5s]
Seat 1: skitai555 (button) folded on the Turn
Seat 2: byakuda (small blind) collected ($0.40)
Seat 3: Hantsirg (big blind) folded before Flop
Seat 4: Gerar NB folded before Flop (didn't bet)
Seat 5: guntren.ps folded on the Turn
Seat 6: Scaaalll folded before Flop (didn't bet)



PokerStars Zoom Hand #229231289202:  Hold'em No Limit ($0.01/$0.02) - 2021/08/21 22:09:04 CET [2021/08/21 16:09:04 ET]
Table 'Halley' 6-max Seat #1 is the button
Seat 1: Scaaalll ($2.54 in chips) 
Seat 2: Mikeloko182 ($2.04 in chips) 
Seat 3: ugi-dugi ($2.08 in chips) 
Seat 4: BigTestIcicle ($5.61 in chips) 
Seat 5: Emilmoller1 ($1.58 in chips) 
Seat 6: willmorel ($2.21 in chips) 
Mikeloko182: posts small blind $0.01
ugi-dugi: posts big blind $0.02
*** HOLE CARDS ***
Dealt to Scaaalll [2s Qd]
BigTestIcicle: folds 
Emilmoller1: folds 
willmorel: raises $0.04 to $0.06
Scaaalll: folds 
Mikeloko182: folds 
ugi-dugi: folds 
Uncalled bet ($0.04) returned to willmorel
willmorel collected $0.05 from pot
willmorel: doesn't show hand 
*** SUMMARY ***
Total pot $0.05 | Rake $0 
Seat 1: Scaaalll (button) folded before Flop (didn't bet)
Seat 2: Mikeloko182 (small blind) folded before Flop
Seat 3: ugi-dugi (big blind) folded before Flop
Seat 4: BigTestIcicle folded before Flop (didn't bet)
Seat 5: Emilmoller1 folded before Flop (didn't bet)
Seat 6: willmorel collected ($0.05)



PokerStars Zoom Hand #229231290900:  Hold'em No Limit ($0.01/$0.02) - 2021/08/21 22:09:07 CET [2021/08/21 16:09:07 ET]
Table 'Halley' 6-max Seat #1 is the button
Seat 1: Hupe2014 ($1.97 in chips) 
Seat 2: djewlz ($1.98 in chips) 
Seat 3: Scaaalll ($2.54 in chips) 
Seat 4: Jujiluju ($2.01 in chips) 
Seat 5: Luk Hander ($2.17 in chips) 
Seat 6: polymorhp ($1.90 in chips) 
djewlz: posts small blind $0.01
Scaaalll: posts big blind $0.02
*** HOLE CARDS ***
Dealt to Scaaalll [6d 8d]
Jujiluju: folds 
Luk Hander: folds 
polymorhp: raises $0.04 to $0.06
Hupe2014: folds 
Hupe2014 is disconnected 
djewlz: folds 
Scaaalll: folds 
Uncalled bet ($0.04) returned to polymorhp
polymorhp collected $0.05 from pot
polymorhp: doesn't show hand 
*** SUMMARY ***
Total pot $0.05 | Rake $0 
Seat 1: Hupe2014 (button) folded before Flop (didn't bet)
Seat 2: djewlz (small blind) folded before Flop
Seat 3: Scaaalll (big blind) folded before Flop
Seat 4: Jujiluju folded before Flop (didn't bet)
Seat 5: Luk Hander folded before Flop (didn't bet)
Seat 6: polymorhp collected ($0.05)



PokerStars Zoom Hand #229231299276:  Hold'em No Limit ($0.01/$0.02) - 2021/08/21 22:09:27 CET [2021/08/21 16:09:27 ET]
Table 'Halley' 6-max Seat #1 is the button
Seat 1: 9557lucas ($2.01 in chips) 
Seat 2: Nikimik ($2.07 in chips) 
Seat 3: Healthys07 ($2.67 in chips) 
Seat 4: Mikeloko182 ($2 in chips) 
Seat 5: smileakafray ($4.27 in chips) 
Seat 6: Scaaalll ($2.52 in chips) 
Nikimik: posts small blind $0.01
Healthys07: posts big blind $0.02
*** HOLE CARDS ***
Dealt to Scaaalll [Qh 2c]
Mikeloko182: folds 
smileakafray: raises $0.04 to $0.06
Scaaalll: folds 
9557lucas: folds 
Nikimik: folds 
Healthys07: folds 
Uncalled bet ($0.04) returned to smileakafray
9557lucas is disconnected 
smileakafray collected $0.05 from pot
smileakafray: doesn't show hand 
*** SUMMARY ***
Total pot $0.05 | Rake $0 
Seat 1: 9557lucas (button) folded before Flop (didn't bet)
Seat 2: Nikimik (small blind) folded before Flop
Seat 3: Healthys07 (big blind) folded before Flop
Seat 4: Mikeloko182 folded before Flop (didn't bet)
Seat 5: smileakafray collected ($0.05)
Seat 6: Scaaalll folded before Flop (didn't bet)



PokerStars Zoom Hand #229231304236:  Hold'em No Limit ($0.01/$0.02) - 2021/08/21 22:09:38 CET [2021/08/21 16:09:38 ET]
Table 'Halley' 6-max Seat #1 is the button
Seat 1: usenovm ($3.79 in chips) 
Seat 2: nemat_g ($1.78 in chips) 
Seat 3: 77omsk ($3.10 in chips) 
Seat 4: 365p2eva ($2.16 in chips) 
Seat 5: Scaaalll ($2.52 in chips) 
Seat 6: KRITAYA ($0.99 in chips) 
nemat_g: posts small blind $0.01
77omsk: posts big blind $0.02
*** HOLE CARDS ***
Dealt to Scaaalll [9d Th]
365p2eva: raises $0.04 to $0.06
Scaaalll: folds 
KRITAYA: folds 
usenovm: folds 
nemat_g: folds 
77omsk: folds 
Uncalled bet ($0.04) returned to 365p2eva
365p2eva collected $0.05 from pot
365p2eva: doesn't show hand 
*** SUMMARY ***
Total pot $0.05 | Rake $0 
Seat 1: usenovm (button) folded before Flop (didn't bet)
Seat 2: nemat_g (small blind) folded before Flop
Seat 3: 77omsk (big blind) folded before Flop
Seat 4: 365p2eva collected ($0.05)
Seat 5: Scaaalll folded before Flop (didn't bet)
Seat 6: KRITAYA folded before Flop (didn't bet)



PokerStars Zoom Hand #229231308623:  Hold'em No Limit ($0.01/$0.02) - 2021/08/21 22:09:48 CET [2021/08/21 16:09:48 ET]
Table 'Halley' 6-max Seat #1 is the button
Seat 1: amwkl4 ($2 in chips) 
Seat 2: Scaaalll ($2.52 in chips) 
Seat 3: 13Mohican ($2.04 in chips) 
Seat 4: 888lifeIS ($2.07 in chips) 
Seat 5: rodrigocvx ($1.21 in chips) 
Seat 6: Ramirres ($2.38 in chips) 
Scaaalll: posts small blind $0.01
13Mohican: posts big blind $0.02
*** HOLE CARDS ***
Dealt to Scaaalll [4s 7c]
888lifeIS: folds 
rodrigocvx: folds 
Ramirres: folds 
amwkl4: raises $0.04 to $0.06
Scaaalll: folds 
13Mohican: folds 
Uncalled bet ($0.04) returned to amwkl4
amwkl4 collected $0.05 from pot
amwkl4: doesn't show hand 
*** SUMMARY ***
Total pot $0.05 | Rake $0 
Seat 1: amwkl4 (button) collected ($0.05)
Seat 2: Scaaalll (small blind) folded before Flop
Seat 3: 13Mohican (big blind) folded before Flop
Seat 4: 888lifeIS folded before Flop (didn't bet)
Seat 5: rodrigocvx folded before Flop (didn't bet)
Seat 6: Ramirres folded before Flop (didn't bet)



PokerStars Zoom Hand #229231313448:  Hold'em No Limit ($0.01/$0.02) - 2021/08/21 22:09:59 CET [2021/08/21 16:09:59 ET]
Table 'Halley' 6-max Seat #1 is the button
Seat 1: olliejaydee ($3.27 in chips) 
Seat 2: estelionat171 ($0.65 in chips) 
Seat 3: olcham7 ($2.16 in chips) 
Seat 4: py100ta ($15.97 in chips) 
Seat 5: Scaaalll ($2.51 in chips) 
Seat 6: alecha11 ($2.29 in chips) 
estelionat171: posts small blind $0.01
olcham7: posts big blind $0.02
*** HOLE CARDS ***
Dealt to Scaaalll [7s As]
py100ta: folds 
Scaaalll: raises $0.04 to $0.06
alecha11: folds 
olliejaydee: raises $0.04 to $0.10
estelionat171: folds 
olcham7: folds 
Scaaalll: calls $0.04
*** FLOP *** [3s Ah Jd]
Scaaalll: checks 
olliejaydee: bets $0.11
Scaaalll: calls $0.11
*** TURN *** [3s Ah Jd] [Td]
Scaaalll: checks 
olliejaydee: bets $0.21
Scaaalll: folds 
Uncalled bet ($0.21) returned to olliejaydee
olliejaydee collected $0.43 from pot
olliejaydee: doesn't show hand 
*** SUMMARY ***
Total pot $0.45 | Rake $0.02 
Board [3s Ah Jd Td]
Seat 1: olliejaydee (button) collected ($0.43)
Seat 2: estelionat171 (small blind) folded before Flop
Seat 3: olcham7 (big blind) folded before Flop
Seat 4: py100ta folded before Flop (didn't bet)
Seat 5: Scaaalll folded on the Turn
Seat 6: alecha11 folded before Flop (didn't bet)



PokerStars Zoom Hand #229231328105:  Hold'em No Limit ($0.01/$0.02) - 2021/08/21 22:10:32 CET [2021/08/21 16:10:32 ET]
Table 'Halley' 6-max Seat #1 is the button
Seat 1: AndreaBsAs ($2.28 in chips) 
Seat 2: RoughRafff ($4.33 in chips) 
Seat 3: DaBaDaBaDooo ($2.07 in chips) 
Seat 4: Scaaalll ($2.30 in chips) 
Seat 5: 13Mohican ($2 in chips) 
Seat 6: Flankeris ($6.05 in chips) 
RoughRafff: posts small blind $0.01
DaBaDaBaDooo: posts big blind $0.02
*** HOLE CARDS ***
Dealt to Scaaalll [Kd 6c]
Scaaalll: folds 
13Mohican: folds 
Flankeris: folds 
AndreaBsAs: folds 
RoughRafff: raises $0.04 to $0.06
DaBaDaBaDooo: folds 
Uncalled bet ($0.04) returned to RoughRafff
RoughRafff collected $0.04 from pot
RoughRafff: doesn't show hand 
*** SUMMARY ***
Total pot $0.04 | Rake $0 
Seat 1: AndreaBsAs (button) folded before Flop (didn't bet)
Seat 2: RoughRafff (small blind) collected ($0.04)
Seat 3: DaBaDaBaDooo (big blind) folded before Flop
Seat 4: Scaaalll folded before Flop (didn't bet)
Seat 5: 13Mohican folded before Flop (didn't bet)
Seat 6: Flankeris folded before Flop (didn't bet)



PokerStars Zoom Hand #229231329809:  Hold'em No Limit ($0.01/$0.02) - 2021/08/21 22:10:36 CET [2021/08/21 16:10:36 ET]
Table 'Halley' 6-max Seat #1 is the button
Seat 1: Luben_76 ($2.42 in chips) 
Seat 2: timasblemba ($2 in chips) 
Seat 3: Scaaalll ($2.30 in chips) 
Seat 4: ramalhorod ($1.70 in chips) 
Seat 5: Befinski_K2 ($0.55 in chips) 
Seat 6: skryg93 ($2.05 in chips) 
timasblemba: posts small blind $0.01
Scaaalll: posts big blind $0.02
*** HOLE CARDS ***
Dealt to Scaaalll [7h Qs]
ramalhorod: folds 
ramalhorod is disconnected 
Befinski_K2: raises $0.02 to $0.04
skryg93: calls $0.04
Luben_76: calls $0.04
timasblemba: calls $0.03
Scaaalll: folds 
*** FLOP *** [4c 4s Ad]
timasblemba: checks 
Befinski_K2: bets $0.17
skryg93: folds 
Luben_76: folds 
timasblemba: folds 
Uncalled bet ($0.17) returned to Befinski_K2
Befinski_K2 collected $0.17 from pot
Befinski_K2: doesn't show hand 
*** SUMMARY ***
Total pot $0.18 | Rake $0.01 
Board [4c 4s Ad]
Seat 1: Luben_76 (button) folded on the Flop
Seat 2: timasblemba (small blind) folded on the Flop
Seat 3: Scaaalll (big blind) folded before Flop
Seat 4: ramalhorod folded before Flop (didn't bet)
Seat 5: Befinski_K2 collected ($0.17)
Seat 6: skryg93 folded on the Flop



PokerStars Zoom Hand #229231337779:  Hold'em No Limit ($0.01/$0.02) - 2021/08/21 22:10:54 CET [2021/08/21 16:10:54 ET]
Table 'Halley' 6-max Seat #1 is the button
Seat 1: FabOliveira9 ($2.94 in chips) 
Seat 2: martinob11 ($2.24 in chips) 
Seat 3: Amigo113 ($3.79 in chips) 
Seat 4: H0mmer99 ($2.65 in chips) 
Seat 5: estelionat171 ($0.74 in chips) 
Seat 6: Scaaalll ($2.28 in chips) 
martinob11: posts small blind $0.01
Amigo113: posts big blind $0.02
*** HOLE CARDS ***
Dealt to Scaaalll [Kd Td]
H0mmer99: folds 
estelionat171: folds 
Scaaalll: raises $0.04 to $0.06
FabOliveira9: folds 
martinob11: folds 
Amigo113: folds 
Uncalled bet ($0.04) returned to Scaaalll
Scaaalll collected $0.05 from pot
Scaaalll: doesn't show hand 
*** SUMMARY ***
Total pot $0.05 | Rake $0 
Seat 1: FabOliveira9 (button) folded before Flop (didn't bet)
Seat 2: martinob11 (small blind) folded before Flop
Seat 3: Amigo113 (big blind) folded before Flop
Seat 4: H0mmer99 folded before Flop (didn't bet)
Seat 5: estelionat171 folded before Flop (didn't bet)
Seat 6: Scaaalll collected ($0.05)



PokerStars Zoom Hand #229231356788:  Hold'em No Limit ($0.01/$0.02) - 2021/08/21 22:11:37 CET [2021/08/21 16:11:37 ET]
Table 'Halley' 6-max Seat #1 is the button
Seat 1: Scaaalll ($2.30 in chips) 
Seat 2: z3317111711 ($4.95 in chips) 
Seat 3: pavlo8855 ($2.18 in chips) 
Seat 4: WithMyWalker ($2.53 in chips) 
Seat 5: Ebbelwoiexp ($2.06 in chips) 
Seat 6: rpycmbEM ($4.33 in chips) 
z3317111711: posts small blind $0.01
pavlo8855: posts big blind $0.02
*** HOLE CARDS ***
Dealt to Scaaalll [Qs Qh]
Ebbelwoiexp is disconnected 
WithMyWalker: folds 
Ebbelwoiexp: folds 
rpycmbEM: folds 
Scaaalll: raises $0.02 to $0.04
z3317111711: folds 
pavlo8855: folds 
Uncalled bet ($0.02) returned to Scaaalll
Scaaalll collected $0.05 from pot
Scaaalll: doesn't show hand 
*** SUMMARY ***
Total pot $0.05 | Rake $0 
Seat 1: Scaaalll (button) collected ($0.05)
Seat 2: z3317111711 (small blind) folded before Flop
Seat 3: pavlo8855 (big blind) folded before Flop
Seat 4: WithMyWalker folded before Flop (didn't bet)
Seat 5: Ebbelwoiexp folded before Flop (didn't bet)
Seat 6: rpycmbEM folded before Flop (didn't bet)



PokerStars Zoom Hand #229231364345:  Hold'em No Limit ($0.01/$0.02) - 2021/08/21 22:11:54 CET [2021/08/21 16:11:54 ET]
Table 'Halley' 6-max Seat #1 is the button
Seat 1: guntren.ps ($2.35 in chips) 
Seat 2: Cid s2 ($2.17 in chips) 
Seat 3: RomiSex ($2 in chips) 
Seat 4: willmorel ($2.03 in chips) 
Seat 5: Scaaalll ($2.33 in chips) 
Seat 6: Mad_Clock ($2.08 in chips) 
Cid s2: posts small blind $0.01
RomiSex: posts big blind $0.02
*** HOLE CARDS ***
Dealt to Scaaalll [6d 2s]
willmorel: folds 
Scaaalll: folds 
Mad_Clock: raises $0.05 to $0.07
guntren.ps: folds 
Cid s2: folds 
RomiSex: folds 
Uncalled bet ($0.05) returned to Mad_Clock
Mad_Clock collected $0.05 from pot
Mad_Clock: doesn't show hand 
*** SUMMARY ***
Total pot $0.05 | Rake $0 
Seat 1: guntren.ps (button) folded before Flop (didn't bet)
Seat 2: Cid s2 (small blind) folded before Flop
Seat 3: RomiSex (big blind) folded before Flop
Seat 4: willmorel folded before Flop (didn't bet)
Seat 5: Scaaalll folded before Flop (didn't bet)
Seat 6: Mad_Clock collected ($0.05)



PokerStars Zoom Hand #229231345246:  Hold'em No Limit ($0.01/$0.02) - 2021/08/21 22:11:11 CET [2021/08/21 16:11:11 ET]
Table 'Halley' 6-max Seat #1 is the button
Seat 1: RaulacateFolds ($2.19 in chips) 
Seat 2: Scaaalll ($2.31 in chips) 
Seat 3: Davingo25 ($2.04 in chips) 
Seat 4: Osetrov.A.A ($1.98 in chips) 
Seat 5: pphit ($2.24 in chips) 
Seat 6: davidalejag ($2.92 in chips) 
Scaaalll: posts small blind $0.01
Davingo25: posts big blind $0.02
*** HOLE CARDS ***
Dealt to Scaaalll [Qh Ts]
Osetrov.A.A: raises $0.04 to $0.06
pphit: raises $0.12 to $0.18
davidalejag: folds 
Davingo25 is disconnected 
RaulacateFolds: folds 
Scaaalll: folds 
Davingo25: folds 
Osetrov.A.A: calls $0.12
*** FLOP *** [2d 6c Td]
Osetrov.A.A: checks 
pphit: bets $0.20
Osetrov.A.A: calls $0.20
*** TURN *** [2d 6c Td] [Ac]
Osetrov.A.A: checks 
pphit: checks 
*** RIVER *** [2d 6c Td Ac] [Tc]
Osetrov.A.A: bets $0.36
pphit: calls $0.36
*** SHOW DOWN ***
Osetrov.A.A: shows [8h 9s] (a pair of Tens)
pphit: shows [3s As] (two pair, Aces and Tens)
pphit collected $1.46 from pot
*** SUMMARY ***
Total pot $1.51 | Rake $0.05 
Board [2d 6c Td Ac Tc]
Seat 1: RaulacateFolds (button) folded before Flop (didn't bet)
Seat 2: Scaaalll (small blind) folded before Flop
Seat 3: Davingo25 (big blind) folded before Flop
Seat 4: Osetrov.A.A showed [8h 9s] and lost with a pair of Tens
Seat 5: pphit showed [3s As] and won ($1.46) with two pair, Aces and Tens
Seat 6: davidalejag folded before Flop (didn't bet)



PokerStars Zoom Hand #229231369187:  Hold'em No Limit ($0.01/$0.02) - 2021/08/21 22:12:05 CET [2021/08/21 16:12:05 ET]
Table 'Halley' 6-max Seat #1 is the button
Seat 1: sewq55 ($0.96 in chips) 
Seat 2: vovo4kapooh ($2.01 in chips) 
Seat 3: Scaaalll ($2.33 in chips) 
Seat 4: uniicecube ($2.66 in chips) 
Seat 5: pipecmolodec ($2.35 in chips) 
Seat 6: malandro733 ($2.44 in chips) 
vovo4kapooh: posts small blind $0.01
Scaaalll: posts big blind $0.02
*** HOLE CARDS ***
Dealt to Scaaalll [Tc 6s]
uniicecube: raises $0.03 to $0.05
pipecmolodec: folds 
malandro733: folds 
sewq55: folds 
vovo4kapooh: folds 
Scaaalll: folds 
Uncalled bet ($0.03) returned to uniicecube
uniicecube collected $0.05 from pot
uniicecube: doesn't show hand 
*** SUMMARY ***
Total pot $0.05 | Rake $0 
Seat 1: sewq55 (button) folded before Flop (didn't bet)
Seat 2: vovo4kapooh (small blind) folded before Flop
Seat 3: Scaaalll (big blind) folded before Flop
Seat 4: uniicecube collected ($0.05)
Seat 5: pipecmolodec folded before Flop (didn't bet)
Seat 6: malandro733 folded before Flop (didn't bet)



PokerStars Zoom Hand #229231375429:  Hold'em No Limit ($0.01/$0.02) - 2021/08/21 22:12:19 CET [2021/08/21 16:12:19 ET]
Table 'Halley' 6-max Seat #1 is the button
Seat 1: EstiBan18 ($2.05 in chips) 
Seat 2: Vitalyi1970 ($1.80 in chips) 
Seat 3: polymorhp ($1.40 in chips) 
Seat 4: Kojak34 ($6.37 in chips) 
Seat 5: Scaaalll ($2.31 in chips) 
Seat 6: boa juice ($1.23 in chips) 
Vitalyi1970: posts small blind $0.01
polymorhp: posts big blind $0.02
*** HOLE CARDS ***
Dealt to Scaaalll [Qh Qd]
Kojak34: raises $0.05 to $0.07
Scaaalll: calls $0.07
boa juice: calls $0.07
EstiBan18: folds 
Vitalyi1970: folds 
polymorhp: folds 
*** FLOP *** [3d Jc 3h]
Kojak34: checks 
Scaaalll: bets $0.15
boa juice: folds 
boa juice is disconnected 
Kojak34: folds 
Uncalled bet ($0.15) returned to Scaaalll
Scaaalll collected $0.23 from pot
Scaaalll: doesn't show hand 
*** SUMMARY ***
Total pot $0.24 | Rake $0.01 
Board [3d Jc 3h]
Seat 1: EstiBan18 (button) folded before Flop (didn't bet)
Seat 2: Vitalyi1970 (small blind) folded before Flop
Seat 3: polymorhp (big blind) folded before Flop
Seat 4: Kojak34 folded on the Flop
Seat 5: Scaaalll collected ($0.23)
Seat 6: boa juice folded on the Flop



PokerStars Zoom Hand #229231394868:  Hold'em No Limit ($0.01/$0.02) - 2021/08/21 22:13:03 CET [2021/08/21 16:13:03 ET]
Table 'Halley' 6-max Seat #1 is the button
Seat 1: dinoVIEIRA ($2.62 in chips) 
Seat 2: lucksuckdonk ($4.06 in chips) 
Seat 3: F_oksi(BLR) ($1.51 in chips) 
Seat 4: Blaackie ($1.22 in chips) 
Seat 5: Scaaalll ($2.47 in chips) 
Seat 6: dcd113 ($3.26 in chips) 
lucksuckdonk: posts small blind $0.01
F_oksi(BLR): posts big blind $0.02
*** HOLE CARDS ***
Dealt to Scaaalll [Ah 7s]
Blaackie: raises $0.03 to $0.05
Scaaalll: folds 
dcd113: folds 
dinoVIEIRA: folds 
lucksuckdonk: folds 
F_oksi(BLR): folds 
Uncalled bet ($0.03) returned to Blaackie
Blaackie collected $0.05 from pot
Blaackie: doesn't show hand 
*** SUMMARY ***
Total pot $0.05 | Rake $0 
Seat 1: dinoVIEIRA (button) folded before Flop (didn't bet)
Seat 2: lucksuckdonk (small blind) folded before Flop
Seat 3: F_oksi(BLR) (big blind) folded before Flop
Seat 4: Blaackie collected ($0.05)
Seat 5: Scaaalll folded before Flop (didn't bet)
Seat 6: dcd113 folded before Flop (didn't bet)



PokerStars Zoom Hand #229231398746:  Hold'em No Limit ($0.01/$0.02) - 2021/08/21 22:13:12 CET [2021/08/21 16:13:12 ET]
Table 'Halley' 6-max Seat #1 is the button
Seat 1: ffffj ($1.52 in chips) 
Seat 2: Scaaalll ($2.47 in chips) 
Seat 3: zielony ($2.12 in chips) 
Seat 4: 77omsk ($8.46 in chips) 
Seat 5: Agno$tic ($2.52 in chips) 
Seat 6: Hantsirg ($0.48 in chips) 
Scaaalll: posts small blind $0.01
zielony: posts big blind $0.02
*** HOLE CARDS ***
Dealt to Scaaalll [4d 5c]
Hantsirg is disconnected 
77omsk: folds 
Agno$tic: folds 
Hantsirg: folds 
ffffj: raises $0.02 to $0.04
Scaaalll: folds 
zielony: folds 
Uncalled bet ($0.02) returned to ffffj
ffffj collected $0.05 from pot
ffffj: doesn't show hand 
*** SUMMARY ***
Total pot $0.05 | Rake $0 
Seat 1: ffffj (button) collected ($0.05)
Seat 2: Scaaalll (small blind) folded before Flop
Seat 3: zielony (big blind) folded before Flop
Seat 4: 77omsk folded before Flop (didn't bet)
Seat 5: Agno$tic folded before Flop (didn't bet)
Seat 6: Hantsirg folded before Flop (didn't bet)



PokerStars Zoom Hand #229231391739:  Hold'em No Limit ($0.01/$0.02) - 2021/08/21 22:12:56 CET [2021/08/21 16:12:56 ET]
Table 'Halley' 6-max Seat #1 is the button
Seat 1: Rafaxn ($2.09 in chips) 
Seat 2: dinoVIEIRA ($2.63 in chips) 
Seat 3: elmex886 ($2.61 in chips) 
Seat 4: Treadero ($2.39 in chips) 
Seat 5: TheJunta ($2.13 in chips) 
Seat 6: Scaaalll ($2.47 in chips) 
dinoVIEIRA: posts small blind $0.01
elmex886: posts big blind $0.02
*** HOLE CARDS ***
Dealt to Scaaalll [2s 4s]
Treadero: raises $0.02 to $0.04
TheJunta: folds 
Scaaalll: folds 
Rafaxn: folds 
dinoVIEIRA: folds 
elmex886: calls $0.02
*** FLOP *** [7c 7h 4h]
elmex886: checks 
Treadero: bets $0.05
elmex886: calls $0.05
*** TURN *** [7c 7h 4h] [9c]
elmex886: checks 
Treadero: checks 
*** RIVER *** [7c 7h 4h 9c] [Js]
elmex886: checks 
Treadero: bets $0.09
elmex886: folds 
Uncalled bet ($0.09) returned to Treadero
Treadero collected $0.18 from pot
Treadero: doesn't show hand 
*** SUMMARY ***
Total pot $0.19 | Rake $0.01 
Board [7c 7h 4h 9c Js]
Seat 1: Rafaxn (button) folded before Flop (didn't bet)
Seat 2: dinoVIEIRA (small blind) folded before Flop
Seat 3: elmex886 (big blind) folded on the River
Seat 4: Treadero collected ($0.18)
Seat 5: TheJunta folded before Flop (didn't bet)
Seat 6: Scaaalll folded before Flop (didn't bet)



PokerStars Zoom Hand #229231405030:  Hold'em No Limit ($0.01/$0.02) - 2021/08/21 22:13:26 CET [2021/08/21 16:13:26 ET]
Table 'Halley' 6-max Seat #1 is the button
Seat 1: Scaaalll ($2.46 in chips) 
Seat 2: EDJF1999 ($0.59 in chips) 
Seat 3: blillad ($0.55 in chips) 
Seat 4: rpycmbEM ($4.53 in chips) 
Seat 5: Alex Koshva1 ($3.21 in chips) 
Seat 6: ARTMVSLV ($6.99 in chips) 
EDJF1999: posts small blind $0.01
blillad: posts big blind $0.02
*** HOLE CARDS ***
Dealt to Scaaalll [Js 6d]
rpycmbEM: raises $0.02 to $0.04
Alex Koshva1: folds 
ARTMVSLV: raises $0.11 to $0.15
Scaaalll: folds 
EDJF1999: folds 
blillad: folds 
rpycmbEM: calls $0.11
*** FLOP *** [Kd 2c 7s]
rpycmbEM: checks 
ARTMVSLV: bets $0.10
rpycmbEM: folds 
Uncalled bet ($0.10) returned to ARTMVSLV
ARTMVSLV collected $0.32 from pot
ARTMVSLV: doesn't show hand 
*** SUMMARY ***
Total pot $0.33 | Rake $0.01 
Board [Kd 2c 7s]
Seat 1: Scaaalll (button) folded before Flop (didn't bet)
Seat 2: EDJF1999 (small blind) folded before Flop
Seat 3: blillad (big blind) folded before Flop
Seat 4: rpycmbEM folded on the Flop
Seat 5: Alex Koshva1 folded before Flop (didn't bet)
Seat 6: ARTMVSLV collected ($0.32)



PokerStars Zoom Hand #229231406722:  Hold'em No Limit ($0.01/$0.02) - 2021/08/21 22:13:30 CET [2021/08/21 16:13:30 ET]
Table 'Halley' 6-max Seat #1 is the button
Seat 1: zbixxx ($5.58 in chips) 
Seat 2: Esskeetit420/69 ($1.41 in chips) 
Seat 3: OFSHOR ($4.28 in chips) 
Seat 4: A.luckebeggr ($2.75 in chips) 
Seat 5: ffffj ($1.55 in chips) 
Seat 6: Scaaalll ($2.46 in chips) 
Esskeetit420/69: posts small blind $0.01
OFSHOR: posts big blind $0.02
*** HOLE CARDS ***
Dealt to Scaaalll [Ac As]
A.luckebeggr: folds 
ffffj: raises $0.03 to $0.05
Scaaalll: raises $0.11 to $0.16
zbixxx: folds 
Esskeetit420/69: folds 
OFSHOR: folds 
ffffj: raises $1.39 to $1.55 and is all-in
Scaaalll: calls $1.39
*** FLOP *** [Ts 6h Jd]
*** TURN *** [Ts 6h Jd] [9c]
*** RIVER *** [Ts 6h Jd 9c] [Qh]
*** SHOW DOWN ***
ffffj: shows [Td Th] (three of a kind, Tens)
Scaaalll: shows [Ac As] (a pair of Aces)
ffffj cashed out the hand for $0.60 | Cash Out Fee $0.01
*** SUMMARY ***
Total pot $3.13 | Rake $0.11 
Board [Ts 6h Jd 9c Qh]
Seat 1: zbixxx (button) folded before Flop (didn't bet)
Seat 2: Esskeetit420/69 (small blind) folded before Flop
Seat 3: OFSHOR (big blind) folded before Flop
Seat 4: A.luckebeggr folded before Flop (didn't bet)
Seat 5: ffffj showed [Td Th] and won ($3.02) with three of a kind, Tens (pot not awarded as player cashed out)
Seat 6: Scaaalll showed [Ac As] and lost with a pair of Aces



PokerStars Zoom Hand #229231444417:  Hold'em No Limit ($0.01/$0.02) - 2021/08/21 22:14:27 CET [2021/08/21 16:14:27 ET]
Table 'Halley' 6-max Seat #1 is the button
Seat 1: 01527368 ($3.90 in chips) 
Seat 2: m3ssy34 ($0.51 in chips) 
Seat 3: tazar34_777 ($2.19 in chips) 
Seat 4: Scaaalll ($2 in chips) 
Seat 5: innexplus ($1.95 in chips) 
Seat 6: ffffj ($0.60 in chips) 
m3ssy34: posts small blind $0.01
tazar34_777: posts big blind $0.02
*** HOLE CARDS ***
Dealt to Scaaalll [8c 6s]
Scaaalll: folds 
innexplus: folds 
ffffj: raises $0.02 to $0.04
01527368: folds 
m3ssy34: calls $0.03
tazar34_777: folds 
*** FLOP *** [Ks Jh 2c]
m3ssy34: checks 
ffffj: bets $0.05
m3ssy34: folds 
Uncalled bet ($0.05) returned to ffffj
ffffj collected $0.10 from pot
ffffj: doesn't show hand 
m3ssy34 is disconnected 
*** SUMMARY ***
Total pot $0.10 | Rake $0 
Board [Ks Jh 2c]
Seat 1: 01527368 (button) folded before Flop (didn't bet)
Seat 2: m3ssy34 (small blind) folded on the Flop
Seat 3: tazar34_777 (big blind) folded before Flop
Seat 4: Scaaalll folded before Flop (didn't bet)
Seat 5: innexplus folded before Flop (didn't bet)
Seat 6: ffffj collected ($0.10)



PokerStars Zoom Hand #229231447965:  Hold'em No Limit ($0.01/$0.02) - 2021/08/21 22:14:35 CET [2021/08/21 16:14:35 ET]
Table 'Halley' 6-max Seat #1 is the button
Seat 1: Kkamm ($2.67 in chips) 
Seat 2: Herr.Hikke ($2 in chips) 
Seat 3: Scaaalll ($2 in chips) 
Seat 4: zergmiky ($2 in chips) 
Seat 5: AlexGTPS ($2.03 in chips) 
Seat 6: sewq55 ($1.02 in chips) 
Herr.Hikke: posts small blind $0.01
Scaaalll: posts big blind $0.02
*** HOLE CARDS ***
Dealt to Scaaalll [Jh 5h]
zergmiky: raises $0.03 to $0.05
AlexGTPS: folds 
sewq55: folds 
Kkamm: folds 
Herr.Hikke: folds 
Scaaalll: folds 
Uncalled bet ($0.03) returned to zergmiky
zergmiky collected $0.05 from pot
zergmiky: doesn't show hand 
*** SUMMARY ***
Total pot $0.05 | Rake $0 
Seat 1: Kkamm (button) folded before Flop (didn't bet)
Seat 2: Herr.Hikke (small blind) folded before Flop
Seat 3: Scaaalll (big blind) folded before Flop
Seat 4: zergmiky collected ($0.05)
Seat 5: AlexGTPS folded before Flop (didn't bet)
Seat 6: sewq55 folded before Flop (didn't bet)



PokerStars Zoom Hand #229231458063:  Hold'em No Limit ($0.01/$0.02) - 2021/08/21 22:14:58 CET [2021/08/21 16:14:58 ET]
Table 'Halley' 6-max Seat #1 is the button
Seat 1: Fanatspartak ($3.71 in chips) 
Seat 2: Scaaalll ($2 in chips) 
Seat 3: so0love ($4.36 in chips) 
Seat 4: Vanekakqj ($2.34 in chips) 
Seat 5: Tabitaji ($2.77 in chips) 
Seat 6: Herr.Hikke ($2 in chips) 
Scaaalll: posts small blind $0.01
so0love: posts big blind $0.02
*** HOLE CARDS ***
Dealt to Scaaalll [4s 9h]
Vanekakqj: raises $0.02 to $0.04
Tabitaji: folds 
Herr.Hikke: folds 
Fanatspartak: folds 
Scaaalll: folds 
so0love: folds 
Uncalled bet ($0.02) returned to Vanekakqj
Vanekakqj collected $0.05 from pot
Vanekakqj: doesn't show hand 
*** SUMMARY ***
Total pot $0.05 | Rake $0 
Seat 1: Fanatspartak (button) folded before Flop (didn't bet)
Seat 2: Scaaalll (small blind) folded before Flop
Seat 3: so0love (big blind) folded before Flop
Seat 4: Vanekakqj collected ($0.05)
Seat 5: Tabitaji folded before Flop (didn't bet)
Seat 6: Herr.Hikke folded before Flop (didn't bet)



PokerStars Zoom Hand #229231461722:  Hold'em No Limit ($0.01/$0.02) - 2021/08/21 22:15:05 CET [2021/08/21 16:15:05 ET]
Table 'Halley' 6-max Seat #1 is the button
Seat 1: Scaaalll ($2 in chips) 
Seat 2: nodtress ($2 in chips) 
Seat 3: kolo84 ($2.01 in chips) 
Seat 4: kahzura ($2 in chips) 
Seat 5: HubertFroh ($2 in chips) 
Seat 6: DaporteWins ($2 in chips) 
nodtress: posts small blind $0.01
kolo84: posts big blind $0.02
*** HOLE CARDS ***
Dealt to Scaaalll [5s 5d]
kahzura: folds 
HubertFroh: folds 
DaporteWins: folds 
Scaaalll: raises $0.02 to $0.04
nodtress: folds 
kolo84: calls $0.02
*** FLOP *** [Ad Th Td]
kolo84: checks 
Scaaalll: bets $0.06
kolo84: folds 
Uncalled bet ($0.06) returned to Scaaalll
Scaaalll collected $0.09 from pot
Scaaalll: doesn't show hand 
*** SUMMARY ***
Total pot $0.09 | Rake $0 
Board [Ad Th Td]
Seat 1: Scaaalll (button) collected ($0.09)
Seat 2: nodtress (small blind) folded before Flop
Seat 3: kolo84 (big blind) folded on the Flop
Seat 4: kahzura folded before Flop (didn't bet)
Seat 5: HubertFroh folded before Flop (didn't bet)
Seat 6: DaporteWins folded before Flop (didn't bet)



PokerStars Zoom Hand #229231471822:  Hold'em No Limit ($0.01/$0.02) - 2021/08/21 22:15:28 CET [2021/08/21 16:15:28 ET]
Table 'Halley' 6-max Seat #1 is the button
Seat 1: Coldact ($1.58 in chips) 
Seat 2: kolo84 ($1.97 in chips) 
Seat 3: Djalmethedj ($1.65 in chips) 
Seat 4: Ne0net ($2.22 in chips) 
Seat 5: VasquezSancho96 ($4.52 in chips) 
Seat 6: Scaaalll ($2.05 in chips) 
kolo84: posts small blind $0.01
Djalmethedj: posts big blind $0.02
*** HOLE CARDS ***
Dealt to Scaaalll [Ad 3c]
Ne0net: folds 
VasquezSancho96: folds 
Scaaalll: folds 
Coldact: raises $0.04 to $0.06
kolo84: folds 
Djalmethedj: raises $0.10 to $0.16
Coldact: folds 
Uncalled bet ($0.10) returned to Djalmethedj
Djalmethedj collected $0.13 from pot
Djalmethedj: doesn't show hand 
*** SUMMARY ***
Total pot $0.13 | Rake $0 
Seat 1: Coldact (button) folded before Flop
Seat 2: kolo84 (small blind) folded before Flop
Seat 3: Djalmethedj (big blind) collected ($0.13)
Seat 4: Ne0net folded before Flop (didn't bet)
Seat 5: VasquezSancho96 folded before Flop (didn't bet)
Seat 6: Scaaalll folded before Flop (didn't bet)



PokerStars Zoom Hand #229231482720:  Hold'em No Limit ($0.01/$0.02) - 2021/08/21 22:15:52 CET [2021/08/21 16:15:52 ET]
Table 'Halley' 6-max Seat #1 is the button
Seat 1: meikoz ($2.28 in chips) 
Seat 2: zielony ($2 in chips) 
Seat 3: Flankeris ($3.02 in chips) 
Seat 4: Scaaalll ($2.05 in chips) 
Seat 5: Alex Koshva1 ($3.17 in chips) 
Seat 6: zergmiky ($2.25 in chips) 
zielony: posts small blind $0.01
Flankeris: posts big blind $0.02
*** HOLE CARDS ***
Dealt to Scaaalll [3h 3c]
Scaaalll: raises $0.04 to $0.06
Alex Koshva1: folds 
zergmiky: folds 
meikoz: folds 
zielony: folds 
Flankeris: folds 
Uncalled bet ($0.04) returned to Scaaalll
Scaaalll collected $0.05 from pot
Scaaalll: doesn't show hand 
*** SUMMARY ***
Total pot $0.05 | Rake $0 
Seat 1: meikoz (button) folded before Flop (didn't bet)
Seat 2: zielony (small blind) folded before Flop
Seat 3: Flankeris (big blind) folded before Flop
Seat 4: Scaaalll collected ($0.05)
Seat 5: Alex Koshva1 folded before Flop (didn't bet)
Seat 6: zergmiky folded before Flop (didn't bet)



PokerStars Zoom Hand #229231492271:  Hold'em No Limit ($0.01/$0.02) - 2021/08/21 22:16:13 CET [2021/08/21 16:16:13 ET]
Table 'Halley' 6-max Seat #1 is the button
Seat 1: felipeciji ($2.04 in chips) 
Seat 2: zbixxx ($6.50 in chips) 
Seat 3: Scaaalll ($2.08 in chips) 
Seat 4: Koldun 2636 ($4.24 in chips) 
Seat 5: dinoVIEIRA ($3.05 in chips) 
Seat 6: fishh_play ($3.98 in chips) 
zbixxx: posts small blind $0.01
Scaaalll: posts big blind $0.02
*** HOLE CARDS ***
Dealt to Scaaalll [9c Js]
Koldun 2636: folds 
dinoVIEIRA: folds 
fishh_play: folds 
felipeciji: folds 
zbixxx: raises $0.04 to $0.06
Scaaalll: folds 
Uncalled bet ($0.04) returned to zbixxx
zbixxx collected $0.04 from pot
zbixxx: doesn't show hand 
*** SUMMARY ***
Total pot $0.04 | Rake $0 
Seat 1: felipeciji (button) folded before Flop (didn't bet)
Seat 2: zbixxx (small blind) collected ($0.04)
Seat 3: Scaaalll (big blind) folded before Flop
Seat 4: Koldun 2636 folded before Flop (didn't bet)
Seat 5: dinoVIEIRA folded before Flop (didn't bet)
Seat 6: fishh_play folded before Flop (didn't bet)



PokerStars Zoom Hand #229231479548:  Hold'em No Limit ($0.01/$0.02) - 2021/08/21 22:15:45 CET [2021/08/21 16:15:45 ET]
Table 'Halley' 6-max Seat #1 is the button
Seat 1: meikoz ($2.27 in chips) 
Seat 2: MATIdf365 ($2.24 in chips) 
Seat 3: sg.32rus ($0.88 in chips) 
Seat 4: KOFE2011 ($2 in chips) 
Seat 5: Scaaalll ($2.05 in chips) 
Seat 6: bananAAbandit ($2.10 in chips) 
MATIdf365: posts small blind $0.01
sg.32rus: posts big blind $0.02
*** HOLE CARDS ***
Dealt to Scaaalll [2s Kd]
KOFE2011: raises $0.02 to $0.04
Scaaalll: folds 
bananAAbandit: folds 
meikoz: raises $0.16 to $0.20
MATIdf365: folds 
sg.32rus: folds 
KOFE2011: calls $0.16
*** FLOP *** [Js 5s Ac]
KOFE2011: bets $0.10
meikoz: calls $0.10
*** TURN *** [Js 5s Ac] [Ah]
KOFE2011: bets $0.20
meikoz: calls $0.20
*** RIVER *** [Js 5s Ac Ah] [3d]
KOFE2011: checks 
meikoz: checks 
*** SHOW DOWN ***
KOFE2011: shows [Ad 8h] (three of a kind, Aces)
meikoz: mucks hand 
KOFE2011 collected $0.99 from pot
*** SUMMARY ***
Total pot $1.03 | Rake $0.04 
Board [Js 5s Ac Ah 3d]
Seat 1: meikoz (button) mucked [Ks Kh]
Seat 2: MATIdf365 (small blind) folded before Flop
Seat 3: sg.32rus (big blind) folded before Flop
Seat 4: KOFE2011 showed [Ad 8h] and won ($0.99) with three of a kind, Aces
Seat 5: Scaaalll folded before Flop (didn't bet)
Seat 6: bananAAbandit folded before Flop (didn't bet)



PokerStars Zoom Hand #229231502864:  Hold'em No Limit ($0.01/$0.02) - 2021/08/21 22:16:36 CET [2021/08/21 16:16:36 ET]
Table 'Halley' 6-max Seat #1 is the button
Seat 1: Scaaalll ($2.06 in chips) 
Seat 2: PapiMik3 ($2.91 in chips) 
Seat 3: Koldun 2636 ($2.93 in chips) 
Seat 4: herket ($0.83 in chips) 
Seat 5: estelionat171 ($0.96 in chips) 
Seat 6: Espartacus5222 ($3.63 in chips) 
PapiMik3: posts small blind $0.01
Koldun 2636: posts big blind $0.02
*** HOLE CARDS ***
Dealt to Scaaalll [Qs 4c]
herket: folds 
estelionat171: folds 
Espartacus5222: folds 
Scaaalll: folds 
PapiMik3: folds 
Uncalled bet ($0.01) returned to Koldun 2636
Koldun 2636 collected $0.02 from pot
Koldun 2636: doesn't show hand 
*** SUMMARY ***
Total pot $0.02 | Rake $0 
Seat 1: Scaaalll (button) folded before Flop (didn't bet)
Seat 2: PapiMik3 (small blind) folded before Flop
Seat 3: Koldun 2636 (big blind) collected ($0.02)
Seat 4: herket folded before Flop (didn't bet)
Seat 5: estelionat171 folded before Flop (didn't bet)
Seat 6: Espartacus5222 folded before Flop (didn't bet)



PokerStars Zoom Hand #229231500591:  Hold'em No Limit ($0.01/$0.02) - 2021/08/21 22:16:31 CET [2021/08/21 16:16:31 ET]
Table 'Halley' 6-max Seat #1 is the button
Seat 1: AlexGTPS ($4.22 in chips) 
Seat 2: EmperorKurr ($2.53 in chips) 
Seat 3: Blaackie ($1.81 in chips) 
Seat 4: Scaaalll ($2.06 in chips) 
Seat 5: dcd113 ($3.21 in chips) 
Seat 6: zielony ($2.03 in chips) 
EmperorKurr: posts small blind $0.01
Blaackie: posts big blind $0.02
*** HOLE CARDS ***
Dealt to Scaaalll [8s 9c]
Scaaalll: folds 
dcd113: folds 
zielony: folds 
AlexGTPS: folds 
EmperorKurr: raises $0.04 to $0.06
Blaackie: folds 
Uncalled bet ($0.04) returned to EmperorKurr
EmperorKurr collected $0.04 from pot
EmperorKurr: doesn't show hand 
*** SUMMARY ***
Total pot $0.04 | Rake $0 
Seat 1: AlexGTPS (button) folded before Flop (didn't bet)
Seat 2: EmperorKurr (small blind) collected ($0.04)
Seat 3: Blaackie (big blind) folded before Flop
Seat 4: Scaaalll folded before Flop (didn't bet)
Seat 5: dcd113 folded before Flop (didn't bet)
Seat 6: zielony folded before Flop (didn't bet)



PokerStars Zoom Hand #229231505624:  Hold'em No Limit ($0.01/$0.02) - 2021/08/21 22:16:42 CET [2021/08/21 16:16:42 ET]
Table 'Halley' 6-max Seat #1 is the button
Seat 1: leoniduch93 ($1.54 in chips) 
Seat 2: HubertFroh ($2.65 in chips) 
Seat 3: wstanula ($1.95 in chips) 
Seat 4: Laonikos ($8.31 in chips) 
Seat 5: Scaaalll ($2.06 in chips) 
Seat 6: estelionat171 ($0.94 in chips) 
HubertFroh: posts small blind $0.01
wstanula: posts big blind $0.02
*** HOLE CARDS ***
Dealt to Scaaalll [Qd Jc]
Laonikos: folds 
Scaaalll: raises $0.04 to $0.06
estelionat171: folds 
leoniduch93: folds 
HubertFroh: folds 
wstanula: calls $0.04
*** FLOP *** [6s Qc Th]
wstanula: checks 
Scaaalll: bets $0.08
wstanula: folds 
Uncalled bet ($0.08) returned to Scaaalll
Scaaalll collected $0.13 from pot
Scaaalll: doesn't show hand 
*** SUMMARY ***
Total pot $0.13 | Rake $0 
Board [6s Qc Th]
Seat 1: leoniduch93 (button) folded before Flop (didn't bet)
Seat 2: HubertFroh (small blind) folded before Flop
Seat 3: wstanula (big blind) folded on the Flop
Seat 4: Laonikos folded before Flop (didn't bet)
Seat 5: Scaaalll collected ($0.13)
Seat 6: estelionat171 folded before Flop (didn't bet)



PokerStars Zoom Hand #229231523082:  Hold'em No Limit ($0.01/$0.02) - 2021/08/21 22:17:20 CET [2021/08/21 16:17:20 ET]
Table 'Halley' 6-max Seat #1 is the button
Seat 1: Ne0net ($2.22 in chips) 
Seat 2: Scaaalll ($2.13 in chips) 
Seat 3: kahzura ($2.19 in chips) 
Seat 4: ugi-dugi ($2.11 in chips) 
Seat 5: Nancy_88 ($2.04 in chips) 
Seat 6: Rafaxn ($2.11 in chips) 
Scaaalll: posts small blind $0.01
kahzura: posts big blind $0.02
*** HOLE CARDS ***
Dealt to Scaaalll [Jd 5h]
ugi-dugi: folds 
Nancy_88: folds 
Nancy_88 is disconnected 
Rafaxn: folds 
Ne0net: raises $0.03 to $0.05
Scaaalll: folds 
kahzura: folds 
Uncalled bet ($0.03) returned to Ne0net
Ne0net collected $0.05 from pot
Ne0net: doesn't show hand 
*** SUMMARY ***
Total pot $0.05 | Rake $0 
Seat 1: Ne0net (button) collected ($0.05)
Seat 2: Scaaalll (small blind) folded before Flop
Seat 3: kahzura (big blind) folded before Flop
Seat 4: ugi-dugi folded before Flop (didn't bet)
Seat 5: Nancy_88 folded before Flop (didn't bet)
Seat 6: Rafaxn folded before Flop (didn't bet)



PokerStars Zoom Hand #229231528151:  Hold'em No Limit ($0.01/$0.02) - 2021/08/21 22:17:30 CET [2021/08/21 16:17:30 ET]
Table 'Halley' 6-max Seat #1 is the button
Seat 1: weire99 ($4.35 in chips) 
Seat 2: yeahyeeei ($0.96 in chips) 
Seat 3: Scaaalll ($2.12 in chips) 
Seat 4: HWalshy ($1.64 in chips) 
Seat 5: alecha11 ($2 in chips) 
Seat 6: SKV_1985 ($2.14 in chips) 
yeahyeeei: posts small blind $0.01
Scaaalll: posts big blind $0.02
*** HOLE CARDS ***
Dealt to Scaaalll [2d 5h]
HWalshy: raises $0.02 to $0.04
alecha11: raises $0.12 to $0.16
SKV_1985: folds 
weire99: folds 
weire99 is disconnected 
yeahyeeei: folds 
Scaaalll: folds 
HWalshy: folds 
Uncalled bet ($0.12) returned to alecha11
alecha11 collected $0.11 from pot
alecha11: doesn't show hand 
*** SUMMARY ***
Total pot $0.11 | Rake $0 
Seat 1: weire99 (button) folded before Flop (didn't bet)
Seat 2: yeahyeeei (small blind) folded before Flop
Seat 3: Scaaalll (big blind) folded before Flop
Seat 4: HWalshy folded before Flop
Seat 5: alecha11 collected ($0.11)
Seat 6: SKV_1985 folded before Flop (didn't bet)



PokerStars Zoom Hand #229231540551:  Hold'em No Limit ($0.01/$0.02) - 2021/08/21 22:17:58 CET [2021/08/21 16:17:58 ET]
Table 'Halley' 6-max Seat #1 is the button
Seat 1: estelionat171 ($1.17 in chips) 
Seat 2: ash1448 ($3.31 in chips) 
Seat 3: PapiMik3 ($2.68 in chips) 
Seat 4: Fanatspartak ($3.57 in chips) 
Seat 5: Flankeris ($4.82 in chips) 
Seat 6: Scaaalll ($2.10 in chips) 
ash1448: posts small blind $0.01
PapiMik3: posts big blind $0.02
*** HOLE CARDS ***
Dealt to Scaaalll [9h 6d]
Fanatspartak: folds 
Flankeris: folds 
Scaaalll: folds 
estelionat171: folds 
ash1448: folds 
Uncalled bet ($0.01) returned to PapiMik3
PapiMik3 collected $0.02 from pot
PapiMik3: doesn't show hand 
*** SUMMARY ***
Total pot $0.02 | Rake $0 
Seat 1: estelionat171 (button) folded before Flop (didn't bet)
Seat 2: ash1448 (small blind) folded before Flop
Seat 3: PapiMik3 (big blind) collected ($0.02)
Seat 4: Fanatspartak folded before Flop (didn't bet)
Seat 5: Flankeris folded before Flop (didn't bet)
Seat 6: Scaaalll folded before Flop (didn't bet)



PokerStars Zoom Hand #229231545159:  Hold'em No Limit ($0.01/$0.02) - 2021/08/21 22:18:08 CET [2021/08/21 16:18:08 ET]
Table 'Halley' 6-max Seat #1 is the button
Seat 1: KoAlRy ($2.12 in chips) 
Seat 2: PapiMik3 ($2 in chips) 
Seat 3: sewq55 ($1.23 in chips) 
Seat 4: Scaaalll ($2.09 in chips) 
Seat 5: NIK1973 23 ($2 in chips) 
Seat 6: RomiSex ($3.90 in chips) 
PapiMik3: posts small blind $0.01
sewq55: posts big blind $0.02
*** HOLE CARDS ***
Dealt to Scaaalll [5d Qd]
Scaaalll: folds 
NIK1973 23: folds 
RomiSex: folds 
KoAlRy: folds 
PapiMik3: raises $0.04 to $0.06
sewq55: folds 
Uncalled bet ($0.04) returned to PapiMik3
PapiMik3 collected $0.04 from pot
PapiMik3: doesn't show hand 
*** SUMMARY ***
Total pot $0.04 | Rake $0 
Seat 1: KoAlRy (button) folded before Flop (didn't bet)
Seat 2: PapiMik3 (small blind) collected ($0.04)
Seat 3: sewq55 (big blind) folded before Flop
Seat 4: Scaaalll folded before Flop (didn't bet)
Seat 5: NIK1973 23 folded before Flop (didn't bet)
Seat 6: RomiSex folded before Flop (didn't bet)



PokerStars Zoom Hand #229231546983:  Hold'em No Limit ($0.01/$0.02) - 2021/08/21 22:18:12 CET [2021/08/21 16:18:12 ET]
Table 'Halley' 6-max Seat #1 is the button
Seat 1: Scaaalll ($2.09 in chips) 
Seat 2: 9zocker9 ($2.42 in chips) 
Seat 3: alecha11 ($2.07 in chips) 
Seat 4: teutonknight ($1.40 in chips) 
Seat 5: Antipirate ($3.59 in chips) 
Seat 6: Koldun 2636 ($3.01 in chips) 
9zocker9: posts small blind $0.01
alecha11: posts big blind $0.02
*** HOLE CARDS ***
Dealt to Scaaalll [7d Th]
teutonknight: folds 
Antipirate has timed out
Antipirate: folds 
Koldun 2636: folds 
Scaaalll: folds 
9zocker9: folds 
Uncalled bet ($0.01) returned to alecha11
Antipirate is disconnected 
alecha11 collected $0.02 from pot
alecha11: doesn't show hand 
*** SUMMARY ***
Total pot $0.02 | Rake $0 
Seat 1: Scaaalll (button) folded before Flop (didn't bet)
Seat 2: 9zocker9 (small blind) folded before Flop
Seat 3: alecha11 (big blind) collected ($0.02)
Seat 4: teutonknight folded before Flop (didn't bet)
Seat 5: Antipirate folded before Flop (didn't bet)
Seat 6: Koldun 2636 folded before Flop (didn't bet)



PokerStars Zoom Hand #229231548802:  Hold'em No Limit ($0.01/$0.02) - 2021/08/21 22:18:16 CET [2021/08/21 16:18:16 ET]
Table 'Halley' 6-max Seat #1 is the button
Seat 1: Blaackie ($3.92 in chips) 
Seat 2: PapiMik3 ($2.69 in chips) 
Seat 3: Scaaalll ($2.09 in chips) 
Seat 4: NIK1973 23 ($2 in chips) 
Seat 5: zielony ($2 in chips) 
Seat 6: puratiino ($2.45 in chips) 
PapiMik3: posts small blind $0.01
Scaaalll: posts big blind $0.02
*** HOLE CARDS ***
Dealt to Scaaalll [Kh 9s]
NIK1973 23: raises $0.04 to $0.06
zielony: folds 
puratiino: folds 
Blaackie: folds 
PapiMik3: folds 
Scaaalll: folds 
Uncalled bet ($0.04) returned to NIK1973 23
NIK1973 23 collected $0.05 from pot
NIK1973 23: doesn't show hand 
*** SUMMARY ***
Total pot $0.05 | Rake $0 
Seat 1: Blaackie (button) folded before Flop (didn't bet)
Seat 2: PapiMik3 (small blind) folded before Flop
Seat 3: Scaaalll (big blind) folded before Flop
Seat 4: NIK1973 23 collected ($0.05)
Seat 5: zielony folded before Flop (didn't bet)
Seat 6: puratiino folded before Flop (didn't bet)



PokerStars Zoom Hand #229231543817:  Hold'em No Limit ($0.01/$0.02) - 2021/08/21 22:18:05 CET [2021/08/21 16:18:05 ET]
Table 'Halley' 6-max Seat #1 is the button
Seat 1: snowy_96 ($2.07 in chips) 
Seat 2: Scaaalll ($2.10 in chips) 
Seat 3: FicheroQuit ($3.57 in chips) 
Seat 4: Mad_Clock ($2.98 in chips) 
Seat 5: TheJunta ($2.08 in chips) 
Seat 6: Befinski_K2 ($0.43 in chips) 
Scaaalll: posts small blind $0.01
FicheroQuit: posts big blind $0.02
*** HOLE CARDS ***
Dealt to Scaaalll [3d 6d]
Mad_Clock: folds 
TheJunta: folds 
Befinski_K2: raises $0.05 to $0.07
snowy_96: calls $0.07
Scaaalll: folds 
FicheroQuit: raises $0.22 to $0.29
Befinski_K2: raises $0.14 to $0.43 and is all-in
snowy_96: folds 
FicheroQuit: calls $0.14
*** FLOP *** [4d Th 4h]
*** TURN *** [4d Th 4h] [8c]
*** RIVER *** [4d Th 4h 8c] [As]
*** SHOW DOWN ***
FicheroQuit: shows [Jh Jc] (two pair, Jacks and Fours)
Befinski_K2: shows [8s Qc] (two pair, Eights and Fours)
FicheroQuit collected $0.91 from pot
*** SUMMARY ***
Total pot $0.94 | Rake $0.03 
Board [4d Th 4h 8c As]
Seat 1: snowy_96 (button) folded before Flop
Seat 2: Scaaalll (small blind) folded before Flop
Seat 3: FicheroQuit (big blind) showed [Jh Jc] and won ($0.91) with two pair, Jacks and Fours
Seat 4: Mad_Clock folded before Flop (didn't bet)
Seat 5: TheJunta folded before Flop (didn't bet)
Seat 6: Befinski_K2 showed [8s Qc] and lost with two pair, Eights and Fours



PokerStars Zoom Hand #229231554399:  Hold'em No Limit ($0.01/$0.02) - 2021/08/21 22:18:28 CET [2021/08/21 16:18:28 ET]
Table 'Halley' 6-max Seat #1 is the button
Seat 1: zbixxx ($3.22 in chips) 
Seat 2: Phoenixxxxxxxx ($2 in chips) 
Seat 3: Luben_76 ($2 in chips) 
Seat 4: kgatihertzavis ($1.48 in chips) 
Seat 5: 4umi4ev ($2.63 in chips) 
Seat 6: Scaaalll ($2.07 in chips) 
Phoenixxxxxxxx: posts small blind $0.01
Luben_76: posts big blind $0.02
*** HOLE CARDS ***
Dealt to Scaaalll [4c 4d]
4umi4ev is disconnected 
kgatihertzavis: folds 
4umi4ev: folds 
kgatihertzavis is disconnected 
Scaaalll: raises $0.04 to $0.06
zbixxx: folds 
Phoenixxxxxxxx: folds 
Luben_76: folds 
Uncalled bet ($0.04) returned to Scaaalll
Scaaalll collected $0.05 from pot
Scaaalll: doesn't show hand 
*** SUMMARY ***
Total pot $0.05 | Rake $0 
Seat 1: zbixxx (button) folded before Flop (didn't bet)
Seat 2: Phoenixxxxxxxx (small blind) folded before Flop
Seat 3: Luben_76 (big blind) folded before Flop
Seat 4: kgatihertzavis folded before Flop (didn't bet)
Seat 5: 4umi4ev folded before Flop (didn't bet)
Seat 6: Scaaalll collected ($0.05)



PokerStars Zoom Hand #229231559894:  Hold'em No Limit ($0.01/$0.02) - 2021/08/21 22:18:40 CET [2021/08/21 16:18:40 ET]
Table 'Halley' 6-max Seat #1 is the button
Seat 1: Koldun 2636 ($4.11 in chips) 
Seat 2: xxRoseIloveu ($7.85 in chips) 
Seat 3: Phoenixxxxxxxx ($2 in chips) 
Seat 4: Scaaalll ($2.10 in chips) 
Seat 5: Kkamm ($2.94 in chips) 
Seat 6: 365p2eva ($3.25 in chips) 
xxRoseIloveu: posts small blind $0.01
Phoenixxxxxxxx: posts big blind $0.02
*** HOLE CARDS ***
Dealt to Scaaalll [Tc 2c]
Scaaalll: folds 
Kkamm: folds 
365p2eva: raises $0.04 to $0.06
Koldun 2636: folds 
xxRoseIloveu: folds 
Phoenixxxxxxxx: folds 
Uncalled bet ($0.04) returned to 365p2eva
365p2eva collected $0.05 from pot
365p2eva: doesn't show hand 
*** SUMMARY ***
Total pot $0.05 | Rake $0 
Seat 1: Koldun 2636 (button) folded before Flop (didn't bet)
Seat 2: xxRoseIloveu (small blind) folded before Flop
Seat 3: Phoenixxxxxxxx (big blind) folded before Flop
Seat 4: Scaaalll folded before Flop (didn't bet)
Seat 5: Kkamm folded before Flop (didn't bet)
Seat 6: 365p2eva collected ($0.05)



PokerStars Zoom Hand #229231563564:  Hold'em No Limit ($0.01/$0.02) - 2021/08/21 22:18:48 CET [2021/08/21 16:18:48 ET]
Table 'Halley' 6-max Seat #1 is the button
Seat 1: BlackhawKK's ($3.54 in chips) 
Seat 2: KonopDima ($2.07 in chips) 
Seat 3: sewq55 ($1.20 in chips) 
Seat 4: RomiSex ($3.89 in chips) 
Seat 5: Scaaalll ($2.10 in chips) 
Seat 6: Rafaxn ($2.17 in chips) 
KonopDima: posts small blind $0.01
sewq55: posts big blind $0.02
*** HOLE CARDS ***
Dealt to Scaaalll [9c 9d]
RomiSex: folds 
Scaaalll: raises $0.04 to $0.06
Rafaxn: folds 
BlackhawKK's: folds 
KonopDima: folds 
sewq55: folds 
Uncalled bet ($0.04) returned to Scaaalll
Scaaalll collected $0.05 from pot
Scaaalll: doesn't show hand 
*** SUMMARY ***
Total pot $0.05 | Rake $0 
Seat 1: BlackhawKK's (button) folded before Flop (didn't bet)
Seat 2: KonopDima (small blind) folded before Flop
Seat 3: sewq55 (big blind) folded before Flop
Seat 4: RomiSex folded before Flop (didn't bet)
Seat 5: Scaaalll collected ($0.05)
Seat 6: Rafaxn folded before Flop (didn't bet)



PokerStars Zoom Hand #229231570990:  Hold'em No Limit ($0.01/$0.02) - 2021/08/21 22:19:04 CET [2021/08/21 16:19:04 ET]
Table 'Halley' 6-max Seat #1 is the button
Seat 1: Daino G ($2 in chips) 
Seat 2: Scaaalll ($2.13 in chips) 
Seat 3: KonopDima ($2.01 in chips) 
Seat 4: dominik7315 ($3.52 in chips) 
Seat 5: Smirandal ($2.17 in chips) 
Seat 6: CordiPS ($4.94 in chips) 
Scaaalll: posts small blind $0.01
KonopDima: posts big blind $0.02
*** HOLE CARDS ***
Dealt to Scaaalll [Jc Qc]
dominik7315: calls $0.02
Smirandal: raises $0.02 to $0.04
CordiPS: folds 
Daino G: folds 
Scaaalll: calls $0.03
KonopDima: folds 
dominik7315: calls $0.02
*** FLOP *** [2s As Ks]
Scaaalll: checks 
dominik7315: checks 
Smirandal: bets $0.02
Scaaalll: folds 
dominik7315: folds 
Uncalled bet ($0.02) returned to Smirandal
Smirandal collected $0.14 from pot
Smirandal: doesn't show hand 
dominik7315 is disconnected 
*** SUMMARY ***
Total pot $0.14 | Rake $0 
Board [2s As Ks]
Seat 1: Daino G (button) folded before Flop (didn't bet)
Seat 2: Scaaalll (small blind) folded on the Flop
Seat 3: KonopDima (big blind) folded before Flop
Seat 4: dominik7315 folded on the Flop
Seat 5: Smirandal collected ($0.14)
Seat 6: CordiPS folded before Flop (didn't bet)



PokerStars Zoom Hand #229231588860:  Hold'em No Limit ($0.01/$0.02) - 2021/08/21 22:19:42 CET [2021/08/21 16:19:42 ET]
Table 'Halley' 6-max Seat #1 is the button
Seat 1: Scaaalll ($2.09 in chips) 
Seat 2: Busya777 ($1.98 in chips) 
Seat 3: Allexii ($2.25 in chips) 
Seat 4: Koldun 2636 ($3 in chips) 
Seat 5: KonopDima ($2.04 in chips) 
Seat 6: Pechorin.G ($2 in chips) 
Busya777: posts small blind $0.01
Allexii: posts big blind $0.02
*** HOLE CARDS ***
Dealt to Scaaalll [Ac 7c]
Koldun 2636: folds 
Busya777 is disconnected 
KonopDima: folds 
Pechorin.G: folds 
Scaaalll: raises $0.02 to $0.04
Busya777: folds 
Allexii: folds 
Uncalled bet ($0.02) returned to Scaaalll
Scaaalll collected $0.05 from pot
Scaaalll: doesn't show hand 
Allexii is disconnected 
*** SUMMARY ***
Total pot $0.05 | Rake $0 
Seat 1: Scaaalll (button) collected ($0.05)
Seat 2: Busya777 (small blind) folded before Flop
Seat 3: Allexii (big blind) folded before Flop
Seat 4: Koldun 2636 folded before Flop (didn't bet)
Seat 5: KonopDima folded before Flop (didn't bet)
Seat 6: Pechorin.G folded before Flop (didn't bet)



PokerStars Zoom Hand #229231593988:  Hold'em No Limit ($0.01/$0.02) - 2021/08/21 22:19:54 CET [2021/08/21 16:19:54 ET]
Table 'Halley' 6-max Seat #1 is the button
Seat 1: Canoinhas37 ($4.60 in chips) 
Seat 2: HubertFroh ($2.55 in chips) 
Seat 3: Scaaalll ($2.12 in chips) 
Seat 4: Phoenixxxxxxxx ($2 in chips) 
Seat 5: zbixxx ($5.71 in chips) 
Seat 6: RaulacateFolds ($2.21 in chips) 
HubertFroh: posts small blind $0.01
Scaaalll: posts big blind $0.02
*** HOLE CARDS ***
Dealt to Scaaalll [9d 9c]
Phoenixxxxxxxx: folds 
zbixxx: folds 
RaulacateFolds: folds 
Canoinhas37: raises $0.02 to $0.04
HubertFroh: folds 
Scaaalll: calls $0.02
*** FLOP *** [4h Ts Kd]
Scaaalll: checks 
Canoinhas37: bets $0.05
Scaaalll: calls $0.05
*** TURN *** [4h Ts Kd] [Ad]
Scaaalll: checks 
Canoinhas37: bets $0.09
Scaaalll: folds 
Uncalled bet ($0.09) returned to Canoinhas37
Canoinhas37 collected $0.18 from pot
Canoinhas37: doesn't show hand 
*** SUMMARY ***
Total pot $0.19 | Rake $0.01 
Board [4h Ts Kd Ad]
Seat 1: Canoinhas37 (button) collected ($0.18)
Seat 2: HubertFroh (small blind) folded before Flop
Seat 3: Scaaalll (big blind) folded on the Turn
Seat 4: Phoenixxxxxxxx folded before Flop (didn't bet)
Seat 5: zbixxx folded before Flop (didn't bet)
Seat 6: RaulacateFolds folded before Flop (didn't bet)



PokerStars Zoom Hand #229231616907:  Hold'em No Limit ($0.01/$0.02) - 2021/08/21 22:20:44 CET [2021/08/21 16:20:44 ET]
Table 'Halley' 6-max Seat #1 is the button
Seat 1: Capitaine Pat ($1.18 in chips) 
Seat 2: sewq55 ($0.98 in chips) 
Seat 3: FabOliveira9 ($2 in chips) 
Seat 4: Scaaalll ($2.03 in chips) 
Seat 5: Colby1771 ($1.97 in chips) 
Seat 6: Vanekakqj ($1.66 in chips) 
sewq55: posts small blind $0.01
FabOliveira9: posts big blind $0.02
*** HOLE CARDS ***
Dealt to Scaaalll [6h Jc]
Scaaalll: folds 
Colby1771: folds 
Vanekakqj: folds 
Capitaine Pat: folds 
sewq55: folds 
Uncalled bet ($0.01) returned to FabOliveira9
FabOliveira9 collected $0.02 from pot
FabOliveira9: doesn't show hand 
*** SUMMARY ***
Total pot $0.02 | Rake $0 
Seat 1: Capitaine Pat (button) folded before Flop (didn't bet)
Seat 2: sewq55 (small blind) folded before Flop
Seat 3: FabOliveira9 (big blind) collected ($0.02)
Seat 4: Scaaalll folded before Flop (didn't bet)
Seat 5: Colby1771 folded before Flop (didn't bet)
Seat 6: Vanekakqj folded before Flop (didn't bet)



PokerStars Zoom Hand #229231614591:  Hold'em No Limit ($0.01/$0.02) - 2021/08/21 22:20:39 CET [2021/08/21 16:20:39 ET]
Table 'Halley' 6-max Seat #1 is the button
Seat 1: RonilsonCosta ($2.20 in chips) 
Seat 2: sewq55 ($0.95 in chips) 
Seat 3: Lacitoo ($2 in chips) 
Seat 4: feybys ($2.54 in chips) 
Seat 5: estelionat171 ($1.06 in chips) 
Seat 6: Scaaalll ($2.03 in chips) 
sewq55: posts small blind $0.01
Lacitoo: posts big blind $0.02
*** HOLE CARDS ***
Dealt to Scaaalll [2h Jd]
feybys: raises $0.04 to $0.06
estelionat171: folds 
Scaaalll: folds 
Lacitoo is disconnected 
RonilsonCosta: folds 
sewq55: folds 
Lacitoo: folds 
Uncalled bet ($0.04) returned to feybys
feybys collected $0.05 from pot
feybys: doesn't show hand 
*** SUMMARY ***
Total pot $0.05 | Rake $0 
Seat 1: RonilsonCosta (button) folded before Flop (didn't bet)
Seat 2: sewq55 (small blind) folded before Flop
Seat 3: Lacitoo (big blind) folded before Flop
Seat 4: feybys collected ($0.05)
Seat 5: estelionat171 folded before Flop (didn't bet)
Seat 6: Scaaalll folded before Flop (didn't bet)



PokerStars Zoom Hand #229231618734:  Hold'em No Limit ($0.01/$0.02) - 2021/08/21 22:20:48 CET [2021/08/21 16:20:48 ET]
Table 'Halley' 6-max Seat #1 is the button
Seat 1: NoLuckLeck ($2 in chips) 
Seat 2: guntren.ps ($2.26 in chips) 
Seat 3: Emilmoller1 ($1.54 in chips) 
Seat 4: Scaaalll ($2.03 in chips) 
Seat 5: zbixxx ($3.36 in chips) 
Seat 6: Capitaine Pat ($1.18 in chips) 
guntren.ps: posts small blind $0.01
Emilmoller1: posts big blind $0.02
*** HOLE CARDS ***
Dealt to Scaaalll [4s Qs]
Scaaalll: folds 
zbixxx: folds 
Capitaine Pat: folds 
NoLuckLeck: raises $0.03 to $0.05
guntren.ps: folds 
Emilmoller1: calls $0.03
*** FLOP *** [4h As 2c]
Emilmoller1: checks 
NoLuckLeck: checks 
*** TURN *** [4h As 2c] [Kc]
Emilmoller1: checks 
NoLuckLeck: bets $0.06
Emilmoller1: folds 
Uncalled bet ($0.06) returned to NoLuckLeck
NoLuckLeck collected $0.11 from pot
NoLuckLeck: doesn't show hand 
*** SUMMARY ***
Total pot $0.11 | Rake $0 
Board [4h As 2c Kc]
Seat 1: NoLuckLeck (button) collected ($0.11)
Seat 2: guntren.ps (small blind) folded before Flop
Seat 3: Emilmoller1 (big blind) folded on the Turn
Seat 4: Scaaalll folded before Flop (didn't bet)
Seat 5: zbixxx folded before Flop (didn't bet)
Seat 6: Capitaine Pat folded before Flop (didn't bet)



PokerStars Zoom Hand #229231625515:  Hold'em No Limit ($0.01/$0.02) - 2021/08/21 22:21:03 CET [2021/08/21 16:21:03 ET]
Table 'Halley' 6-max Seat #1 is the button
Seat 1: Gnürg ($5.82 in chips) 
Seat 2: HellNative ($3.32 in chips) 
Seat 3: Scaaalll ($2.02 in chips) 
Seat 4: BexleyBoy ($2.15 in chips) 
Seat 5: KoAlRy ($2.11 in chips) 
Seat 6: EdwardF95 ($2 in chips) 
HellNative: posts small blind $0.01
Scaaalll: posts big blind $0.02
*** HOLE CARDS ***
Dealt to Scaaalll [5d 4c]
BexleyBoy: folds 
KoAlRy: folds 
EdwardF95: folds 
Gnürg: folds 
Gnürg is disconnected 
HellNative: folds 
Uncalled bet ($0.01) returned to Scaaalll
Scaaalll collected $0.02 from pot
Scaaalll: doesn't show hand 
*** SUMMARY ***
Total pot $0.02 | Rake $0 
Seat 1: Gnürg (button) folded before Flop (didn't bet)
Seat 2: HellNative (small blind) folded before Flop
Seat 3: Scaaalll (big blind) collected ($0.02)
Seat 4: BexleyBoy folded before Flop (didn't bet)
Seat 5: KoAlRy folded before Flop (didn't bet)
Seat 6: EdwardF95 folded before Flop (didn't bet)



PokerStars Zoom Hand #229231621440:  Hold'em No Limit ($0.01/$0.02) - 2021/08/21 22:20:54 CET [2021/08/21 16:20:54 ET]
Table 'Halley' 6-max Seat #1 is the button
Seat 1: BenOKopen ($2.62 in chips) 
Seat 2: Scaaalll ($2.03 in chips) 
Seat 3: ZunderSS ($4.26 in chips) 
Seat 4: NNGun ($1.64 in chips) 
Seat 5: Ebbelwoiexp ($2 in chips) 
Seat 6: sg.32rus ($1.01 in chips) 
Scaaalll: posts small blind $0.01
ZunderSS: posts big blind $0.02
*** HOLE CARDS ***
Dealt to Scaaalll [8h 2s]
Ebbelwoiexp is disconnected 
NNGun: folds 
Ebbelwoiexp: folds 
sg.32rus: calls $0.02
BenOKopen: folds 
Scaaalll: folds 
ZunderSS: raises $0.02 to $0.04
sg.32rus: calls $0.02
*** FLOP *** [3s 9c 3c]
ZunderSS: bets $0.05
sg.32rus: raises $0.23 to $0.28
ZunderSS: raises $0.33 to $0.61
sg.32rus: folds 
Uncalled bet ($0.33) returned to ZunderSS
ZunderSS collected $0.63 from pot
ZunderSS: doesn't show hand 
*** SUMMARY ***
Total pot $0.65 | Rake $0.02 
Board [3s 9c 3c]
Seat 1: BenOKopen (button) folded before Flop (didn't bet)
Seat 2: Scaaalll (small blind) folded before Flop
Seat 3: ZunderSS (big blind) collected ($0.63)
Seat 4: NNGun folded before Flop (didn't bet)
Seat 5: Ebbelwoiexp folded before Flop (didn't bet)
Seat 6: sg.32rus folded on the Flop



PokerStars Zoom Hand #229231637502:  Hold'em No Limit ($0.01/$0.02) - 2021/08/21 22:21:29 CET [2021/08/21 16:21:29 ET]
Table 'Halley' 6-max Seat #1 is the button
Seat 1: NoEff0rt2w1n ($2 in chips) 
Seat 2: zielony ($2.11 in chips) 
Seat 3: RaulacateFolds ($2.51 in chips) 
Seat 4: EevAA190 ($2.66 in chips) 
Seat 5: Scaaalll ($2.03 in chips) 
Seat 6: Daiting1 ($1.66 in chips) 
zielony: posts small blind $0.01
RaulacateFolds: posts big blind $0.02
*** HOLE CARDS ***
Dealt to Scaaalll [Tc 7h]
EevAA190: folds 
Scaaalll: folds 
Daiting1: folds 
NoEff0rt2w1n: folds 
zielony: folds 
Uncalled bet ($0.01) returned to RaulacateFolds
RaulacateFolds collected $0.02 from pot
RaulacateFolds: doesn't show hand 
*** SUMMARY ***
Total pot $0.02 | Rake $0 
Seat 1: NoEff0rt2w1n (button) folded before Flop (didn't bet)
Seat 2: zielony (small blind) folded before Flop
Seat 3: RaulacateFolds (big blind) collected ($0.02)
Seat 4: EevAA190 folded before Flop (didn't bet)
Seat 5: Scaaalll folded before Flop (didn't bet)
Seat 6: Daiting1 folded before Flop (didn't bet)



PokerStars Zoom Hand #229231640127:  Hold'em No Limit ($0.01/$0.02) - 2021/08/21 22:21:34 CET [2021/08/21 16:21:34 ET]
Table 'Halley' 6-max Seat #1 is the button
Seat 1: Scaaalll ($2.03 in chips) 
Seat 2: Allekccc ($1.82 in chips) 
Seat 3: Busya777 ($2 in chips) 
Seat 4: pavlo8855 ($2 in chips) 
Seat 5: fishh_play ($4.48 in chips) 
Seat 6: Ogni ($4.70 in chips) 
Allekccc: posts small blind $0.01
Busya777: posts big blind $0.02
*** HOLE CARDS ***
Dealt to Scaaalll [3d 3c]
pavlo8855: folds 
fishh_play: raises $0.03 to $0.05
Busya777 is disconnected 
Ogni: folds 
Scaaalll: calls $0.05
Allekccc: calls $0.04
Busya777: folds 
*** FLOP *** [5d Jd 2h]
Allekccc: checks 
fishh_play: bets $0.09
Scaaalll: folds 
Allekccc: raises $0.26 to $0.35
fishh_play: folds 
Uncalled bet ($0.26) returned to Allekccc
Allekccc collected $0.34 from pot
Allekccc: doesn't show hand 
*** SUMMARY ***
Total pot $0.35 | Rake $0.01 
Board [5d Jd 2h]
Seat 1: Scaaalll (button) folded on the Flop
Seat 2: Allekccc (small blind) collected ($0.34)
Seat 3: Busya777 (big blind) folded before Flop
Seat 4: pavlo8855 folded before Flop (didn't bet)
Seat 5: fishh_play folded on the Flop
Seat 6: Ogni folded before Flop (didn't bet)



PokerStars Zoom Hand #229231632443:  Hold'em No Limit ($0.01/$0.02) - 2021/08/21 22:21:18 CET [2021/08/21 16:21:18 ET]
Table 'Halley' 6-max Seat #1 is the button
Seat 1: Scaaalll ($2.03 in chips) 
Seat 2: Esskeetit420/69 ($1.85 in chips) 
Seat 3: 77omsk ($8.47 in chips) 
Seat 4: feybys ($3.71 in chips) 
Seat 5: lucksuckdonk ($2.91 in chips) 
Seat 6: felipeciji ($2 in chips) 
Esskeetit420/69: posts small blind $0.01
77omsk: posts big blind $0.02
*** HOLE CARDS ***
Dealt to Scaaalll [7h 2s]
feybys: raises $0.04 to $0.06
lucksuckdonk: folds 
felipeciji: folds 
Scaaalll: folds 
Esskeetit420/69: folds 
77omsk: calls $0.04
*** FLOP *** [3c Tc 8h]
77omsk: checks 
feybys: bets $0.10
77omsk: raises $0.11 to $0.21
feybys: calls $0.11
*** TURN *** [3c Tc 8h] [4h]
77omsk: bets $0.29
feybys: folds 
Uncalled bet ($0.29) returned to 77omsk
77omsk collected $0.53 from pot
77omsk: doesn't show hand 
*** SUMMARY ***
Total pot $0.55 | Rake $0.02 
Board [3c Tc 8h 4h]
Seat 1: Scaaalll (button) folded before Flop (didn't bet)
Seat 2: Esskeetit420/69 (small blind) folded before Flop
Seat 3: 77omsk (big blind) collected ($0.53)
Seat 4: feybys folded on the Turn
Seat 5: lucksuckdonk folded before Flop (didn't bet)
Seat 6: felipeciji folded before Flop (didn't bet)



PokerStars Zoom Hand #229231652012:  Hold'em No Limit ($0.01/$0.02) - 2021/08/21 22:22:01 CET [2021/08/21 16:22:01 ET]
Table 'Halley' 6-max Seat #1 is the button
Seat 1: Herr.Hikke ($2.44 in chips) 
Seat 2: Scaaalll ($2 in chips) 
Seat 3: F_oksi(BLR) ($1.52 in chips) 
Seat 4: 365p2eva ($3.21 in chips) 
Seat 5: KonopDima ($2.10 in chips) 
Seat 6: yeahyeeei ($0.49 in chips) 
Scaaalll: posts small blind $0.01
F_oksi(BLR): posts big blind $0.02
*** HOLE CARDS ***
Dealt to Scaaalll [Kd 3c]
365p2eva: raises $0.04 to $0.06
KonopDima: folds 
yeahyeeei: folds 
Herr.Hikke: folds 
Scaaalll: folds 
F_oksi(BLR): folds 
Uncalled bet ($0.04) returned to 365p2eva
365p2eva collected $0.05 from pot
365p2eva: doesn't show hand 
*** SUMMARY ***
Total pot $0.05 | Rake $0 
Seat 1: Herr.Hikke (button) folded before Flop (didn't bet)
Seat 2: Scaaalll (small blind) folded before Flop
Seat 3: F_oksi(BLR) (big blind) folded before Flop
Seat 4: 365p2eva collected ($0.05)
Seat 5: KonopDima folded before Flop (didn't bet)
Seat 6: yeahyeeei folded before Flop (didn't bet)



PokerStars Zoom Hand #229231661167:  Hold'em No Limit ($0.01/$0.02) - 2021/08/21 22:22:21 CET [2021/08/21 16:22:21 ET]
Table 'Halley' 6-max Seat #1 is the button
Seat 1: Luben_76 ($2.50 in chips) 
Seat 2: Busya777 ($2.01 in chips) 
Seat 3: Scaaalll ($2 in chips) 
Seat 4: Kkamm ($2.17 in chips) 
Seat 5: sergeyl01 ($0.96 in chips) 
Seat 6: AtZ3899 ($1.36 in chips) 
Busya777: posts small blind $0.01
Scaaalll: posts big blind $0.02
*** HOLE CARDS ***
Dealt to Scaaalll [Th 2d]
Kkamm: folds 
sergeyl01: folds 
AtZ3899: folds 
Luben_76: folds 
Busya777: calls $0.01
Scaaalll: checks 
*** FLOP *** [2h 3c Tc]
Busya777: checks 
Scaaalll: bets $0.04
Busya777: folds 
Uncalled bet ($0.04) returned to Scaaalll
Scaaalll collected $0.04 from pot
Scaaalll: doesn't show hand 
Busya777 is disconnected 
*** SUMMARY ***
Total pot $0.04 | Rake $0 
Board [2h 3c Tc]
Seat 1: Luben_76 (button) folded before Flop (didn't bet)
Seat 2: Busya777 (small blind) folded on the Flop
Seat 3: Scaaalll (big blind) collected ($0.04)
Seat 4: Kkamm folded before Flop (didn't bet)
Seat 5: sergeyl01 folded before Flop (didn't bet)
Seat 6: AtZ3899 folded before Flop (didn't bet)



PokerStars Zoom Hand #229231659301:  Hold'em No Limit ($0.01/$0.02) - 2021/08/21 22:22:17 CET [2021/08/21 16:22:17 ET]
Table 'Halley' 6-max Seat #1 is the button
Seat 1: SKV_1985 ($2.17 in chips) 
Seat 2: Fanatspartak ($1.56 in chips) 
Seat 3: Janey44 ($5 in chips) 
Seat 4: KonopDima ($2.10 in chips) 
Seat 5: juraa14 ($1.62 in chips) 
Seat 6: Scaaalll ($2 in chips) 
Fanatspartak: posts small blind $0.01
Janey44: posts big blind $0.02
*** HOLE CARDS ***
Dealt to Scaaalll [Ts 7h]
KonopDima: folds 
juraa14: raises $0.04 to $0.06
Scaaalll: folds 
SKV_1985: folds 
Fanatspartak: folds 
Janey44: calls $0.04
*** FLOP *** [6h 6d 9c]
Janey44: bets $0.02
juraa14: raises $0.05 to $0.07
Janey44: calls $0.05
*** TURN *** [6h 6d 9c] [3s]
Janey44: bets $0.02
juraa14: calls $0.02
*** RIVER *** [6h 6d 9c 3s] [8h]
Janey44: checks 
juraa14: checks 
*** SHOW DOWN ***
Janey44: shows [4s 4h] (two pair, Sixes and Fours)
juraa14: mucks hand 
Janey44 collected $0.30 from pot
*** SUMMARY ***
Total pot $0.31 | Rake $0.01 
Board [6h 6d 9c 3s 8h]
Seat 1: SKV_1985 (button) folded before Flop (didn't bet)
Seat 2: Fanatspartak (small blind) folded before Flop
Seat 3: Janey44 (big blind) showed [4s 4h] and won ($0.30) with two pair, Sixes and Fours
Seat 4: KonopDima folded before Flop (didn't bet)
Seat 5: juraa14 mucked [Kd Ad]
Seat 6: Scaaalll folded before Flop (didn't bet)



PokerStars Zoom Hand #229231675890:  Hold'em No Limit ($0.01/$0.02) - 2021/08/21 22:22:53 CET [2021/08/21 16:22:53 ET]
Table 'Halley' 6-max Seat #1 is the button
Seat 1: BenOKopen ($2.06 in chips) 
Seat 2: 21041956 ($1.83 in chips) 
Seat 3: RrriotGrrrl ($9.37 in chips) 
Seat 4: RonilsonCosta ($2.08 in chips) 
Seat 5: Scaaalll ($2.02 in chips) 
Seat 6: CordiPS ($5 in chips) 
21041956: posts small blind $0.01
RrriotGrrrl: posts big blind $0.02
*** HOLE CARDS ***
Dealt to Scaaalll [As 9s]
RonilsonCosta: folds 
Scaaalll: raises $0.04 to $0.06
CordiPS: folds 
BenOKopen: folds 
21041956: folds 
RrriotGrrrl: folds 
Uncalled bet ($0.04) returned to Scaaalll
Scaaalll collected $0.05 from pot
Scaaalll: doesn't show hand 
*** SUMMARY ***
Total pot $0.05 | Rake $0 
Seat 1: BenOKopen (button) folded before Flop (didn't bet)
Seat 2: 21041956 (small blind) folded before Flop
Seat 3: RrriotGrrrl (big blind) folded before Flop
Seat 4: RonilsonCosta folded before Flop (didn't bet)
Seat 5: Scaaalll collected ($0.05)
Seat 6: CordiPS folded before Flop (didn't bet)



PokerStars Zoom Hand #229231671269:  Hold'em No Limit ($0.01/$0.02) - 2021/08/21 22:22:43 CET [2021/08/21 16:22:43 ET]
Table 'Halley' 6-max Seat #1 is the button
Seat 1: sg.32rus ($1.77 in chips) 
Seat 2: roukoun1984 ($0.98 in chips) 
Seat 3: lucksuckdonk ($3.38 in chips) 
Seat 4: RrriotGrrrl ($5.50 in chips) 
Seat 5: Scaaalll ($2.02 in chips) 
Seat 6: BexleyBoy ($2.31 in chips) 
roukoun1984: posts small blind $0.01
lucksuckdonk: posts big blind $0.02
*** HOLE CARDS ***
Dealt to Scaaalll [7d Qc]
RrriotGrrrl: raises $0.04 to $0.06
roukoun1984 is disconnected 
Scaaalll: folds 
BexleyBoy: folds 
sg.32rus: calls $0.06
roukoun1984: folds 
lucksuckdonk: raises $0.24 to $0.30
RrriotGrrrl: folds 
sg.32rus: folds 
Uncalled bet ($0.24) returned to lucksuckdonk
lucksuckdonk collected $0.19 from pot
lucksuckdonk: doesn't show hand 
*** SUMMARY ***
Total pot $0.19 | Rake $0 
Seat 1: sg.32rus (button) folded before Flop
Seat 2: roukoun1984 (small blind) folded before Flop
Seat 3: lucksuckdonk (big blind) collected ($0.19)
Seat 4: RrriotGrrrl folded before Flop
Seat 5: Scaaalll folded before Flop (didn't bet)
Seat 6: BexleyBoy folded before Flop (didn't bet)



PokerStars Zoom Hand #229231681406:  Hold'em No Limit ($0.01/$0.02) - 2021/08/21 22:23:05 CET [2021/08/21 16:23:05 ET]
Table 'Halley' 6-max Seat #1 is the button
Seat 1: Davingo25 ($1.95 in chips) 
Seat 2: arturtsutsaev ($1.20 in chips) 
Seat 3: yannikdaehne ($8.74 in chips) 
Seat 4: Scaaalll ($2.05 in chips) 
Seat 5: MirkoV224 ($1.55 in chips) 
Seat 6: TomoKondo ($2 in chips) 
arturtsutsaev: posts small blind $0.01
yannikdaehne: posts big blind $0.02
*** HOLE CARDS ***
Dealt to Scaaalll [As Jd]
Scaaalll: raises $0.04 to $0.06
MirkoV224: folds 
Davingo25 is disconnected 
TomoKondo: folds 
Davingo25: folds 
arturtsutsaev: folds 
yannikdaehne: folds 
Uncalled bet ($0.04) returned to Scaaalll
arturtsutsaev is disconnected 
Scaaalll collected $0.05 from pot
Scaaalll: doesn't show hand 
*** SUMMARY ***
Total pot $0.05 | Rake $0 
Seat 1: Davingo25 (button) folded before Flop (didn't bet)
Seat 2: arturtsutsaev (small blind) folded before Flop
Seat 3: yannikdaehne (big blind) folded before Flop
Seat 4: Scaaalll collected ($0.05)
Seat 5: MirkoV224 folded before Flop (didn't bet)
Seat 6: TomoKondo folded before Flop (didn't bet)



PokerStars Zoom Hand #229231688174:  Hold'em No Limit ($0.01/$0.02) - 2021/08/21 22:23:20 CET [2021/08/21 16:23:20 ET]
Table 'Halley' 6-max Seat #1 is the button
Seat 1: 77omsk ($8.70 in chips) 
Seat 2: BigTestIcicle ($4.91 in chips) 
Seat 3: guntren.ps ($2.45 in chips) 
Seat 4: plmanuelpl ($1.13 in chips) 
Seat 5: Scaaalll ($2.08 in chips) 
Seat 6: lucksuckdonk ($3.51 in chips) 
BigTestIcicle: posts small blind $0.01
guntren.ps: posts big blind $0.02
*** HOLE CARDS ***
Dealt to Scaaalll [4d Ks]
plmanuelpl: folds 
Scaaalll: folds 
lucksuckdonk: folds 
plmanuelpl is disconnected 
77omsk: folds 
BigTestIcicle: folds 
Uncalled bet ($0.01) returned to guntren.ps
guntren.ps collected $0.02 from pot
guntren.ps: doesn't show hand 
*** SUMMARY ***
Total pot $0.02 | Rake $0 
Seat 1: 77omsk (button) folded before Flop (didn't bet)
Seat 2: BigTestIcicle (small blind) folded before Flop
Seat 3: guntren.ps (big blind) collected ($0.02)
Seat 4: plmanuelpl folded before Flop (didn't bet)
Seat 5: Scaaalll folded before Flop (didn't bet)
Seat 6: lucksuckdonk folded before Flop (didn't bet)



PokerStars Zoom Hand #229231690016:  Hold'em No Limit ($0.01/$0.02) - 2021/08/21 22:23:24 CET [2021/08/21 16:23:24 ET]
Table 'Halley' 6-max Seat #1 is the button
Seat 1: Allexii ($2.47 in chips) 
Seat 2: Scaaalll ($2.08 in chips) 
Seat 3: AtZ3899 ($1.98 in chips) 
Seat 4: sewq55 ($1.22 in chips) 
Seat 5: robokop358 ($0.94 in chips) 
Seat 6: The-End-snglr ($1.89 in chips) 
Scaaalll: posts small blind $0.01
AtZ3899: posts big blind $0.02
*** HOLE CARDS ***
Dealt to Scaaalll [7s Qd]
sewq55: folds 
robokop358: folds 
The-End-snglr: raises $0.04 to $0.06
Allexii: folds 
Scaaalll: folds 
AtZ3899: folds 
Uncalled bet ($0.04) returned to The-End-snglr
Allexii is disconnected 
The-End-snglr collected $0.05 from pot
The-End-snglr: doesn't show hand 
*** SUMMARY ***
Total pot $0.05 | Rake $0 
Seat 1: Allexii (button) folded before Flop (didn't bet)
Seat 2: Scaaalll (small blind) folded before Flop
Seat 3: AtZ3899 (big blind) folded before Flop
Seat 4: sewq55 folded before Flop (didn't bet)
Seat 5: robokop358 folded before Flop (didn't bet)
Seat 6: The-End-snglr collected ($0.05)



PokerStars Zoom Hand #229231673985:  Hold'em No Limit ($0.01/$0.02) - 2021/08/21 22:22:49 CET [2021/08/21 16:22:49 ET]
Table 'Halley' 6-max Seat #1 is the button
Seat 1: polymorhp ($1 in chips) 
Seat 2: mheronmagno ($0.70 in chips) 
Seat 3: zergmiky ($2.66 in chips) 
Seat 4: Mikeloko182 ($2 in chips) 
Seat 5: Maradonna663 ($2.25 in chips) 
Seat 6: Scaaalll ($2.02 in chips) 
mheronmagno: posts small blind $0.01
zergmiky: posts big blind $0.02
*** HOLE CARDS ***
Dealt to Scaaalll [8s 7c]
Mikeloko182: folds 
Maradonna663: raises $0.04 to $0.06
Scaaalll: folds 
polymorhp: folds 
mheronmagno: calls $0.05
zergmiky: folds 
*** FLOP *** [Ks 9c 8c]
mheronmagno: checks 
Maradonna663: bets $0.07
mheronmagno: calls $0.07
*** TURN *** [Ks 9c 8c] [5d]
mheronmagno: checks 
Maradonna663: bets $0.27
mheronmagno: calls $0.27
*** RIVER *** [Ks 9c 8c 5d] [Ac]
mheronmagno: bets $0.30 and is all-in
Maradonna663: folds 
Uncalled bet ($0.30) returned to mheronmagno
mheronmagno collected $0.79 from pot
mheronmagno: doesn't show hand 
Maradonna663 is disconnected 
*** SUMMARY ***
Total pot $0.82 | Rake $0.03 
Board [Ks 9c 8c 5d Ac]
Seat 1: polymorhp (button) folded before Flop (didn't bet)
Seat 2: mheronmagno (small blind) collected ($0.79)
Seat 3: zergmiky (big blind) folded before Flop
Seat 4: Mikeloko182 folded before Flop (didn't bet)
Seat 5: Maradonna663 folded on the River
Seat 6: Scaaalll folded before Flop (didn't bet)



PokerStars Zoom Hand #229231691847:  Hold'em No Limit ($0.01/$0.02) - 2021/08/21 22:23:28 CET [2021/08/21 16:23:28 ET]
Table 'Halley' 6-max Seat #1 is the button
Seat 1: Scaaalll ($2.07 in chips) 
Seat 2: Tn 939 ($2.17 in chips) 
Seat 3: Fanatspartak ($1.04 in chips) 
Seat 4: ppluiaule ($3.98 in chips) 
Seat 5: 365p2eva ($3.24 in chips) 
Seat 6: robokop358 ($0.94 in chips) 
Tn 939: posts small blind $0.01
Fanatspartak: posts big blind $0.02
*** HOLE CARDS ***
Dealt to Scaaalll [9s 7d]
ppluiaule: folds 
365p2eva: folds 
robokop358: folds 
Scaaalll: folds 
Tn 939: folds 
Uncalled bet ($0.01) returned to Fanatspartak
Fanatspartak collected $0.02 from pot
Fanatspartak: doesn't show hand 
*** SUMMARY ***
Total pot $0.02 | Rake $0 
Seat 1: Scaaalll (button) folded before Flop (didn't bet)
Seat 2: Tn 939 (small blind) folded before Flop
Seat 3: Fanatspartak (big blind) collected ($0.02)
Seat 4: ppluiaule folded before Flop (didn't bet)
Seat 5: 365p2eva folded before Flop (didn't bet)
Seat 6: robokop358 folded before Flop (didn't bet)



PokerStars Zoom Hand #229231697689:  Hold'em No Limit ($0.01/$0.02) - 2021/08/21 22:23:41 CET [2021/08/21 16:23:41 ET]
Table 'Halley' 6-max Seat #1 is the button
Seat 1: martinob11 ($2.22 in chips) 
Seat 2: Flankeris ($5.83 in chips) 
Seat 3: Scaaalll ($2.07 in chips) 
Seat 4: rancing87 ($2.02 in chips) 
Seat 5: djewlz ($2.37 in chips) 
Seat 6: Healthys07 ($2.15 in chips) 
Flankeris: posts small blind $0.01
Scaaalll: posts big blind $0.02
*** HOLE CARDS ***
Dealt to Scaaalll [Ah 4s]
rancing87: raises $0.04 to $0.06
djewlz: folds 
Healthys07: folds 
martinob11: folds 
Flankeris: folds 
Scaaalll: folds 
Uncalled bet ($0.04) returned to rancing87
rancing87 collected $0.05 from pot
rancing87: doesn't show hand 
*** SUMMARY ***
Total pot $0.05 | Rake $0 
Seat 1: martinob11 (button) folded before Flop (didn't bet)
Seat 2: Flankeris (small blind) folded before Flop
Seat 3: Scaaalll (big blind) folded before Flop
Seat 4: rancing87 collected ($0.05)
Seat 5: djewlz folded before Flop (didn't bet)
Seat 6: Healthys07 folded before Flop (didn't bet)



PokerStars Zoom Hand #229231708233:  Hold'em No Limit ($0.01/$0.02) - 2021/08/21 22:24:04 CET [2021/08/21 16:24:04 ET]
Table 'Halley' 6-max Seat #1 is the button
Seat 1: KonopDima ($2.13 in chips) 
Seat 2: japoneis mt ($2.66 in chips) 
Seat 3: rodrigoasor ($0.33 in chips) 
Seat 4: Scaaalll ($2.05 in chips) 
Seat 5: Tony-Broke ($2.08 in chips) 
Seat 6: Mad_Clock ($2.59 in chips) 
japoneis mt: posts small blind $0.01
rodrigoasor: posts big blind $0.02
*** HOLE CARDS ***
Dealt to Scaaalll [4d 3c]
Scaaalll: folds 
Tony-Broke: folds 
Mad_Clock: folds 
KonopDima: folds 
japoneis mt: folds 
Uncalled bet ($0.01) returned to rodrigoasor
rodrigoasor collected $0.02 from pot
rodrigoasor: doesn't show hand 
japoneis mt is disconnected 
*** SUMMARY ***
Total pot $0.02 | Rake $0 
Seat 1: KonopDima (button) folded before Flop (didn't bet)
Seat 2: japoneis mt (small blind) folded before Flop
Seat 3: rodrigoasor (big blind) collected ($0.02)
Seat 4: Scaaalll folded before Flop (didn't bet)
Seat 5: Tony-Broke folded before Flop (didn't bet)
Seat 6: Mad_Clock folded before Flop (didn't bet)



PokerStars Zoom Hand #229231693570:  Hold'em No Limit ($0.01/$0.02) - 2021/08/21 22:23:32 CET [2021/08/21 16:23:32 ET]
Table 'Halley' 6-max Seat #1 is the button
Seat 1: van Alien ($1.98 in chips) 
Seat 2: LuckyCheewey ($11.93 in chips) 
Seat 3: Jacon2905 ($2.07 in chips) 
Seat 4: RoughRafff ($3.97 in chips) 
Seat 5: Chupacabra G ($1.63 in chips) 
Seat 6: Scaaalll ($2.07 in chips) 
LuckyCheewey: posts small blind $0.01
Jacon2905: posts big blind $0.02
*** HOLE CARDS ***
Dealt to Scaaalll [2s Kh]
RoughRafff: raises $0.03 to $0.05
Chupacabra G: folds 
Scaaalll: folds 
van Alien: calls $0.05
LuckyCheewey: folds 
Jacon2905: folds 
*** FLOP *** [Qc 2h 5d]
RoughRafff: bets $0.10
van Alien: calls $0.10
*** TURN *** [Qc 2h 5d] [8c]
RoughRafff: bets $0.31
van Alien: calls $0.31
*** RIVER *** [Qc 2h 5d 8c] [9s]
RoughRafff: checks 
van Alien: checks 
*** SHOW DOWN ***
RoughRafff: shows [Qd As] (a pair of Queens)
van Alien: mucks hand 
RoughRafff collected $0.92 from pot
*** SUMMARY ***
Total pot $0.95 | Rake $0.03 
Board [Qc 2h 5d 8c 9s]
Seat 1: van Alien (button) mucked [4d 4s]
Seat 2: LuckyCheewey (small blind) folded before Flop
Seat 3: Jacon2905 (big blind) folded before Flop
Seat 4: RoughRafff showed [Qd As] and won ($0.92) with a pair of Queens
Seat 5: Chupacabra G folded before Flop (didn't bet)
Seat 6: Scaaalll folded before Flop (didn't bet)



PokerStars Zoom Hand #229231710086:  Hold'em No Limit ($0.01/$0.02) - 2021/08/21 22:24:08 CET [2021/08/21 16:24:08 ET]
Table 'Halley' 6-max Seat #1 is the button
Seat 1: pavlo8855 ($2.20 in chips) 
Seat 2: Scaaalll ($2.05 in chips) 
Seat 3: NIK1973 23 ($2.32 in chips) 
Seat 4: hubertott ($4.99 in chips) 
Seat 5: xmaksimus ($4.04 in chips) 
Seat 6: anes.v. ($2.03 in chips) 
Scaaalll: posts small blind $0.01
NIK1973 23: posts big blind $0.02
*** HOLE CARDS ***
Dealt to Scaaalll [4d 3c]
hubertott: raises $0.04 to $0.06
xmaksimus: folds 
anes.v.: folds 
pavlo8855: calls $0.06
Scaaalll: folds 
NIK1973 23: folds 
*** FLOP *** [Jd 5c 2s]
hubertott: bets $0.07
pavlo8855: folds 
Uncalled bet ($0.07) returned to hubertott
hubertott collected $0.14 from pot
hubertott: doesn't show hand 
*** SUMMARY ***
Total pot $0.15 | Rake $0.01 
Board [Jd 5c 2s]
Seat 1: pavlo8855 (button) folded on the Flop
Seat 2: Scaaalll (small blind) folded before Flop
Seat 3: NIK1973 23 (big blind) folded before Flop
Seat 4: hubertott collected ($0.14)
Seat 5: xmaksimus folded before Flop (didn't bet)
Seat 6: anes.v. folded before Flop (didn't bet)



PokerStars Zoom Hand #229231717277:  Hold'em No Limit ($0.01/$0.02) - 2021/08/21 22:24:24 CET [2021/08/21 16:24:24 ET]
Table 'Halley' 6-max Seat #1 is the button
Seat 1: Scaaalll ($2.04 in chips) 
Seat 2: Capitaine Pat ($1.45 in chips) 
Seat 3: rodrigovini ($3.89 in chips) 
Seat 4: WITKOW_AV ($2.38 in chips) 
Seat 5: Phoenixxxxxxxx ($2 in chips) 
Seat 6: Luben_76 ($2.30 in chips) 
Capitaine Pat: posts small blind $0.01
rodrigovini: posts big blind $0.02
*** HOLE CARDS ***
Dealt to Scaaalll [9d Jd]
WITKOW_AV: folds 
Phoenixxxxxxxx: folds 
Luben_76: folds 
Scaaalll: raises $0.02 to $0.04
Capitaine Pat: folds 
rodrigovini: calls $0.02
*** FLOP *** [3d 7h 5d]
rodrigovini: checks 
Scaaalll: bets $0.06
rodrigovini: raises $0.12 to $0.18
Scaaalll: calls $0.12
*** TURN *** [3d 7h 5d] [As]
rodrigovini: bets $0.36
Scaaalll: folds 
Uncalled bet ($0.36) returned to rodrigovini
rodrigovini collected $0.43 from pot
rodrigovini: doesn't show hand 
*** SUMMARY ***
Total pot $0.45 | Rake $0.02 
Board [3d 7h 5d As]
Seat 1: Scaaalll (button) folded on the Turn
Seat 2: Capitaine Pat (small blind) folded before Flop
Seat 3: rodrigovini (big blind) collected ($0.43)
Seat 4: WITKOW_AV folded before Flop (didn't bet)
Seat 5: Phoenixxxxxxxx folded before Flop (didn't bet)
Seat 6: Luben_76 folded before Flop (didn't bet)



PokerStars Zoom Hand #229231740557:  Hold'em No Limit ($0.01/$0.02) - 2021/08/21 22:25:15 CET [2021/08/21 16:25:15 ET]
Table 'Halley' 6-max Seat #1 is the button
Seat 1: Chapaev136 ($3.19 in chips) 
Seat 2: Shcherbak252 ($2.18 in chips) 
Seat 3: Scaaalll ($2 in chips) 
Seat 4: ash1448 ($3.51 in chips) 
Seat 5: Red Sky 15 ($8.68 in chips) 
Seat 6: PapiMik3 ($5.62 in chips) 
Shcherbak252: posts small blind $0.01
Scaaalll: posts big blind $0.02
*** HOLE CARDS ***
Dealt to Scaaalll [8h 3s]
ash1448: folds 
Red Sky 15: folds 
PapiMik3: folds 
Red Sky 15 is disconnected 
Chapaev136: folds 
Shcherbak252: raises $0.04 to $0.06
Scaaalll: folds 
Uncalled bet ($0.04) returned to Shcherbak252
Shcherbak252 collected $0.04 from pot
Shcherbak252: doesn't show hand 
*** SUMMARY ***
Total pot $0.04 | Rake $0 
Seat 1: Chapaev136 (button) folded before Flop (didn't bet)
Seat 2: Shcherbak252 (small blind) collected ($0.04)
Seat 3: Scaaalll (big blind) folded before Flop
Seat 4: ash1448 folded before Flop (didn't bet)
Seat 5: Red Sky 15 folded before Flop (didn't bet)
Seat 6: PapiMik3 folded before Flop (didn't bet)



PokerStars Zoom Hand #229231745984:  Hold'em No Limit ($0.01/$0.02) - 2021/08/21 22:25:27 CET [2021/08/21 16:25:27 ET]
Table 'Halley' 6-max Seat #1 is the button
Seat 1: sal_sagev41 ($2.23 in chips) 
Seat 2: hubertott ($5.26 in chips) 
Seat 3: guntren.ps ($2.32 in chips) 
Seat 4: csmall14 ($2 in chips) 
Seat 5: 888lifeIS ($2 in chips) 
Seat 6: Scaaalll ($2 in chips) 
hubertott: posts small blind $0.01
guntren.ps: posts big blind $0.02
*** HOLE CARDS ***
Dealt to Scaaalll [7d Qd]
csmall14: folds 
888lifeIS: folds 
Scaaalll: folds 
sal_sagev41: folds 
hubertott: folds 
Uncalled bet ($0.01) returned to guntren.ps
guntren.ps collected $0.02 from pot
guntren.ps: doesn't show hand 
*** SUMMARY ***
Total pot $0.02 | Rake $0 
Seat 1: sal_sagev41 (button) folded before Flop (didn't bet)
Seat 2: hubertott (small blind) folded before Flop
Seat 3: guntren.ps (big blind) collected ($0.02)
Seat 4: csmall14 folded before Flop (didn't bet)
Seat 5: 888lifeIS folded before Flop (didn't bet)
Seat 6: Scaaalll folded before Flop (didn't bet)



PokerStars Zoom Hand #229231749578:  Hold'em No Limit ($0.01/$0.02) - 2021/08/21 22:25:35 CET [2021/08/21 16:25:35 ET]
Table 'Halley' 6-max Seat #1 is the button
Seat 1: ppluiaule ($3 in chips) 
Seat 2: Koldun 2636 ($3.62 in chips) 
Seat 3: NIK1973 23 ($2.07 in chips) 
Seat 4: Scaaalll ($2 in chips) 
Seat 5: HWalshy ($1.27 in chips) 
Seat 6: gasmar_29 ($2 in chips) 
Koldun 2636: posts small blind $0.01
NIK1973 23: posts big blind $0.02
*** HOLE CARDS ***
Dealt to Scaaalll [9d Kd]
Scaaalll: raises $0.04 to $0.06
HWalshy: folds 
gasmar_29: raises $0.12 to $0.18
ppluiaule: folds 
Koldun 2636: folds 
NIK1973 23: folds 
Scaaalll: folds 
Uncalled bet ($0.12) returned to gasmar_29
gasmar_29 collected $0.15 from pot
gasmar_29: doesn't show hand 
*** SUMMARY ***
Total pot $0.15 | Rake $0 
Seat 1: ppluiaule (button) folded before Flop (didn't bet)
Seat 2: Koldun 2636 (small blind) folded before Flop
Seat 3: NIK1973 23 (big blind) folded before Flop
Seat 4: Scaaalll folded before Flop
Seat 5: HWalshy folded before Flop (didn't bet)
Seat 6: gasmar_29 collected ($0.15)



PokerStars Zoom Hand #229231757796:  Hold'em No Limit ($0.01/$0.02) - 2021/08/21 22:25:53 CET [2021/08/21 16:25:53 ET]
Table 'Halley' 6-max Seat #1 is the button
Seat 1: Scaaalll ($2 in chips) 
Seat 2: NIK1973 23 ($2.05 in chips) 
Seat 3: le_vlimeux ($2.78 in chips) 
Seat 4: 77omsk ($8.81 in chips) 
Seat 5: NecromiconP ($2.51 in chips) 
Seat 6: so0love ($4.28 in chips) 
NIK1973 23: posts small blind $0.01
le_vlimeux: posts big blind $0.02
*** HOLE CARDS ***
Dealt to Scaaalll [9h 6d]
77omsk: folds 
NecromiconP: folds 
so0love: folds 
Scaaalll: folds 
NIK1973 23: folds 
Uncalled bet ($0.01) returned to le_vlimeux
le_vlimeux collected $0.02 from pot
le_vlimeux: doesn't show hand 
*** SUMMARY ***
Total pot $0.02 | Rake $0 
Seat 1: Scaaalll (button) folded before Flop (didn't bet)
Seat 2: NIK1973 23 (small blind) folded before Flop
Seat 3: le_vlimeux (big blind) collected ($0.02)
Seat 4: 77omsk folded before Flop (didn't bet)
Seat 5: NecromiconP folded before Flop (didn't bet)
Seat 6: so0love folded before Flop (didn't bet)



PokerStars Zoom Hand #229231761757:  Hold'em No Limit ($0.01/$0.02) - 2021/08/21 22:26:02 CET [2021/08/21 16:26:02 ET]
Table 'Halley' 6-max Seat #1 is the button
Seat 1: JTbukowski ($1.92 in chips) 
Seat 2: IIDARKROBOTII ($2 in chips) 
Seat 3: gasmar_29 ($2.11 in chips) 
Seat 4: Scaaalll ($2 in chips) 
Seat 5: felipeciji ($2.38 in chips) 
Seat 6: HubertFroh ($4.36 in chips) 
IIDARKROBOTII: posts small blind $0.01
gasmar_29: posts big blind $0.02
*** HOLE CARDS ***
Dealt to Scaaalll [6d Jd]
Scaaalll: folds 
felipeciji: folds 
HubertFroh: calls $0.02
JTbukowski: folds 
IIDARKROBOTII: raises $0.06 to $0.08
gasmar_29: folds 
HubertFroh: calls $0.06
*** FLOP *** [7c 3c 8c]
IIDARKROBOTII: bets $0.08
HubertFroh: folds 
Uncalled bet ($0.08) returned to IIDARKROBOTII
IIDARKROBOTII collected $0.17 from pot
IIDARKROBOTII: doesn't show hand 
*** SUMMARY ***
Total pot $0.18 | Rake $0.01 
Board [7c 3c 8c]
Seat 1: JTbukowski (button) folded before Flop (didn't bet)
Seat 2: IIDARKROBOTII (small blind) collected ($0.17)
Seat 3: gasmar_29 (big blind) folded before Flop
Seat 4: Scaaalll folded before Flop (didn't bet)
Seat 5: felipeciji folded before Flop (didn't bet)
Seat 6: HubertFroh folded on the Flop



PokerStars Zoom Hand #229231772367:  Hold'em No Limit ($0.01/$0.02) - 2021/08/21 22:26:25 CET [2021/08/21 16:26:25 ET]
Table 'Halley' 6-max Seat #1 is the button
Seat 1: ppluiaule ($2.97 in chips) 
Seat 2: Scaaalll ($2 in chips) 
Seat 3: Feliciano16 ($3.63 in chips) 
Seat 4: Mikeloko182 ($5.96 in chips) 
Seat 5: IceTdannyB ($2.91 in chips) 
Seat 6: Rafaxn ($2.06 in chips) 
Scaaalll: posts small blind $0.01
Feliciano16: posts big blind $0.02
*** HOLE CARDS ***
Dealt to Scaaalll [7d 4c]
IceTdannyB is disconnected 
Mikeloko182: folds 
IceTdannyB: folds 
Rafaxn: folds 
ppluiaule: folds 
Scaaalll: folds 
Uncalled bet ($0.01) returned to Feliciano16
Feliciano16 collected $0.02 from pot
Feliciano16: doesn't show hand 
*** SUMMARY ***
Total pot $0.02 | Rake $0 
Seat 1: ppluiaule (button) folded before Flop (didn't bet)
Seat 2: Scaaalll (small blind) folded before Flop
Seat 3: Feliciano16 (big blind) collected ($0.02)
Seat 4: Mikeloko182 folded before Flop (didn't bet)
Seat 5: IceTdannyB folded before Flop (didn't bet)
Seat 6: Rafaxn folded before Flop (didn't bet)



PokerStars Zoom Hand #229231777294:  Hold'em No Limit ($0.01/$0.02) - 2021/08/21 22:26:36 CET [2021/08/21 16:26:36 ET]
Table 'Halley' 6-max Seat #1 is the button
Seat 1: Allexii ($2.22 in chips) 
Seat 2: olga3021221 ($4.95 in chips) 
Seat 3: ZorroZoltan ($3.61 in chips) 
Seat 4: kotpigav ($1.08 in chips) 
Seat 5: gordoatlantico ($2.17 in chips) 
Seat 6: Scaaalll ($2 in chips) 
olga3021221: posts small blind $0.01
ZorroZoltan: posts big blind $0.02
*** HOLE CARDS ***
Dealt to Scaaalll [Qh Th]
kotpigav: folds 
kotpigav is disconnected 
gordoatlantico: folds 
Scaaalll: raises $0.04 to $0.06
Allexii: folds 
olga3021221: folds 
ZorroZoltan: folds 
Uncalled bet ($0.04) returned to Scaaalll
Allexii is disconnected 
Scaaalll collected $0.05 from pot
Scaaalll: doesn't show hand 
*** SUMMARY ***
Total pot $0.05 | Rake $0 
Seat 1: Allexii (button) folded before Flop (didn't bet)
Seat 2: olga3021221 (small blind) folded before Flop
Seat 3: ZorroZoltan (big blind) folded before Flop
Seat 4: kotpigav folded before Flop (didn't bet)
Seat 5: gordoatlantico folded before Flop (didn't bet)
Seat 6: Scaaalll collected ($0.05)



PokerStars Zoom Hand #229231764024:  Hold'em No Limit ($0.01/$0.02) - 2021/08/21 22:26:07 CET [2021/08/21 16:26:07 ET]
Table 'Halley' 6-max Seat #1 is the button
Seat 1: JBPY ($2.06 in chips) 
Seat 2: Tabitaji ($3.02 in chips) 
Seat 3: Scaaalll ($2 in chips) 
Seat 4: olcham7 ($2.81 in chips) 
Seat 5: Emilmoller1 ($1.32 in chips) 
Seat 6: fishh_play ($4.51 in chips) 
Tabitaji: posts small blind $0.01
Scaaalll: posts big blind $0.02
*** HOLE CARDS ***
Dealt to Scaaalll [3s Ac]
olcham7: folds 
Emilmoller1: folds 
fishh_play: raises $0.03 to $0.05
JBPY: folds 
Tabitaji: raises $0.15 to $0.20
Scaaalll: folds 
fishh_play: calls $0.15
*** FLOP *** [2d Qd 7s]
Tabitaji: bets $0.20
fishh_play: calls $0.20
*** TURN *** [2d Qd 7s] [Ad]
Tabitaji: checks 
fishh_play: checks 
*** RIVER *** [2d Qd 7s Ad] [9c]
Tabitaji: checks 
fishh_play: checks 
*** SHOW DOWN ***
Tabitaji: shows [Ts As] (a pair of Aces)
fishh_play: mucks hand 
Tabitaji collected $0.79 from pot
*** SUMMARY ***
Total pot $0.82 | Rake $0.03 
Board [2d Qd 7s Ad 9c]
Seat 1: JBPY (button) folded before Flop (didn't bet)
Seat 2: Tabitaji (small blind) showed [Ts As] and won ($0.79) with a pair of Aces
Seat 3: Scaaalll (big blind) folded before Flop
Seat 4: olcham7 folded before Flop (didn't bet)
Seat 5: Emilmoller1 folded before Flop (didn't bet)
Seat 6: fishh_play mucked [Qh Jh]



PokerStars Zoom Hand #229231796895:  Hold'em No Limit ($0.01/$0.02) - 2021/08/21 22:27:11 CET [2021/08/21 16:27:11 ET]
Table 'Halley' 6-max Seat #1 is the button
Seat 1: van Alien ($1.29 in chips) 
Seat 2: LuckyCheewey ($6.40 in chips) 
Seat 3: HubertFroh ($4.25 in chips) 
Seat 4: Tacojesuscrisp ($2.03 in chips) 
Seat 5: Scaaalll ($2.03 in chips) 
Seat 6: EevAA190 ($3.09 in chips) 
LuckyCheewey: posts small blind $0.01
HubertFroh: posts big blind $0.02
*** HOLE CARDS ***
Dealt to Scaaalll [8c Th]
Tacojesuscrisp: folds 
Scaaalll: folds 
EevAA190: folds 
van Alien: folds 
LuckyCheewey: folds 
Uncalled bet ($0.01) returned to HubertFroh
HubertFroh collected $0.02 from pot
HubertFroh: doesn't show hand 
*** SUMMARY ***
Total pot $0.02 | Rake $0 
Seat 1: van Alien (button) folded before Flop (didn't bet)
Seat 2: LuckyCheewey (small blind) folded before Flop
Seat 3: HubertFroh (big blind) collected ($0.02)
Seat 4: Tacojesuscrisp folded before Flop (didn't bet)
Seat 5: Scaaalll folded before Flop (didn't bet)
Seat 6: EevAA190 folded before Flop (didn't bet)



PokerStars Zoom Hand #229231792338:  Hold'em No Limit ($0.01/$0.02) - 2021/08/21 22:27:01 CET [2021/08/21 16:27:01 ET]
Table 'Halley' 6-max Seat #1 is the button
Seat 1: Scaaalll ($2.03 in chips) 
Seat 2: Mikeloko182 ($2.06 in chips) 
Seat 3: pokershevela ($2.62 in chips) 
Seat 4: olcham7 ($2.81 in chips) 
Seat 5: KareAAAA ($1.87 in chips) 
Seat 6: IamFixxed ($8.52 in chips) 
Mikeloko182: posts small blind $0.01
pokershevela: posts big blind $0.02
*** HOLE CARDS ***
Dealt to Scaaalll [4h 8d]
KareAAAA is disconnected 
olcham7: raises $0.04 to $0.06
KareAAAA: folds 
IamFixxed: folds 
Scaaalll: folds 
Mikeloko182: folds 
pokershevela: folds 
Uncalled bet ($0.04) returned to olcham7
olcham7 collected $0.05 from pot
olcham7: doesn't show hand 
pokershevela is disconnected 
*** SUMMARY ***
Total pot $0.05 | Rake $0 
Seat 1: Scaaalll (button) folded before Flop (didn't bet)
Seat 2: Mikeloko182 (small blind) folded before Flop
Seat 3: pokershevela (big blind) folded before Flop
Seat 4: olcham7 collected ($0.05)
Seat 5: KareAAAA folded before Flop (didn't bet)
Seat 6: IamFixxed folded before Flop (didn't bet)



PokerStars Zoom Hand #229231790474:  Hold'em No Limit ($0.01/$0.02) - 2021/08/21 22:26:57 CET [2021/08/21 16:26:57 ET]
Table 'Halley' 6-max Seat #1 is the button
Seat 1: guntren.ps ($3.22 in chips) 
Seat 2: AndreaBsAs ($2 in chips) 
Seat 3: MirkoV224 ($1.59 in chips) 
Seat 4: Red Sky 15 ($8.88 in chips) 
Seat 5: Scaaalll ($2.03 in chips) 
Seat 6: texashenry2 ($2.21 in chips) 
AndreaBsAs: posts small blind $0.01
MirkoV224: posts big blind $0.02
*** HOLE CARDS ***
Dealt to Scaaalll [2c 9h]
Red Sky 15: folds 
Scaaalll: folds 
Red Sky 15 is disconnected 
texashenry2: raises $0.04 to $0.06
guntren.ps: folds 
AndreaBsAs: folds 
MirkoV224: calls $0.04
*** FLOP *** [5d 8s 5h]
MirkoV224: checks 
texashenry2: bets $0.13
MirkoV224: folds 
Uncalled bet ($0.13) returned to texashenry2
texashenry2 collected $0.13 from pot
texashenry2: doesn't show hand 
*** SUMMARY ***
Total pot $0.13 | Rake $0 
Board [5d 8s 5h]
Seat 1: guntren.ps (button) folded before Flop (didn't bet)
Seat 2: AndreaBsAs (small blind) folded before Flop
Seat 3: MirkoV224 (big blind) folded on the Flop
Seat 4: Red Sky 15 folded before Flop (didn't bet)
Seat 5: Scaaalll folded before Flop (didn't bet)
Seat 6: texashenry2 collected ($0.13)



PokerStars Zoom Hand #229231798623:  Hold'em No Limit ($0.01/$0.02) - 2021/08/21 22:27:15 CET [2021/08/21 16:27:15 ET]
Table 'Halley' 6-max Seat #1 is the button
Seat 1: hubertott ($5.08 in chips) 
Seat 2: Scaaalll ($2.03 in chips) 
Seat 3: Earl_greyPL ($1.41 in chips) 
Seat 4: 888lifeIS ($2.09 in chips) 
Seat 5: vovo4kapooh ($4.67 in chips) 
Seat 6: WellWell57 ($3.62 in chips) 
Scaaalll: posts small blind $0.01
Earl_greyPL: posts big blind $0.02
*** HOLE CARDS ***
Dealt to Scaaalll [6c Qd]
888lifeIS: raises $0.02 to $0.04
vovo4kapooh: folds 
WellWell57: calls $0.04
hubertott: folds 
Scaaalll: folds 
Earl_greyPL: folds 
*** FLOP *** [As 5h 3d]
888lifeIS: checks 
WellWell57: checks 
*** TURN *** [As 5h 3d] [Tc]
888lifeIS: bets $0.07
WellWell57: calls $0.07
*** RIVER *** [As 5h 3d Tc] [3h]
888lifeIS: bets $0.18
WellWell57: folds 
Uncalled bet ($0.18) returned to 888lifeIS
888lifeIS collected $0.24 from pot
888lifeIS: doesn't show hand 
*** SUMMARY ***
Total pot $0.25 | Rake $0.01 
Board [As 5h 3d Tc 3h]
Seat 1: hubertott (button) folded before Flop (didn't bet)
Seat 2: Scaaalll (small blind) folded before Flop
Seat 3: Earl_greyPL (big blind) folded before Flop
Seat 4: 888lifeIS collected ($0.24)
Seat 5: vovo4kapooh folded before Flop (didn't bet)
Seat 6: WellWell57 folded on the River



PokerStars Zoom Hand #229231805955:  Hold'em No Limit ($0.01/$0.02) - 2021/08/21 22:27:31 CET [2021/08/21 16:27:31 ET]
Table 'Halley' 6-max Seat #1 is the button
Seat 1: auxy89 ($2.02 in chips) 
Seat 2: 78joniboy ($2 in chips) 
Seat 3: rpycmbEM ($4.89 in chips) 
Seat 4: LuckyCheewey ($6.39 in chips) 
Seat 5: Scaaalll ($2.02 in chips) 
Seat 6: elmex886 ($2.02 in chips) 
78joniboy: posts small blind $0.01
rpycmbEM: posts big blind $0.02
*** HOLE CARDS ***
Dealt to Scaaalll [3d 5d]
LuckyCheewey: folds 
auxy89 is disconnected 
Scaaalll: folds 
elmex886: folds 
auxy89: folds 
78joniboy: raises $0.04 to $0.06
rpycmbEM: folds 
Uncalled bet ($0.04) returned to 78joniboy
78joniboy collected $0.04 from pot
78joniboy: doesn't show hand 
*** SUMMARY ***
Total pot $0.04 | Rake $0 
Seat 1: auxy89 (button) folded before Flop (didn't bet)
Seat 2: 78joniboy (small blind) collected ($0.04)
Seat 3: rpycmbEM (big blind) folded before Flop
Seat 4: LuckyCheewey folded before Flop (didn't bet)
Seat 5: Scaaalll folded before Flop (didn't bet)
Seat 6: elmex886 folded before Flop (didn't bet)



PokerStars Zoom Hand #229231803665:  Hold'em No Limit ($0.01/$0.02) - 2021/08/21 22:27:26 CET [2021/08/21 16:27:26 ET]
Table 'Halley' 6-max Seat #1 is the button
Seat 1: texashenry2 ($2.28 in chips) 
Seat 2: Dulli007 ($5.31 in chips) 
Seat 3: ppluiaule ($2.06 in chips) 
Seat 4: pavlo8855 ($2.04 in chips) 
Seat 5: LuckyCheewey ($6.39 in chips) 
Seat 6: Scaaalll ($2.02 in chips) 
Dulli007: posts small blind $0.01
ppluiaule: posts big blind $0.02
*** HOLE CARDS ***
Dealt to Scaaalll [7h Ks]
pavlo8855: folds 
LuckyCheewey: folds 
Scaaalll: folds 
texashenry2: folds 
Dulli007: calls $0.01
ppluiaule: raises $0.07 to $0.09
Dulli007: calls $0.07
*** FLOP *** [Tc Js 6h]
Dulli007: checks 
ppluiaule: bets $0.08
Dulli007: calls $0.08
*** TURN *** [Tc Js 6h] [3c]
Dulli007: checks 
ppluiaule: checks 
*** RIVER *** [Tc Js 6h 3c] [Kc]
Dulli007: bets $0.17
ppluiaule: folds 
Uncalled bet ($0.17) returned to Dulli007
Dulli007 collected $0.33 from pot
Dulli007: doesn't show hand 
*** SUMMARY ***
Total pot $0.34 | Rake $0.01 
Board [Tc Js 6h 3c Kc]
Seat 1: texashenry2 (button) folded before Flop (didn't bet)
Seat 2: Dulli007 (small blind) collected ($0.33)
Seat 3: ppluiaule (big blind) folded on the River
Seat 4: pavlo8855 folded before Flop (didn't bet)
Seat 5: LuckyCheewey folded before Flop (didn't bet)
Seat 6: Scaaalll folded before Flop (didn't bet)



PokerStars Zoom Hand #229231809044:  Hold'em No Limit ($0.01/$0.02) - 2021/08/21 22:27:38 CET [2021/08/21 16:27:38 ET]
Table 'Halley' 6-max Seat #1 is the button
Seat 1: lexus00174 ($2 in chips) 
Seat 2: Ahoy_04 ($0.30 in chips) 
Seat 3: Scaaalll ($2.02 in chips) 
Seat 4: LSDenny ($2.14 in chips) 
Seat 5: krowio ($2.99 in chips) 
Seat 6: Kreodont1987 ($2.57 in chips) 
Ahoy_04: posts small blind $0.01
Scaaalll: posts big blind $0.02
*** HOLE CARDS ***
Dealt to Scaaalll [8c Jd]
LSDenny: folds 
LSDenny is disconnected 
krowio: folds 
Kreodont1987: folds 
lexus00174: raises $0.04 to $0.06
Ahoy_04: folds 
Scaaalll: folds 
Uncalled bet ($0.04) returned to lexus00174
lexus00174 collected $0.05 from pot
lexus00174: doesn't show hand 
*** SUMMARY ***
Total pot $0.05 | Rake $0 
Seat 1: lexus00174 (button) collected ($0.05)
Seat 2: Ahoy_04 (small blind) folded before Flop
Seat 3: Scaaalll (big blind) folded before Flop
Seat 4: LSDenny folded before Flop (didn't bet)
Seat 5: krowio folded before Flop (didn't bet)
Seat 6: Kreodont1987 folded before Flop (didn't bet)



PokerStars Zoom Hand #229231819547:  Hold'em No Limit ($0.01/$0.02) - 2021/08/21 22:28:01 CET [2021/08/21 16:28:01 ET]
Table 'Halley' 6-max Seat #1 is the button
Seat 1: Scaaalll ($2 in chips) 
Seat 2: olcham7 ($2.82 in chips) 
Seat 3: Ne0net ($2 in chips) 
Seat 4: osantos401 ($4.68 in chips) 
Seat 5: Stryda00 ($2 in chips) 
Seat 6: van Alien ($1.21 in chips) 
olcham7: posts small blind $0.01
Ne0net: posts big blind $0.02
*** HOLE CARDS ***
Dealt to Scaaalll [2h 7c]
osantos401: folds 
Stryda00: folds 
van Alien: folds 
Scaaalll: folds 
olcham7: folds 
Uncalled bet ($0.01) returned to Ne0net
Ne0net collected $0.02 from pot
Ne0net: doesn't show hand 
*** SUMMARY ***
Total pot $0.02 | Rake $0 
Seat 1: Scaaalll (button) folded before Flop (didn't bet)
Seat 2: olcham7 (small blind) folded before Flop
Seat 3: Ne0net (big blind) collected ($0.02)
Seat 4: osantos401 folded before Flop (didn't bet)
Seat 5: Stryda00 folded before Flop (didn't bet)
Seat 6: van Alien folded before Flop (didn't bet)



PokerStars Zoom Hand #229231821809:  Hold'em No Limit ($0.01/$0.02) - 2021/08/21 22:28:06 CET [2021/08/21 16:28:06 ET]
Table 'Halley' 6-max Seat #1 is the button
Seat 1: Kreodont1987 ($4.45 in chips) 
Seat 2: fishh_play ($4.81 in chips) 
Seat 3: zergmiky ($2 in chips) 
Seat 4: Scaaalll ($2 in chips) 
Seat 5: EdwardF95 ($3.13 in chips) 
Seat 6: WITKOW_AV ($2.46 in chips) 
fishh_play: posts small blind $0.01
zergmiky: posts big blind $0.02
*** HOLE CARDS ***
Dealt to Scaaalll [Qc 3s]
Scaaalll: folds 
EdwardF95: raises $0.04 to $0.06
WITKOW_AV: folds 
Kreodont1987: folds 
fishh_play: folds 
zergmiky: folds 
Uncalled bet ($0.04) returned to EdwardF95
EdwardF95 collected $0.05 from pot
EdwardF95: doesn't show hand 
*** SUMMARY ***
Total pot $0.05 | Rake $0 
Seat 1: Kreodont1987 (button) folded before Flop (didn't bet)
Seat 2: fishh_play (small blind) folded before Flop
Seat 3: zergmiky (big blind) folded before Flop
Seat 4: Scaaalll folded before Flop (didn't bet)
Seat 5: EdwardF95 collected ($0.05)
Seat 6: WITKOW_AV folded before Flop (didn't bet)



PokerStars Zoom Hand #229231824958:  Hold'em No Limit ($0.01/$0.02) - 2021/08/21 22:28:13 CET [2021/08/21 16:28:13 ET]
Table 'Halley' 6-max Seat #1 is the button
Seat 1: Dershura1989 ($2.09 in chips) 
Seat 2: Scaaalll ($2 in chips) 
Seat 3: Osetrov.A.A ($1.87 in chips) 
Seat 4: humo97 ($2.32 in chips) 
Seat 5: teutonknight ($0.35 in chips) 
Seat 6: HellNative ($2.24 in chips) 
Scaaalll: posts small blind $0.01
Osetrov.A.A: posts big blind $0.02
*** HOLE CARDS ***
Dealt to Scaaalll [7c 7s]
humo97: raises $0.02 to $0.04
teutonknight: folds 
HellNative: folds 
Dershura1989: folds 
Scaaalll: calls $0.03
Osetrov.A.A: folds 
*** FLOP *** [9c 7d Th]
Scaaalll: checks 
humo97: bets $0.04
Scaaalll: calls $0.04
*** TURN *** [9c 7d Th] [Ah]
Scaaalll: checks 
humo97: checks 
*** RIVER *** [9c 7d Th Ah] [Ac]
Scaaalll: checks 
humo97: checks 
*** SHOW DOWN ***
Scaaalll: shows [7c 7s] (a full house, Sevens full of Aces)
humo97: mucks hand 
Scaaalll collected $0.17 from pot
*** SUMMARY ***
Total pot $0.18 | Rake $0.01 
Board [9c 7d Th Ah Ac]
Seat 1: Dershura1989 (button) folded before Flop (didn't bet)
Seat 2: Scaaalll (small blind) showed [7c 7s] and won ($0.17) with a full house, Sevens full of Aces
Seat 3: Osetrov.A.A (big blind) folded before Flop
Seat 4: humo97 mucked [6c 5c]
Seat 5: teutonknight folded before Flop (didn't bet)
Seat 6: HellNative folded before Flop (didn't bet)



PokerStars Zoom Hand #229231844806:  Hold'em No Limit ($0.01/$0.02) - 2021/08/21 22:28:57 CET [2021/08/21 16:28:57 ET]
Table 'Halley' 6-max Seat #1 is the button
Seat 1: Tabitaji ($2.69 in chips) 
Seat 2: rodrigovini ($4.46 in chips) 
Seat 3: Scaaalll ($2.09 in chips) 
Seat 4: HirotoBeats ($1.84 in chips) 
Seat 5: krowio ($3.96 in chips) 
Seat 6: Janey44 ($4.97 in chips) 
rodrigovini: posts small blind $0.01
Scaaalll: posts big blind $0.02
*** HOLE CARDS ***
Dealt to Scaaalll [4s 3d]
HirotoBeats: folds 
krowio: folds 
Janey44: folds 
Tabitaji: folds 
Janey44 is disconnected 
rodrigovini: folds 
Uncalled bet ($0.01) returned to Scaaalll
Scaaalll collected $0.02 from pot
Scaaalll: doesn't show hand 
*** SUMMARY ***
Total pot $0.02 | Rake $0 
Seat 1: Tabitaji (button) folded before Flop (didn't bet)
Seat 2: rodrigovini (small blind) folded before Flop
Seat 3: Scaaalll (big blind) collected ($0.02)
Seat 4: HirotoBeats folded before Flop (didn't bet)
Seat 5: krowio folded before Flop (didn't bet)
Seat 6: Janey44 folded before Flop (didn't bet)



PokerStars Zoom Hand #229231850226:  Hold'em No Limit ($0.01/$0.02) - 2021/08/21 22:29:09 CET [2021/08/21 16:29:09 ET]
Table 'Halley' 6-max Seat #1 is the button
Seat 1: lexus00174 ($2.09 in chips) 
Seat 2: vovo4kapooh ($4.69 in chips) 
Seat 3: caiolima99 ($7.86 in chips) 
Seat 4: Hantsirg ($1.31 in chips) 
Seat 5: Scaaalll ($2.10 in chips) 
Seat 6: 77omsk ($2.63 in chips) 
vovo4kapooh: posts small blind $0.01
caiolima99: posts big blind $0.02
*** HOLE CARDS ***
Dealt to Scaaalll [Qd 7c]
Hantsirg: folds 
Hantsirg is disconnected 
Scaaalll: folds 
77omsk: folds 
lexus00174: folds 
vovo4kapooh: folds 
Uncalled bet ($0.01) returned to caiolima99
caiolima99 collected $0.02 from pot
caiolima99: doesn't show hand 
*** SUMMARY ***
Total pot $0.02 | Rake $0 
Seat 1: lexus00174 (button) folded before Flop (didn't bet)
Seat 2: vovo4kapooh (small blind) folded before Flop
Seat 3: caiolima99 (big blind) collected ($0.02)
Seat 4: Hantsirg folded before Flop (didn't bet)
Seat 5: Scaaalll folded before Flop (didn't bet)
Seat 6: 77omsk folded before Flop (didn't bet)



PokerStars Zoom Hand #229231860429:  Hold'em No Limit ($0.01/$0.02) - 2021/08/21 22:29:32 CET [2021/08/21 16:29:32 ET]
Table 'Halley' 6-max Seat #1 is the button
Seat 1: bbarao ($1.86 in chips) 
Seat 2: Scaaalll ($2.10 in chips) 
Seat 3: HellNative ($4.94 in chips) 
Seat 4: SKV_1985 ($3.22 in chips) 
Seat 5: elmex886 ($2 in chips) 
Seat 6: Kreodont1987 ($4.42 in chips) 
Scaaalll: posts small blind $0.01
HellNative: posts big blind $0.02
*** HOLE CARDS ***
Dealt to Scaaalll [4s 3d]
SKV_1985: folds 
elmex886: folds 
Kreodont1987: folds 
bbarao: raises $0.04 to $0.06
Scaaalll: folds 
HellNative: folds 
Uncalled bet ($0.04) returned to bbarao
bbarao collected $0.05 from pot
bbarao: doesn't show hand 
*** SUMMARY ***
Total pot $0.05 | Rake $0 
Seat 1: bbarao (button) collected ($0.05)
Seat 2: Scaaalll (small blind) folded before Flop
Seat 3: HellNative (big blind) folded before Flop
Seat 4: SKV_1985 folded before Flop (didn't bet)
Seat 5: elmex886 folded before Flop (didn't bet)
Seat 6: Kreodont1987 folded before Flop (didn't bet)



PokerStars Zoom Hand #229231858157:  Hold'em No Limit ($0.01/$0.02) - 2021/08/21 22:29:27 CET [2021/08/21 16:29:27 ET]
Table 'Halley' 6-max Seat #1 is the button
Seat 1: Dulli007 ($4.95 in chips) 
Seat 2: dcd113 ($1.18 in chips) 
Seat 3: Blaackie ($5.14 in chips) 
Seat 4: Scaaalll ($2.10 in chips) 
Seat 5: Loydyfrody ($1.96 in chips) 
Seat 6: kahzura ($2.01 in chips) 
dcd113: posts small blind $0.01
Blaackie: posts big blind $0.02
*** HOLE CARDS ***
Dealt to Scaaalll [Qc 7s]
Scaaalll: folds 
Loydyfrody: calls $0.02
kahzura: folds 
Dulli007: folds 
dcd113: folds 
Blaackie: checks 
*** FLOP *** [Jc 8h Qs]
Blaackie: checks 
Loydyfrody: bets $0.02
Blaackie: calls $0.02
*** TURN *** [Jc 8h Qs] [Qh]
Blaackie: checks 
Loydyfrody: checks 
*** RIVER *** [Jc 8h Qs Qh] [2s]
Blaackie: checks 
Loydyfrody: checks 
*** SHOW DOWN ***
Blaackie: shows [7d Js] (two pair, Queens and Jacks)
Loydyfrody: mucks hand 
Blaackie collected $0.09 from pot
*** SUMMARY ***
Total pot $0.09 | Rake $0 
Board [Jc 8h Qs Qh 2s]
Seat 1: Dulli007 (button) folded before Flop (didn't bet)
Seat 2: dcd113 (small blind) folded before Flop
Seat 3: Blaackie (big blind) showed [7d Js] and won ($0.09) with two pair, Queens and Jacks
Seat 4: Scaaalll folded before Flop (didn't bet)
Seat 5: Loydyfrody mucked [Th As]
Seat 6: kahzura folded before Flop (didn't bet)



PokerStars Zoom Hand #229231852394:  Hold'em No Limit ($0.01/$0.02) - 2021/08/21 22:29:14 CET [2021/08/21 16:29:14 ET]
Table 'Halley' 6-max Seat #1 is the button
Seat 1: Luben_76 ($1.81 in chips) 
Seat 2: rekopo203 ($6.10 in chips) 
Seat 3: astapowitsch ($2 in chips) 
Seat 4: SchinkenToni ($1.70 in chips) 
Seat 5: The-End-snglr ($2.18 in chips) 
Seat 6: Scaaalll ($2.10 in chips) 
rekopo203: posts small blind $0.01
astapowitsch: posts big blind $0.02
*** HOLE CARDS ***
Dealt to Scaaalll [4s 7h]
SchinkenToni: raises $0.04 to $0.06
The-End-snglr: folds 
Scaaalll: folds 
Luben_76: folds 
rekopo203: calls $0.05
astapowitsch: calls $0.04
*** FLOP *** [6h Qc 8c]
rekopo203: checks 
astapowitsch: bets $0.06
SchinkenToni: calls $0.06
rekopo203: calls $0.06
*** TURN *** [6h Qc 8c] [4d]
rekopo203: checks 
astapowitsch: bets $0.26
SchinkenToni: folds 
rekopo203: calls $0.26
*** RIVER *** [6h Qc 8c 4d] [Td]
rekopo203: checks 
astapowitsch: bets $0.46
rekopo203: calls $0.46
*** SHOW DOWN ***
astapowitsch: shows [6s 6d] (three of a kind, Sixes)
rekopo203: mucks hand 
astapowitsch collected $1.74 from pot
*** SUMMARY ***
Total pot $1.80 | Rake $0.06 
Board [6h Qc 8c 4d Td]
Seat 1: Luben_76 (button) folded before Flop (didn't bet)
Seat 2: rekopo203 (small blind) mucked [Kc Kd]
Seat 3: astapowitsch (big blind) showed [6s 6d] and won ($1.74) with three of a kind, Sixes
Seat 4: SchinkenToni folded on the Turn
Seat 5: The-End-snglr folded before Flop (didn't bet)
Seat 6: Scaaalll folded before Flop (didn't bet)



PokerStars Zoom Hand #229231865935:  Hold'em No Limit ($0.01/$0.02) - 2021/08/21 22:29:44 CET [2021/08/21 16:29:44 ET]
Table 'Halley' 6-max Seat #1 is the button
Seat 1: EdwardF95 ($2.55 in chips) 
Seat 2: Shcherbak252 ($2.64 in chips) 
Seat 3: Scaaalll ($2.09 in chips) 
Seat 4: Antipirate ($2.29 in chips) 
Seat 5: Axel201388 ($0.80 in chips) 
Seat 6: RrriotGrrrl ($3.76 in chips) 
Shcherbak252: posts small blind $0.01
Scaaalll: posts big blind $0.02
*** HOLE CARDS ***
Dealt to Scaaalll [2c 9d]
Antipirate: folds 
Antipirate is disconnected 
Axel201388: folds 
RrriotGrrrl: folds 
EdwardF95: folds 
Shcherbak252 has timed out while disconnected
Shcherbak252: folds 
Uncalled bet ($0.01) returned to Scaaalll
Scaaalll collected $0.02 from pot
Scaaalll: doesn't show hand 
*** SUMMARY ***
Total pot $0.02 | Rake $0 
Seat 1: EdwardF95 (button) folded before Flop (didn't bet)
Seat 2: Shcherbak252 (small blind) folded before Flop
Seat 3: Scaaalll (big blind) collected ($0.02)
Seat 4: Antipirate folded before Flop (didn't bet)
Seat 5: Axel201388 folded before Flop (didn't bet)
Seat 6: RrriotGrrrl folded before Flop (didn't bet)



PokerStars Zoom Hand #229231854169:  Hold'em No Limit ($0.01/$0.02) - 2021/08/21 22:29:18 CET [2021/08/21 16:29:18 ET]
Table 'Halley' 6-max Seat #1 is the button
Seat 1: Scaaalll ($2.10 in chips) 
Seat 2: CROVOSOS-1978 ($3.62 in chips) 
Seat 3: auxy89 ($2.02 in chips) 
Seat 4: VovaU164 ($1.66 in chips) 
Seat 5: kotpigav ($0.78 in chips) 
Seat 6: AlexGTPS ($3.24 in chips) 
CROVOSOS-1978: posts small blind $0.01
auxy89: posts big blind $0.02
*** HOLE CARDS ***
Dealt to Scaaalll [8d 4d]
kotpigav is disconnected 
VovaU164: raises $0.04 to $0.06
kotpigav: folds 
AlexGTPS: calls $0.06
Scaaalll: folds 
CROVOSOS-1978: calls $0.05
auxy89: calls $0.04
*** FLOP *** [7d Th 6h]
CROVOSOS-1978: bets $0.02
auxy89: calls $0.02
VovaU164: calls $0.02
AlexGTPS: calls $0.02
*** TURN *** [7d Th 6h] [9s]
CROVOSOS-1978: checks 
auxy89: checks 
VovaU164: checks 
AlexGTPS: checks 
*** RIVER *** [7d Th 6h 9s] [2s]
CROVOSOS-1978: checks 
auxy89: checks 
VovaU164: bets $0.19
AlexGTPS: folds 
CROVOSOS-1978: calls $0.19
auxy89: folds 
*** SHOW DOWN ***
VovaU164: shows [8c 8h] (a straight, Six to Ten)
CROVOSOS-1978: mucks hand 
auxy89 is disconnected 
VovaU164 collected $0.68 from pot
*** SUMMARY ***
Total pot $0.70 | Rake $0.02 
Board [7d Th 6h 9s 2s]
Seat 1: Scaaalll (button) folded before Flop (didn't bet)
Seat 2: CROVOSOS-1978 (small blind) mucked [Qs 9c]
Seat 3: auxy89 (big blind) folded on the River
Seat 4: VovaU164 showed [8c 8h] and won ($0.68) with a straight, Six to Ten
Seat 5: kotpigav folded before Flop (didn't bet)
Seat 6: AlexGTPS folded on the River



PokerStars Zoom Hand #229231876883:  Hold'em No Limit ($0.01/$0.02) - 2021/08/21 22:30:08 CET [2021/08/21 16:30:08 ET]
Table 'Halley' 6-max Seat #1 is the button
Seat 1: robokop358 ($0.57 in chips) 
Seat 2: FabOliveira9 ($2 in chips) 
Seat 3: Russian MA ($1.42 in chips) 
Seat 4: Tn 939 ($2 in chips) 
Seat 5: Scaaalll ($2.10 in chips) 
Seat 6: ca$hmeoutsid ($2.33 in chips) 
FabOliveira9: posts small blind $0.01
Russian MA: posts big blind $0.02
*** HOLE CARDS ***
Dealt to Scaaalll [Ac 4d]
Tn 939: folds 
Scaaalll: folds 
ca$hmeoutsid: raises $0.04 to $0.06
robokop358: folds 
FabOliveira9: folds 
Russian MA: calls $0.04
*** FLOP *** [6h 5d 5h]
Russian MA: checks 
ca$hmeoutsid: bets $0.07
Russian MA: calls $0.07
*** TURN *** [6h 5d 5h] [Qh]
Russian MA: bets $0.15
ca$hmeoutsid: folds 
Uncalled bet ($0.15) returned to Russian MA
Russian MA collected $0.26 from pot
Russian MA: doesn't show hand 
*** SUMMARY ***
Total pot $0.27 | Rake $0.01 
Board [6h 5d 5h Qh]
Seat 1: robokop358 (button) folded before Flop (didn't bet)
Seat 2: FabOliveira9 (small blind) folded before Flop
Seat 3: Russian MA (big blind) collected ($0.26)
Seat 4: Tn 939 folded before Flop (didn't bet)
Seat 5: Scaaalll folded before Flop (didn't bet)
Seat 6: ca$hmeoutsid folded on the Turn



PokerStars Zoom Hand #229231883628:  Hold'em No Limit ($0.01/$0.02) - 2021/08/21 22:30:23 CET [2021/08/21 16:30:23 ET]
Table 'Halley' 6-max Seat #1 is the button
Seat 1: Scaaalll ($2.10 in chips) 
Seat 2: Enoffllescini ($2 in chips) 
Seat 3: Sinad1302 ($3.84 in chips) 
Seat 4: z3317111711 ($3.62 in chips) 
Seat 5: lucksuckdonk ($3.92 in chips) 
Seat 6: RrriotGrrrl ($9.36 in chips) 
Enoffllescini: posts small blind $0.01
Sinad1302: posts big blind $0.02
*** HOLE CARDS ***
Dealt to Scaaalll [Qh 8d]
z3317111711: folds 
lucksuckdonk: folds 
RrriotGrrrl: folds 
Scaaalll: raises $0.02 to $0.04
Enoffllescini: folds 
Sinad1302: calls $0.02
*** FLOP *** [9c Jc 4s]
Sinad1302: checks 
Scaaalll: bets $0.06
Sinad1302: raises $0.12 to $0.18
Scaaalll: folds 
Uncalled bet ($0.12) returned to Sinad1302
Sinad1302 collected $0.20 from pot
Sinad1302: doesn't show hand 
*** SUMMARY ***
Total pot $0.21 | Rake $0.01 
Board [9c Jc 4s]
Seat 1: Scaaalll (button) folded on the Flop
Seat 2: Enoffllescini (small blind) folded before Flop
Seat 3: Sinad1302 (big blind) collected ($0.20)
Seat 4: z3317111711 folded before Flop (didn't bet)
Seat 5: lucksuckdonk folded before Flop (didn't bet)
Seat 6: RrriotGrrrl folded before Flop (didn't bet)



PokerStars Zoom Hand #229231881414:  Hold'em No Limit ($0.01/$0.02) - 2021/08/21 22:30:18 CET [2021/08/21 16:30:18 ET]
Table 'Halley' 6-max Seat #1 is the button
Seat 1: fishh_play ($3.95 in chips) 
Seat 2: h3cTics ($0.84 in chips) 
Seat 3: RaulacateFolds ($2.52 in chips) 
Seat 4: Scaaalll ($2.10 in chips) 
Seat 5: EevAA190 ($2.97 in chips) 
Seat 6: Russian MA ($3.37 in chips) 
h3cTics: posts small blind $0.01
RaulacateFolds: posts big blind $0.02
*** HOLE CARDS ***
Dealt to Scaaalll [Jd 2c]
Scaaalll: folds 
EevAA190: folds 
Russian MA: folds 
Russian MA is disconnected 
fishh_play: raises $0.03 to $0.05
h3cTics: folds 
RaulacateFolds: calls $0.03
*** FLOP *** [6c 5s 8s]
RaulacateFolds: checks 
fishh_play: bets $0.06
RaulacateFolds: calls $0.06
*** TURN *** [6c 5s 8s] [Qc]
RaulacateFolds: checks 
fishh_play: checks 
*** RIVER *** [6c 5s 8s Qc] [9s]
RaulacateFolds: checks 
fishh_play: bets $0.18
RaulacateFolds: folds 
Uncalled bet ($0.18) returned to fishh_play
fishh_play collected $0.22 from pot
fishh_play: doesn't show hand 
*** SUMMARY ***
Total pot $0.23 | Rake $0.01 
Board [6c 5s 8s Qc 9s]
Seat 1: fishh_play (button) collected ($0.22)
Seat 2: h3cTics (small blind) folded before Flop
Seat 3: RaulacateFolds (big blind) folded on the River
Seat 4: Scaaalll folded before Flop (didn't bet)
Seat 5: EevAA190 folded before Flop (didn't bet)
Seat 6: Russian MA folded before Flop (didn't bet)



PokerStars Zoom Hand #229231899774:  Hold'em No Limit ($0.01/$0.02) - 2021/08/21 22:30:59 CET [2021/08/21 16:30:59 ET]
Table 'Halley' 6-max Seat #1 is the button
Seat 1: Enoffllescini ($2 in chips) 
Seat 2: EdwardF95 ($2.25 in chips) 
Seat 3: sima4ev ($2.49 in chips) 
Seat 4: ded serch ($2 in chips) 
Seat 5: Rafaxn ($2.08 in chips) 
Seat 6: Scaaalll ($2 in chips) 
EdwardF95: posts small blind $0.01
sima4ev: posts big blind $0.02
*** HOLE CARDS ***
Dealt to Scaaalll [Th Tc]
ded serch: folds 
Rafaxn: folds 
Scaaalll: raises $0.04 to $0.06
Enoffllescini: folds 
EdwardF95: folds 
sima4ev: calls $0.04
*** FLOP *** [3d 6s Ts]
sima4ev: checks 
Scaaalll: bets $0.09
sima4ev: folds 
Uncalled bet ($0.09) returned to Scaaalll
Scaaalll collected $0.13 from pot
Scaaalll: doesn't show hand 
sima4ev is disconnected 
*** SUMMARY ***
Total pot $0.13 | Rake $0 
Board [3d 6s Ts]
Seat 1: Enoffllescini (button) folded before Flop (didn't bet)
Seat 2: EdwardF95 (small blind) folded before Flop
Seat 3: sima4ev (big blind) folded on the Flop
Seat 4: ded serch folded before Flop (didn't bet)
Seat 5: Rafaxn folded before Flop (didn't bet)
Seat 6: Scaaalll collected ($0.13)



PokerStars Zoom Hand #229231913642:  Hold'em No Limit ($0.01/$0.02) - 2021/08/21 22:31:30 CET [2021/08/21 16:31:30 ET]
Table 'Halley' 6-max Seat #1 is the button
Seat 1: moshniy1976 ($1.34 in chips) 
Seat 2: csmall14 ($2.11 in chips) 
Seat 3: Scaaalll ($2.07 in chips) 
Seat 4: Luk Hander ($1.63 in chips) 
Seat 5: Stryda00 ($2 in chips) 
Seat 6: Mikeloko182 ($2.04 in chips) 
csmall14: posts small blind $0.01
Scaaalll: posts big blind $0.02
*** HOLE CARDS ***
Dealt to Scaaalll [4s 8h]
Luk Hander: folds 
moshniy1976 is disconnected 
Stryda00: raises $0.04 to $0.06
Mikeloko182: folds 
moshniy1976: folds 
csmall14: folds 
Scaaalll: folds 
Uncalled bet ($0.04) returned to Stryda00
Stryda00 collected $0.05 from pot
Stryda00: doesn't show hand 
*** SUMMARY ***
Total pot $0.05 | Rake $0 
Seat 1: moshniy1976 (button) folded before Flop (didn't bet)
Seat 2: csmall14 (small blind) folded before Flop
Seat 3: Scaaalll (big blind) folded before Flop
Seat 4: Luk Hander folded before Flop (didn't bet)
Seat 5: Stryda00 collected ($0.05)
Seat 6: Mikeloko182 folded before Flop (didn't bet)



PokerStars Zoom Hand #229231928659:  Hold'em No Limit ($0.01/$0.02) - 2021/08/21 22:32:03 CET [2021/08/21 16:32:03 ET]
Table 'Halley' 6-max Seat #1 is the button
Seat 1: Scaaalll ($2.04 in chips) 
Seat 2: Pechorin.G ($2 in chips) 
Seat 3: TomoKondo ($2.18 in chips) 
Seat 4: Tacojesuscrisp ($2.43 in chips) 
Seat 5: stealth_ua ($2 in chips) 
Seat 6: WithMyWalker ($3.60 in chips) 
Pechorin.G: posts small blind $0.01
TomoKondo: posts big blind $0.02
*** HOLE CARDS ***
Dealt to Scaaalll [8s Qs]
Tacojesuscrisp: folds 
stealth_ua: folds 
WithMyWalker: folds 
Scaaalll: raises $0.02 to $0.04
Pechorin.G: folds 
TomoKondo: folds 
Uncalled bet ($0.02) returned to Scaaalll
Scaaalll collected $0.05 from pot
Scaaalll: doesn't show hand 
*** SUMMARY ***
Total pot $0.05 | Rake $0 
Seat 1: Scaaalll (button) collected ($0.05)
Seat 2: Pechorin.G (small blind) folded before Flop
Seat 3: TomoKondo (big blind) folded before Flop
Seat 4: Tacojesuscrisp folded before Flop (didn't bet)
Seat 5: stealth_ua folded before Flop (didn't bet)
Seat 6: WithMyWalker folded before Flop (didn't bet)



PokerStars Zoom Hand #229231919907:  Hold'em No Limit ($0.01/$0.02) - 2021/08/21 22:31:44 CET [2021/08/21 16:31:44 ET]
Table 'Halley' 6-max Seat #1 is the button
Seat 1: zergmiky ($2.21 in chips) 
Seat 2: Scaaalll ($2.05 in chips) 
Seat 3: VasquezSancho96 ($6.93 in chips) 
Seat 4: alecha11 ($2.44 in chips) 
Seat 5: 9zocker9 ($2.19 in chips) 
Seat 6: Peimievvt ($1.38 in chips) 
Scaaalll: posts small blind $0.01
VasquezSancho96: posts big blind $0.02
*** HOLE CARDS ***
Dealt to Scaaalll [Kd 3c]
alecha11: raises $0.03 to $0.05
9zocker9: calls $0.05
Peimievvt: raises $0.13 to $0.18
zergmiky: folds 
Scaaalll: folds 
VasquezSancho96: folds 
alecha11: calls $0.13
9zocker9: calls $0.13
*** FLOP *** [Ts 8s Kh]
alecha11: checks 
9zocker9: checks 
Peimievvt: bets $0.20
alecha11: folds 
9zocker9: folds 
Uncalled bet ($0.20) returned to Peimievvt
Peimievvt collected $0.55 from pot
Peimievvt: doesn't show hand 
*** SUMMARY ***
Total pot $0.57 | Rake $0.02 
Board [Ts 8s Kh]
Seat 1: zergmiky (button) folded before Flop (didn't bet)
Seat 2: Scaaalll (small blind) folded before Flop
Seat 3: VasquezSancho96 (big blind) folded before Flop
Seat 4: alecha11 folded on the Flop
Seat 5: 9zocker9 folded on the Flop
Seat 6: Peimievvt collected ($0.55)



PokerStars Zoom Hand #229231939276:  Hold'em No Limit ($0.01/$0.02) - 2021/08/21 22:32:27 CET [2021/08/21 16:32:27 ET]
Table 'Halley' 6-max Seat #1 is the button
Seat 1: thi_spe ($2.34 in chips) 
Seat 2: Thaleshs ($2 in chips) 
Seat 3: Yangyang1407 ($2 in chips) 
Seat 4: Scaaalll ($2.07 in chips) 
Seat 5: rpycmbEM ($0.81 in chips) 
Seat 6: Enoffllescini ($2 in chips) 
Thaleshs: posts small blind $0.01
Yangyang1407: posts big blind $0.02
*** HOLE CARDS ***
Dealt to Scaaalll [Ad 5d]
Scaaalll: folds 
rpycmbEM: folds 
Enoffllescini: folds 
thi_spe: folds 
Thaleshs: folds 
Uncalled bet ($0.01) returned to Yangyang1407
Yangyang1407 collected $0.02 from pot
Yangyang1407: doesn't show hand 
*** SUMMARY ***
Total pot $0.02 | Rake $0 
Seat 1: thi_spe (button) folded before Flop (didn't bet)
Seat 2: Thaleshs (small blind) folded before Flop
Seat 3: Yangyang1407 (big blind) collected ($0.02)
Seat 4: Scaaalll folded before Flop (didn't bet)
Seat 5: rpycmbEM folded before Flop (didn't bet)
Seat 6: Enoffllescini folded before Flop (didn't bet)



PokerStars Zoom Hand #229231937093:  Hold'em No Limit ($0.01/$0.02) - 2021/08/21 22:32:22 CET [2021/08/21 16:32:22 ET]
Table 'Halley' 6-max Seat #1 is the button
Seat 1: keb1981 ($2.49 in chips) 
Seat 2: BigTestIcicle ($3.05 in chips) 
Seat 3: Pulp Hands ($1.60 in chips) 
Seat 4: ray147741 ($1.89 in chips) 
Seat 5: Scaaalll ($2.07 in chips) 
Seat 6: Artezito ($2 in chips) 
BigTestIcicle: posts small blind $0.01
Pulp Hands: posts big blind $0.02
*** HOLE CARDS ***
Dealt to Scaaalll [Th 4c]
ray147741: calls $0.02
Scaaalll: folds 
Artezito: folds 
keb1981: folds 
BigTestIcicle: folds 
Pulp Hands: checks 
*** FLOP *** [Kd 7s 6h]
Pulp Hands: checks 
ray147741: bets $0.04
Pulp Hands: folds 
Uncalled bet ($0.04) returned to ray147741
ray147741 collected $0.05 from pot
ray147741: doesn't show hand 
*** SUMMARY ***
Total pot $0.05 | Rake $0 
Board [Kd 7s 6h]
Seat 1: keb1981 (button) folded before Flop (didn't bet)
Seat 2: BigTestIcicle (small blind) folded before Flop
Seat 3: Pulp Hands (big blind) folded on the Flop
Seat 4: ray147741 collected ($0.05)
Seat 5: Scaaalll folded before Flop (didn't bet)
Seat 6: Artezito folded before Flop (didn't bet)



PokerStars Zoom Hand #229231942046:  Hold'em No Limit ($0.01/$0.02) - 2021/08/21 22:32:33 CET [2021/08/21 16:32:33 ET]
Table 'Halley' 6-max Seat #1 is the button
Seat 1: vw2014 ($0.47 in chips) 
Seat 2: Kojak34 ($6.30 in chips) 
Seat 3: ARS_POLI13 ($1.99 in chips) 
Seat 4: estelionat171 ($1.13 in chips) 
Seat 5: xxVanquishxx ($3.63 in chips) 
Seat 6: Scaaalll ($2.07 in chips) 
Kojak34: posts small blind $0.01
ARS_POLI13: posts big blind $0.02
*** HOLE CARDS ***
Dealt to Scaaalll [5c 6d]
estelionat171: folds 
xxVanquishxx: folds 
Scaaalll: folds 
vw2014: raises $0.04 to $0.06
Kojak34: calls $0.05
ARS_POLI13: folds 
*** FLOP *** [4c Jd Jh]
Kojak34: checks 
vw2014: bets $0.07
Kojak34: calls $0.07
*** TURN *** [4c Jd Jh] [8h]
Kojak34: checks 
vw2014: checks 
*** RIVER *** [4c Jd Jh 8h] [8d]
Kojak34: bets $0.14
vw2014: folds 
Uncalled bet ($0.14) returned to Kojak34
Kojak34 collected $0.27 from pot
Kojak34: doesn't show hand 
vw2014 is disconnected 
*** SUMMARY ***
Total pot $0.28 | Rake $0.01 
Board [4c Jd Jh 8h 8d]
Seat 1: vw2014 (button) folded on the River
Seat 2: Kojak34 (small blind) collected ($0.27)
Seat 3: ARS_POLI13 (big blind) folded before Flop
Seat 4: estelionat171 folded before Flop (didn't bet)
Seat 5: xxVanquishxx folded before Flop (didn't bet)
Seat 6: Scaaalll folded before Flop (didn't bet)



PokerStars Zoom Hand #229231971384:  Hold'em No Limit ($0.01/$0.02) - 2021/08/21 22:33:38 CET [2021/08/21 16:33:38 ET]
Table 'Halley' 6-max Seat #1 is the button
Seat 1: NNGun ($1.30 in chips) 
Seat 2: Scaaalll ($2.03 in chips) 
Seat 3: willmorel ($2.41 in chips) 
Seat 4: Dulli007 ($4.94 in chips) 
Seat 5: Yangyang1407 ($2 in chips) 
Seat 6: balalaikaRUS47 ($0.78 in chips) 
Scaaalll: posts small blind $0.01
willmorel: posts big blind $0.02
*** HOLE CARDS ***
Dealt to Scaaalll [Qh Ah]
Dulli007: folds 
Yangyang1407: folds 
balalaikaRUS47: folds 
balalaikaRUS47 is disconnected 
NNGun: folds 
Scaaalll: raises $0.04 to $0.06
willmorel: folds 
Uncalled bet ($0.04) returned to Scaaalll
Scaaalll collected $0.04 from pot
Scaaalll: doesn't show hand 
*** SUMMARY ***
Total pot $0.04 | Rake $0 
Seat 1: NNGun (button) folded before Flop (didn't bet)
Seat 2: Scaaalll (small blind) collected ($0.04)
Seat 3: willmorel (big blind) folded before Flop
Seat 4: Dulli007 folded before Flop (didn't bet)
Seat 5: Yangyang1407 folded before Flop (didn't bet)
Seat 6: balalaikaRUS47 folded before Flop (didn't bet)



PokerStars Zoom Hand #229231945141:  Hold'em No Limit ($0.01/$0.02) - 2021/08/21 22:32:40 CET [2021/08/21 16:32:40 ET]
Table 'Halley' 6-max Seat #1 is the button
Seat 1: SIGREX ($2.96 in chips) 
Seat 2: Diegor1924 ($2.29 in chips) 
Seat 3: Scaaalll ($2.07 in chips) 
Seat 4: VoidEclipse ($2 in chips) 
Seat 5: h3cTics ($0.40 in chips) 
Seat 6: Kkamm ($2.11 in chips) 
Diegor1924: posts small blind $0.01
Scaaalll: posts big blind $0.02
*** HOLE CARDS ***
Dealt to Scaaalll [Js 6s]
VoidEclipse: folds 
h3cTics: calls $0.02
Kkamm: folds 
SIGREX: folds 
Diegor1924: raises $0.02 to $0.04
Scaaalll: calls $0.02
h3cTics: calls $0.02
*** FLOP *** [9c Qs Jh]
Diegor1924: checks 
Scaaalll: checks 
h3cTics: bets $0.04
Diegor1924: calls $0.04
Scaaalll: folds 
*** TURN *** [9c Qs Jh] [2h]
Diegor1924: bets $0.06
h3cTics: calls $0.06
*** RIVER *** [9c Qs Jh 2h] [4c]
Diegor1924: checks 
h3cTics: checks 
*** SHOW DOWN ***
Diegor1924: shows [Qc 8c] (a pair of Queens)
h3cTics: mucks hand 
Diegor1924 collected $0.31 from pot
*** SUMMARY ***
Total pot $0.32 | Rake $0.01 
Board [9c Qs Jh 2h 4c]
Seat 1: SIGREX (button) folded before Flop (didn't bet)
Seat 2: Diegor1924 (small blind) showed [Qc 8c] and won ($0.31) with a pair of Queens
Seat 3: Scaaalll (big blind) folded on the Flop
Seat 4: VoidEclipse folded before Flop (didn't bet)
Seat 5: h3cTics mucked [4h As]
Seat 6: Kkamm folded before Flop (didn't bet)



PokerStars Zoom Hand #229231976850:  Hold'em No Limit ($0.01/$0.02) - 2021/08/21 22:33:50 CET [2021/08/21 16:33:50 ET]
Table 'Halley' 6-max Seat #1 is the button
Seat 1: zbixxx ($4.62 in chips) 
Seat 2: Iwanb4 ($3.10 in chips) 
Seat 3: BORODA-X ($2.27 in chips) 
Seat 4: HirotoBeats ($2.09 in chips) 
Seat 5: Scaaalll ($2.05 in chips) 
Seat 6: NIK1973 23 ($2.39 in chips) 
Iwanb4: posts small blind $0.01
BORODA-X: posts big blind $0.02
*** HOLE CARDS ***
Dealt to Scaaalll [7s 5h]
HirotoBeats: folds 
Scaaalll: folds 
NIK1973 23: raises $0.04 to $0.06
zbixxx: folds 
Iwanb4: raises $0.14 to $0.20
BORODA-X: folds 
BORODA-X is disconnected 
NIK1973 23: folds 
Uncalled bet ($0.14) returned to Iwanb4
Iwanb4 collected $0.14 from pot
Iwanb4: doesn't show hand 
*** SUMMARY ***
Total pot $0.14 | Rake $0 
Seat 1: zbixxx (button) folded before Flop (didn't bet)
Seat 2: Iwanb4 (small blind) collected ($0.14)
Seat 3: BORODA-X (big blind) folded before Flop
Seat 4: HirotoBeats folded before Flop (didn't bet)
Seat 5: Scaaalll folded before Flop (didn't bet)
Seat 6: NIK1973 23 folded before Flop



PokerStars Zoom Hand #229231979922:  Hold'em No Limit ($0.01/$0.02) - 2021/08/21 22:33:57 CET [2021/08/21 16:33:57 ET]
Table 'Halley' 6-max Seat #1 is the button
Seat 1: Scaaalll ($2.05 in chips) 
Seat 2: olcham7 ($2 in chips) 
Seat 3: Laonikos ($8.39 in chips) 
Seat 4: KonopDima ($2.53 in chips) 
Seat 5: Kkamm ($2.16 in chips) 
Seat 6: HubertFroh ($4.26 in chips) 
olcham7: posts small blind $0.01
Laonikos: posts big blind $0.02
*** HOLE CARDS ***
Dealt to Scaaalll [7h 2d]
KonopDima: folds 
Kkamm: folds 
HubertFroh: folds 
Scaaalll: folds 
olcham7: folds 
Uncalled bet ($0.01) returned to Laonikos
Laonikos collected $0.02 from pot
Laonikos: doesn't show hand 
*** SUMMARY ***
Total pot $0.02 | Rake $0 
Seat 1: Scaaalll (button) folded before Flop (didn't bet)
Seat 2: olcham7 (small blind) folded before Flop
Seat 3: Laonikos (big blind) collected ($0.02)
Seat 4: KonopDima folded before Flop (didn't bet)
Seat 5: Kkamm folded before Flop (didn't bet)
Seat 6: HubertFroh folded before Flop (didn't bet)



PokerStars Zoom Hand #229231969121:  Hold'em No Limit ($0.01/$0.02) - 2021/08/21 22:33:33 CET [2021/08/21 16:33:33 ET]
Table 'Halley' 6-max Seat #1 is the button
Seat 1: elmex886 ($2.59 in chips) 
Seat 2: Bufre ($3.39 in chips) 
Seat 3: 77omsk ($11.49 in chips) 
Seat 4: NOLUWDtC ($2.11 in chips) 
Seat 5: Ogni ($4.68 in chips) 
Seat 6: Scaaalll ($2.03 in chips) 
Bufre: posts small blind $0.01
77omsk: posts big blind $0.02
*** HOLE CARDS ***
Dealt to Scaaalll [7d Jc]
NOLUWDtC has timed out
NOLUWDtC: folds 
Ogni: folds 
Scaaalll: folds 
elmex886: folds 
NOLUWDtC is disconnected 
Bufre: raises $0.03 to $0.05
77omsk: calls $0.03
*** FLOP *** [9d 6c 7s]
Bufre: bets $0.08
77omsk: calls $0.08
*** TURN *** [9d 6c 7s] [3d]
Bufre: bets $0.20
77omsk: calls $0.20
*** RIVER *** [9d 6c 7s 3d] [6s]
Bufre: bets $0.50
77omsk: raises $1.64 to $2.14
Bufre: calls $1.64
*** SHOW DOWN ***
77omsk: shows [9c 9s] (a full house, Nines full of Sixes)
Bufre: mucks hand 
77omsk collected $4.77 from pot
*** SUMMARY ***
Total pot $4.94 | Rake $0.17 
Board [9d 6c 7s 3d 6s]
Seat 1: elmex886 (button) folded before Flop (didn't bet)
Seat 2: Bufre (small blind) mucked [As Ad]
Seat 3: 77omsk (big blind) showed [9c 9s] and won ($4.77) with a full house, Nines full of Sixes
Seat 4: NOLUWDtC folded before Flop (didn't bet)
Seat 5: Ogni folded before Flop (didn't bet)
Seat 6: Scaaalll folded before Flop (didn't bet)



PokerStars Zoom Hand #229231986297:  Hold'em No Limit ($0.01/$0.02) - 2021/08/21 22:34:11 CET [2021/08/21 16:34:11 ET]
Table 'Halley' 6-max Seat #1 is the button
Seat 1: Kreodont1987 ($2.21 in chips) 
Seat 2: Gamer577 ($2 in chips) 
Seat 3: VasquezSancho96 ($6.11 in chips) 
Seat 4: davidalejag ($3.68 in chips) 
Seat 5: Scaaalll ($2.05 in chips) 
Seat 6: Stryda00 ($2.11 in chips) 
Gamer577: posts small blind $0.01
VasquezSancho96: posts big blind $0.02
*** HOLE CARDS ***
Dealt to Scaaalll [8c Js]
davidalejag: folds 
Scaaalll: folds 
Stryda00: folds 
Kreodont1987: folds 
Gamer577: folds 
Uncalled bet ($0.01) returned to VasquezSancho96
VasquezSancho96 collected $0.02 from pot
VasquezSancho96: doesn't show hand 
*** SUMMARY ***
Total pot $0.02 | Rake $0 
Seat 1: Kreodont1987 (button) folded before Flop (didn't bet)
Seat 2: Gamer577 (small blind) folded before Flop
Seat 3: VasquezSancho96 (big blind) collected ($0.02)
Seat 4: davidalejag folded before Flop (didn't bet)
Seat 5: Scaaalll folded before Flop (didn't bet)
Seat 6: Stryda00 folded before Flop (didn't bet)



PokerStars Zoom Hand #229231992946:  Hold'em No Limit ($0.01/$0.02) - 2021/08/21 22:34:26 CET [2021/08/21 16:34:26 ET]
Table 'Halley' 6-max Seat #1 is the button
Seat 1: Ramirres ($2 in chips) 
Seat 2: alecha11 ($2 in chips) 
Seat 3: Scaaalll ($2.04 in chips) 
Seat 4: Artezito ($2 in chips) 
Seat 5: Enoffllescini ($2.33 in chips) 
Seat 6: cultuurpaus ($0.68 in chips) 
alecha11: posts small blind $0.01
Scaaalll: posts big blind $0.02
*** HOLE CARDS ***
Dealt to Scaaalll [Ad Kh]
Artezito: folds 
Enoffllescini: folds 
cultuurpaus: raises $0.02 to $0.04
Ramirres: folds 
alecha11: folds 
Scaaalll: raises $0.12 to $0.16
cultuurpaus: calls $0.12
*** FLOP *** [Kd 9c 9s]
Scaaalll: checks 
cultuurpaus: bets $0.52 and is all-in
Scaaalll: calls $0.52
*** TURN *** [Kd 9c 9s] [9d]
*** RIVER *** [Kd 9c 9s 9d] [4s]
*** SHOW DOWN ***
Scaaalll: shows [Ad Kh] (a full house, Nines full of Kings)
cultuurpaus: shows [Ks Qh] (a full house, Nines full of Kings)
Scaaalll collected $0.65 from pot
cultuurpaus collected $0.66 from pot
*** SUMMARY ***
Total pot $1.37 | Rake $0.06 
Board [Kd 9c 9s 9d 4s]
Seat 1: Ramirres (button) folded before Flop (didn't bet)
Seat 2: alecha11 (small blind) folded before Flop
Seat 3: Scaaalll (big blind) showed [Ad Kh] and won ($0.65) with a full house, Nines full of Kings
Seat 4: Artezito folded before Flop (didn't bet)
Seat 5: Enoffllescini folded before Flop (didn't bet)
Seat 6: cultuurpaus showed [Ks Qh] and won ($0.66) with a full house, Nines full of Kings



PokerStars Zoom Hand #229231989417:  Hold'em No Limit ($0.01/$0.02) - 2021/08/21 22:34:18 CET [2021/08/21 16:34:18 ET]
Table 'Halley' 6-max Seat #1 is the button
Seat 1: xxVanquishxx ($3.86 in chips) 
Seat 2: Scaaalll ($2.05 in chips) 
Seat 3: Fedor_Gar ($3.78 in chips) 
Seat 4: shingo594 ($4.25 in chips) 
Seat 5: Ne0net ($2.39 in chips) 
Seat 6: LuckyCheewey ($11.13 in chips) 
Scaaalll: posts small blind $0.01
Fedor_Gar: posts big blind $0.02
*** HOLE CARDS ***
Dealt to Scaaalll [4s 5d]
shingo594: folds 
shingo594 is disconnected 
Ne0net: raises $0.04 to $0.06
LuckyCheewey: folds 
xxVanquishxx: calls $0.06
Scaaalll: folds 
Fedor_Gar: folds 
*** FLOP *** [7s Jh 9c]
Ne0net: bets $0.07
xxVanquishxx: raises $0.09 to $0.16
Ne0net: calls $0.09
*** TURN *** [7s Jh 9c] [9h]
Ne0net: checks 
xxVanquishxx: bets $0.24
Ne0net: calls $0.24
*** RIVER *** [7s Jh 9c 9h] [3d]
Ne0net: checks 
xxVanquishxx: bets $0.50
Ne0net: calls $0.50
*** SHOW DOWN ***
xxVanquishxx: shows [8h Th] (a straight, Seven to Jack)
Ne0net: mucks hand 
xxVanquishxx collected $1.86 from pot
*** SUMMARY ***
Total pot $1.95 | Rake $0.09 
Board [7s Jh 9c 9h 3d]
Seat 1: xxVanquishxx (button) showed [8h Th] and won ($1.86) with a straight, Seven to Jack
Seat 2: Scaaalll (small blind) folded before Flop
Seat 3: Fedor_Gar (big blind) folded before Flop
Seat 4: shingo594 folded before Flop (didn't bet)
Seat 5: Ne0net mucked [Jc Kc]
Seat 6: LuckyCheewey folded before Flop (didn't bet)



PokerStars Zoom Hand #229232008967:  Hold'em No Limit ($0.01/$0.02) - 2021/08/21 22:35:02 CET [2021/08/21 16:35:02 ET]
Table 'Halley' 6-max Seat #1 is the button
Seat 1: Yangyang1407 ($2 in chips) 
Seat 2: Umnik_M ($2.03 in chips) 
Seat 3: arturtsutsaev ($1.04 in chips) 
Seat 4: tomsa01 ($1.58 in chips) 
Seat 5: boa juice ($1.82 in chips) 
Seat 6: Scaaalll ($2.01 in chips) 
Umnik_M: posts small blind $0.01
arturtsutsaev: posts big blind $0.02
*** HOLE CARDS ***
Dealt to Scaaalll [Ks 8s]
tomsa01: raises $0.05 to $0.07
arturtsutsaev is disconnected 
boa juice: calls $0.07
Scaaalll: folds 
Yangyang1407: folds 
Umnik_M: folds 
arturtsutsaev: folds 
*** FLOP *** [6h Kc Qh]
tomsa01: bets $0.06
boa juice: folds 
Uncalled bet ($0.06) returned to tomsa01
tomsa01 collected $0.16 from pot
tomsa01: doesn't show hand 
boa juice is disconnected 
*** SUMMARY ***
Total pot $0.17 | Rake $0.01 
Board [6h Kc Qh]
Seat 1: Yangyang1407 (button) folded before Flop (didn't bet)
Seat 2: Umnik_M (small blind) folded before Flop
Seat 3: arturtsutsaev (big blind) folded before Flop
Seat 4: tomsa01 collected ($0.16)
Seat 5: boa juice folded on the Flop
Seat 6: Scaaalll folded before Flop (didn't bet)



PokerStars Zoom Hand #229232013805:  Hold'em No Limit ($0.01/$0.02) - 2021/08/21 22:35:13 CET [2021/08/21 16:35:13 ET]
Table 'Halley' 6-max Seat #1 is the button
Seat 1: tazar34_777 ($5.60 in chips) 
Seat 2: zaharoff74 ($2.82 in chips) 
Seat 3: EdwardF95 ($2.16 in chips) 
Seat 4: Scaaalll ($2.01 in chips) 
Seat 5: homka45 ($1.68 in chips) 
Seat 6: Maennlich 40 ($1.14 in chips) 
zaharoff74: posts small blind $0.01
EdwardF95: posts big blind $0.02
*** HOLE CARDS ***
Dealt to Scaaalll [4c 4h]
Scaaalll: raises $0.04 to $0.06
homka45: folds 
Maennlich 40: folds 
tazar34_777: folds 
zaharoff74: folds 
EdwardF95: calls $0.04
*** FLOP *** [Qc Kh Ks]
EdwardF95: checks 
Scaaalll: checks 
*** TURN *** [Qc Kh Ks] [Kc]
EdwardF95: checks 
Scaaalll: bets $0.07
EdwardF95: folds 
Uncalled bet ($0.07) returned to Scaaalll
Scaaalll collected $0.13 from pot
Scaaalll: doesn't show hand 
*** SUMMARY ***
Total pot $0.13 | Rake $0 
Board [Qc Kh Ks Kc]
Seat 1: tazar34_777 (button) folded before Flop (didn't bet)
Seat 2: zaharoff74 (small blind) folded before Flop
Seat 3: EdwardF95 (big blind) folded on the Turn
Seat 4: Scaaalll collected ($0.13)
Seat 5: homka45 folded before Flop (didn't bet)
Seat 6: Maennlich 40 folded before Flop (didn't bet)



PokerStars Zoom Hand #229232025471:  Hold'em No Limit ($0.01/$0.02) - 2021/08/21 22:35:39 CET [2021/08/21 16:35:39 ET]
Table 'Halley' 6-max Seat #1 is the button
Seat 1: Scaaalll ($2.08 in chips) 
Seat 2: xxVanquishxx ($4.74 in chips) 
Seat 3: Marcus579 ($2.46 in chips) 
Seat 4: sg.32rus ($0.13 in chips) 
Seat 5: FCSF.Angel ($1.63 in chips) 
Seat 6: fishh_play ($5.40 in chips) 
xxVanquishxx: posts small blind $0.01
Marcus579: posts big blind $0.02
*** HOLE CARDS ***
Dealt to Scaaalll [Ad As]
sg.32rus: calls $0.02
FCSF.Angel: folds 
fishh_play: calls $0.02
Scaaalll: raises $0.08 to $0.10
xxVanquishxx: folds 
Marcus579: folds 
sg.32rus: raises $0.03 to $0.13 and is all-in
fishh_play: calls $0.11
Scaaalll: calls $0.03
*** FLOP *** [9d 5d 6h]
fishh_play: checks 
Scaaalll: bets $0.18
fishh_play: folds 
Uncalled bet ($0.18) returned to Scaaalll
*** TURN *** [9d 5d 6h] [9c]
*** RIVER *** [9d 5d 6h 9c] [6s]
*** SHOW DOWN ***
sg.32rus: shows [Qd Th] (two pair, Nines and Sixes)
Scaaalll: shows [Ad As] (two pair, Aces and Nines)
Scaaalll collected $0.41 from pot
*** SUMMARY ***
Total pot $0.42 | Rake $0.01 
Board [9d 5d 6h 9c 6s]
Seat 1: Scaaalll (button) showed [Ad As] and won ($0.41) with two pair, Aces and Nines
Seat 2: xxVanquishxx (small blind) folded before Flop
Seat 3: Marcus579 (big blind) folded before Flop
Seat 4: sg.32rus showed [Qd Th] and lost with two pair, Nines and Sixes
Seat 5: FCSF.Angel folded before Flop (didn't bet)
Seat 6: fishh_play folded on the Flop



PokerStars Zoom Hand #229232041568:  Hold'em No Limit ($0.01/$0.02) - 2021/08/21 22:36:15 CET [2021/08/21 16:36:15 ET]
Table 'Halley' 6-max Seat #1 is the button
Seat 1: RrriotGrrrl ($9.63 in chips) 
Seat 2: Mad_Clock ($2.46 in chips) 
Seat 3: EmperorKurr ($3.05 in chips) 
Seat 4: Scaaalll ($2.36 in chips) 
Seat 5: Posaunengodi ($2 in chips) 
Seat 6: Dr.stromg ($2.39 in chips) 
Mad_Clock: posts small blind $0.01
EmperorKurr: posts big blind $0.02
*** HOLE CARDS ***
Dealt to Scaaalll [4d 2h]
Scaaalll: folds 
Posaunengodi: folds 
Dr.stromg: folds 
RrriotGrrrl: folds 
Mad_Clock: folds 
Uncalled bet ($0.01) returned to EmperorKurr
EmperorKurr collected $0.02 from pot
EmperorKurr: doesn't show hand 
*** SUMMARY ***
Total pot $0.02 | Rake $0 
Seat 1: RrriotGrrrl (button) folded before Flop (didn't bet)
Seat 2: Mad_Clock (small blind) folded before Flop
Seat 3: EmperorKurr (big blind) collected ($0.02)
Seat 4: Scaaalll folded before Flop (didn't bet)
Seat 5: Posaunengodi folded before Flop (didn't bet)
Seat 6: Dr.stromg folded before Flop (didn't bet)



PokerStars Zoom Hand #229232044182:  Hold'em No Limit ($0.01/$0.02) - 2021/08/21 22:36:21 CET [2021/08/21 16:36:21 ET]
Table 'Halley' 6-max Seat #1 is the button
Seat 1: rodrigovini ($2.01 in chips) 
Seat 2: Scaaalll ($2.36 in chips) 
Seat 3: krowio ($2 in chips) 
Seat 4: guntren.ps ($2.28 in chips) 
Seat 5: gilberto98 ($1.97 in chips) 
Seat 6: Ck@tih@ ($1.87 in chips) 
Scaaalll: posts small blind $0.01
krowio: posts big blind $0.02
*** HOLE CARDS ***
Dealt to Scaaalll [Kc Ks]
guntren.ps: folds 
gilberto98: folds 
Ck@tih@: folds 
rodrigovini: folds 
Scaaalll: raises $0.04 to $0.06
krowio: folds 
Uncalled bet ($0.04) returned to Scaaalll
Scaaalll collected $0.04 from pot
Scaaalll: doesn't show hand 
*** SUMMARY ***
Total pot $0.04 | Rake $0 
Seat 1: rodrigovini (button) folded before Flop (didn't bet)
Seat 2: Scaaalll (small blind) collected ($0.04)
Seat 3: krowio (big blind) folded before Flop
Seat 4: guntren.ps folded before Flop (didn't bet)
Seat 5: gilberto98 folded before Flop (didn't bet)
Seat 6: Ck@tih@ folded before Flop (didn't bet)



PokerStars Zoom Hand #229232058182:  Hold'em No Limit ($0.01/$0.02) - 2021/08/21 22:36:52 CET [2021/08/21 16:36:52 ET]
Table 'Halley' 6-max Seat #1 is the button
Seat 1: Scaaalll ($2.38 in chips) 
Seat 2: Agno$tic ($3.37 in chips) 
Seat 3: martoniv ($3.14 in chips) 
Seat 4: 365p2eva ($5.36 in chips) 
Seat 5: Osetrov.A.A ($1.96 in chips) 
Seat 6: The-End-snglr ($0.20 in chips) 
Agno$tic: posts small blind $0.01
martoniv: posts big blind $0.02
*** HOLE CARDS ***
Dealt to Scaaalll [7s Jh]
365p2eva: folds 
Osetrov.A.A: folds 
The-End-snglr: folds 
Scaaalll: raises $0.02 to $0.04
Agno$tic: folds 
martoniv: folds 
Uncalled bet ($0.02) returned to Scaaalll
Scaaalll collected $0.05 from pot
Scaaalll: doesn't show hand 
*** SUMMARY ***
Total pot $0.05 | Rake $0 
Seat 1: Scaaalll (button) collected ($0.05)
Seat 2: Agno$tic (small blind) folded before Flop
Seat 3: martoniv (big blind) folded before Flop
Seat 4: 365p2eva folded before Flop (didn't bet)
Seat 5: Osetrov.A.A folded before Flop (didn't bet)
Seat 6: The-End-snglr folded before Flop (didn't bet)



PokerStars Zoom Hand #229232068921:  Hold'em No Limit ($0.01/$0.02) - 2021/08/21 22:37:16 CET [2021/08/21 16:37:16 ET]
Table 'Halley' 6-max Seat #1 is the button
Seat 1: guntren.ps ($2.15 in chips) 
Seat 2: zbixxx ($9.09 in chips) 
Seat 3: Scaaalll ($2.41 in chips) 
Seat 4: LuckyCheewey ($11.02 in chips) 
Seat 5: NecromiconP ($3.29 in chips) 
Seat 6: feybys ($1.90 in chips) 
zbixxx: posts small blind $0.01
Scaaalll: posts big blind $0.02
*** HOLE CARDS ***
Dealt to Scaaalll [5d Ks]
LuckyCheewey: folds 
NecromiconP: folds 
feybys: folds 
guntren.ps: folds 
zbixxx: folds 
Uncalled bet ($0.01) returned to Scaaalll
Scaaalll collected $0.02 from pot
Scaaalll: doesn't show hand 
*** SUMMARY ***
Total pot $0.02 | Rake $0 
Seat 1: guntren.ps (button) folded before Flop (didn't bet)
Seat 2: zbixxx (small blind) folded before Flop
Seat 3: Scaaalll (big blind) collected ($0.02)
Seat 4: LuckyCheewey folded before Flop (didn't bet)
Seat 5: NecromiconP folded before Flop (didn't bet)
Seat 6: feybys folded before Flop (didn't bet)



PokerStars Zoom Hand #229232066652:  Hold'em No Limit ($0.01/$0.02) - 2021/08/21 22:37:11 CET [2021/08/21 16:37:11 ET]
Table 'Halley' 6-max Seat #1 is the button
Seat 1: SIGREX ($2.50 in chips) 
Seat 2: znak312 ($2.03 in chips) 
Seat 3: thi_spe ($2.52 in chips) 
Seat 4: Gabr Ribeiro ($1.84 in chips) 
Seat 5: alphabeta1d ($2 in chips) 
Seat 6: Scaaalll ($2.41 in chips) 
znak312: posts small blind $0.01
thi_spe: posts big blind $0.02
*** HOLE CARDS ***
Dealt to Scaaalll [6h 4d]
Gabr Ribeiro: raises $0.03 to $0.05
alphabeta1d: folds 
Scaaalll: folds 
SIGREX: raises $0.10 to $0.15
znak312: raises $0.37 to $0.52
thi_spe: folds 
Gabr Ribeiro: folds 
SIGREX: folds 
Uncalled bet ($0.37) returned to znak312
znak312 collected $0.37 from pot
znak312: doesn't show hand 
*** SUMMARY ***
Total pot $0.37 | Rake $0 
Seat 1: SIGREX (button) folded before Flop
Seat 2: znak312 (small blind) collected ($0.37)
Seat 3: thi_spe (big blind) folded before Flop
Seat 4: Gabr Ribeiro folded before Flop
Seat 5: alphabeta1d folded before Flop (didn't bet)
Seat 6: Scaaalll folded before Flop (didn't bet)



PokerStars Zoom Hand #229232075111:  Hold'em No Limit ($0.01/$0.02) - 2021/08/21 22:37:30 CET [2021/08/21 16:37:30 ET]
Table 'Halley' 6-max Seat #1 is the button
Seat 1: Finderra ($1.90 in chips) 
Seat 2: EdwardF95 ($2.10 in chips) 
Seat 3: pipecmolodec ($2.04 in chips) 
Seat 4: EmperorKurr ($2.98 in chips) 
Seat 5: Scaaalll ($2.42 in chips) 
Seat 6: Earl_greyPL ($1.08 in chips) 
EdwardF95: posts small blind $0.01
pipecmolodec: posts big blind $0.02
*** HOLE CARDS ***
Dealt to Scaaalll [9h 7h]
EmperorKurr: raises $0.04 to $0.06
Scaaalll: folds 
Earl_greyPL: folds 
Finderra: folds 
EdwardF95: folds 
pipecmolodec: folds 
Uncalled bet ($0.04) returned to EmperorKurr
EmperorKurr collected $0.05 from pot
EmperorKurr: doesn't show hand 
*** SUMMARY ***
Total pot $0.05 | Rake $0 
Seat 1: Finderra (button) folded before Flop (didn't bet)
Seat 2: EdwardF95 (small blind) folded before Flop
Seat 3: pipecmolodec (big blind) folded before Flop
Seat 4: EmperorKurr collected ($0.05)
Seat 5: Scaaalll folded before Flop (didn't bet)
Seat 6: Earl_greyPL folded before Flop (didn't bet)



PokerStars Zoom Hand #229232077761:  Hold'em No Limit ($0.01/$0.02) - 2021/08/21 22:37:36 CET [2021/08/21 16:37:36 ET]
Table 'Halley' 6-max Seat #1 is the button
Seat 1: SIGREX ($2.91 in chips) 
Seat 2: Chapaev136 ($2.68 in chips) 
Seat 3: Pampusel ($2 in chips) 
Seat 4: Phoenixxxxxxxx ($2 in chips) 
Seat 5: Scaaalll ($2.42 in chips) 
Seat 6: yannikdaehne ($6.65 in chips) 
Chapaev136: posts small blind $0.01
Pampusel: posts big blind $0.02
*** HOLE CARDS ***
Dealt to Scaaalll [4c 2s]
Phoenixxxxxxxx: folds 
Scaaalll: folds 
yannikdaehne: folds 
SIGREX: raises $0.02 to $0.04
Chapaev136: folds 
Pampusel: calls $0.02
*** FLOP *** [Ad 4h 6h]
Pampusel: checks 
SIGREX: bets $0.14
Pampusel: calls $0.14
*** TURN *** [Ad 4h 6h] [5s]
Pampusel: checks 
SIGREX: checks 
*** RIVER *** [Ad 4h 6h 5s] [Kd]
Pampusel: checks 
SIGREX: checks 
*** SHOW DOWN ***
Pampusel: shows [3d 5h] (a pair of Fives)
SIGREX: mucks hand 
Pampusel collected $0.36 from pot
*** SUMMARY ***
Total pot $0.37 | Rake $0.01 
Board [Ad 4h 6h 5s Kd]
Seat 1: SIGREX (button) mucked [Jh 9h]
Seat 2: Chapaev136 (small blind) folded before Flop
Seat 3: Pampusel (big blind) showed [3d 5h] and won ($0.36) with a pair of Fives
Seat 4: Phoenixxxxxxxx folded before Flop (didn't bet)
Seat 5: Scaaalll folded before Flop (didn't bet)
Seat 6: yannikdaehne folded before Flop (didn't bet)



PokerStars Zoom Hand #229232087171:  Hold'em No Limit ($0.01/$0.02) - 2021/08/21 22:37:57 CET [2021/08/21 16:37:57 ET]
Table 'Halley' 6-max Seat #1 is the button
Seat 1: Gamer577 ($2 in chips) 
Seat 2: ser313131 ($6.03 in chips) 
Seat 3: Scaaalll ($2.41 in chips) 
Seat 4: pescador2 ($0.55 in chips) 
Seat 5: rodrigovini ($2.29 in chips) 
Seat 6: Got_BrownMagic ($1.97 in chips) 
ser313131: posts small blind $0.01
Scaaalll: posts big blind $0.02
*** HOLE CARDS ***
Dealt to Scaaalll [Ks Kc]
pescador2: calls $0.02
rodrigovini: folds 
Got_BrownMagic: folds 
Gamer577: folds 
ser313131: folds 
Scaaalll: raises $0.06 to $0.08
pescador2: calls $0.06
*** FLOP *** [5c 9h As]
Scaaalll: checks 
pescador2: checks 
*** TURN *** [5c 9h As] [Qh]
Scaaalll: checks 
pescador2: checks 
*** RIVER *** [5c 9h As Qh] [7h]
Scaaalll: bets $0.11
pescador2: folds 
Uncalled bet ($0.11) returned to Scaaalll
Scaaalll collected $0.16 from pot
Scaaalll: doesn't show hand 
pescador2 is disconnected 
*** SUMMARY ***
Total pot $0.17 | Rake $0.01 
Board [5c 9h As Qh 7h]
Seat 1: Gamer577 (button) folded before Flop (didn't bet)
Seat 2: ser313131 (small blind) folded before Flop
Seat 3: Scaaalll (big blind) collected ($0.16)
Seat 4: pescador2 folded on the River
Seat 5: rodrigovini folded before Flop (didn't bet)
Seat 6: Got_BrownMagic folded before Flop (didn't bet)



PokerStars Zoom Hand #229232082208:  Hold'em No Limit ($0.01/$0.02) - 2021/08/21 22:37:46 CET [2021/08/21 16:37:46 ET]
Table 'Halley' 6-max Seat #1 is the button
Seat 1: Koldun 2636 ($2.33 in chips) 
Seat 2: Scaaalll ($2.42 in chips) 
Seat 3: sergeyl01 ($0.65 in chips) 
Seat 4: lexus00174 ($1.19 in chips) 
Seat 5: IIDARKROBOTII ($2.79 in chips) 
Seat 6: geo8787891 ($2.41 in chips) 
Scaaalll: posts small blind $0.01
sergeyl01: posts big blind $0.02
*** HOLE CARDS ***
Dealt to Scaaalll [5h 6d]
lexus00174: folds 
geo8787891 is disconnected 
IIDARKROBOTII: raises $0.04 to $0.06
geo8787891: folds 
Koldun 2636: folds 
Scaaalll: folds 
sergeyl01: calls $0.04
*** FLOP *** [Kh Ts 7d]
sergeyl01: checks 
IIDARKROBOTII: bets $0.13
sergeyl01: folds 
Uncalled bet ($0.13) returned to IIDARKROBOTII
IIDARKROBOTII collected $0.13 from pot
IIDARKROBOTII: doesn't show hand 
*** SUMMARY ***
Total pot $0.13 | Rake $0 
Board [Kh Ts 7d]
Seat 1: Koldun 2636 (button) folded before Flop (didn't bet)
Seat 2: Scaaalll (small blind) folded before Flop
Seat 3: sergeyl01 (big blind) folded on the Flop
Seat 4: lexus00174 folded before Flop (didn't bet)
Seat 5: IIDARKROBOTII collected ($0.13)
Seat 6: geo8787891 folded before Flop (didn't bet)



PokerStars Zoom Hand #229232101343:  Hold'em No Limit ($0.01/$0.02) - 2021/08/21 22:38:29 CET [2021/08/21 16:38:29 ET]
Table 'Halley' 6-max Seat #1 is the button
Seat 1: Scaaalll ($2.49 in chips) 
Seat 2: EdwardF95 ($2.78 in chips) 
Seat 3: Finderra ($2.95 in chips) 
Seat 4: guntren.ps ($2.09 in chips) 
Seat 5: rodrigovini ($2.03 in chips) 
Seat 6: Hope2706 ($1.22 in chips) 
EdwardF95: posts small blind $0.01
Finderra: posts big blind $0.02
*** HOLE CARDS ***
Dealt to Scaaalll [Tc Jd]
guntren.ps: folds 
rodrigovini: folds 
Hope2706: folds 
Hope2706 is disconnected 
Scaaalll: raises $0.02 to $0.04
EdwardF95: folds 
Finderra: raises $0.14 to $0.18
Scaaalll: folds 
Uncalled bet ($0.14) returned to Finderra
Finderra collected $0.09 from pot
Finderra: doesn't show hand 
*** SUMMARY ***
Total pot $0.09 | Rake $0 
Seat 1: Scaaalll (button) folded before Flop
Seat 2: EdwardF95 (small blind) folded before Flop
Seat 3: Finderra (big blind) collected ($0.09)
Seat 4: guntren.ps folded before Flop (didn't bet)
Seat 5: rodrigovini folded before Flop (didn't bet)
Seat 6: Hope2706 folded before Flop (didn't bet)



PokerStars Zoom Hand #229232099516:  Hold'em No Limit ($0.01/$0.02) - 2021/08/21 22:38:25 CET [2021/08/21 16:38:25 ET]
Table 'Halley' 6-max Seat #1 is the button
Seat 1: zbixxx ($4.29 in chips) 
Seat 2: 48159348 ($3.63 in chips) 
Seat 3: Kkamm ($2 in chips) 
Seat 4: Scaaalll ($2.49 in chips) 
Seat 5: Koldun 2636 ($3.02 in chips) 
Seat 6: Colby1771 ($3.30 in chips) 
48159348: posts small blind $0.01
Kkamm: posts big blind $0.02
*** HOLE CARDS ***
Dealt to Scaaalll [7d 8s]
Scaaalll: folds 
Koldun 2636: folds 
Colby1771: raises $0.04 to $0.06
zbixxx: folds 
48159348: calls $0.05
Kkamm: folds 
*** FLOP *** [5h Ks Ts]
48159348: checks 
Colby1771: bets $0.10
48159348: folds 
Uncalled bet ($0.10) returned to Colby1771
Colby1771 collected $0.14 from pot
Colby1771: doesn't show hand 
*** SUMMARY ***
Total pot $0.14 | Rake $0 
Board [5h Ks Ts]
Seat 1: zbixxx (button) folded before Flop (didn't bet)
Seat 2: 48159348 (small blind) folded on the Flop
Seat 3: Kkamm (big blind) folded before Flop
Seat 4: Scaaalll folded before Flop (didn't bet)
Seat 5: Koldun 2636 folded before Flop (didn't bet)
Seat 6: Colby1771 collected ($0.14)



PokerStars Zoom Hand #229232115036:  Hold'em No Limit ($0.01/$0.02) - 2021/08/21 22:39:00 CET [2021/08/21 16:39:00 ET]
Table 'Halley' 6-max Seat #1 is the button
Seat 1: Fanatspartak ($1.25 in chips) 
Seat 2: Scaaalll ($2.45 in chips) 
Seat 3: Marcus579 ($2.67 in chips) 
Seat 4: Richaud ($2.54 in chips) 
Seat 5: znak312 ($2.23 in chips) 
Seat 6: jejmcclu ($3.73 in chips) 
Scaaalll: posts small blind $0.01
Marcus579: posts big blind $0.02
*** HOLE CARDS ***
Dealt to Scaaalll [8c Jd]
Richaud: folds 
znak312: raises $0.03 to $0.05
jejmcclu: folds 
Fanatspartak: folds 
Scaaalll: folds 
Marcus579: folds 
Uncalled bet ($0.03) returned to znak312
znak312 collected $0.05 from pot
znak312: doesn't show hand 
*** SUMMARY ***
Total pot $0.05 | Rake $0 
Seat 1: Fanatspartak (button) folded before Flop (didn't bet)
Seat 2: Scaaalll (small blind) folded before Flop
Seat 3: Marcus579 (big blind) folded before Flop
Seat 4: Richaud folded before Flop (didn't bet)
Seat 5: znak312 collected ($0.05)
Seat 6: jejmcclu folded before Flop (didn't bet)



PokerStars Zoom Hand #229232111510:  Hold'em No Limit ($0.01/$0.02) - 2021/08/21 22:38:52 CET [2021/08/21 16:38:52 ET]
Table 'Halley' 6-max Seat #1 is the button
Seat 1: Tsopan77 ($1.10 in chips) 
Seat 2: Earl_greyPL ($1.68 in chips) 
Seat 3: volt_by ($1.11 in chips) 
Seat 4: juraa14 ($2.11 in chips) 
Seat 5: Reipinguimm ($2 in chips) 
Seat 6: Scaaalll ($2.45 in chips) 
Earl_greyPL: posts small blind $0.01
volt_by: posts big blind $0.02
*** HOLE CARDS ***
Dealt to Scaaalll [3c Ac]
juraa14: raises $0.03 to $0.05
Reipinguimm: folds 
Scaaalll: folds 
Tsopan77: folds 
Earl_greyPL: folds 
volt_by: calls $0.03
*** FLOP *** [4s 3h Ts]
volt_by: checks 
juraa14: bets $0.03
volt_by: raises $0.03 to $0.06
juraa14: raises $0.07 to $0.13
volt_by: calls $0.07
*** TURN *** [4s 3h Ts] [Jc]
volt_by: checks 
juraa14: checks 
*** RIVER *** [4s 3h Ts Jc] [Kc]
volt_by: bets $0.93 and is all-in
juraa14: folds 
Uncalled bet ($0.93) returned to volt_by
volt_by collected $0.36 from pot
volt_by: doesn't show hand 
*** SUMMARY ***
Total pot $0.37 | Rake $0.01 
Board [4s 3h Ts Jc Kc]
Seat 1: Tsopan77 (button) folded before Flop (didn't bet)
Seat 2: Earl_greyPL (small blind) folded before Flop
Seat 3: volt_by (big blind) collected ($0.36)
Seat 4: juraa14 folded on the River
Seat 5: Reipinguimm folded before Flop (didn't bet)
Seat 6: Scaaalll folded before Flop (didn't bet)



PokerStars Zoom Hand #229232117696:  Hold'em No Limit ($0.01/$0.02) - 2021/08/21 22:39:06 CET [2021/08/21 16:39:06 ET]
Table 'Halley' 6-max Seat #1 is the button
Seat 1: martinob11 ($1.95 in chips) 
Seat 2: WellWell57 ($4.10 in chips) 
Seat 3: Scaaalll ($2.44 in chips) 
Seat 4: kahzura ($2.12 in chips) 
Seat 5: uniicecube ($5.56 in chips) 
Seat 6: ADWish ($1.30 in chips) 
WellWell57: posts small blind $0.01
Scaaalll: posts big blind $0.02
*** HOLE CARDS ***
Dealt to Scaaalll [4d Qh]
kahzura: folds 
uniicecube: folds 
ADWish: folds 
martinob11: folds 
WellWell57: raises $0.04 to $0.06
Scaaalll: folds 
Uncalled bet ($0.04) returned to WellWell57
WellWell57 collected $0.04 from pot
WellWell57: doesn't show hand 
*** SUMMARY ***
Total pot $0.04 | Rake $0 
Seat 1: martinob11 (button) folded before Flop (didn't bet)
Seat 2: WellWell57 (small blind) collected ($0.04)
Seat 3: Scaaalll (big blind) folded before Flop
Seat 4: kahzura folded before Flop (didn't bet)
Seat 5: uniicecube folded before Flop (didn't bet)
Seat 6: ADWish folded before Flop (didn't bet)



PokerStars Zoom Hand #229232127231:  Hold'em No Limit ($0.01/$0.02) - 2021/08/21 22:39:26 CET [2021/08/21 16:39:26 ET]
Table 'Halley' 6-max Seat #1 is the button
Seat 1: jejmcclu ($3.72 in chips) 
Seat 2: keldh ($2.77 in chips) 
Seat 3: Umnik_M ($2.03 in chips) 
Seat 4: baksu12 ($3.14 in chips) 
Seat 5: Scaaalll ($2.42 in chips) 
Seat 6: KoAlRy ($2 in chips) 
keldh: posts small blind $0.01
Umnik_M: posts big blind $0.02
*** HOLE CARDS ***
Dealt to Scaaalll [Td Ks]
baksu12: folds 
Scaaalll: folds 
KoAlRy: folds 
jejmcclu: raises $0.03 to $0.05
keldh: folds 
Umnik_M: folds 
Uncalled bet ($0.03) returned to jejmcclu
jejmcclu collected $0.05 from pot
jejmcclu: doesn't show hand 
*** SUMMARY ***
Total pot $0.05 | Rake $0 
Seat 1: jejmcclu (button) collected ($0.05)
Seat 2: keldh (small blind) folded before Flop
Seat 3: Umnik_M (big blind) folded before Flop
Seat 4: baksu12 folded before Flop (didn't bet)
Seat 5: Scaaalll folded before Flop (didn't bet)
Seat 6: KoAlRy folded before Flop (didn't bet)



PokerStars Zoom Hand #229232129443:  Hold'em No Limit ($0.01/$0.02) - 2021/08/21 22:39:31 CET [2021/08/21 16:39:31 ET]
Table 'Halley' 6-max Seat #1 is the button
Seat 1: Scaaalll ($2.42 in chips) 
Seat 2: tittenholmes ($1.98 in chips) 
Seat 3: Aces_Pik_58 ($1 in chips) 
Seat 4: Reipinguimm ($2 in chips) 
Seat 5: Phoenixxxxxxxx ($2.07 in chips) 
Seat 6: polymorhp ($2 in chips) 
tittenholmes: posts small blind $0.01
Aces_Pik_58: posts big blind $0.02
*** HOLE CARDS ***
Dealt to Scaaalll [4d 7h]
Reipinguimm: folds 
Phoenixxxxxxxx: folds 
polymorhp: folds 
Scaaalll: folds 
tittenholmes: folds 
Uncalled bet ($0.01) returned to Aces_Pik_58
Aces_Pik_58 collected $0.02 from pot
Aces_Pik_58: doesn't show hand 
*** SUMMARY ***
Total pot $0.02 | Rake $0 
Seat 1: Scaaalll (button) folded before Flop (didn't bet)
Seat 2: tittenholmes (small blind) folded before Flop
Seat 3: Aces_Pik_58 (big blind) collected ($0.02)
Seat 4: Reipinguimm folded before Flop (didn't bet)
Seat 5: Phoenixxxxxxxx folded before Flop (didn't bet)
Seat 6: polymorhp folded before Flop (didn't bet)



PokerStars Zoom Hand #229232139141:  Hold'em No Limit ($0.01/$0.02) - 2021/08/21 22:39:53 CET [2021/08/21 16:39:53 ET]
Table 'Halley' 6-max Seat #1 is the button
Seat 1: djewlz ($2.92 in chips) 
Seat 2: Dipod1991 ($1.79 in chips) 
Seat 3: rodrigoasor ($0.68 in chips) 
Seat 4: Ne0net ($6.53 in chips) 
Seat 5: Scaaalll ($2.42 in chips) 
Seat 6: plmanuelpl ($0.45 in chips) 
Dipod1991: posts small blind $0.01
rodrigoasor: posts big blind $0.02
*** HOLE CARDS ***
Dealt to Scaaalll [2d 8c]
Ne0net: folds 
Scaaalll: folds 
plmanuelpl: calls $0.02
djewlz: folds 
Dipod1991: folds 
rodrigoasor: checks 
*** FLOP *** [6d 4d As]
rodrigoasor: checks 
plmanuelpl: bets $0.43 and is all-in
rodrigoasor: calls $0.43
*** TURN *** [6d 4d As] [Ks]
*** RIVER *** [6d 4d As Ks] [Jd]
*** SHOW DOWN ***
rodrigoasor: shows [9d Ad] (a flush, Ace high)
plmanuelpl: shows [Ac Qd] (a pair of Aces)
rodrigoasor collected $0.88 from pot
plmanuelpl cashed out the hand for $0.49
*** SUMMARY ***
Total pot $0.91 | Rake $0.03 
Board [6d 4d As Ks Jd]
Seat 1: djewlz (button) folded before Flop (didn't bet)
Seat 2: Dipod1991 (small blind) folded before Flop
Seat 3: rodrigoasor (big blind) showed [9d Ad] and won ($0.88) with a flush, Ace high
Seat 4: Ne0net folded before Flop (didn't bet)
Seat 5: Scaaalll folded before Flop (didn't bet)
Seat 6: plmanuelpl showed [Ac Qd] and lost with a pair of Aces (cashed out).



PokerStars Zoom Hand #229232143912:  Hold'em No Limit ($0.01/$0.02) - 2021/08/21 22:40:04 CET [2021/08/21 16:40:04 ET]
Table 'Halley' 6-max Seat #1 is the button
Seat 1: anes.v. ($2.81 in chips) 
Seat 2: zergmiky ($2.05 in chips) 
Seat 3: Scaaalll ($2.41 in chips) 
Seat 4: Kelingor ($3.37 in chips) 
Seat 5: BigTestIcicle ($1.54 in chips) 
Seat 6: Ruslan076 ($0.97 in chips) 
zergmiky: posts small blind $0.01
Scaaalll: posts big blind $0.02
*** HOLE CARDS ***
Dealt to Scaaalll [Ad Kd]
Kelingor: folds 
BigTestIcicle: folds 
Ruslan076: calls $0.02
anes.v.: folds 
zergmiky: folds 
Scaaalll: raises $0.06 to $0.08
Ruslan076: folds 
Uncalled bet ($0.06) returned to Scaaalll
Scaaalll collected $0.05 from pot
Scaaalll: doesn't show hand 
Ruslan076 is disconnected 
*** SUMMARY ***
Total pot $0.05 | Rake $0 
Seat 1: anes.v. (button) folded before Flop (didn't bet)
Seat 2: zergmiky (small blind) folded before Flop
Seat 3: Scaaalll (big blind) collected ($0.05)
Seat 4: Kelingor folded before Flop (didn't bet)
Seat 5: BigTestIcicle folded before Flop (didn't bet)
Seat 6: Ruslan076 folded before Flop



PokerStars Zoom Hand #229232142164:  Hold'em No Limit ($0.01/$0.02) - 2021/08/21 22:40:00 CET [2021/08/21 16:40:00 ET]
Table 'Halley' 6-max Seat #1 is the button
Seat 1: Colby1771 ($3.37 in chips) 
Seat 2: Scaaalll ($2.42 in chips) 
Seat 3: zallav ($2.93 in chips) 
Seat 4: Earl_greyPL ($1.66 in chips) 
Seat 5: MATIdf365 ($2.60 in chips) 
Seat 6: zbixxx ($8.78 in chips) 
Scaaalll: posts small blind $0.01
zallav: posts big blind $0.02
*** HOLE CARDS ***
Dealt to Scaaalll [7s 3s]
Earl_greyPL: folds 
MATIdf365: folds 
zbixxx: folds 
Colby1771: raises $0.04 to $0.06
Scaaalll: folds 
zallav: calls $0.04
*** FLOP *** [8c Kd Jc]
zallav: checks 
Colby1771: bets $0.08
zallav: folds 
Uncalled bet ($0.08) returned to Colby1771
Colby1771 collected $0.13 from pot
Colby1771: doesn't show hand 
zallav is disconnected 
*** SUMMARY ***
Total pot $0.13 | Rake $0 
Board [8c Kd Jc]
Seat 1: Colby1771 (button) collected ($0.13)
Seat 2: Scaaalll (small blind) folded before Flop
Seat 3: zallav (big blind) folded on the Flop
Seat 4: Earl_greyPL folded before Flop (didn't bet)
Seat 5: MATIdf365 folded before Flop (didn't bet)
Seat 6: zbixxx folded before Flop (didn't bet)



PokerStars Zoom Hand #229232135158:  Hold'em No Limit ($0.01/$0.02) - 2021/08/21 22:39:44 CET [2021/08/21 16:39:44 ET]
Table 'Halley' 6-max Seat #1 is the button
Seat 1: Koldun 2636 ($2.30 in chips) 
Seat 2: EmperorKurr ($3.19 in chips) 
Seat 3: Healthys07 ($5.04 in chips) 
Seat 4: estelionat171 ($0.72 in chips) 
Seat 5: jribeiros ($1.94 in chips) 
Seat 6: Scaaalll ($2.42 in chips) 
EmperorKurr: posts small blind $0.01
Healthys07: posts big blind $0.02
*** HOLE CARDS ***
Dealt to Scaaalll [2s Ac]
estelionat171: raises $0.02 to $0.04
jribeiros: calls $0.04
Scaaalll: folds 
Koldun 2636: folds 
EmperorKurr: folds 
Healthys07: folds 
*** FLOP *** [Kd 2c Js]
estelionat171: checks 
jribeiros: bets $0.06
estelionat171: calls $0.06
*** TURN *** [Kd 2c Js] [5s]
estelionat171: checks 
jribeiros: checks 
*** RIVER *** [Kd 2c Js 5s] [3s]
estelionat171: bets $0.08
jribeiros: calls $0.08
*** SHOW DOWN ***
estelionat171: shows [Qd Qc] (a pair of Queens)
jribeiros: mucks hand 
estelionat171 collected $0.38 from pot
*** SUMMARY ***
Total pot $0.39 | Rake $0.01 
Board [Kd 2c Js 5s 3s]
Seat 1: Koldun 2636 (button) folded before Flop (didn't bet)
Seat 2: EmperorKurr (small blind) folded before Flop
Seat 3: Healthys07 (big blind) folded before Flop
Seat 4: estelionat171 showed [Qd Qc] and won ($0.38) with a pair of Queens
Seat 5: jribeiros mucked [4h 4c]
Seat 6: Scaaalll folded before Flop (didn't bet)



PokerStars Zoom Hand #229232152783:  Hold'em No Limit ($0.01/$0.02) - 2021/08/21 22:40:24 CET [2021/08/21 16:40:24 ET]
Table 'Halley' 6-max Seat #1 is the button
Seat 1: Scaaalll ($2.44 in chips) 
Seat 2: guntren.ps ($2.10 in chips) 
Seat 3: Dipod1991 ($1.78 in chips) 
Seat 4: ca$hmeoutsid ($2.22 in chips) 
Seat 5: humo97 ($1.68 in chips) 
Seat 6: rpycmbEM ($4.72 in chips) 
guntren.ps: posts small blind $0.01
Dipod1991: posts big blind $0.02
*** HOLE CARDS ***
Dealt to Scaaalll [Ks Ts]
ca$hmeoutsid: folds 
humo97: raises $0.02 to $0.04
rpycmbEM: folds 
Scaaalll: calls $0.04
guntren.ps: folds 
Dipod1991: calls $0.02
*** FLOP *** [7d 6d 7c]
Dipod1991: checks 
humo97: bets $0.10
Scaaalll: folds 
Dipod1991: folds 
Uncalled bet ($0.10) returned to humo97
humo97 collected $0.13 from pot
humo97: doesn't show hand 
*** SUMMARY ***
Total pot $0.13 | Rake $0 
Board [7d 6d 7c]
Seat 1: Scaaalll (button) folded on the Flop
Seat 2: guntren.ps (small blind) folded before Flop
Seat 3: Dipod1991 (big blind) folded on the Flop
Seat 4: ca$hmeoutsid folded before Flop (didn't bet)
Seat 5: humo97 collected ($0.13)
Seat 6: rpycmbEM folded before Flop (didn't bet)



PokerStars Zoom Hand #229232166099:  Hold'em No Limit ($0.01/$0.02) - 2021/08/21 22:40:54 CET [2021/08/21 16:40:54 ET]
Table 'Halley' 6-max Seat #1 is the button
Seat 1: Billy Beane1 ($1.98 in chips) 
Seat 2: Yangyang1407 ($2 in chips) 
Seat 3: NIK1973 23 ($2.38 in chips) 
Seat 4: Tn 939 ($2 in chips) 
Seat 5: jnbjnb1010 ($1.22 in chips) 
Seat 6: Scaaalll ($2.40 in chips) 
Yangyang1407: posts small blind $0.01
NIK1973 23: posts big blind $0.02
*** HOLE CARDS ***
Dealt to Scaaalll [7d 2s]
Tn 939: folds 
jnbjnb1010: raises $1.20 to $1.22 and is all-in
Scaaalll: folds 
Billy Beane1: folds 
Yangyang1407: folds 
NIK1973 23: folds 
Uncalled bet ($1.20) returned to jnbjnb1010
jnbjnb1010 collected $0.05 from pot
jnbjnb1010: doesn't show hand 
*** SUMMARY ***
Total pot $0.05 | Rake $0 
Seat 1: Billy Beane1 (button) folded before Flop (didn't bet)
Seat 2: Yangyang1407 (small blind) folded before Flop
Seat 3: NIK1973 23 (big blind) folded before Flop
Seat 4: Tn 939 folded before Flop (didn't bet)
Seat 5: jnbjnb1010 collected ($0.05)
Seat 6: Scaaalll folded before Flop (didn't bet)



PokerStars Zoom Hand #229232173179:  Hold'em No Limit ($0.01/$0.02) - 2021/08/21 22:41:07 CET [2021/08/21 16:41:07 ET]
Table 'Halley' 6-max Seat #1 is the button
Seat 1: parrotman991 ($2.37 in chips) 
Seat 2: jnbjnb1010 ($1.25 in chips) 
Seat 3: punkosk8 ($1.69 in chips) 
Seat 4: Scaaalll ($2.40 in chips) 
Seat 5: zaharoff74 ($2.56 in chips) 
Seat 6: Davingo25 ($1.73 in chips) 
jnbjnb1010: posts small blind $0.01
punkosk8: posts big blind $0.02
*** HOLE CARDS ***
Dealt to Scaaalll [3s 8c]
Scaaalll: folds 
zaharoff74: folds 
Davingo25: raises $0.04 to $0.06
parrotman991: calls $0.06
punkosk8 is disconnected 
jnbjnb1010: raises $1.19 to $1.25 and is all-in
punkosk8: folds 
Davingo25: folds 
parrotman991: folds 
Uncalled bet ($1.19) returned to jnbjnb1010
Davingo25 is disconnected 
jnbjnb1010 collected $0.20 from pot
jnbjnb1010: doesn't show hand 
*** SUMMARY ***
Total pot $0.20 | Rake $0 
Seat 1: parrotman991 (button) folded before Flop
Seat 2: jnbjnb1010 (small blind) collected ($0.20)
Seat 3: punkosk8 (big blind) folded before Flop
Seat 4: Scaaalll folded before Flop (didn't bet)
Seat 5: zaharoff74 folded before Flop (didn't bet)
Seat 6: Davingo25 folded before Flop



PokerStars Zoom Hand #229232174889:  Hold'em No Limit ($0.01/$0.02) - 2021/08/21 22:41:11 CET [2021/08/21 16:41:11 ET]
Table 'Halley' 6-max Seat #1 is the button
Seat 1: Fanatspartak ($1 in chips) 
Seat 2: HirotoBeats ($2.07 in chips) 
Seat 3: new face onl ($2 in chips) 
Seat 4: 5gold jigsaw ($1.43 in chips) 
Seat 5: Scaaalll ($2.40 in chips) 
Seat 6: zergmiky ($2.17 in chips) 
HirotoBeats: posts small blind $0.01
new face onl: posts big blind $0.02
*** HOLE CARDS ***
Dealt to Scaaalll [3d 6c]
5gold jigsaw: raises $0.02 to $0.04
Scaaalll: folds 
zergmiky: folds 
Fanatspartak: folds 
HirotoBeats: calls $0.03
new face onl: folds 
*** FLOP *** [Th 6s Kc]
HirotoBeats: checks 
5gold jigsaw: bets $0.06
HirotoBeats: calls $0.06
*** TURN *** [Th 6s Kc] [2c]
HirotoBeats: checks 
5gold jigsaw: bets $0.08
HirotoBeats: calls $0.08
*** RIVER *** [Th 6s Kc 2c] [7c]
HirotoBeats: checks 
5gold jigsaw: checks 
*** SHOW DOWN ***
HirotoBeats: shows [Kh 4h] (a pair of Kings)
5gold jigsaw: mucks hand 
HirotoBeats collected $0.37 from pot
*** SUMMARY ***
Total pot $0.38 | Rake $0.01 
Board [Th 6s Kc 2c 7c]
Seat 1: Fanatspartak (button) folded before Flop (didn't bet)
Seat 2: HirotoBeats (small blind) showed [Kh 4h] and won ($0.37) with a pair of Kings
Seat 3: new face onl (big blind) folded before Flop
Seat 4: 5gold jigsaw mucked [Js Qs]
Seat 5: Scaaalll folded before Flop (didn't bet)
Seat 6: zergmiky folded before Flop (didn't bet)



PokerStars Zoom Hand #229232170999:  Hold'em No Limit ($0.01/$0.02) - 2021/08/21 22:41:02 CET [2021/08/21 16:41:02 ET]
Table 'Halley' 6-max Seat #1 is the button
Seat 1: AlexGTPS ($2.66 in chips) 
Seat 2: HubertFroh ($5.30 in chips) 
Seat 3: mheronmagno ($0.96 in chips) 
Seat 4: Scaaalll ($2.40 in chips) 
Seat 5: lexus00174 ($1.56 in chips) 
Seat 6: Mikeloko182 ($2.52 in chips) 
HubertFroh: posts small blind $0.01
mheronmagno: posts big blind $0.02
*** HOLE CARDS ***
Dealt to Scaaalll [As 9h]
Scaaalll: folds 
lexus00174: raises $0.04 to $0.06
Mikeloko182: folds 
AlexGTPS: folds 
HubertFroh: folds 
mheronmagno: calls $0.04
*** FLOP *** [Tc Td 6h]
mheronmagno: checks 
lexus00174: checks 
*** TURN *** [Tc Td 6h] [7d]
mheronmagno: checks 
lexus00174: checks 
*** RIVER *** [Tc Td 6h 7d] [9s]
mheronmagno: bets $0.11
lexus00174: raises $1.39 to $1.50 and is all-in
mheronmagno: calls $0.79 and is all-in
Uncalled bet ($0.60) returned to lexus00174
*** SHOW DOWN ***
lexus00174: shows [8h Jh] (a straight, Seven to Jack)
mheronmagno: shows [9d Ad] (two pair, Tens and Nines)
lexus00174 collected $1.86 from pot
*** SUMMARY ***
Total pot $1.93 | Rake $0.07 
Board [Tc Td 6h 7d 9s]
Seat 1: AlexGTPS (button) folded before Flop (didn't bet)
Seat 2: HubertFroh (small blind) folded before Flop
Seat 3: mheronmagno (big blind) showed [9d Ad] and lost with two pair, Tens and Nines
Seat 4: Scaaalll folded before Flop (didn't bet)
Seat 5: lexus00174 showed [8h Jh] and won ($1.86) with a straight, Seven to Jack
Seat 6: Mikeloko182 folded before Flop (didn't bet)



PokerStars Zoom Hand #229232186780:  Hold'em No Limit ($0.01/$0.02) - 2021/08/21 22:41:38 CET [2021/08/21 16:41:38 ET]
Table 'Halley' 6-max Seat #1 is the button
Seat 1: uniicecube ($2.79 in chips) 
Seat 2: Posaunengodi ($2 in chips) 
Seat 3: Poker&Gitar ($2 in chips) 
Seat 4: Scaaalll ($2.39 in chips) 
Seat 5: Thaleshs ($2 in chips) 
Seat 6: so0love ($6.87 in chips) 
Posaunengodi: posts small blind $0.01
Poker&Gitar: posts big blind $0.02
*** HOLE CARDS ***
Dealt to Scaaalll [7s 9d]
Scaaalll: folds 
Thaleshs: folds 
so0love: folds 
uniicecube: folds 
Posaunengodi: folds 
Uncalled bet ($0.01) returned to Poker&Gitar
Poker&Gitar collected $0.02 from pot
Poker&Gitar: doesn't show hand 
*** SUMMARY ***
Total pot $0.02 | Rake $0 
Seat 1: uniicecube (button) folded before Flop (didn't bet)
Seat 2: Posaunengodi (small blind) folded before Flop
Seat 3: Poker&Gitar (big blind) collected ($0.02)
Seat 4: Scaaalll folded before Flop (didn't bet)
Seat 5: Thaleshs folded before Flop (didn't bet)
Seat 6: so0love folded before Flop (didn't bet)



PokerStars Zoom Hand #229232192053:  Hold'em No Limit ($0.01/$0.02) - 2021/08/21 22:41:50 CET [2021/08/21 16:41:50 ET]
Table 'Halley' 6-max Seat #1 is the button
Seat 1: pavlo8855 ($2.31 in chips) 
Seat 2: sewq55 ($0.87 in chips) 
Seat 3: Scaaalll ($2.39 in chips) 
Seat 4: thi_spe ($2 in chips) 
Seat 5: NecromiconP ($3.21 in chips) 
Seat 6: SaRCh_Ale ($3.03 in chips) 
sewq55: posts small blind $0.01
Scaaalll: posts big blind $0.02
*** HOLE CARDS ***
Dealt to Scaaalll [4s 2s]
thi_spe: folds 
NecromiconP: folds 
SaRCh_Ale: folds 
pavlo8855: raises $0.03 to $0.05
sewq55: folds 
Scaaalll: folds 
Uncalled bet ($0.03) returned to pavlo8855
pavlo8855 collected $0.05 from pot
pavlo8855: doesn't show hand 
*** SUMMARY ***
Total pot $0.05 | Rake $0 
Seat 1: pavlo8855 (button) collected ($0.05)
Seat 2: sewq55 (small blind) folded before Flop
Seat 3: Scaaalll (big blind) folded before Flop
Seat 4: thi_spe folded before Flop (didn't bet)
Seat 5: NecromiconP folded before Flop (didn't bet)
Seat 6: SaRCh_Ale folded before Flop (didn't bet)



PokerStars Zoom Hand #229232177984:  Hold'em No Limit ($0.01/$0.02) - 2021/08/21 22:41:18 CET [2021/08/21 16:41:18 ET]
Table 'Halley' 6-max Seat #1 is the button
Seat 1: lucksuckdonk ($5.25 in chips) 
Seat 2: Scaaalll ($2.40 in chips) 
Seat 3: KonopDima ($3.06 in chips) 
Seat 4: Gamer577 ($2 in chips) 
Seat 5: kukulagosleep ($2.03 in chips) 
Seat 6: ded serch ($2.01 in chips) 
Scaaalll: posts small blind $0.01
KonopDima: posts big blind $0.02
*** HOLE CARDS ***
Dealt to Scaaalll [Qd 2c]
Gamer577: folds 
kukulagosleep: raises $0.04 to $0.06
ded serch: folds 
lucksuckdonk: calls $0.06
Scaaalll: folds 
KonopDima: folds 
*** FLOP *** [4h 4s Ts]
kukulagosleep: bets $0.08
lucksuckdonk: raises $0.17 to $0.25
kukulagosleep: calls $0.17
*** TURN *** [4h 4s Ts] [8s]
kukulagosleep: checks 
lucksuckdonk: checks 
*** RIVER *** [4h 4s Ts 8s] [Th]
kukulagosleep: checks 
lucksuckdonk: bets $0.35
kukulagosleep: folds 
Uncalled bet ($0.35) returned to lucksuckdonk
lucksuckdonk collected $0.63 from pot
lucksuckdonk: doesn't show hand 
*** SUMMARY ***
Total pot $0.65 | Rake $0.02 
Board [4h 4s Ts 8s Th]
Seat 1: lucksuckdonk (button) collected ($0.63)
Seat 2: Scaaalll (small blind) folded before Flop
Seat 3: KonopDima (big blind) folded before Flop
Seat 4: Gamer577 folded before Flop (didn't bet)
Seat 5: kukulagosleep folded on the River
Seat 6: ded serch folded before Flop (didn't bet)



PokerStars Zoom Hand #229232202036:  Hold'em No Limit ($0.01/$0.02) - 2021/08/21 22:42:13 CET [2021/08/21 16:42:13 ET]
Table 'Halley' 6-max Seat #1 is the button
Seat 1: Scaaalll ($2.37 in chips) 
Seat 2: Reipinguimm ($2 in chips) 
Seat 3: lexus00174 ($3.59 in chips) 
Seat 4: Healthys07 ($3.25 in chips) 
Seat 5: Gullsnyta ($2.54 in chips) 
Seat 6: KoAlRy ($2.22 in chips) 
Reipinguimm: posts small blind $0.01
lexus00174: posts big blind $0.02
*** HOLE CARDS ***
Dealt to Scaaalll [Jc 3h]
Healthys07: raises $0.04 to $0.06
Gullsnyta: folds 
KoAlRy: folds 
Scaaalll: folds 
Reipinguimm: folds 
lexus00174: calls $0.04
*** FLOP *** [5s Qs 9c]
lexus00174: checks 
Healthys07: bets $0.07
lexus00174: folds 
Uncalled bet ($0.07) returned to Healthys07
Healthys07 collected $0.13 from pot
Healthys07: doesn't show hand 
*** SUMMARY ***
Total pot $0.13 | Rake $0 
Board [5s Qs 9c]
Seat 1: Scaaalll (button) folded before Flop (didn't bet)
Seat 2: Reipinguimm (small blind) folded before Flop
Seat 3: lexus00174 (big blind) folded on the Flop
Seat 4: Healthys07 collected ($0.13)
Seat 5: Gullsnyta folded before Flop (didn't bet)
Seat 6: KoAlRy folded before Flop (didn't bet)



PokerStars Zoom Hand #229232204197:  Hold'em No Limit ($0.01/$0.02) - 2021/08/21 22:42:18 CET [2021/08/21 16:42:18 ET]
Table 'Halley' 6-max Seat #1 is the button
Seat 1: Demidov V.S. ($2.29 in chips) 
Seat 2: kresooo ($0.60 in chips) 
Seat 3: bananAAbandit ($4.35 in chips) 
Seat 4: SKV_1985 ($3.81 in chips) 
Seat 5: neo1200 ($1 in chips) 
Seat 6: Scaaalll ($2.37 in chips) 
kresooo: posts small blind $0.01
bananAAbandit: posts big blind $0.02
*** HOLE CARDS ***
Dealt to Scaaalll [4s Ac]
SKV_1985: raises $0.04 to $0.06
Demidov V.S. is disconnected 
neo1200: folds 
Scaaalll: folds 
Demidov V.S.: folds 
kresooo: raises $0.54 to $0.60 and is all-in
bananAAbandit: folds 
SKV_1985: folds 
Uncalled bet ($0.54) returned to kresooo
kresooo collected $0.14 from pot
kresooo: doesn't show hand 
*** SUMMARY ***
Total pot $0.14 | Rake $0 
Seat 1: Demidov V.S. (button) folded before Flop (didn't bet)
Seat 2: kresooo (small blind) collected ($0.14)
Seat 3: bananAAbandit (big blind) folded before Flop
Seat 4: SKV_1985 folded before Flop
Seat 5: neo1200 folded before Flop (didn't bet)
Seat 6: Scaaalll folded before Flop (didn't bet)



PokerStars Zoom Hand #229232210358:  Hold'em No Limit ($0.01/$0.02) - 2021/08/21 22:42:32 CET [2021/08/21 16:42:32 ET]
Table 'Halley' 6-max Seat #1 is the button
Seat 1: basyan111 ($4.39 in chips) 
Seat 2: Demidov V.S. ($2.29 in chips) 
Seat 3: Ne0net ($6.32 in chips) 
Seat 4: 78joniboy ($4.26 in chips) 
Seat 5: Earl_greyPL ($1.61 in chips) 
Seat 6: Scaaalll ($2.37 in chips) 
Demidov V.S.: posts small blind $0.01
Ne0net: posts big blind $0.02
*** HOLE CARDS ***
Dealt to Scaaalll [As Qd]
Demidov V.S. is disconnected 
basyan111 is disconnected 
78joniboy: raises $0.04 to $0.06
Earl_greyPL: calls $0.06
Scaaalll: calls $0.06
basyan111: folds 
Demidov V.S.: folds 
Ne0net: folds 
*** FLOP *** [4d 3c 9c]
78joniboy: checks 
Earl_greyPL: checks 
Scaaalll: bets $0.13
78joniboy: folds 
Earl_greyPL: folds 
Uncalled bet ($0.13) returned to Scaaalll
Scaaalll collected $0.20 from pot
Scaaalll: doesn't show hand 
*** SUMMARY ***
Total pot $0.21 | Rake $0.01 
Board [4d 3c 9c]
Seat 1: basyan111 (button) folded before Flop (didn't bet)
Seat 2: Demidov V.S. (small blind) folded before Flop
Seat 3: Ne0net (big blind) folded before Flop
Seat 4: 78joniboy folded on the Flop
Seat 5: Earl_greyPL folded on the Flop
Seat 6: Scaaalll collected ($0.20)



PokerStars Zoom Hand #229232227177:  Hold'em No Limit ($0.01/$0.02) - 2021/08/21 22:43:11 CET [2021/08/21 16:43:11 ET]
Table 'Halley' 6-max Seat #1 is the button
Seat 1: KonopDima ($3.73 in chips) 
Seat 2: fran2291 ($1.24 in chips) 
Seat 3: SIGREX ($2.02 in chips) 
Seat 4: guntren.ps ($2.30 in chips) 
Seat 5: Scaaalll ($2.51 in chips) 
Seat 6: Finderra ($1.84 in chips) 
fran2291: posts small blind $0.01
SIGREX: posts big blind $0.02
*** HOLE CARDS ***
Dealt to Scaaalll [2s 3d]
guntren.ps: folds 
Scaaalll: folds 
Finderra: folds 
KonopDima: folds 
fran2291: folds 
Uncalled bet ($0.01) returned to SIGREX
SIGREX collected $0.02 from pot
SIGREX: doesn't show hand 
*** SUMMARY ***
Total pot $0.02 | Rake $0 
Seat 1: KonopDima (button) folded before Flop (didn't bet)
Seat 2: fran2291 (small blind) folded before Flop
Seat 3: SIGREX (big blind) collected ($0.02)
Seat 4: guntren.ps folded before Flop (didn't bet)
Seat 5: Scaaalll folded before Flop (didn't bet)
Seat 6: Finderra folded before Flop (didn't bet)



PokerStars Zoom Hand #229232230256:  Hold'em No Limit ($0.01/$0.02) - 2021/08/21 22:43:18 CET [2021/08/21 16:43:18 ET]
Table 'Halley' 6-max Seat #1 is the button
Seat 1: weire99 ($4 in chips) 
Seat 2: AtZ3899 ($1.36 in chips) 
Seat 3: Scaaalll ($2.51 in chips) 
Seat 4: alexan00 ($3.47 in chips) 
Seat 5: Enoffllescini ($2.22 in chips) 
Seat 6: egroj1700 ($2.01 in chips) 
AtZ3899: posts small blind $0.01
Scaaalll: posts big blind $0.02
*** HOLE CARDS ***
Dealt to Scaaalll [2h Qd]
weire99 is disconnected 
alexan00: folds 
Enoffllescini: folds 
egroj1700: folds 
weire99: folds 
AtZ3899: folds 
Uncalled bet ($0.01) returned to Scaaalll
Scaaalll collected $0.02 from pot
Scaaalll: doesn't show hand 
*** SUMMARY ***
Total pot $0.02 | Rake $0 
Seat 1: weire99 (button) folded before Flop (didn't bet)
Seat 2: AtZ3899 (small blind) folded before Flop
Seat 3: Scaaalll (big blind) collected ($0.02)
Seat 4: alexan00 folded before Flop (didn't bet)
Seat 5: Enoffllescini folded before Flop (didn't bet)
Seat 6: egroj1700 folded before Flop (didn't bet)



PokerStars Zoom Hand #229232240644:  Hold'em No Limit ($0.01/$0.02) - 2021/08/21 22:43:42 CET [2021/08/21 16:43:42 ET]
Table 'Halley' 6-max Seat #1 is the button
Seat 1: Tn 939 ($2.13 in chips) 
Seat 2: so0love ($5.50 in chips) 
Seat 3: sewq55 ($0.63 in chips) 
Seat 4: Scaaalll ($2.51 in chips) 
Seat 5: z3317111711 ($7.40 in chips) 
Seat 6: anes.v. ($2.40 in chips) 
so0love: posts small blind $0.01
sewq55: posts big blind $0.02
*** HOLE CARDS ***
Dealt to Scaaalll [2h Kc]
Scaaalll: folds 
z3317111711: folds 
anes.v.: folds 
Tn 939: raises $0.03 to $0.05
so0love: folds 
sewq55: folds 
Uncalled bet ($0.03) returned to Tn 939
Tn 939 collected $0.05 from pot
Tn 939: doesn't show hand 
*** SUMMARY ***
Total pot $0.05 | Rake $0 
Seat 1: Tn 939 (button) collected ($0.05)
Seat 2: so0love (small blind) folded before Flop
Seat 3: sewq55 (big blind) folded before Flop
Seat 4: Scaaalll folded before Flop (didn't bet)
Seat 5: z3317111711 folded before Flop (didn't bet)
Seat 6: anes.v. folded before Flop (didn't bet)



PokerStars Zoom Hand #229232235024:  Hold'em No Limit ($0.01/$0.02) - 2021/08/21 22:43:29 CET [2021/08/21 16:43:29 ET]
Table 'Halley' 6-max Seat #1 is the button
Seat 1: jribeiros ($1.01 in chips) 
Seat 2: Scaaalll ($2.52 in chips) 
Seat 3: FabOliveira9 ($2 in chips) 
Seat 4: sewq55 ($0.64 in chips) 
Seat 5: weire99 ($4 in chips) 
Seat 6: Kreodont1987 ($6.13 in chips) 
Scaaalll: posts small blind $0.01
FabOliveira9: posts big blind $0.02
*** HOLE CARDS ***
Dealt to Scaaalll [Tc 9s]
sewq55: folds 
weire99: raises $0.04 to $0.06
Kreodont1987: calls $0.06
jribeiros: folds 
Scaaalll: folds 
FabOliveira9: folds 
*** FLOP *** [Js 5s 4c]
weire99: bets $0.07
Kreodont1987: calls $0.07
*** TURN *** [Js 5s 4c] [Qc]
weire99: checks 
Kreodont1987: checks 
*** RIVER *** [Js 5s 4c Qc] [2d]
weire99: checks 
Kreodont1987: checks 
*** SHOW DOWN ***
weire99: shows [Kh 7h] (high card King)
Kreodont1987: shows [6h 6d] (a pair of Sixes)
Kreodont1987 collected $0.28 from pot
*** SUMMARY ***
Total pot $0.29 | Rake $0.01 
Board [Js 5s 4c Qc 2d]
Seat 1: jribeiros (button) folded before Flop (didn't bet)
Seat 2: Scaaalll (small blind) folded before Flop
Seat 3: FabOliveira9 (big blind) folded before Flop
Seat 4: sewq55 folded before Flop (didn't bet)
Seat 5: weire99 showed [Kh 7h] and lost with high card King
Seat 6: Kreodont1987 showed [6h 6d] and won ($0.28) with a pair of Sixes



PokerStars Zoom Hand #229232245672:  Hold'em No Limit ($0.01/$0.02) - 2021/08/21 22:43:54 CET [2021/08/21 16:43:54 ET]
Table 'Halley' 6-max Seat #1 is the button
Seat 1: Dakosm ($1.79 in chips) 
Seat 2: WithMyWalker ($2.38 in chips) 
Seat 3: lucksuckdonk ($3.82 in chips) 
Seat 4: Umnik_M ($1.94 in chips) 
Seat 5: Scaaalll ($2.51 in chips) 
Seat 6: py100ta ($20.28 in chips) 
WithMyWalker: posts small blind $0.01
lucksuckdonk: posts big blind $0.02
*** HOLE CARDS ***
Dealt to Scaaalll [2s Ad]
Umnik_M: folds 
Scaaalll: folds 
py100ta: folds 
Dakosm: raises $0.02 to $0.04
WithMyWalker: folds 
lucksuckdonk: folds 
Uncalled bet ($0.02) returned to Dakosm
Dakosm collected $0.05 from pot
Dakosm: doesn't show hand 
*** SUMMARY ***
Total pot $0.05 | Rake $0 
Seat 1: Dakosm (button) collected ($0.05)
Seat 2: WithMyWalker (small blind) folded before Flop
Seat 3: lucksuckdonk (big blind) folded before Flop
Seat 4: Umnik_M folded before Flop (didn't bet)
Seat 5: Scaaalll folded before Flop (didn't bet)
Seat 6: py100ta folded before Flop (didn't bet)



PokerStars Zoom Hand #229232248745:  Hold'em No Limit ($0.01/$0.02) - 2021/08/21 22:44:01 CET [2021/08/21 16:44:01 ET]
Table 'Halley' 6-max Seat #1 is the button
Seat 1: Scaaalll ($2.51 in chips) 
Seat 2: WITKOW_AV ($2.18 in chips) 
Seat 3: vxDARK_CATxv ($1 in chips) 
Seat 4: SKV_1985 ($2.55 in chips) 
Seat 5: AlexGTPS ($2.33 in chips) 
Seat 6: Ck@tih@ ($2.29 in chips) 
WITKOW_AV: posts small blind $0.01
vxDARK_CATxv: posts big blind $0.02
*** HOLE CARDS ***
Dealt to Scaaalll [4d 7h]
SKV_1985: folds 
AlexGTPS: folds 
Ck@tih@: folds 
Scaaalll: folds 
WITKOW_AV: raises $0.04 to $0.06
vxDARK_CATxv: folds 
Uncalled bet ($0.04) returned to WITKOW_AV
WITKOW_AV collected $0.04 from pot
WITKOW_AV: doesn't show hand 
vxDARK_CATxv is disconnected 
*** SUMMARY ***
Total pot $0.04 | Rake $0 
Seat 1: Scaaalll (button) folded before Flop (didn't bet)
Seat 2: WITKOW_AV (small blind) collected ($0.04)
Seat 3: vxDARK_CATxv (big blind) folded before Flop
Seat 4: SKV_1985 folded before Flop (didn't bet)
Seat 5: AlexGTPS folded before Flop (didn't bet)
Seat 6: Ck@tih@ folded before Flop (didn't bet)



PokerStars Zoom Hand #229232253827:  Hold'em No Limit ($0.01/$0.02) - 2021/08/21 22:44:13 CET [2021/08/21 16:44:13 ET]
Table 'Halley' 6-max Seat #1 is the button
Seat 1: MEZz828 ($2.09 in chips) 
Seat 2: Scaaalll ($2.51 in chips) 
Seat 3: Pulp Hands ($1.92 in chips) 
Seat 4: ulvitev ($3.03 in chips) 
Seat 5: EdwardF95 ($2.98 in chips) 
Seat 6: KoAlRy ($2 in chips) 
Scaaalll: posts small blind $0.01
Pulp Hands: posts big blind $0.02
*** HOLE CARDS ***
Dealt to Scaaalll [Jh Kc]
ulvitev: folds 
EdwardF95: folds 
ulvitev is disconnected 
KoAlRy: raises $0.03 to $0.05
MEZz828: calls $0.05
Scaaalll: calls $0.04
Pulp Hands: folds 
*** FLOP *** [8h 8s 3s]
Scaaalll: checks 
KoAlRy: checks 
MEZz828: checks 
*** TURN *** [8h 8s 3s] [2h]
Scaaalll: checks 
KoAlRy: checks 
MEZz828: checks 
*** RIVER *** [8h 8s 3s 2h] [9c]
Scaaalll: checks 
KoAlRy: checks 
MEZz828: bets $0.16
Scaaalll: folds 
KoAlRy: folds 
Uncalled bet ($0.16) returned to MEZz828
MEZz828 collected $0.16 from pot
MEZz828: doesn't show hand 
*** SUMMARY ***
Total pot $0.17 | Rake $0.01 
Board [8h 8s 3s 2h 9c]
Seat 1: MEZz828 (button) collected ($0.16)
Seat 2: Scaaalll (small blind) folded on the River
Seat 3: Pulp Hands (big blind) folded before Flop
Seat 4: ulvitev folded before Flop (didn't bet)
Seat 5: EdwardF95 folded before Flop (didn't bet)
Seat 6: KoAlRy folded on the River



PokerStars Zoom Hand #229232271666:  Hold'em No Limit ($0.01/$0.02) - 2021/08/21 22:44:55 CET [2021/08/21 16:44:55 ET]
Table 'Halley' 6-max Seat #1 is the button
Seat 1: cr@sh test ($2.63 in chips) 
Seat 2: EdwardF95 ($2 in chips) 
Seat 3: Scaaalll ($2.46 in chips) 
Seat 4: Coldact ($0.52 in chips) 
Seat 5: lucksuckdonk ($3.61 in chips) 
Seat 6: maliniak75 ($0.57 in chips) 
EdwardF95: posts small blind $0.01
Scaaalll: posts big blind $0.02
*** HOLE CARDS ***
Dealt to Scaaalll [4d 5c]
Coldact has timed out
Coldact: folds 
lucksuckdonk: folds 
maliniak75: raises $0.55 to $0.57 and is all-in
cr@sh test: folds 
EdwardF95: folds 
Scaaalll: folds 
Uncalled bet ($0.55) returned to maliniak75
maliniak75 collected $0.05 from pot
maliniak75: doesn't show hand 
*** SUMMARY ***
Total pot $0.05 | Rake $0 
Seat 1: cr@sh test (button) folded before Flop (didn't bet)
Seat 2: EdwardF95 (small blind) folded before Flop
Seat 3: Scaaalll (big blind) folded before Flop
Seat 4: Coldact folded before Flop (didn't bet)
Seat 5: lucksuckdonk folded before Flop (didn't bet)
Seat 6: maliniak75 collected ($0.05)



PokerStars Zoom Hand #229232284934:  Hold'em No Limit ($0.01/$0.02) - 2021/08/21 22:45:25 CET [2021/08/21 16:45:25 ET]
Table 'Halley' 6-max Seat #1 is the button
Seat 1: Scaaalll ($2.44 in chips) 
Seat 2: sergeyl01 ($0.46 in chips) 
Seat 3: Dr.stromg ($2.98 in chips) 
Seat 4: sg.32rus ($1.15 in chips) 
Seat 5: lucksuckdonk ($4.18 in chips) 
Seat 6: PEDACIT0 ($2.11 in chips) 
sergeyl01: posts small blind $0.01
Dr.stromg: posts big blind $0.02
*** HOLE CARDS ***
Dealt to Scaaalll [Tc 4c]
sg.32rus: calls $0.02
lucksuckdonk: folds 
PEDACIT0: folds 
Scaaalll: folds 
sergeyl01: calls $0.01
Dr.stromg: checks 
*** FLOP *** [3c 2s Th]
sergeyl01: checks 
Dr.stromg: bets $0.03
sg.32rus: folds 
sergeyl01: folds 
Uncalled bet ($0.03) returned to Dr.stromg
Dr.stromg collected $0.06 from pot
Dr.stromg: doesn't show hand 
*** SUMMARY ***
Total pot $0.06 | Rake $0 
Board [3c 2s Th]
Seat 1: Scaaalll (button) folded before Flop (didn't bet)
Seat 2: sergeyl01 (small blind) folded on the Flop
Seat 3: Dr.stromg (big blind) collected ($0.06)
Seat 4: sg.32rus folded on the Flop
Seat 5: lucksuckdonk folded before Flop (didn't bet)
Seat 6: PEDACIT0 folded before Flop (didn't bet)



PokerStars Zoom Hand #229232288356:  Hold'em No Limit ($0.01/$0.02) - 2021/08/21 22:45:33 CET [2021/08/21 16:45:33 ET]
Table 'Halley' 6-max Seat #1 is the button
Seat 1: krowio ($2.08 in chips) 
Seat 2: kahzura ($3.34 in chips) 
Seat 3: lucksuckdonk ($4.18 in chips) 
Seat 4: ciucibaby ($4.43 in chips) 
Seat 5: ded serch ($2 in chips) 
Seat 6: Scaaalll ($2.44 in chips) 
kahzura: posts small blind $0.01
lucksuckdonk: posts big blind $0.02
*** HOLE CARDS ***
Dealt to Scaaalll [8c Qs]
ciucibaby: raises $0.05 to $0.07
ded serch: folds 
Scaaalll: folds 
krowio: folds 
kahzura: folds 
lucksuckdonk: folds 
Uncalled bet ($0.05) returned to ciucibaby
ciucibaby collected $0.05 from pot
ciucibaby: doesn't show hand 
*** SUMMARY ***
Total pot $0.05 | Rake $0 
Seat 1: krowio (button) folded before Flop (didn't bet)
Seat 2: kahzura (small blind) folded before Flop
Seat 3: lucksuckdonk (big blind) folded before Flop
Seat 4: ciucibaby collected ($0.05)
Seat 5: ded serch folded before Flop (didn't bet)
Seat 6: Scaaalll folded before Flop (didn't bet)



PokerStars Zoom Hand #229232304992:  Hold'em No Limit ($0.01/$0.02) - 2021/08/21 22:45:48 CET [2021/08/21 16:45:48 ET]
Table 'Halley' 6-max Seat #1 is the button
Seat 1: guntren.ps ($2 in chips) 
Seat 2: Gamer577 ($2 in chips) 
Seat 3: Gek77 ($5.48 in chips) 
Seat 4: Scaaalll ($2.44 in chips) 
Seat 5: Canoinhas37 ($6.14 in chips) 
Seat 6: storo98 ($16.02 in chips) 
Gamer577: posts small blind $0.01
Gek77: posts big blind $0.02
*** HOLE CARDS ***
Dealt to Scaaalll [2s 3d]
Scaaalll: folds 
Canoinhas37: raises $0.02 to $0.04
storo98: folds 
guntren.ps: folds 
Gamer577: folds 
Gek77: calls $0.02
*** FLOP *** [4s 7d Ks]
Gek77: checks 
Canoinhas37: checks 
*** TURN *** [4s 7d Ks] [5c]
Gek77: checks 
Canoinhas37: checks 
*** RIVER *** [4s 7d Ks 5c] [7s]
Gek77: checks 
Canoinhas37: checks 
*** SHOW DOWN ***
Gek77: shows [2h Ah] (a pair of Sevens)
Canoinhas37: shows [Ad Jd] (a pair of Sevens - Ace+King+Jack kicker)
Canoinhas37 collected $0.09 from pot
*** SUMMARY ***
Total pot $0.09 | Rake $0 
Board [4s 7d Ks 5c 7s]
Seat 1: guntren.ps (button) folded before Flop (didn't bet)
Seat 2: Gamer577 (small blind) folded before Flop
Seat 3: Gek77 (big blind) showed [2h Ah] and lost with a pair of Sevens
Seat 4: Scaaalll folded before Flop (didn't bet)
Seat 5: Canoinhas37 showed [Ad Jd] and won ($0.09) with a pair of Sevens
Seat 6: storo98 folded before Flop (didn't bet)



PokerStars Zoom Hand #229232306662:  Hold'em No Limit ($0.01/$0.02) - 2021/08/21 22:45:51 CET [2021/08/21 16:45:51 ET]
Table 'Halley' 6-max Seat #1 is the button
Seat 1: xxVanquishxx ($8.79 in chips) 
Seat 2: KonopDima ($2.08 in chips) 
Seat 3: Scaaalll ($2.44 in chips) 
Seat 4: dryan04 ($1.56 in chips) 
Seat 5: OmahaWheels ($3.90 in chips) 
Seat 6: Buka1224 ($4.26 in chips) 
KonopDima: posts small blind $0.01
Scaaalll: posts big blind $0.02
*** HOLE CARDS ***
Dealt to Scaaalll [5h 5d]
dryan04: raises $0.02 to $0.04
OmahaWheels: folds 
Buka1224: calls $0.04
xxVanquishxx: folds 
KonopDima: folds 
Scaaalll: calls $0.02
*** FLOP *** [2h Ts 7s]
Scaaalll: checks 
dryan04: checks 
Buka1224: bets $0.06
dryan04 is disconnected 
Scaaalll: folds 
dryan04: folds 
Uncalled bet ($0.06) returned to Buka1224
Buka1224 collected $0.13 from pot
Buka1224: doesn't show hand 
*** SUMMARY ***
Total pot $0.13 | Rake $0 
Board [2h Ts 7s]
Seat 1: xxVanquishxx (button) folded before Flop (didn't bet)
Seat 2: KonopDima (small blind) folded before Flop
Seat 3: Scaaalll (big blind) folded on the Flop
Seat 4: dryan04 folded on the Flop
Seat 5: OmahaWheels folded before Flop (didn't bet)
Seat 6: Buka1224 collected ($0.13)



PokerStars Zoom Hand #229232324979:  Hold'em No Limit ($0.01/$0.02) - 2021/08/21 22:46:27 CET [2021/08/21 16:46:27 ET]
Table 'Halley' 6-max Seat #1 is the button
Seat 1: Scaaalll ($2.39 in chips) 
Seat 2: HubertFroh ($5.33 in chips) 
Seat 3: HDYD18 ($5.61 in chips) 
Seat 4: dryan04 ($1.48 in chips) 
Seat 5: Enoffllescini ($3.12 in chips) 
Seat 6: tazar34_777 ($5.20 in chips) 
HubertFroh: posts small blind $0.01
HDYD18: posts big blind $0.02
*** HOLE CARDS ***
Dealt to Scaaalll [Td 2d]
dryan04: raises $0.02 to $0.04
Enoffllescini: folds 
tazar34_777: raises $0.04 to $0.08
Scaaalll: folds 
HubertFroh: folds 
HDYD18: folds 
dryan04: folds 
Uncalled bet ($0.04) returned to tazar34_777
tazar34_777 collected $0.11 from pot
tazar34_777: doesn't show hand 
dryan04 is disconnected 
*** SUMMARY ***
Total pot $0.11 | Rake $0 
Seat 1: Scaaalll (button) folded before Flop (didn't bet)
Seat 2: HubertFroh (small blind) folded before Flop
Seat 3: HDYD18 (big blind) folded before Flop
Seat 4: dryan04 folded before Flop
Seat 5: Enoffllescini folded before Flop (didn't bet)
Seat 6: tazar34_777 collected ($0.11)



PokerStars Zoom Hand #229232328467:  Hold'em No Limit ($0.01/$0.02) - 2021/08/21 22:46:35 CET [2021/08/21 16:46:35 ET]
Table 'Halley' 6-max Seat #1 is the button
Seat 1: sewq55 ($1.19 in chips) 
Seat 2: Scaaalll ($2.39 in chips) 
Seat 3: volf55321 ($1.53 in chips) 
Seat 4: py100ta ($20.62 in chips) 
Seat 5: Leonpy92 ($2.17 in chips) 
Seat 6: ryokun@tps ($0.81 in chips) 
Scaaalll: posts small blind $0.01
volf55321: posts big blind $0.02
*** HOLE CARDS ***
Dealt to Scaaalll [4h 3h]
py100ta has timed out
py100ta: folds 
Leonpy92: folds 
ryokun@tps: folds 
sewq55: folds 
Scaaalll: folds 
Uncalled bet ($0.01) returned to volf55321
volf55321 collected $0.02 from pot
volf55321: doesn't show hand 
*** SUMMARY ***
Total pot $0.02 | Rake $0 
Seat 1: sewq55 (button) folded before Flop (didn't bet)
Seat 2: Scaaalll (small blind) folded before Flop
Seat 3: volf55321 (big blind) collected ($0.02)
Seat 4: py100ta folded before Flop (didn't bet)
Seat 5: Leonpy92 folded before Flop (didn't bet)
Seat 6: ryokun@tps folded before Flop (didn't bet)



PokerStars Zoom Hand #229232303255:  Hold'em No Limit ($0.01/$0.02) - 2021/08/21 22:45:44 CET [2021/08/21 16:45:44 ET]
Table 'Halley' 6-max Seat #1 is the button
Seat 1: balalaikaRUS47 ($1.91 in chips) 
Seat 2: jens 305 ($1.29 in chips) 
Seat 3: Akrobat94 ($1 in chips) 
Seat 4: 888lifeIS ($2.60 in chips) 
Seat 5: Scaaalll ($2.44 in chips) 
Seat 6: WITKOW_AV ($2.13 in chips) 
jens 305: posts small blind $0.01
Akrobat94: posts big blind $0.02
*** HOLE CARDS ***
Dealt to Scaaalll [Qh 5c]
888lifeIS: folds 
Scaaalll: folds 
WITKOW_AV: folds 
balalaikaRUS47: raises $0.02 to $0.04
jens 305: calls $0.03
Akrobat94: raises $0.02 to $0.06
balalaikaRUS47: raises $0.02 to $0.08
jens 305: calls $0.04
Akrobat94: calls $0.02
*** FLOP *** [6c 3c Jh]
jens 305: bets $0.10
Akrobat94: calls $0.10
balalaikaRUS47: folds 
*** TURN *** [6c 3c Jh] [2s]
balalaikaRUS47 is disconnected 
jens 305: checks 
Akrobat94: bets $0.42
jens 305: folds 
Uncalled bet ($0.42) returned to Akrobat94
Akrobat94 collected $0.42 from pot
Akrobat94: doesn't show hand 
*** SUMMARY ***
Total pot $0.44 | Rake $0.02 
Board [6c 3c Jh 2s]
Seat 1: balalaikaRUS47 (button) folded on the Flop
Seat 2: jens 305 (small blind) folded on the Turn
Seat 3: Akrobat94 (big blind) collected ($0.42)
Seat 4: 888lifeIS folded before Flop (didn't bet)
Seat 5: Scaaalll folded before Flop (didn't bet)
Seat 6: WITKOW_AV folded before Flop (didn't bet)



PokerStars Zoom Hand #229232332867:  Hold'em No Limit ($0.01/$0.02) - 2021/08/21 22:46:45 CET [2021/08/21 16:46:45 ET]
Table 'Halley' 6-max Seat #1 is the button
Seat 1: cr@sh test ($2.60 in chips) 
Seat 2: Umnik_M ($1.95 in chips) 
Seat 3: Gek77 ($5.42 in chips) 
Seat 4: JTbukowski ($3.93 in chips) 
Seat 5: Scaaalll ($2.38 in chips) 
Seat 6: CrazyyParis ($2 in chips) 
Umnik_M: posts small blind $0.01
Gek77: posts big blind $0.02
*** HOLE CARDS ***
Dealt to Scaaalll [3c 2h]
JTbukowski: folds 
Scaaalll: folds 
CrazyyParis: folds 
cr@sh test: folds 
Umnik_M: folds 
Uncalled bet ($0.01) returned to Gek77
Gek77 collected $0.02 from pot
Gek77: doesn't show hand 
*** SUMMARY ***
Total pot $0.02 | Rake $0 
Seat 1: cr@sh test (button) folded before Flop (didn't bet)
Seat 2: Umnik_M (small blind) folded before Flop
Seat 3: Gek77 (big blind) collected ($0.02)
Seat 4: JTbukowski folded before Flop (didn't bet)
Seat 5: Scaaalll folded before Flop (didn't bet)
Seat 6: CrazyyParis folded before Flop (didn't bet)



PokerStars Zoom Hand #229232320247:  Hold'em No Limit ($0.01/$0.02) - 2021/08/21 22:46:16 CET [2021/08/21 16:46:16 ET]
Table 'Halley' 6-max Seat #1 is the button
Seat 1: bossquaid ($2.17 in chips) 
Seat 2: Scaaalll ($2.40 in chips) 
Seat 3: elmex886 ($2 in chips) 
Seat 4: AlexGTPS ($3.69 in chips) 
Seat 5: CordiPS ($6.35 in chips) 
Seat 6: gilberto98 ($2.01 in chips) 
Scaaalll: posts small blind $0.01
elmex886: posts big blind $0.02
*** HOLE CARDS ***
Dealt to Scaaalll [Qs 2d]
AlexGTPS: folds 
CordiPS: raises $0.04 to $0.06
gilberto98: folds 
bossquaid: folds 
Scaaalll: folds 
elmex886: calls $0.04
*** FLOP *** [3c Ac 8s]
elmex886: checks 
CordiPS: bets $0.04
elmex886: calls $0.04
*** TURN *** [3c Ac 8s] [8h]
elmex886: checks 
CordiPS: checks 
*** RIVER *** [3c Ac 8s 8h] [Tc]
elmex886: bets $0.10
CordiPS: folds 
Uncalled bet ($0.10) returned to elmex886
elmex886 collected $0.20 from pot
elmex886: doesn't show hand 
*** SUMMARY ***
Total pot $0.21 | Rake $0.01 
Board [3c Ac 8s 8h Tc]
Seat 1: bossquaid (button) folded before Flop (didn't bet)
Seat 2: Scaaalll (small blind) folded before Flop
Seat 3: elmex886 (big blind) collected ($0.20)
Seat 4: AlexGTPS folded before Flop (didn't bet)
Seat 5: CordiPS folded on the River
Seat 6: gilberto98 folded before Flop (didn't bet)



PokerStars Zoom Hand #229232334613:  Hold'em No Limit ($0.01/$0.02) - 2021/08/21 22:46:49 CET [2021/08/21 16:46:49 ET]
Table 'Halley' 6-max Seat #1 is the button
Seat 1: Hallyson_23 ($4.61 in chips) 
Seat 2: Yangyang1407 ($2.06 in chips) 
Seat 3: SILBERRRR ($2.40 in chips) 
Seat 4: Fedor_Gar ($3.89 in chips) 
Seat 5: SKV_1985 ($3.70 in chips) 
Seat 6: Scaaalll ($2.38 in chips) 
Yangyang1407: posts small blind $0.01
SILBERRRR: posts big blind $0.02
*** HOLE CARDS ***
Dealt to Scaaalll [3c Qc]
Fedor_Gar: folds 
SKV_1985: raises $0.04 to $0.06
Scaaalll: folds 
Hallyson_23: folds 
Yangyang1407: folds 
SILBERRRR: calls $0.04
*** FLOP *** [Kh Ad 9s]
SILBERRRR: checks 
SKV_1985: bets $0.08
SILBERRRR: calls $0.08
*** TURN *** [Kh Ad 9s] [9d]
SILBERRRR: checks 
SKV_1985: bets $0.18
SILBERRRR: calls $0.18
*** RIVER *** [Kh Ad 9s 9d] [2d]
SILBERRRR: bets $0.28
SKV_1985: calls $0.28
*** SHOW DOWN ***
SILBERRRR: shows [9c Td] (three of a kind, Nines)
SKV_1985: mucks hand 
SILBERRRR collected $1.16 from pot
*** SUMMARY ***
Total pot $1.21 | Rake $0.05 
Board [Kh Ad 9s 9d 2d]
Seat 1: Hallyson_23 (button) folded before Flop (didn't bet)
Seat 2: Yangyang1407 (small blind) folded before Flop
Seat 3: SILBERRRR (big blind) showed [9c Td] and won ($1.16) with three of a kind, Nines
Seat 4: Fedor_Gar folded before Flop (didn't bet)
Seat 5: SKV_1985 mucked [Th Ac]
Seat 6: Scaaalll folded before Flop (didn't bet)



PokerStars Zoom Hand #229232336833:  Hold'em No Limit ($0.01/$0.02) - 2021/08/21 22:46:54 CET [2021/08/21 16:46:54 ET]
Table 'Halley' 6-max Seat #1 is the button
Seat 1: Yangyang1407 ($2.05 in chips) 
Seat 2: Herr.Hikke ($2.28 in chips) 
Seat 3: balalaikaRUS47 ($1.82 in chips) 
Seat 4: alphabeta1d ($2 in chips) 
Seat 5: ryokun@tps ($0.82 in chips) 
Seat 6: Scaaalll ($2.38 in chips) 
Herr.Hikke: posts small blind $0.01
balalaikaRUS47: posts big blind $0.02
*** HOLE CARDS ***
Dealt to Scaaalll [Ah 8d]
alphabeta1d: folds 
ryokun@tps: folds 
Scaaalll: raises $0.04 to $0.06
Yangyang1407: folds 
Herr.Hikke: folds 
balalaikaRUS47: calls $0.04
*** FLOP *** [6d 3d Ks]
balalaikaRUS47: checks 
Scaaalll: bets $0.08
balalaikaRUS47: calls $0.08
*** TURN *** [6d 3d Ks] [4h]
balalaikaRUS47: checks 
Scaaalll: bets $0.20
balalaikaRUS47: calls $0.20
*** RIVER *** [6d 3d Ks 4h] [Qd]
balalaikaRUS47: checks 
Scaaalll: checks 
*** SHOW DOWN ***
balalaikaRUS47: shows [As 6c] (a pair of Sixes)
Scaaalll: mucks hand 
balalaikaRUS47 collected $0.67 from pot
*** SUMMARY ***
Total pot $0.69 | Rake $0.02 
Board [6d 3d Ks 4h Qd]
Seat 1: Yangyang1407 (button) folded before Flop (didn't bet)
Seat 2: Herr.Hikke (small blind) folded before Flop
Seat 3: balalaikaRUS47 (big blind) showed [As 6c] and won ($0.67) with a pair of Sixes
Seat 4: alphabeta1d folded before Flop (didn't bet)
Seat 5: ryokun@tps folded before Flop (didn't bet)
Seat 6: Scaaalll mucked [Ah 8d]



PokerStars Zoom Hand #229232360136:  Hold'em No Limit ($0.01/$0.02) - 2021/08/21 22:47:47 CET [2021/08/21 16:47:47 ET]
Table 'Halley' 6-max Seat #1 is the button
Seat 1: djewlz ($0.55 in chips) 
Seat 2: QCcumm ($3.36 in chips) 
Seat 3: JTbukowski ($3.89 in chips) 
Seat 4: A.luckebeggr ($6.02 in chips) 
Seat 5: Scaaalll ($2.04 in chips) 
Seat 6: XHerrTUMNUSX ($8.02 in chips) 
QCcumm: posts small blind $0.01
JTbukowski: posts big blind $0.02
*** HOLE CARDS ***
Dealt to Scaaalll [Jc 5h]
A.luckebeggr: raises $0.02 to $0.04
Scaaalll: folds 
XHerrTUMNUSX: folds 
djewlz: folds 
QCcumm: calls $0.03
JTbukowski: folds 
*** FLOP *** [5c Kc 7c]
QCcumm: checks 
A.luckebeggr: bets $0.08
QCcumm: calls $0.08
*** TURN *** [5c Kc 7c] [4d]
QCcumm: checks 
A.luckebeggr: bets $0.38
QCcumm: calls $0.38
*** RIVER *** [5c Kc 7c 4d] [9c]
QCcumm: checks 
A.luckebeggr: bets $1.47
QCcumm: folds 
Uncalled bet ($1.47) returned to A.luckebeggr
A.luckebeggr collected $0.98 from pot
A.luckebeggr: doesn't show hand 
QCcumm is disconnected 
*** SUMMARY ***
Total pot $1.02 | Rake $0.04 
Board [5c Kc 7c 4d 9c]
Seat 1: djewlz (button) folded before Flop (didn't bet)
Seat 2: QCcumm (small blind) folded on the River
Seat 3: JTbukowski (big blind) folded before Flop
Seat 4: A.luckebeggr collected ($0.98)
Seat 5: Scaaalll folded before Flop (didn't bet)
Seat 6: XHerrTUMNUSX folded before Flop (didn't bet)



PokerStars Zoom Hand #229232363323:  Hold'em No Limit ($0.01/$0.02) - 2021/08/21 22:47:54 CET [2021/08/21 16:47:54 ET]
Table 'Halley' 6-max Seat #1 is the button
Seat 1: Kb013497 ($1.69 in chips) 
Seat 2: botyesz999 ($1.03 in chips) 
Seat 3: Scaaalll ($2.04 in chips) 
Seat 4: Axel201388 ($2.38 in chips) 
Seat 5: BlackhawKK's ($2.08 in chips) 
Seat 6: Ck@tih@ ($1.85 in chips) 
botyesz999: posts small blind $0.01
Scaaalll: posts big blind $0.02
*** HOLE CARDS ***
Dealt to Scaaalll [Jd Jc]
Axel201388: folds 
BlackhawKK's: raises $0.04 to $0.06
Ck@tih@: folds 
Kb013497: folds 
botyesz999: folds 
Scaaalll: calls $0.04
*** FLOP *** [Tc Kc 4d]
Scaaalll: checks 
BlackhawKK's: bets $0.04
Scaaalll: calls $0.04
*** TURN *** [Tc Kc 4d] [Qd]
Scaaalll: checks 
BlackhawKK's: bets $0.15
Scaaalll: calls $0.15
*** RIVER *** [Tc Kc 4d Qd] [8c]
Scaaalll: checks 
BlackhawKK's: checks 
*** SHOW DOWN ***
Scaaalll: shows [Jd Jc] (a pair of Jacks)
BlackhawKK's: mucks hand 
Scaaalll collected $0.49 from pot
*** SUMMARY ***
Total pot $0.51 | Rake $0.02 
Board [Tc Kc 4d Qd 8c]
Seat 1: Kb013497 (button) folded before Flop (didn't bet)
Seat 2: botyesz999 (small blind) folded before Flop
Seat 3: Scaaalll (big blind) showed [Jd Jc] and won ($0.49) with a pair of Jacks
Seat 4: Axel201388 folded before Flop (didn't bet)
Seat 5: BlackhawKK's mucked [5c 5h]
Seat 6: Ck@tih@ folded before Flop (didn't bet)



PokerStars Zoom Hand #229232384338:  Hold'em No Limit ($0.01/$0.02) - 2021/08/21 22:48:42 CET [2021/08/21 16:48:42 ET]
Table 'Halley' 6-max Seat #1 is the button
Seat 1: znak312 ($2.05 in chips) 
Seat 2: HubertFroh ($5.27 in chips) 
Seat 3: BlackhawKK's ($2 in chips) 
Seat 4: Scaaalll ($2.28 in chips) 
Seat 5: Apollonnn_13 ($1.97 in chips) 
Seat 6: rabbitmeat73 ($3.15 in chips) 
HubertFroh: posts small blind $0.01
BlackhawKK's: posts big blind $0.02
*** HOLE CARDS ***
Dealt to Scaaalll [3h Qd]
Scaaalll: folds 
Apollonnn_13: folds 
rabbitmeat73: folds 
znak312: folds 
HubertFroh: folds 
Uncalled bet ($0.01) returned to BlackhawKK's
BlackhawKK's collected $0.02 from pot
BlackhawKK's: doesn't show hand 
*** SUMMARY ***
Total pot $0.02 | Rake $0 
Seat 1: znak312 (button) folded before Flop (didn't bet)
Seat 2: HubertFroh (small blind) folded before Flop
Seat 3: BlackhawKK's (big blind) collected ($0.02)
Seat 4: Scaaalll folded before Flop (didn't bet)
Seat 5: Apollonnn_13 folded before Flop (didn't bet)
Seat 6: rabbitmeat73 folded before Flop (didn't bet)



PokerStars Zoom Hand #229232389608:  Hold'em No Limit ($0.01/$0.02) - 2021/08/21 22:48:54 CET [2021/08/21 16:48:54 ET]
Table 'Halley' 6-max Seat #1 is the button
Seat 1: Scaaalll ($2.28 in chips) 
Seat 2: OmahaWheels ($2 in chips) 
Seat 3: sewq55 ($2.54 in chips) 
Seat 4: gilberto98 ($3.69 in chips) 
Seat 5: coltrain1986 ($0.31 in chips) 
Seat 6: ppluiaule ($2.27 in chips) 
OmahaWheels: posts small blind $0.01
sewq55: posts big blind $0.02
*** HOLE CARDS ***
Dealt to Scaaalll [4h 9d]
gilberto98: folds 
coltrain1986: folds 
ppluiaule: raises $0.03 to $0.05
Scaaalll: folds 
OmahaWheels: folds 
sewq55: calls $0.03
*** FLOP *** [3d 2c Jh]
sewq55: checks 
ppluiaule: bets $0.08
sewq55: folds 
Uncalled bet ($0.08) returned to ppluiaule
ppluiaule collected $0.11 from pot
ppluiaule: doesn't show hand 
*** SUMMARY ***
Total pot $0.11 | Rake $0 
Board [3d 2c Jh]
Seat 1: Scaaalll (button) folded before Flop (didn't bet)
Seat 2: OmahaWheels (small blind) folded before Flop
Seat 3: sewq55 (big blind) folded on the Flop
Seat 4: gilberto98 folded before Flop (didn't bet)
Seat 5: coltrain1986 folded before Flop (didn't bet)
Seat 6: ppluiaule collected ($0.11)



PokerStars Zoom Hand #229232393140:  Hold'em No Limit ($0.01/$0.02) - 2021/08/21 22:49:02 CET [2021/08/21 16:49:02 ET]
Table 'Halley' 6-max Seat #1 is the button
Seat 1: sg.32rus ($0.78 in chips) 
Seat 2: nagiloR ($1.78 in chips) 
Seat 3: gordoatlantico ($4.52 in chips) 
Seat 4: Scaaalll ($2.28 in chips) 
Seat 5: SKV_1985 ($4.31 in chips) 
Seat 6: Poker&Gitar ($2.14 in chips) 
nagiloR: posts small blind $0.01
gordoatlantico: posts big blind $0.02
*** HOLE CARDS ***
Dealt to Scaaalll [Ts 3s]
Scaaalll: folds 
SKV_1985: raises $0.04 to $0.06
Poker&Gitar: calls $0.06
sg.32rus: folds 
nagiloR: folds 
gordoatlantico: folds 
*** FLOP *** [9c 8c Jd]
nagiloR is disconnected 
SKV_1985: bets $0.09
Poker&Gitar: folds 
Uncalled bet ($0.09) returned to SKV_1985
SKV_1985 collected $0.14 from pot
SKV_1985: doesn't show hand 
*** SUMMARY ***
Total pot $0.15 | Rake $0.01 
Board [9c 8c Jd]
Seat 1: sg.32rus (button) folded before Flop (didn't bet)
Seat 2: nagiloR (small blind) folded before Flop
Seat 3: gordoatlantico (big blind) folded before Flop
Seat 4: Scaaalll folded before Flop (didn't bet)
Seat 5: SKV_1985 collected ($0.14)
Seat 6: Poker&Gitar folded on the Flop



PokerStars Zoom Hand #229232395186:  Hold'em No Limit ($0.01/$0.02) - 2021/08/21 22:49:06 CET [2021/08/21 16:49:06 ET]
Table 'Halley' 6-max Seat #1 is the button
Seat 1: pavlo8855 ($2.36 in chips) 
Seat 2: Scaaalll ($2.28 in chips) 
Seat 3: xxVanquishxx ($9.02 in chips) 
Seat 4: Flo_Ned ($0.81 in chips) 
Seat 5: ca$hmeoutsid ($6.58 in chips) 
Seat 6: olcham7 ($2 in chips) 
Scaaalll: posts small blind $0.01
xxVanquishxx: posts big blind $0.02
*** HOLE CARDS ***
Dealt to Scaaalll [3s Ad]
Flo_Ned: folds 
ca$hmeoutsid: raises $0.04 to $0.06
olcham7: folds 
pavlo8855: folds 
Scaaalll: folds 
xxVanquishxx: folds 
Uncalled bet ($0.04) returned to ca$hmeoutsid
ca$hmeoutsid collected $0.05 from pot
ca$hmeoutsid: doesn't show hand 
*** SUMMARY ***
Total pot $0.05 | Rake $0 
Seat 1: pavlo8855 (button) folded before Flop (didn't bet)
Seat 2: Scaaalll (small blind) folded before Flop
Seat 3: xxVanquishxx (big blind) folded before Flop
Seat 4: Flo_Ned folded before Flop (didn't bet)
Seat 5: ca$hmeoutsid collected ($0.05)
Seat 6: olcham7 folded before Flop (didn't bet)



PokerStars Zoom Hand #229232402436:  Hold'em No Limit ($0.01/$0.02) - 2021/08/21 22:49:23 CET [2021/08/21 16:49:23 ET]
Table 'Halley' 6-max Seat #1 is the button
Seat 1: gilberto98 ($3.66 in chips) 
Seat 2: lumpek1112 ($3.11 in chips) 
Seat 3: Scaaalll ($2.27 in chips) 
Seat 4: olcham7 ($2.06 in chips) 
Seat 5: WithMyWalker ($2.32 in chips) 
Seat 6: Smailodon ($0.75 in chips) 
lumpek1112: posts small blind $0.01
Scaaalll: posts big blind $0.02
*** HOLE CARDS ***
Dealt to Scaaalll [7h 9s]
olcham7: folds 
WithMyWalker has timed out
WithMyWalker: folds 
Smailodon: raises $0.04 to $0.06
gilberto98: folds 
lumpek1112: calls $0.05
Scaaalll: folds 
*** FLOP *** [Qd As 9d]
lumpek1112: checks 
Smailodon: bets $0.14
lumpek1112: folds 
Uncalled bet ($0.14) returned to Smailodon
Smailodon collected $0.14 from pot
Smailodon: doesn't show hand 
*** SUMMARY ***
Total pot $0.14 | Rake $0 
Board [Qd As 9d]
Seat 1: gilberto98 (button) folded before Flop (didn't bet)
Seat 2: lumpek1112 (small blind) folded on the Flop
Seat 3: Scaaalll (big blind) folded before Flop
Seat 4: olcham7 folded before Flop (didn't bet)
Seat 5: WithMyWalker folded before Flop (didn't bet)
Seat 6: Smailodon collected ($0.14)



PokerStars Zoom Hand #229232415714:  Hold'em No Limit ($0.01/$0.02) - 2021/08/21 22:49:53 CET [2021/08/21 16:49:53 ET]
Table 'Halley' 6-max Seat #1 is the button
Seat 1: Scaaalll ($2.25 in chips) 
Seat 2: Ne0net ($2.14 in chips) 
Seat 3: Dakosm ($1.55 in chips) 
Seat 4: RzkPoker ($1.35 in chips) 
Seat 5: Mad_Clock ($3.50 in chips) 
Seat 6: thi_spe ($2.37 in chips) 
Ne0net: posts small blind $0.01
Dakosm: posts big blind $0.02
*** HOLE CARDS ***
Dealt to Scaaalll [4s 3s]
RzkPoker: raises $0.04 to $0.06
Mad_Clock: folds 
thi_spe: folds 
Scaaalll: folds 
Ne0net: folds 
Dakosm: folds 
Uncalled bet ($0.04) returned to RzkPoker
RzkPoker collected $0.05 from pot
RzkPoker: doesn't show hand 
*** SUMMARY ***
Total pot $0.05 | Rake $0 
Seat 1: Scaaalll (button) folded before Flop (didn't bet)
Seat 2: Ne0net (small blind) folded before Flop
Seat 3: Dakosm (big blind) folded before Flop
Seat 4: RzkPoker collected ($0.05)
Seat 5: Mad_Clock folded before Flop (didn't bet)
Seat 6: thi_spe folded before Flop (didn't bet)



PokerStars Zoom Hand #229232423161:  Hold'em No Limit ($0.01/$0.02) - 2021/08/21 22:50:10 CET [2021/08/21 16:50:10 ET]
Table 'Halley' 6-max Seat #1 is the button
Seat 1: Jellycube ($3.94 in chips) 
Seat 2: AlexGTPS ($2.47 in chips) 
Seat 3: squidy4 ($1 in chips) 
Seat 4: dkno77 ($1.43 in chips) 
Seat 5: Demidov V.S. ($3.08 in chips) 
Seat 6: Scaaalll ($2.25 in chips) 
AlexGTPS: posts small blind $0.01
squidy4: posts big blind $0.02
*** HOLE CARDS ***
Dealt to Scaaalll [4s 6d]
dkno77: raises $0.02 to $0.04
Demidov V.S.: folds 
Demidov V.S. is disconnected 
Scaaalll: folds 
Jellycube: folds 
squidy4 is disconnected 
AlexGTPS: folds 
squidy4: folds 
Uncalled bet ($0.02) returned to dkno77
dkno77 collected $0.05 from pot
dkno77: doesn't show hand 
*** SUMMARY ***
Total pot $0.05 | Rake $0 
Seat 1: Jellycube (button) folded before Flop (didn't bet)
Seat 2: AlexGTPS (small blind) folded before Flop
Seat 3: squidy4 (big blind) folded before Flop
Seat 4: dkno77 collected ($0.05)
Seat 5: Demidov V.S. folded before Flop (didn't bet)
Seat 6: Scaaalll folded before Flop (didn't bet)



PokerStars Zoom Hand #229232426723:  Hold'em No Limit ($0.01/$0.02) - 2021/08/21 22:50:18 CET [2021/08/21 16:50:18 ET]
Table 'Halley' 6-max Seat #1 is the button
Seat 1: bossquaid ($2.66 in chips) 
Seat 2: Mad_Clock ($2.12 in chips) 
Seat 3: Poker&Gitar ($1.98 in chips) 
Seat 4: Apollonnn_13 ($1.88 in chips) 
Seat 5: Scaaalll ($2.25 in chips) 
Seat 6: Posaunengodi ($2 in chips) 
Mad_Clock: posts small blind $0.01
Poker&Gitar: posts big blind $0.02
*** HOLE CARDS ***
Dealt to Scaaalll [Qs 5d]
Apollonnn_13: folds 
Scaaalll: folds 
Posaunengodi: raises $0.04 to $0.06
bossquaid: folds 
Mad_Clock: folds 
Poker&Gitar: folds 
Uncalled bet ($0.04) returned to Posaunengodi
Posaunengodi collected $0.05 from pot
Posaunengodi: doesn't show hand 
*** SUMMARY ***
Total pot $0.05 | Rake $0 
Seat 1: bossquaid (button) folded before Flop (didn't bet)
Seat 2: Mad_Clock (small blind) folded before Flop
Seat 3: Poker&Gitar (big blind) folded before Flop
Seat 4: Apollonnn_13 folded before Flop (didn't bet)
Seat 5: Scaaalll folded before Flop (didn't bet)
Seat 6: Posaunengodi collected ($0.05)



PokerStars Zoom Hand #229232430753:  Hold'em No Limit ($0.01/$0.02) - 2021/08/21 22:50:27 CET [2021/08/21 16:50:27 ET]
Table 'Halley' 6-max Seat #1 is the button
Seat 1: kalina998 ($2.02 in chips) 
Seat 2: ppluiaule ($2.22 in chips) 
Seat 3: Scaaalll ($2.25 in chips) 
Seat 4: HDYD18 ($5.27 in chips) 
Seat 5: Kergie ($16.08 in chips) 
Seat 6: ash1448 ($3.72 in chips) 
ppluiaule: posts small blind $0.01
Scaaalll: posts big blind $0.02
*** HOLE CARDS ***
Dealt to Scaaalll [Kc 2s]
kalina998 is disconnected 
HDYD18: raises $0.04 to $0.06
Kergie: folds 
ash1448: folds 
kalina998: folds 
ppluiaule: folds 
Scaaalll: folds 
Uncalled bet ($0.04) returned to HDYD18
HDYD18 collected $0.05 from pot
HDYD18: doesn't show hand 
*** SUMMARY ***
Total pot $0.05 | Rake $0 
Seat 1: kalina998 (button) folded before Flop (didn't bet)
Seat 2: ppluiaule (small blind) folded before Flop
Seat 3: Scaaalll (big blind) folded before Flop
Seat 4: HDYD18 collected ($0.05)
Seat 5: Kergie folded before Flop (didn't bet)
Seat 6: ash1448 folded before Flop (didn't bet)



PokerStars Zoom Hand #229232439148:  Hold'em No Limit ($0.01/$0.02) - 2021/08/21 22:50:46 CET [2021/08/21 16:50:46 ET]
Table 'Halley' 6-max Seat #1 is the button
Seat 1: VovaU164 ($1.86 in chips) 
Seat 2: Scaaalll ($2.23 in chips) 
Seat 3: yurkaa_pf ($1.94 in chips) 
Seat 4: zallav ($3.28 in chips) 
Seat 5: pepope ($2.07 in chips) 
Seat 6: Fedor_Gar ($3.89 in chips) 
Scaaalll: posts small blind $0.01
yurkaa_pf: posts big blind $0.02
*** HOLE CARDS ***
Dealt to Scaaalll [Qc 6c]
zallav: folds 
zallav is disconnected 
pepope: folds 
Fedor_Gar: folds 
VovaU164: raises $0.02 to $0.04
yurkaa_pf is disconnected 
Scaaalll: folds 
yurkaa_pf: folds 
Uncalled bet ($0.02) returned to VovaU164
VovaU164 collected $0.05 from pot
VovaU164: doesn't show hand 
*** SUMMARY ***
Total pot $0.05 | Rake $0 
Seat 1: VovaU164 (button) collected ($0.05)
Seat 2: Scaaalll (small blind) folded before Flop
Seat 3: yurkaa_pf (big blind) folded before Flop
Seat 4: zallav folded before Flop (didn't bet)
Seat 5: pepope folded before Flop (didn't bet)
Seat 6: Fedor_Gar folded before Flop (didn't bet)



PokerStars Zoom Hand #229232443967:  Hold'em No Limit ($0.01/$0.02) - 2021/08/21 22:50:57 CET [2021/08/21 16:50:57 ET]
Table 'Halley' 6-max Seat #1 is the button
Seat 1: Ne0net ($6.38 in chips) 
Seat 2: Yangyang1407 ($2.11 in chips) 
Seat 3: Merlin_Arg ($2 in chips) 
Seat 4: Scaaalll ($2.22 in chips) 
Seat 5: Thaleshs ($4.01 in chips) 
Seat 6: Boris_Garich ($2.03 in chips) 
Yangyang1407: posts small blind $0.01
Merlin_Arg: posts big blind $0.02
*** HOLE CARDS ***
Dealt to Scaaalll [Kc Js]
Scaaalll: folds 
Thaleshs: folds 
Boris_Garich: folds 
Ne0net: folds 
Yangyang1407: folds 
Uncalled bet ($0.01) returned to Merlin_Arg
Merlin_Arg collected $0.02 from pot
Merlin_Arg: doesn't show hand 
*** SUMMARY ***
Total pot $0.02 | Rake $0 
Seat 1: Ne0net (button) folded before Flop (didn't bet)
Seat 2: Yangyang1407 (small blind) folded before Flop
Seat 3: Merlin_Arg (big blind) collected ($0.02)
Seat 4: Scaaalll folded before Flop (didn't bet)
Seat 5: Thaleshs folded before Flop (didn't bet)
Seat 6: Boris_Garich folded before Flop (didn't bet)



PokerStars Zoom Hand #229232449607:  Hold'em No Limit ($0.01/$0.02) - 2021/08/21 22:51:10 CET [2021/08/21 16:51:10 ET]
Table 'Halley' 6-max Seat #1 is the button
Seat 1: Herr.Hikke ($2.37 in chips) 
Seat 2: BlackhawKK's ($3 in chips) 
Seat 3: zaharoff74 ($2.07 in chips) 
Seat 4: rabbitmeat73 ($3.13 in chips) 
Seat 5: KonopDima ($2.13 in chips) 
Seat 6: Scaaalll ($2.22 in chips) 
BlackhawKK's: posts small blind $0.01
zaharoff74: posts big blind $0.02
*** HOLE CARDS ***
Dealt to Scaaalll [5s Kd]
rabbitmeat73: folds 
KonopDima: folds 
Scaaalll: folds 
Herr.Hikke: folds 
BlackhawKK's: folds 
Uncalled bet ($0.01) returned to zaharoff74
zaharoff74 collected $0.02 from pot
zaharoff74: doesn't show hand 
*** SUMMARY ***
Total pot $0.02 | Rake $0 
Seat 1: Herr.Hikke (button) folded before Flop (didn't bet)
Seat 2: BlackhawKK's (small blind) folded before Flop
Seat 3: zaharoff74 (big blind) collected ($0.02)
Seat 4: rabbitmeat73 folded before Flop (didn't bet)
Seat 5: KonopDima folded before Flop (didn't bet)
Seat 6: Scaaalll folded before Flop (didn't bet)



PokerStars Zoom Hand #229232451835:  Hold'em No Limit ($0.01/$0.02) - 2021/08/21 22:51:15 CET [2021/08/21 16:51:15 ET]
Table 'Halley' 6-max Seat #1 is the button
Seat 1: zbixxx ($4.78 in chips) 
Seat 2: MATIdf365 ($3.77 in chips) 
Seat 3: vovo4kapooh ($3.08 in chips) 
Seat 4: Kb013497 ($1.64 in chips) 
Seat 5: Scaaalll ($2.22 in chips) 
Seat 6: vvk22 ($1.93 in chips) 
MATIdf365: posts small blind $0.01
vovo4kapooh: posts big blind $0.02
*** HOLE CARDS ***
Dealt to Scaaalll [9s 3h]
Kb013497: folds 
Scaaalll: folds 
vvk22: folds 
zbixxx: raises $0.03 to $0.05
MATIdf365: folds 
vovo4kapooh: folds 
Uncalled bet ($0.03) returned to zbixxx
zbixxx collected $0.05 from pot
zbixxx: doesn't show hand 
*** SUMMARY ***
Total pot $0.05 | Rake $0 
Seat 1: zbixxx (button) collected ($0.05)
Seat 2: MATIdf365 (small blind) folded before Flop
Seat 3: vovo4kapooh (big blind) folded before Flop
Seat 4: Kb013497 folded before Flop (didn't bet)
Seat 5: Scaaalll folded before Flop (didn't bet)
Seat 6: vvk22 folded before Flop (didn't bet)



PokerStars Zoom Hand #229232453625:  Hold'em No Limit ($0.01/$0.02) - 2021/08/21 22:51:19 CET [2021/08/21 16:51:19 ET]
Table 'Halley' 6-max Seat #1 is the button
Seat 1: AlexGTPS ($2.43 in chips) 
Seat 2: Diogen07 ($1.59 in chips) 
Seat 3: Kb013497 ($1.64 in chips) 
Seat 4: Scaaalll ($2.22 in chips) 
Seat 5: WITKOW_AV ($2 in chips) 
Seat 6: Tibelloni ($2.71 in chips) 
Diogen07: posts small blind $0.01
Kb013497: posts big blind $0.02
*** HOLE CARDS ***
Dealt to Scaaalll [9c Tc]
Diogen07 is disconnected 
Scaaalll: raises $0.04 to $0.06
WITKOW_AV: folds 
Tibelloni: folds 
Tibelloni is disconnected 
AlexGTPS: raises $0.15 to $0.21
Diogen07: folds 
Kb013497: folds 
Scaaalll: folds 
Uncalled bet ($0.15) returned to AlexGTPS
AlexGTPS collected $0.15 from pot
AlexGTPS: doesn't show hand 
*** SUMMARY ***
Total pot $0.15 | Rake $0 
Seat 1: AlexGTPS (button) collected ($0.15)
Seat 2: Diogen07 (small blind) folded before Flop
Seat 3: Kb013497 (big blind) folded before Flop
Seat 4: Scaaalll folded before Flop
Seat 5: WITKOW_AV folded before Flop (didn't bet)
Seat 6: Tibelloni folded before Flop (didn't bet)



PokerStars Zoom Hand #229232446174:  Hold'em No Limit ($0.01/$0.02) - 2021/08/21 22:51:02 CET [2021/08/21 16:51:02 ET]
Table 'Halley' 6-max Seat #1 is the button
Seat 1: Scaaalll ($2.22 in chips) 
Seat 2: alphabeta1d ($2 in chips) 
Seat 3: auxy89 ($2.29 in chips) 
Seat 4: Kelingor ($4.25 in chips) 
Seat 5: Baksit79 ($1.17 in chips) 
Seat 6: Habarovs18 ($2.50 in chips) 
alphabeta1d: posts small blind $0.01
auxy89: posts big blind $0.02
*** HOLE CARDS ***
Dealt to Scaaalll [8h Kc]
Kelingor: raises $0.03 to $0.05
Habarovs18 is disconnected 
Baksit79: folds 
Habarovs18: folds 
Baksit79 is disconnected 
Scaaalll: folds 
alphabeta1d: folds 
auxy89: calls $0.03
*** FLOP *** [4c Js 6c]
auxy89: checks 
Kelingor: bets $0.06
auxy89: folds 
Uncalled bet ($0.06) returned to Kelingor
Kelingor collected $0.11 from pot
Kelingor: doesn't show hand 
auxy89 is disconnected 
*** SUMMARY ***
Total pot $0.11 | Rake $0 
Board [4c Js 6c]
Seat 1: Scaaalll (button) folded before Flop (didn't bet)
Seat 2: alphabeta1d (small blind) folded before Flop
Seat 3: auxy89 (big blind) folded on the Flop
Seat 4: Kelingor collected ($0.11)
Seat 5: Baksit79 folded before Flop (didn't bet)
Seat 6: Habarovs18 folded before Flop (didn't bet)



PokerStars Zoom Hand #229232460223:  Hold'em No Limit ($0.01/$0.02) - 2021/08/21 22:51:34 CET [2021/08/21 16:51:34 ET]
Table 'Halley' 6-max Seat #1 is the button
Seat 1: NecromiconP ($2.16 in chips) 
Seat 2: CrazyyParis ($2.15 in chips) 
Seat 3: Scaaalll ($2.16 in chips) 
Seat 4: squidy4 ($1 in chips) 
Seat 5: STE1NBERG ($3.96 in chips) 
Seat 6: dorro61966 ($1.16 in chips) 
CrazyyParis: posts small blind $0.01
Scaaalll: posts big blind $0.02
*** HOLE CARDS ***
Dealt to Scaaalll [Tc 7d]
squidy4: folds 
STE1NBERG: folds 
squidy4 is disconnected 
dorro61966: raises $0.02 to $0.04
NecromiconP: folds 
CrazyyParis: folds 
Scaaalll: folds 
Uncalled bet ($0.02) returned to dorro61966
dorro61966 collected $0.05 from pot
dorro61966: doesn't show hand 
*** SUMMARY ***
Total pot $0.05 | Rake $0 
Seat 1: NecromiconP (button) folded before Flop (didn't bet)
Seat 2: CrazyyParis (small blind) folded before Flop
Seat 3: Scaaalll (big blind) folded before Flop
Seat 4: squidy4 folded before Flop (didn't bet)
Seat 5: STE1NBERG folded before Flop (didn't bet)
Seat 6: dorro61966 collected ($0.05)



PokerStars Zoom Hand #229232467744:  Hold'em No Limit ($0.01/$0.02) - 2021/08/21 22:51:51 CET [2021/08/21 16:51:51 ET]
Table 'Halley' 6-max Seat #1 is the button
Seat 1: Espartacus5222 ($2.04 in chips) 
Seat 2: Scaaalll ($2.14 in chips) 
Seat 3: Coldact ($1.68 in chips) 
Seat 4: Ck@tih@ ($1.40 in chips) 
Seat 5: ca$hmeoutsid ($2.23 in chips) 
Seat 6: wstanula ($1.14 in chips) 
Scaaalll: posts small blind $0.01
Coldact: posts big blind $0.02
*** HOLE CARDS ***
Dealt to Scaaalll [5c 5h]
Ck@tih@: folds 
ca$hmeoutsid: folds 
wstanula: folds 
Espartacus5222: folds 
Scaaalll: raises $0.04 to $0.06
Coldact: calls $0.04
*** FLOP *** [Jh Ah 3h]
Scaaalll: checks 
Coldact: bets $0.06
Scaaalll: calls $0.06
*** TURN *** [Jh Ah 3h] [Tc]
Scaaalll: checks 
Coldact: bets $0.06
Scaaalll: folds 
Uncalled bet ($0.06) returned to Coldact
Coldact collected $0.23 from pot
Coldact: doesn't show hand 
*** SUMMARY ***
Total pot $0.24 | Rake $0.01 
Board [Jh Ah 3h Tc]
Seat 1: Espartacus5222 (button) folded before Flop (didn't bet)
Seat 2: Scaaalll (small blind) folded on the Turn
Seat 3: Coldact (big blind) collected ($0.23)
Seat 4: Ck@tih@ folded before Flop (didn't bet)
Seat 5: ca$hmeoutsid folded before Flop (didn't bet)
Seat 6: wstanula folded before Flop (didn't bet)



PokerStars Zoom Hand #229232489890:  Hold'em No Limit ($0.01/$0.02) - 2021/08/21 22:52:41 CET [2021/08/21 16:52:41 ET]
Table 'Halley' 6-max Seat #1 is the button
Seat 1: keb1981 ($2.13 in chips) 
Seat 2: Summerstrike ($3.88 in chips) 
Seat 3: gilberto98 ($2.12 in chips) 
Seat 4: Scaaalll ($2.02 in chips) 
Seat 5: MEZz828 ($1.95 in chips) 
Seat 6: Apollonnn_13 ($1.99 in chips) 
Summerstrike: posts small blind $0.01
gilberto98: posts big blind $0.02
*** HOLE CARDS ***
Dealt to Scaaalll [Jd Td]
Scaaalll: raises $0.04 to $0.06
MEZz828: folds 
Apollonnn_13: calls $0.06
keb1981: folds 
Summerstrike: folds 
Summerstrike is disconnected 
gilberto98: raises $0.19 to $0.25
Scaaalll: folds 
Apollonnn_13: folds 
Uncalled bet ($0.19) returned to gilberto98
gilberto98 collected $0.19 from pot
gilberto98: doesn't show hand 
*** SUMMARY ***
Total pot $0.19 | Rake $0 
Seat 1: keb1981 (button) folded before Flop (didn't bet)
Seat 2: Summerstrike (small blind) folded before Flop
Seat 3: gilberto98 (big blind) collected ($0.19)
Seat 4: Scaaalll folded before Flop
Seat 5: MEZz828 folded before Flop (didn't bet)
Seat 6: Apollonnn_13 folded before Flop



PokerStars Zoom Hand #229232496887:  Hold'em No Limit ($0.01/$0.02) - 2021/08/21 22:52:57 CET [2021/08/21 16:52:57 ET]
Table 'Halley' 6-max Seat #1 is the button
Seat 1: Scaaalll ($2 in chips) 
Seat 2: MattieBOZ ($1.98 in chips) 
Seat 3: kukulagosleep ($2.03 in chips) 
Seat 4: BigTestIcicle ($2.62 in chips) 
Seat 5: rekopo203 ($5.58 in chips) 
Seat 6: Hantsirg ($0.74 in chips) 
MattieBOZ: posts small blind $0.01
kukulagosleep: posts big blind $0.02
*** HOLE CARDS ***
Dealt to Scaaalll [5d 6c]
Hantsirg is disconnected 
MattieBOZ is disconnected 
BigTestIcicle: folds 
rekopo203: folds 
Hantsirg: folds 
Scaaalll: folds 
MattieBOZ: folds 
Uncalled bet ($0.01) returned to kukulagosleep
kukulagosleep collected $0.02 from pot
kukulagosleep: doesn't show hand 
*** SUMMARY ***
Total pot $0.02 | Rake $0 
Seat 1: Scaaalll (button) folded before Flop (didn't bet)
Seat 2: MattieBOZ (small blind) folded before Flop
Seat 3: kukulagosleep (big blind) collected ($0.02)
Seat 4: BigTestIcicle folded before Flop (didn't bet)
Seat 5: rekopo203 folded before Flop (didn't bet)
Seat 6: Hantsirg folded before Flop (didn't bet)



PokerStars Zoom Hand #229232501337:  Hold'em No Limit ($0.01/$0.02) - 2021/08/21 22:53:07 CET [2021/08/21 16:53:07 ET]
Table 'Halley' 6-max Seat #1 is the button
Seat 1: WITKOW_AV ($2.10 in chips) 
Seat 2: Xlavariable ($2 in chips) 
Seat 3: pipecmolodec ($2 in chips) 
Seat 4: LijanaV ($6.34 in chips) 
Seat 5: Apollonnn_13 ($1.73 in chips) 
Seat 6: Scaaalll ($2 in chips) 
Xlavariable: posts small blind $0.01
pipecmolodec: posts big blind $0.02
*** HOLE CARDS ***
Dealt to Scaaalll [Js 9s]
LijanaV: folds 
Apollonnn_13: folds 
LijanaV is disconnected 
Scaaalll: raises $0.04 to $0.06
WITKOW_AV: folds 
Xlavariable: folds 
pipecmolodec: folds 
Uncalled bet ($0.04) returned to Scaaalll
Scaaalll collected $0.05 from pot
Scaaalll: doesn't show hand 
*** SUMMARY ***
Total pot $0.05 | Rake $0 
Seat 1: WITKOW_AV (button) folded before Flop (didn't bet)
Seat 2: Xlavariable (small blind) folded before Flop
Seat 3: pipecmolodec (big blind) folded before Flop
Seat 4: LijanaV folded before Flop (didn't bet)
Seat 5: Apollonnn_13 folded before Flop (didn't bet)
Seat 6: Scaaalll collected ($0.05)



PokerStars Zoom Hand #229232513656:  Hold'em No Limit ($0.01/$0.02) - 2021/08/21 22:53:35 CET [2021/08/21 16:53:35 ET]
Table 'Halley' 6-max Seat #1 is the button
Seat 1: Boris_Garich ($2 in chips) 
Seat 2: polymorhp ($3.99 in chips) 
Seat 3: Scaaalll ($2.03 in chips) 
Seat 4: Apollonnn_13 ($1.71 in chips) 
Seat 5: slipknot956 ($2.08 in chips) 
Seat 6: Tacojesuscrisp ($2.22 in chips) 
polymorhp: posts small blind $0.01
Scaaalll: posts big blind $0.02
*** HOLE CARDS ***
Dealt to Scaaalll [Jd 6s]
Apollonnn_13: folds 
slipknot956: folds 
Tacojesuscrisp: folds 
Boris_Garich: raises $0.04 to $0.06
polymorhp: folds 
Scaaalll: folds 
Uncalled bet ($0.04) returned to Boris_Garich
Boris_Garich collected $0.05 from pot
Boris_Garich: doesn't show hand 
*** SUMMARY ***
Total pot $0.05 | Rake $0 
Seat 1: Boris_Garich (button) collected ($0.05)
Seat 2: polymorhp (small blind) folded before Flop
Seat 3: Scaaalll (big blind) folded before Flop
Seat 4: Apollonnn_13 folded before Flop (didn't bet)
Seat 5: slipknot956 folded before Flop (didn't bet)
Seat 6: Tacojesuscrisp folded before Flop (didn't bet)



PokerStars Zoom Hand #229232511426:  Hold'em No Limit ($0.01/$0.02) - 2021/08/21 22:53:30 CET [2021/08/21 16:53:30 ET]
Table 'Halley' 6-max Seat #1 is the button
Seat 1: Zero_sdk ($2.94 in chips) 
Seat 2: eastcoast777 ($1.81 in chips) 
Seat 3: Koldun 2636 ($2.71 in chips) 
Seat 4: mcisaac05 ($4.53 in chips) 
Seat 5: Scaaalll ($2.03 in chips) 
Seat 6: baksu12 ($2.66 in chips) 
eastcoast777: posts small blind $0.01
Koldun 2636: posts big blind $0.02
*** HOLE CARDS ***
Dealt to Scaaalll [6c 9h]
Zero_sdk is disconnected 
mcisaac05: raises $0.02 to $0.04
Scaaalll: folds 
baksu12: folds 
Zero_sdk: folds 
eastcoast777: calls $0.03
Koldun 2636: folds 
*** FLOP *** [3d 4c 8c]
eastcoast777: checks 
mcisaac05: checks 
*** TURN *** [3d 4c 8c] [Jh]
eastcoast777: checks 
mcisaac05: checks 
*** RIVER *** [3d 4c 8c Jh] [Td]
eastcoast777: checks 
mcisaac05: bets $0.10
eastcoast777: folds 
Uncalled bet ($0.10) returned to mcisaac05
mcisaac05 collected $0.10 from pot
mcisaac05: doesn't show hand 
*** SUMMARY ***
Total pot $0.10 | Rake $0 
Board [3d 4c 8c Jh Td]
Seat 1: Zero_sdk (button) folded before Flop (didn't bet)
Seat 2: eastcoast777 (small blind) folded on the River
Seat 3: Koldun 2636 (big blind) folded before Flop
Seat 4: mcisaac05 collected ($0.10)
Seat 5: Scaaalll folded before Flop (didn't bet)
Seat 6: baksu12 folded before Flop (didn't bet)



PokerStars Zoom Hand #229232529754:  Hold'em No Limit ($0.01/$0.02) - 2021/08/21 22:54:11 CET [2021/08/21 16:54:11 ET]
Table 'Halley' 6-max Seat #1 is the button
Seat 1: egopi ($2.11 in chips) 
Seat 2: Richaud ($2.37 in chips) 
Seat 3: rodrigoasor ($2.70 in chips) 
Seat 4: Earl_greyPL ($1.08 in chips) 
Seat 5: Scaaalll ($2 in chips) 
Seat 6: Posaunengodi ($2.15 in chips) 
Richaud: posts small blind $0.01
rodrigoasor: posts big blind $0.02
*** HOLE CARDS ***
Dealt to Scaaalll [7d 9c]
Earl_greyPL: folds 
Scaaalll: folds 
egopi is disconnected 
Posaunengodi: folds 
egopi: folds 
Richaud: raises $0.04 to $0.06
rodrigoasor: folds 
Uncalled bet ($0.04) returned to Richaud
Richaud collected $0.04 from pot
Richaud: doesn't show hand 
*** SUMMARY ***
Total pot $0.04 | Rake $0 
Seat 1: egopi (button) folded before Flop (didn't bet)
Seat 2: Richaud (small blind) collected ($0.04)
Seat 3: rodrigoasor (big blind) folded before Flop
Seat 4: Earl_greyPL folded before Flop (didn't bet)
Seat 5: Scaaalll folded before Flop (didn't bet)
Seat 6: Posaunengodi folded before Flop (didn't bet)



PokerStars Zoom Hand #229232531518:  Hold'em No Limit ($0.01/$0.02) - 2021/08/21 22:54:15 CET [2021/08/21 16:54:15 ET]
Table 'Halley' 6-max Seat #1 is the button
Seat 1: Scaaalll ($2 in chips) 
Seat 2: TomoKondo ($3.40 in chips) 
Seat 3: Apollonnn_13 ($1.88 in chips) 
Seat 4: AlexGTPS ($2.66 in chips) 
Seat 5: Tabitaji ($2.48 in chips) 
Seat 6: Earl_greyPL ($1.39 in chips) 
TomoKondo: posts small blind $0.01
Apollonnn_13: posts big blind $0.02
*** HOLE CARDS ***
Dealt to Scaaalll [9s 8s]
AlexGTPS: folds 
Tabitaji: folds 
Earl_greyPL: folds 
Scaaalll: raises $0.02 to $0.04
TomoKondo: raises $0.16 to $0.20
Apollonnn_13: folds 
Scaaalll: folds 
Uncalled bet ($0.16) returned to TomoKondo
TomoKondo collected $0.10 from pot
TomoKondo: doesn't show hand 
*** SUMMARY ***
Total pot $0.10 | Rake $0 
Seat 1: Scaaalll (button) folded before Flop
Seat 2: TomoKondo (small blind) collected ($0.10)
Seat 3: Apollonnn_13 (big blind) folded before Flop
Seat 4: AlexGTPS folded before Flop (didn't bet)
Seat 5: Tabitaji folded before Flop (didn't bet)
Seat 6: Earl_greyPL folded before Flop (didn't bet)



PokerStars Zoom Hand #229232519909:  Hold'em No Limit ($0.01/$0.02) - 2021/08/21 22:53:49 CET [2021/08/21 16:53:49 ET]
Table 'Halley' 6-max Seat #1 is the button
Seat 1: znak312 ($2 in chips) 
Seat 2: Scaaalll ($2.01 in chips) 
Seat 3: Dr.stromg ($5.62 in chips) 
Seat 4: kboskov123 ($2.32 in chips) 
Seat 5: MattieBOZ ($2.07 in chips) 
Seat 6: pipecmolodec ($2 in chips) 
Scaaalll: posts small blind $0.01
Dr.stromg: posts big blind $0.02
*** HOLE CARDS ***
Dealt to Scaaalll [2s 5h]
kboskov123: calls $0.02
MattieBOZ: folds 
MattieBOZ is disconnected 
pipecmolodec: folds 
znak312: raises $0.06 to $0.08
Scaaalll: folds 
Dr.stromg: folds 
kboskov123: calls $0.06
*** FLOP *** [9h 8d 3h]
kboskov123: checks 
znak312: checks 
*** TURN *** [9h 8d 3h] [6s]
kboskov123: bets $0.12
znak312: folds 
Uncalled bet ($0.12) returned to kboskov123
kboskov123 collected $0.18 from pot
kboskov123: doesn't show hand 
*** SUMMARY ***
Total pot $0.19 | Rake $0.01 
Board [9h 8d 3h 6s]
Seat 1: znak312 (button) folded on the Turn
Seat 2: Scaaalll (small blind) folded before Flop
Seat 3: Dr.stromg (big blind) folded before Flop
Seat 4: kboskov123 collected ($0.18)
Seat 5: MattieBOZ folded before Flop (didn't bet)
Seat 6: pipecmolodec folded before Flop (didn't bet)



PokerStars Zoom Hand #229232541063:  Hold'em No Limit ($0.01/$0.02) - 2021/08/21 22:54:37 CET [2021/08/21 16:54:37 ET]
Table 'Halley' 6-max Seat #1 is the button
Seat 1: causavera ($1.97 in chips) 
Seat 2: Tabitaji ($2.46 in chips) 
Seat 3: Sv1ch ($1.02 in chips) 
Seat 4: ussr246 ($1.50 in chips) 
Seat 5: CrazyyParis ($2 in chips) 
Seat 6: Scaaalll ($2 in chips) 
Tabitaji: posts small blind $0.01
Sv1ch: posts big blind $0.02
*** HOLE CARDS ***
Dealt to Scaaalll [Tc 5s]
ussr246: folds 
CrazyyParis: folds 
Scaaalll: folds 
causavera: raises $0.02 to $0.04
Tabitaji: folds 
Sv1ch: folds 
Uncalled bet ($0.02) returned to causavera
causavera collected $0.05 from pot
causavera: doesn't show hand 
*** SUMMARY ***
Total pot $0.05 | Rake $0 
Seat 1: causavera (button) collected ($0.05)
Seat 2: Tabitaji (small blind) folded before Flop
Seat 3: Sv1ch (big blind) folded before Flop
Seat 4: ussr246 folded before Flop (didn't bet)
Seat 5: CrazyyParis folded before Flop (didn't bet)
Seat 6: Scaaalll folded before Flop (didn't bet)



PokerStars Zoom Hand #229232544141:  Hold'em No Limit ($0.01/$0.02) - 2021/08/21 22:54:44 CET [2021/08/21 16:54:44 ET]
Table 'Halley' 6-max Seat #1 is the button
Seat 1: egopi ($1.20 in chips) 
Seat 2: polymorhp ($2.75 in chips) 
Seat 3: tittenholmes ($2.56 in chips) 
Seat 4: Scaaalll ($2 in chips) 
Seat 5: Tacojesuscrisp ($2.46 in chips) 
Seat 6: Herr.Hikke ($2.12 in chips) 
polymorhp: posts small blind $0.01
tittenholmes: posts big blind $0.02
*** HOLE CARDS ***
Dealt to Scaaalll [7s 6h]
egopi is disconnected 
Scaaalll: folds 
Tacojesuscrisp: folds 
Herr.Hikke: raises $0.04 to $0.06
egopi: folds 
polymorhp: folds 
tittenholmes: folds 
Uncalled bet ($0.04) returned to Herr.Hikke
Herr.Hikke collected $0.05 from pot
Herr.Hikke: doesn't show hand 
*** SUMMARY ***
Total pot $0.05 | Rake $0 
Seat 1: egopi (button) folded before Flop (didn't bet)
Seat 2: polymorhp (small blind) folded before Flop
Seat 3: tittenholmes (big blind) folded before Flop
Seat 4: Scaaalll folded before Flop (didn't bet)
Seat 5: Tacojesuscrisp folded before Flop (didn't bet)
Seat 6: Herr.Hikke collected ($0.05)



PokerStars Zoom Hand #229232539343:  Hold'em No Limit ($0.01/$0.02) - 2021/08/21 22:54:33 CET [2021/08/21 16:54:33 ET]
Table 'Halley' 6-max Seat #1 is the button
Seat 1: stUPolak ($2.01 in chips) 
Seat 2: bt710 ($4.85 in chips) 
Seat 3: sakourtele ($2.58 in chips) 
Seat 4: Scaaalll ($2 in chips) 
Seat 5: Dr.stromg ($3.12 in chips) 
Seat 6: HDYD18 ($5.57 in chips) 
bt710: posts small blind $0.01
sakourtele: posts big blind $0.02
*** HOLE CARDS ***
Dealt to Scaaalll [Kc 5c]
Scaaalll: folds 
Dr.stromg: folds 
HDYD18: folds 
stUPolak: raises $0.02 to $0.04
bt710: raises $0.12 to $0.16
sakourtele: folds 
stUPolak: folds 
Uncalled bet ($0.12) returned to bt710
bt710 collected $0.10 from pot
bt710: doesn't show hand 
*** SUMMARY ***
Total pot $0.10 | Rake $0 
Seat 1: stUPolak (button) folded before Flop
Seat 2: bt710 (small blind) collected ($0.10)
Seat 3: sakourtele (big blind) folded before Flop
Seat 4: Scaaalll folded before Flop (didn't bet)
Seat 5: Dr.stromg folded before Flop (didn't bet)
Seat 6: HDYD18 folded before Flop (didn't bet)



PokerStars Zoom Hand #229232548145:  Hold'em No Limit ($0.01/$0.02) - 2021/08/21 22:54:53 CET [2021/08/21 16:54:53 ET]
Table 'Halley' 6-max Seat #1 is the button
Seat 1: Sinad1302 ($1.74 in chips) 
Seat 2: zbixxx ($4.60 in chips) 
Seat 3: Scaaalll ($2 in chips) 
Seat 4: igara tigara ($1.96 in chips) 
Seat 5: CrazyyParis ($2.13 in chips) 
Seat 6: bananAAbandit ($4.10 in chips) 
zbixxx: posts small blind $0.01
Scaaalll: posts big blind $0.02
*** HOLE CARDS ***
Dealt to Scaaalll [Th 3s]
Sinad1302 is disconnected 
igara tigara: folds 
CrazyyParis: raises $0.02 to $0.04
bananAAbandit: folds 
Sinad1302: folds 
zbixxx: folds 
Scaaalll: folds 
Uncalled bet ($0.02) returned to CrazyyParis
CrazyyParis collected $0.05 from pot
CrazyyParis: doesn't show hand 
*** SUMMARY ***
Total pot $0.05 | Rake $0 
Seat 1: Sinad1302 (button) folded before Flop (didn't bet)
Seat 2: zbixxx (small blind) folded before Flop
Seat 3: Scaaalll (big blind) folded before Flop
Seat 4: igara tigara folded before Flop (didn't bet)
Seat 5: CrazyyParis collected ($0.05)
Seat 6: bananAAbandit folded before Flop (didn't bet)



PokerStars Zoom Hand #229232553484:  Hold'em No Limit ($0.01/$0.02) - 2021/08/21 22:55:06 CET [2021/08/21 16:55:06 ET]
Table 'Halley' 6-max Seat #1 is the button
Seat 1: vvk22 ($4.10 in chips) 
Seat 2: Scaaalll ($2 in chips) 
Seat 3: Thaleshs ($2.04 in chips) 
Seat 4: Buka1224 ($0.40 in chips) 
Seat 5: pepope ($2.12 in chips) 
Seat 6: kukulagosleep ($2.86 in chips) 
Scaaalll: posts small blind $0.01
Thaleshs: posts big blind $0.02
*** HOLE CARDS ***
Dealt to Scaaalll [2s 6s]
Buka1224: raises $0.38 to $0.40 and is all-in
pepope: folds 
kukulagosleep: folds 
vvk22: folds 
Scaaalll: folds 
Thaleshs: folds 
Uncalled bet ($0.38) returned to Buka1224
Buka1224 collected $0.05 from pot
Buka1224: doesn't show hand 
*** SUMMARY ***
Total pot $0.05 | Rake $0 
Seat 1: vvk22 (button) folded before Flop (didn't bet)
Seat 2: Scaaalll (small blind) folded before Flop
Seat 3: Thaleshs (big blind) folded before Flop
Seat 4: Buka1224 collected ($0.05)
Seat 5: pepope folded before Flop (didn't bet)
Seat 6: kukulagosleep folded before Flop (didn't bet)



PokerStars Zoom Hand #229232557051:  Hold'em No Limit ($0.01/$0.02) - 2021/08/21 22:55:17 CET [2021/08/21 16:55:17 ET]
Table 'Halley' 6-max Seat #1 is the button
Seat 1: YGrandmaster ($2.90 in chips) 
Seat 2: tolstii906 ($0.98 in chips) 
Seat 3: kboskov123 ($1.72 in chips) 
Seat 4: Scaaalll ($2 in chips) 
Seat 5: Richaud ($2.34 in chips) 
Seat 6: Gamer577 ($2.18 in chips) 
tolstii906: posts small blind $0.01
kboskov123: posts big blind $0.02
*** HOLE CARDS ***
Dealt to Scaaalll [Ac 5c]
Scaaalll: folds 
Richaud: raises $0.04 to $0.06
YGrandmaster is disconnected 
Gamer577: raises $0.15 to $0.21
YGrandmaster: folds 
tolstii906: folds 
kboskov123: folds 
Richaud: folds 
Uncalled bet ($0.15) returned to Gamer577
Gamer577 collected $0.15 from pot
Gamer577: doesn't show hand 
*** SUMMARY ***
Total pot $0.15 | Rake $0 
Seat 1: YGrandmaster (button) folded before Flop (didn't bet)
Seat 2: tolstii906 (small blind) folded before Flop
Seat 3: kboskov123 (big blind) folded before Flop
Seat 4: Scaaalll folded before Flop (didn't bet)
Seat 5: Richaud folded before Flop
Seat 6: Gamer577 collected ($0.15)



PokerStars Zoom Hand #229232558304:  Hold'em No Limit ($0.01/$0.02) - 2021/08/21 22:55:21 CET [2021/08/21 16:55:21 ET]
Table 'Halley' 6-max Seat #1 is the button
Seat 1: Scaaalll ($2 in chips) 
Seat 2: ash1448 ($10.94 in chips) 
Seat 3: KonopDima ($2 in chips) 
Seat 4: Healthys07 ($3.38 in chips) 
Seat 5: alphabeta1d ($2 in chips) 
Seat 6: boa juice ($1.83 in chips) 
ash1448: posts small blind $0.01
KonopDima: posts big blind $0.02
*** HOLE CARDS ***
Dealt to Scaaalll [Th 3d]
Healthys07: folds 
boa juice is disconnected 
alphabeta1d: folds 
boa juice: folds 
Scaaalll: folds 
ash1448: raises $0.04 to $0.06
KonopDima: folds 
Uncalled bet ($0.04) returned to ash1448
ash1448 collected $0.04 from pot
ash1448: doesn't show hand 
*** SUMMARY ***
Total pot $0.04 | Rake $0 
Seat 1: Scaaalll (button) folded before Flop (didn't bet)
Seat 2: ash1448 (small blind) collected ($0.04)
Seat 3: KonopDima (big blind) folded before Flop
Seat 4: Healthys07 folded before Flop (didn't bet)
Seat 5: alphabeta1d folded before Flop (didn't bet)
Seat 6: boa juice folded before Flop (didn't bet)



PokerStars Zoom Hand #229232559610:  Hold'em No Limit ($0.01/$0.02) - 2021/08/21 22:55:25 CET [2021/08/21 16:55:25 ET]
Table 'Halley' 6-max Seat #1 is the button
Seat 1: CrazyyParis ($2.15 in chips) 
Seat 2: YGrandmaster ($2.90 in chips) 
Seat 3: Fanatspartak ($0.82 in chips) 
Seat 4: astapowitsch ($2.33 in chips) 
Seat 5: Scaaalll ($2 in chips) 
Seat 6: levachok ($3.09 in chips) 
YGrandmaster: posts small blind $0.01
Fanatspartak: posts big blind $0.02
*** HOLE CARDS ***
Dealt to Scaaalll [4s 5h]
astapowitsch: folds 
Scaaalll: folds 
levachok: folds 
CrazyyParis: raises $0.03 to $0.05
YGrandmaster: raises $0.08 to $0.13
Fanatspartak: folds 
CrazyyParis: folds 
Uncalled bet ($0.08) returned to YGrandmaster
YGrandmaster collected $0.12 from pot
YGrandmaster: doesn't show hand 
*** SUMMARY ***
Total pot $0.12 | Rake $0 
Seat 1: CrazyyParis (button) folded before Flop
Seat 2: YGrandmaster (small blind) collected ($0.12)
Seat 3: Fanatspartak (big blind) folded before Flop
Seat 4: astapowitsch folded before Flop (didn't bet)
Seat 5: Scaaalll folded before Flop (didn't bet)
Seat 6: levachok folded before Flop (didn't bet)



PokerStars Zoom Hand #229232560885:  Hold'em No Limit ($0.01/$0.02) - 2021/08/21 22:55:29 CET [2021/08/21 16:55:29 ET]
Table 'Halley' 6-max Seat #1 is the button
Seat 1: znak312 ($2 in chips) 
Seat 2: Ogni ($5.52 in chips) 
Seat 3: Scaaalll ($2 in chips) 
Seat 4: zbixxx ($5.38 in chips) 
Seat 5: Posaunengodi ($2.41 in chips) 
Seat 6: gerhavfc ($1 in chips) 
Ogni: posts small blind $0.01
Scaaalll: posts big blind $0.02
*** HOLE CARDS ***
Dealt to Scaaalll [Js 3d]
zbixxx: folds 
Posaunengodi: folds 
gerhavfc: calls $0.02
znak312: folds 
Ogni: folds 
Scaaalll: checks 
*** FLOP *** [6c Kc Qs]
Scaaalll: checks 
gerhavfc: bets $0.05
Scaaalll: folds 
Uncalled bet ($0.05) returned to gerhavfc
gerhavfc collected $0.05 from pot
gerhavfc: doesn't show hand 
*** SUMMARY ***
Total pot $0.05 | Rake $0 
Board [6c Kc Qs]
Seat 1: znak312 (button) folded before Flop (didn't bet)
Seat 2: Ogni (small blind) folded before Flop
Seat 3: Scaaalll (big blind) folded on the Flop
Seat 4: zbixxx folded before Flop (didn't bet)
Seat 5: Posaunengodi folded before Flop (didn't bet)
Seat 6: gerhavfc collected ($0.05)



PokerStars Zoom Hand #229232568305:  Hold'em No Limit ($0.01/$0.02) - 2021/08/21 22:55:52 CET [2021/08/21 16:55:52 ET]
Table 'Halley' 6-max Seat #1 is the button
Seat 1: Habarovs18 ($2.47 in chips) 
Seat 2: Scaaalll ($2 in chips) 
Seat 3: NoEff0rt2w1n ($6.76 in chips) 
Seat 4: HDYD18 ($10.36 in chips) 
Seat 5: El Chicha.CL ($2.57 in chips) 
Seat 6: ash1448 ($3.89 in chips) 
Scaaalll: posts small blind $0.01
NoEff0rt2w1n: posts big blind $0.02
*** HOLE CARDS ***
Dealt to Scaaalll [3h Kd]
Habarovs18 is disconnected 
HDYD18: folds 
El Chicha.CL: folds 
ash1448: folds 
Habarovs18: folds 
Scaaalll: folds 
Uncalled bet ($0.01) returned to NoEff0rt2w1n
NoEff0rt2w1n collected $0.02 from pot
NoEff0rt2w1n: doesn't show hand 
*** SUMMARY ***
Total pot $0.02 | Rake $0 
Seat 1: Habarovs18 (button) folded before Flop (didn't bet)
Seat 2: Scaaalll (small blind) folded before Flop
Seat 3: NoEff0rt2w1n (big blind) collected ($0.02)
Seat 4: HDYD18 folded before Flop (didn't bet)
Seat 5: El Chicha.CL folded before Flop (didn't bet)
Seat 6: ash1448 folded before Flop (didn't bet)



PokerStars Zoom Hand #229232572194:  Hold'em No Limit ($0.01/$0.02) - 2021/08/21 22:56:04 CET [2021/08/21 16:56:04 ET]
Table 'Halley' 6-max Seat #1 is the button
Seat 1: tazar34_777 ($5.04 in chips) 
Seat 2: maliniak75 ($3.34 in chips) 
Seat 3: PapiMik3 ($6.15 in chips) 
Seat 4: Reipinguimm ($2 in chips) 
Seat 5: MattieBOZ ($2.12 in chips) 
Seat 6: Scaaalll ($2 in chips) 
maliniak75: posts small blind $0.01
PapiMik3: posts big blind $0.02
*** HOLE CARDS ***
Dealt to Scaaalll [Ac Qh]
MattieBOZ is disconnected 
Reipinguimm: folds 
MattieBOZ: folds 
Scaaalll: raises $0.04 to $0.06
tazar34_777: folds 
maliniak75: folds 
PapiMik3: folds 
Uncalled bet ($0.04) returned to Scaaalll
Scaaalll collected $0.05 from pot
Scaaalll: doesn't show hand 
*** SUMMARY ***
Total pot $0.05 | Rake $0 
Seat 1: tazar34_777 (button) folded before Flop (didn't bet)
Seat 2: maliniak75 (small blind) folded before Flop
Seat 3: PapiMik3 (big blind) folded before Flop
Seat 4: Reipinguimm folded before Flop (didn't bet)
Seat 5: MattieBOZ folded before Flop (didn't bet)
Seat 6: Scaaalll collected ($0.05)



PokerStars Zoom Hand #229232591092:  Hold'em No Limit ($0.01/$0.02) - 2021/08/21 22:56:24 CET [2021/08/21 16:56:24 ET]
Table 'Halley' 6-max Seat #1 is the button
Seat 1: Scaaalll ($2.03 in chips) 
Seat 2: Ne0net ($6.51 in chips) 
Seat 3: Merlin_Arg ($2 in chips) 
Seat 4: fishh_play ($3.23 in chips) 
Seat 5: Thaleshs ($3.69 in chips) 
Seat 6: osantos401 ($4.68 in chips) 
Ne0net: posts small blind $0.01
Merlin_Arg: posts big blind $0.02
*** HOLE CARDS ***
Dealt to Scaaalll [As Kd]
fishh_play: folds 
Thaleshs: folds 
osantos401: folds 
Scaaalll: raises $0.02 to $0.04
Ne0net: folds 
Merlin_Arg: calls $0.02
*** FLOP *** [Qd Ts 3h]
Merlin_Arg: checks 
Scaaalll: bets $0.06
Merlin_Arg: folds 
Uncalled bet ($0.06) returned to Scaaalll
Scaaalll collected $0.09 from pot
Scaaalll: doesn't show hand 
*** SUMMARY ***
Total pot $0.09 | Rake $0 
Board [Qd Ts 3h]
Seat 1: Scaaalll (button) collected ($0.09)
Seat 2: Ne0net (small blind) folded before Flop
Seat 3: Merlin_Arg (big blind) folded on the Flop
Seat 4: fishh_play folded before Flop (didn't bet)
Seat 5: Thaleshs folded before Flop (didn't bet)
Seat 6: osantos401 folded before Flop (didn't bet)



PokerStars Zoom Hand #229232600529:  Hold'em No Limit ($0.01/$0.02) - 2021/08/21 22:56:53 CET [2021/08/21 16:56:53 ET]
Table 'Halley' 6-max Seat #1 is the button
Seat 1: Chapaev136 ($5.12 in chips) 
Seat 2: Andnet ($2.06 in chips) 
Seat 3: zbixxx ($2.03 in chips) 
Seat 4: PEDACIT0 ($2.04 in chips) 
Seat 5: Scaaalll ($2.08 in chips) 
Seat 6: pavlo8855 ($2.04 in chips) 
Andnet: posts small blind $0.01
zbixxx: posts big blind $0.02
*** HOLE CARDS ***
Dealt to Scaaalll [3h 5s]
PEDACIT0: folds 
Scaaalll: folds 
pavlo8855: folds 
Chapaev136: raises $0.04 to $0.06
Andnet: folds 
zbixxx: folds 
Uncalled bet ($0.04) returned to Chapaev136
Chapaev136 collected $0.05 from pot
Chapaev136: doesn't show hand 
*** SUMMARY ***
Total pot $0.05 | Rake $0 
Seat 1: Chapaev136 (button) collected ($0.05)
Seat 2: Andnet (small blind) folded before Flop
Seat 3: zbixxx (big blind) folded before Flop
Seat 4: PEDACIT0 folded before Flop (didn't bet)
Seat 5: Scaaalll folded before Flop (didn't bet)
Seat 6: pavlo8855 folded before Flop (didn't bet)



PokerStars Zoom Hand #229232602481:  Hold'em No Limit ($0.01/$0.02) - 2021/08/21 22:56:59 CET [2021/08/21 16:56:59 ET]
Table 'Halley' 6-max Seat #1 is the button
Seat 1: Poker&Gitar ($1.91 in chips) 
Seat 2: vvk22 ($4.39 in chips) 
Seat 3: Scaaalll ($2.08 in chips) 
Seat 4: Vitalyi1970 ($3.63 in chips) 
Seat 5: Kb013497 ($2.17 in chips) 
Seat 6: KonopDima ($3.38 in chips) 
vvk22: posts small blind $0.01
Scaaalll: posts big blind $0.02
*** HOLE CARDS ***
Dealt to Scaaalll [9h 3h]
Vitalyi1970: folds 
Kb013497: folds 
KonopDima: folds 
Poker&Gitar: raises $0.04 to $0.06
vvk22: folds 
Scaaalll: folds 
Uncalled bet ($0.04) returned to Poker&Gitar
Poker&Gitar collected $0.05 from pot
Poker&Gitar: doesn't show hand 
*** SUMMARY ***
Total pot $0.05 | Rake $0 
Seat 1: Poker&Gitar (button) collected ($0.05)
Seat 2: vvk22 (small blind) folded before Flop
Seat 3: Scaaalll (big blind) folded before Flop
Seat 4: Vitalyi1970 folded before Flop (didn't bet)
Seat 5: Kb013497 folded before Flop (didn't bet)
Seat 6: KonopDima folded before Flop (didn't bet)



PokerStars Zoom Hand #229232611644:  Hold'em No Limit ($0.01/$0.02) - 2021/08/21 22:57:27 CET [2021/08/21 16:57:27 ET]
Table 'Halley' 6-max Seat #1 is the button
Seat 1: Mustang01373 ($1.71 in chips) 
Seat 2: RomiSex ($5.55 in chips) 
Seat 3: Merlin_Arg ($2.11 in chips) 
Seat 4: Hope2706 ($1.17 in chips) 
Seat 5: keb1981 ($2.37 in chips) 
Seat 6: Scaaalll ($2.06 in chips) 
RomiSex: posts small blind $0.01
Merlin_Arg: posts big blind $0.02
*** HOLE CARDS ***
Dealt to Scaaalll [4s 6c]
Hope2706: raises $0.04 to $0.06
keb1981: folds 
Scaaalll: folds 
Mustang01373: folds 
RomiSex: folds 
Merlin_Arg: folds 
Uncalled bet ($0.04) returned to Hope2706
Hope2706 collected $0.05 from pot
Hope2706: doesn't show hand 
*** SUMMARY ***
Total pot $0.05 | Rake $0 
Seat 1: Mustang01373 (button) folded before Flop (didn't bet)
Seat 2: RomiSex (small blind) folded before Flop
Seat 3: Merlin_Arg (big blind) folded before Flop
Seat 4: Hope2706 collected ($0.05)
Seat 5: keb1981 folded before Flop (didn't bet)
Seat 6: Scaaalll folded before Flop (didn't bet)



PokerStars Zoom Hand #229232613986:  Hold'em No Limit ($0.01/$0.02) - 2021/08/21 22:57:34 CET [2021/08/21 16:57:34 ET]
Table 'Halley' 6-max Seat #1 is the button
Seat 1: astapowitsch ($2.25 in chips) 
Seat 2: Scaaalll ($2.06 in chips) 
Seat 3: PapiMik3 ($6.26 in chips) 
Seat 4: shingo594 ($4.03 in chips) 
Seat 5: JTbukowski ($4.19 in chips) 
Seat 6: Feliciano16 ($3.53 in chips) 
Scaaalll: posts small blind $0.01
PapiMik3: posts big blind $0.02
*** HOLE CARDS ***
Dealt to Scaaalll [4s Kh]
shingo594: raises $0.04 to $0.06
JTbukowski: folds 
Feliciano16: folds 
astapowitsch: folds 
Scaaalll: folds 
PapiMik3: folds 
Uncalled bet ($0.04) returned to shingo594
shingo594 collected $0.05 from pot
shingo594: doesn't show hand 
*** SUMMARY ***
Total pot $0.05 | Rake $0 
Seat 1: astapowitsch (button) folded before Flop (didn't bet)
Seat 2: Scaaalll (small blind) folded before Flop
Seat 3: PapiMik3 (big blind) folded before Flop
Seat 4: shingo594 collected ($0.05)
Seat 5: JTbukowski folded before Flop (didn't bet)
Seat 6: Feliciano16 folded before Flop (didn't bet)



PokerStars Zoom Hand #229232606715:  Hold'em No Limit ($0.01/$0.02) - 2021/08/21 22:57:12 CET [2021/08/21 16:57:12 ET]
Table 'Halley' 6-max Seat #1 is the button
Seat 1: Scaaalll ($2.06 in chips) 
Seat 2: kahzura ($2 in chips) 
Seat 3: MEZz828 ($2.07 in chips) 
Seat 4: Bufre ($2.62 in chips) 
Seat 5: sg.32rus ($1.50 in chips) 
Seat 6: squidy4 ($2.73 in chips) 
kahzura: posts small blind $0.01
MEZz828: posts big blind $0.02
*** HOLE CARDS ***
Dealt to Scaaalll [Qs 8h]
Bufre: folds 
sg.32rus: folds 
squidy4: raises $0.04 to $0.06
Scaaalll: folds 
kahzura: calls $0.05
MEZz828: folds 
*** FLOP *** [9c Ac 7d]
kahzura: bets $0.09
squidy4: calls $0.09
*** TURN *** [9c Ac 7d] [Jh]
kahzura: checks 
squidy4: checks 
*** RIVER *** [9c Ac 7d Jh] [8s]
kahzura: bets $0.21
squidy4: folds 
Uncalled bet ($0.21) returned to kahzura
kahzura collected $0.31 from pot
kahzura: doesn't show hand 
squidy4 is disconnected 
*** SUMMARY ***
Total pot $0.32 | Rake $0.01 
Board [9c Ac 7d Jh 8s]
Seat 1: Scaaalll (button) folded before Flop (didn't bet)
Seat 2: kahzura (small blind) collected ($0.31)
Seat 3: MEZz828 (big blind) folded before Flop
Seat 4: Bufre folded before Flop (didn't bet)
Seat 5: sg.32rus folded before Flop (didn't bet)
Seat 6: squidy4 folded on the River



PokerStars Zoom Hand #229232620145:  Hold'em No Limit ($0.01/$0.02) - 2021/08/21 22:57:53 CET [2021/08/21 16:57:53 ET]
Table 'Halley' 6-max Seat #1 is the button
Seat 1: Ne0net ($2 in chips) 
Seat 2: F_oksi(BLR) ($4.46 in chips) 
Seat 3: Scaaalll ($2.05 in chips) 
Seat 4: juraa14 ($3.47 in chips) 
Seat 5: bananAAbandit ($4.72 in chips) 
Seat 6: Mac9Monty2 ($2.16 in chips) 
F_oksi(BLR): posts small blind $0.01
Scaaalll: posts big blind $0.02
*** HOLE CARDS ***
Dealt to Scaaalll [9s 3s]
juraa14: folds 
bananAAbandit: raises $0.04 to $0.06
Mac9Monty2: folds 
Ne0net: folds 
F_oksi(BLR): folds 
Scaaalll: folds 
Uncalled bet ($0.04) returned to bananAAbandit
bananAAbandit collected $0.05 from pot
bananAAbandit: doesn't show hand 
*** SUMMARY ***
Total pot $0.05 | Rake $0 
Seat 1: Ne0net (button) folded before Flop (didn't bet)
Seat 2: F_oksi(BLR) (small blind) folded before Flop
Seat 3: Scaaalll (big blind) folded before Flop
Seat 4: juraa14 folded before Flop (didn't bet)
Seat 5: bananAAbandit collected ($0.05)
Seat 6: Mac9Monty2 folded before Flop (didn't bet)



PokerStars Zoom Hand #229232618905:  Hold'em No Limit ($0.01/$0.02) - 2021/08/21 22:57:49 CET [2021/08/21 16:57:49 ET]
Table 'Halley' 6-max Seat #1 is the button
Seat 1: maressen ($2.02 in chips) 
Seat 2: jribeiros ($1.29 in chips) 
Seat 3: RrriotGrrrl ($3.93 in chips) 
Seat 4: Scaaalll ($2.05 in chips) 
Seat 5: IceTdannyB ($2.87 in chips) 
Seat 6: innexplus ($4.29 in chips) 
jribeiros: posts small blind $0.01
RrriotGrrrl: posts big blind $0.02
*** HOLE CARDS ***
Dealt to Scaaalll [Jc 6h]
Scaaalll: folds 
IceTdannyB: folds 
IceTdannyB is disconnected 
innexplus: folds 
maressen: raises $0.03 to $0.05
jribeiros: folds 
RrriotGrrrl: raises $0.19 to $0.24
maressen: calls $0.19
*** FLOP *** [7h 2s 3d]
RrriotGrrrl: bets $0.24
maressen: folds 
Uncalled bet ($0.24) returned to RrriotGrrrl
RrriotGrrrl collected $0.47 from pot
RrriotGrrrl: doesn't show hand 
*** SUMMARY ***
Total pot $0.49 | Rake $0.02 
Board [7h 2s 3d]
Seat 1: maressen (button) folded on the Flop
Seat 2: jribeiros (small blind) folded before Flop
Seat 3: RrriotGrrrl (big blind) collected ($0.47)
Seat 4: Scaaalll folded before Flop (didn't bet)
Seat 5: IceTdannyB folded before Flop (didn't bet)
Seat 6: innexplus folded before Flop (didn't bet)



PokerStars Zoom Hand #229232616582:  Hold'em No Limit ($0.01/$0.02) - 2021/08/21 22:57:42 CET [2021/08/21 16:57:42 ET]
Table 'Halley' 6-max Seat #1 is the button
Seat 1: kboskov123 ($2.01 in chips) 
Seat 2: Koldun 2636 ($3.94 in chips) 
Seat 3: elmex886 ($2.21 in chips) 
Seat 4: Healthys07 ($3.32 in chips) 
Seat 5: Scaaalll ($2.05 in chips) 
Seat 6: NecromiconP ($5.01 in chips) 
Koldun 2636: posts small blind $0.01
elmex886: posts big blind $0.02
*** HOLE CARDS ***
Dealt to Scaaalll [8d 7c]
Healthys07: raises $0.03 to $0.05
Scaaalll: folds 
NecromiconP: folds 
kboskov123: folds 
Koldun 2636: folds 
elmex886: calls $0.03
*** FLOP *** [3d Qc As]
elmex886: checks 
Healthys07: bets $0.06
elmex886: calls $0.06
*** TURN *** [3d Qc As] [2c]
elmex886: checks 
Healthys07: bets $0.12
elmex886: calls $0.12
*** RIVER *** [3d Qc As 2c] [5d]
elmex886: checks 
Healthys07: bets $0.23
elmex886: calls $0.23
*** SHOW DOWN ***
Healthys07: shows [Ah Qh] (two pair, Aces and Queens)
elmex886: mucks hand 
Healthys07 collected $0.90 from pot
*** SUMMARY ***
Total pot $0.93 | Rake $0.03 
Board [3d Qc As 2c 5d]
Seat 1: kboskov123 (button) folded before Flop (didn't bet)
Seat 2: Koldun 2636 (small blind) folded before Flop
Seat 3: elmex886 (big blind) mucked [Ac Tc]
Seat 4: Healthys07 showed [Ah Qh] and won ($0.90) with two pair, Aces and Queens
Seat 5: Scaaalll folded before Flop (didn't bet)
Seat 6: NecromiconP folded before Flop (didn't bet)



PokerStars Zoom Hand #229232627987:  Hold'em No Limit ($0.01/$0.02) - 2021/08/21 22:58:17 CET [2021/08/21 16:58:17 ET]
Table 'Halley' 6-max Seat #1 is the button
Seat 1: OmahaWheels ($4.31 in chips) 
Seat 2: Apollonnn_13 ($1.64 in chips) 
Seat 3: volf55321 ($1.13 in chips) 
Seat 4: dorro61966 ($1.27 in chips) 
Seat 5: bananAAbandit ($8.45 in chips) 
Seat 6: Scaaalll ($2.03 in chips) 
Apollonnn_13: posts small blind $0.01
volf55321: posts big blind $0.02
*** HOLE CARDS ***
Dealt to Scaaalll [5h 9s]
dorro61966: folds 
bananAAbandit: folds 
Scaaalll: folds 
OmahaWheels: raises $0.04 to $0.06
Apollonnn_13: folds 
volf55321: folds 
Uncalled bet ($0.04) returned to OmahaWheels
OmahaWheels collected $0.05 from pot
OmahaWheels: doesn't show hand 
volf55321 is disconnected 
*** SUMMARY ***
Total pot $0.05 | Rake $0 
Seat 1: OmahaWheels (button) collected ($0.05)
Seat 2: Apollonnn_13 (small blind) folded before Flop
Seat 3: volf55321 (big blind) folded before Flop
Seat 4: dorro61966 folded before Flop (didn't bet)
Seat 5: bananAAbandit folded before Flop (didn't bet)
Seat 6: Scaaalll folded before Flop (didn't bet)



PokerStars Zoom Hand #229232632485:  Hold'em No Limit ($0.01/$0.02) - 2021/08/21 22:58:31 CET [2021/08/21 16:58:31 ET]
Table 'Halley' 6-max Seat #1 is the button
Seat 1: so0love ($7.28 in chips) 
Seat 2: Scaaalll ($2.03 in chips) 
Seat 3: maliniak75 ($3.13 in chips) 
Seat 4: RomiSex ($5.44 in chips) 
Seat 5: F_oksi(BLR) ($4.45 in chips) 
Seat 6: Apollonnn_13 ($1.76 in chips) 
Scaaalll: posts small blind $0.01
maliniak75: posts big blind $0.02
*** HOLE CARDS ***
Dealt to Scaaalll [Jh Jc]
RomiSex: folds 
F_oksi(BLR): folds 
Apollonnn_13: folds 
so0love: folds 
Scaaalll: raises $0.04 to $0.06
maliniak75: calls $0.04
*** FLOP *** [9h Qd 6h]
Scaaalll: bets $0.08
maliniak75: raises $0.28 to $0.36
Scaaalll: calls $0.28
*** TURN *** [9h Qd 6h] [As]
Scaaalll: checks 
maliniak75: bets $2.71 and is all-in
Scaaalll: folds 
Uncalled bet ($2.71) returned to maliniak75
maliniak75 collected $0.81 from pot
maliniak75: doesn't show hand 
*** SUMMARY ***
Total pot $0.84 | Rake $0.03 
Board [9h Qd 6h As]
Seat 1: so0love (button) folded before Flop (didn't bet)
Seat 2: Scaaalll (small blind) folded on the Turn
Seat 3: maliniak75 (big blind) collected ($0.81)
Seat 4: RomiSex folded before Flop (didn't bet)
Seat 5: F_oksi(BLR) folded before Flop (didn't bet)
Seat 6: Apollonnn_13 folded before Flop (didn't bet)



PokerStars Zoom Hand #229232648668:  Hold'em No Limit ($0.01/$0.02) - 2021/08/21 22:59:21 CET [2021/08/21 16:59:21 ET]
Table 'Halley' 6-max Seat #1 is the button
Seat 1: pipecmolodec ($2.03 in chips) 
Seat 2: giselerebelo ($3.54 in chips) 
Seat 3: rodrigoasor ($3.14 in chips) 
Seat 4: Scaaalll ($2 in chips) 
Seat 5: F_oksi(BLR) ($4.11 in chips) 
Seat 6: tuolau ($4.08 in chips) 
giselerebelo: posts small blind $0.01
rodrigoasor: posts big blind $0.02
*** HOLE CARDS ***
Dealt to Scaaalll [2h Kc]
Scaaalll: folds 
F_oksi(BLR): folds 
tuolau: folds 
tuolau is disconnected 
pipecmolodec: raises $0.02 to $0.04
giselerebelo: folds 
rodrigoasor: folds 
Uncalled bet ($0.02) returned to pipecmolodec
pipecmolodec collected $0.05 from pot
pipecmolodec: doesn't show hand 
*** SUMMARY ***
Total pot $0.05 | Rake $0 
Seat 1: pipecmolodec (button) collected ($0.05)
Seat 2: giselerebelo (small blind) folded before Flop
Seat 3: rodrigoasor (big blind) folded before Flop
Seat 4: Scaaalll folded before Flop (didn't bet)
Seat 5: F_oksi(BLR) folded before Flop (didn't bet)
Seat 6: tuolau folded before Flop (didn't bet)



PokerStars Zoom Hand #229232650307:  Hold'em No Limit ($0.01/$0.02) - 2021/08/21 22:59:26 CET [2021/08/21 16:59:26 ET]
Table 'Halley' 6-max Seat #1 is the button
Seat 1: so0love ($3.92 in chips) 
Seat 2: Gamer577 ($2.03 in chips) 
Seat 3: astapowitsch ($2.18 in chips) 
Seat 4: Koldun 2636 ($4.01 in chips) 
Seat 5: Gofman A ($1.57 in chips) 
Seat 6: Scaaalll ($2 in chips) 
Gamer577: posts small blind $0.01
astapowitsch: posts big blind $0.02
*** HOLE CARDS ***
Dealt to Scaaalll [Jc 2d]
Koldun 2636: folds 
Gofman A: folds 
Scaaalll: folds 
so0love: folds 
Gamer577: folds 
Uncalled bet ($0.01) returned to astapowitsch
astapowitsch collected $0.02 from pot
astapowitsch: doesn't show hand 
*** SUMMARY ***
Total pot $0.02 | Rake $0 
Seat 1: so0love (button) folded before Flop (didn't bet)
Seat 2: Gamer577 (small blind) folded before Flop
Seat 3: astapowitsch (big blind) collected ($0.02)
Seat 4: Koldun 2636 folded before Flop (didn't bet)
Seat 5: Gofman A folded before Flop (didn't bet)
Seat 6: Scaaalll folded before Flop (didn't bet)



PokerStars Zoom Hand #229232654471:  Hold'em No Limit ($0.01/$0.02) - 2021/08/21 22:59:39 CET [2021/08/21 16:59:39 ET]
Table 'Halley' 6-max Seat #1 is the button
Seat 1: Scaaalll ($2 in chips) 
Seat 2: OFSHOR ($2 in chips) 
Seat 3: Sergio Rigel ($3.47 in chips) 
Seat 4: stanthema661 ($2.37 in chips) 
Seat 5: Merlin_Arg ($2.22 in chips) 
Seat 6: WITKOW_AV ($2.98 in chips) 
OFSHOR: posts small blind $0.01
Sergio Rigel: posts big blind $0.02
*** HOLE CARDS ***
Dealt to Scaaalll [5d 4c]
stanthema661: folds 
Merlin_Arg: folds 
stanthema661 is disconnected 
WITKOW_AV: folds 
Scaaalll: folds 
OFSHOR: folds 
Uncalled bet ($0.01) returned to Sergio Rigel
Sergio Rigel collected $0.02 from pot
Sergio Rigel: doesn't show hand 
*** SUMMARY ***
Total pot $0.02 | Rake $0 
Seat 1: Scaaalll (button) folded before Flop (didn't bet)
Seat 2: OFSHOR (small blind) folded before Flop
Seat 3: Sergio Rigel (big blind) collected ($0.02)
Seat 4: stanthema661 folded before Flop (didn't bet)
Seat 5: Merlin_Arg folded before Flop (didn't bet)
Seat 6: WITKOW_AV folded before Flop (didn't bet)



PokerStars Zoom Hand #229232655745:  Hold'em No Limit ($0.01/$0.02) - 2021/08/21 22:59:43 CET [2021/08/21 16:59:43 ET]
Table 'Halley' 6-max Seat #1 is the button
Seat 1: SILBERRRR ($1.87 in chips) 
Seat 2: kboskov123 ($2.44 in chips) 
Seat 3: sg.32rus ($2.03 in chips) 
Seat 4: polymorhp ($2.63 in chips) 
Seat 5: Scaaalll ($2 in chips) 
Seat 6: snowpepsi ($2.11 in chips) 
kboskov123: posts small blind $0.01
sg.32rus: posts big blind $0.02
*** HOLE CARDS ***
Dealt to Scaaalll [2h 7s]
polymorhp: folds 
Scaaalll: folds 
snowpepsi: folds 
SILBERRRR: raises $0.03 to $0.05
kboskov123: folds 
sg.32rus: folds 
Uncalled bet ($0.03) returned to SILBERRRR
SILBERRRR collected $0.05 from pot
SILBERRRR: doesn't show hand 
*** SUMMARY ***
Total pot $0.05 | Rake $0 
Seat 1: SILBERRRR (button) collected ($0.05)
Seat 2: kboskov123 (small blind) folded before Flop
Seat 3: sg.32rus (big blind) folded before Flop
Seat 4: polymorhp folded before Flop (didn't bet)
Seat 5: Scaaalll folded before Flop (didn't bet)
Seat 6: snowpepsi folded before Flop (didn't bet)



PokerStars Zoom Hand #229232657352:  Hold'em No Limit ($0.01/$0.02) - 2021/08/21 22:59:48 CET [2021/08/21 16:59:48 ET]
Table 'Halley' 6-max Seat #1 is the button
Seat 1: Merlin_Arg ($2 in chips) 
Seat 2: DiPchable ($0.89 in chips) 
Seat 3: nitzed12 ($2 in chips) 
Seat 4: Scaaalll ($2 in chips) 
Seat 5: guappa007 ($2.51 in chips) 
Seat 6: simensgh ($3.89 in chips) 
DiPchable: posts small blind $0.01
nitzed12: posts big blind $0.02
*** HOLE CARDS ***
Dealt to Scaaalll [8d 3h]
DiPchable is disconnected 
Scaaalll: folds 
guappa007: folds 
simensgh: folds 
Merlin_Arg: folds 
DiPchable: folds 
Uncalled bet ($0.01) returned to nitzed12
nitzed12 collected $0.02 from pot
nitzed12: doesn't show hand 
*** SUMMARY ***
Total pot $0.02 | Rake $0 
Seat 1: Merlin_Arg (button) folded before Flop (didn't bet)
Seat 2: DiPchable (small blind) folded before Flop
Seat 3: nitzed12 (big blind) collected ($0.02)
Seat 4: Scaaalll folded before Flop (didn't bet)
Seat 5: guappa007 folded before Flop (didn't bet)
Seat 6: simensgh folded before Flop (didn't bet)



PokerStars Zoom Hand #229232658982:  Hold'em No Limit ($0.01/$0.02) - 2021/08/21 22:59:53 CET [2021/08/21 16:59:53 ET]
Table 'Halley' 6-max Seat #1 is the button
Seat 1: Hope2706 ($1.36 in chips) 
Seat 2: Dr.stromg ($3.72 in chips) 
Seat 3: Scaaalll ($2 in chips) 
Seat 4: Kb013497 ($1.91 in chips) 
Seat 5: WITKOW_AV ($2.08 in chips) 
Seat 6: rodrigoasor ($3.11 in chips) 
Dr.stromg: posts small blind $0.01
Scaaalll: posts big blind $0.02
*** HOLE CARDS ***
Dealt to Scaaalll [Qd Ks]
Kb013497: folds 
WITKOW_AV: raises $0.04 to $0.06
rodrigoasor: folds 
Hope2706: raises $0.04 to $0.10
Dr.stromg: folds 
Scaaalll: folds 
WITKOW_AV: calls $0.04
*** FLOP *** [Td 6h 5d]
WITKOW_AV: checks 
Hope2706: bets $0.11
WITKOW_AV: folds 
Uncalled bet ($0.11) returned to Hope2706
Hope2706 collected $0.22 from pot
Hope2706: doesn't show hand 
*** SUMMARY ***
Total pot $0.23 | Rake $0.01 
Board [Td 6h 5d]
Seat 1: Hope2706 (button) collected ($0.22)
Seat 2: Dr.stromg (small blind) folded before Flop
Seat 3: Scaaalll (big blind) folded before Flop
Seat 4: Kb013497 folded before Flop (didn't bet)
Seat 5: WITKOW_AV folded on the Flop
Seat 6: rodrigoasor folded before Flop (didn't bet)



PokerStars Zoom Hand #229232664367:  Hold'em No Limit ($0.01/$0.02) - 2021/08/21 23:00:09 CET [2021/08/21 17:00:09 ET]
Table 'Halley' 6-max Seat #1 is the button
Seat 1: Scaaalll ($2 in chips) 
Seat 2: z3317111711 ($6.28 in chips) 
Seat 3: KRITAYA ($1.09 in chips) 
Seat 4: rodrigoasor ($4.48 in chips) 
Seat 5: Tibeau21 ($0.78 in chips) 
Seat 6: Kedziorboy ($1.76 in chips) 
z3317111711: posts small blind $0.01
KRITAYA: posts big blind $0.02
*** HOLE CARDS ***
Dealt to Scaaalll [8s Jc]
Kedziorboy is disconnected 
rodrigoasor: folds 
Tibeau21: folds 
Kedziorboy: folds 
Scaaalll: folds 
z3317111711: folds 
Uncalled bet ($0.01) returned to KRITAYA
KRITAYA collected $0.02 from pot
KRITAYA: doesn't show hand 
*** SUMMARY ***
Total pot $0.02 | Rake $0 
Seat 1: Scaaalll (button) folded before Flop (didn't bet)
Seat 2: z3317111711 (small blind) folded before Flop
Seat 3: KRITAYA (big blind) collected ($0.02)
Seat 4: rodrigoasor folded before Flop (didn't bet)
Seat 5: Tibeau21 folded before Flop (didn't bet)
Seat 6: Kedziorboy folded before Flop (didn't bet)



PokerStars Zoom Hand #229232668089:  Hold'em No Limit ($0.01/$0.02) - 2021/08/21 23:00:20 CET [2021/08/21 17:00:20 ET]
Table 'Halley' 6-max Seat #1 is the button
Seat 1: STE1NBERG ($4.11 in chips) 
Seat 2: CordiPS ($3.59 in chips) 
Seat 3: egopi ($0.96 in chips) 
Seat 4: Phoenixxxxxxxx ($7.76 in chips) 
Seat 5: Scaaalll ($2 in chips) 
Seat 6: storo98 ($15.08 in chips) 
CordiPS: posts small blind $0.01
egopi: posts big blind $0.02
*** HOLE CARDS ***
Dealt to Scaaalll [8s 7d]
Phoenixxxxxxxx: folds 
Scaaalll: folds 
storo98: folds 
STE1NBERG: raises $0.03 to $0.05
CordiPS: folds 
egopi: folds 
Uncalled bet ($0.03) returned to STE1NBERG
STE1NBERG collected $0.05 from pot
STE1NBERG: doesn't show hand 
egopi is disconnected 
*** SUMMARY ***
Total pot $0.05 | Rake $0 
Seat 1: STE1NBERG (button) collected ($0.05)
Seat 2: CordiPS (small blind) folded before Flop
Seat 3: egopi (big blind) folded before Flop
Seat 4: Phoenixxxxxxxx folded before Flop (didn't bet)
Seat 5: Scaaalll folded before Flop (didn't bet)
Seat 6: storo98 folded before Flop (didn't bet)



PokerStars Zoom Hand #229232665716:  Hold'em No Limit ($0.01/$0.02) - 2021/08/21 23:00:13 CET [2021/08/21 17:00:13 ET]
Table 'Halley' 6-max Seat #1 is the button
Seat 1: HDYD18 ($10.16 in chips) 
Seat 2: Tibeau21 ($0.78 in chips) 
Seat 3: _TsarukV_12 ($6.74 in chips) 
Seat 4: Espartacus5222 ($5.43 in chips) 
Seat 5: TTGemi ($2 in chips) 
Seat 6: Scaaalll ($2 in chips) 
Tibeau21: posts small blind $0.01
_TsarukV_12: posts big blind $0.02
*** HOLE CARDS ***
Dealt to Scaaalll [3c 9d]
Espartacus5222: folds 
TTGemi: folds 
Scaaalll: folds 
HDYD18: folds 
Tibeau21: calls $0.01
_TsarukV_12: checks 
*** FLOP *** [Kh 6s 9c]
Tibeau21: checks 
_TsarukV_12: checks 
*** TURN *** [Kh 6s 9c] [Qh]
Tibeau21: bets $0.02
_TsarukV_12: calls $0.02
*** RIVER *** [Kh 6s 9c Qh] [4s]
Tibeau21: checks 
_TsarukV_12: bets $0.08
Tibeau21: folds 
Uncalled bet ($0.08) returned to _TsarukV_12
_TsarukV_12 collected $0.08 from pot
_TsarukV_12: doesn't show hand 
*** SUMMARY ***
Total pot $0.08 | Rake $0 
Board [Kh 6s 9c Qh 4s]
Seat 1: HDYD18 (button) folded before Flop (didn't bet)
Seat 2: Tibeau21 (small blind) folded on the River
Seat 3: _TsarukV_12 (big blind) collected ($0.08)
Seat 4: Espartacus5222 folded before Flop (didn't bet)
Seat 5: TTGemi folded before Flop (didn't bet)
Seat 6: Scaaalll folded before Flop (didn't bet)



PokerStars Zoom Hand #229232669435:  Hold'em No Limit ($0.01/$0.02) - 2021/08/21 23:00:24 CET [2021/08/21 17:00:24 ET]
Table 'Halley' 6-max Seat #1 is the button
Seat 1: simensgh ($3.91 in chips) 
Seat 2: Hope2706 ($1.48 in chips) 
Seat 3: eastcoast777 ($2.29 in chips) 
Seat 4: Scaaalll ($2 in chips) 
Seat 5: znak312 ($2.10 in chips) 
Seat 6: bioern ($2.06 in chips) 
Hope2706: posts small blind $0.01
eastcoast777: posts big blind $0.02
*** HOLE CARDS ***
Dealt to Scaaalll [7d Ts]
Hope2706 is disconnected 
Scaaalll: folds 
znak312: folds 
bioern: raises $0.04 to $0.06
simensgh: folds 
Hope2706: folds 
eastcoast777: calls $0.04
*** FLOP *** [5c Jh Kd]
eastcoast777: checks 
bioern: bets $0.16
eastcoast777: folds 
Uncalled bet ($0.16) returned to bioern
bioern collected $0.13 from pot
bioern: doesn't show hand 
*** SUMMARY ***
Total pot $0.13 | Rake $0 
Board [5c Jh Kd]
Seat 1: simensgh (button) folded before Flop (didn't bet)
Seat 2: Hope2706 (small blind) folded before Flop
Seat 3: eastcoast777 (big blind) folded on the Flop
Seat 4: Scaaalll folded before Flop (didn't bet)
Seat 5: znak312 folded before Flop (didn't bet)
Seat 6: bioern collected ($0.13)



PokerStars Zoom Hand #229232670809:  Hold'em No Limit ($0.01/$0.02) - 2021/08/21 23:00:28 CET [2021/08/21 17:00:28 ET]
Table 'Halley' 6-max Seat #1 is the button
Seat 1: Ne0net ($6.60 in chips) 
Seat 2: didiclavi777 ($2.27 in chips) 
Seat 3: Hope2706 ($1.47 in chips) 
Seat 4: Scaaalll ($2 in chips) 
Seat 5: staviko ($2 in chips) 
Seat 6: KRITAYA ($1.36 in chips) 
didiclavi777: posts small blind $0.01
Hope2706: posts big blind $0.02
*** HOLE CARDS ***
Dealt to Scaaalll [8c 7d]
Scaaalll: folds 
staviko: folds 
KRITAYA: raises $0.03 to $0.05
Ne0net: calls $0.05
Hope2706 is disconnected 
didiclavi777: folds 
Hope2706: folds 
*** FLOP *** [6s As 5c]
KRITAYA: checks 
Ne0net: checks 
*** TURN *** [6s As 5c] [8d]
KRITAYA: checks 
Ne0net: checks 
*** RIVER *** [6s As 5c 8d] [8s]
KRITAYA: checks 
Ne0net: checks 
*** SHOW DOWN ***
KRITAYA: shows [Jd Kd] (a pair of Eights)
Ne0net: shows [Kh Jh] (a pair of Eights)
KRITAYA collected $0.07 from pot
Ne0net collected $0.06 from pot
*** SUMMARY ***
Total pot $0.13 | Rake $0 
Board [6s As 5c 8d 8s]
Seat 1: Ne0net (button) showed [Kh Jh] and won ($0.06) with a pair of Eights
Seat 2: didiclavi777 (small blind) folded before Flop
Seat 3: Hope2706 (big blind) folded before Flop
Seat 4: Scaaalll folded before Flop (didn't bet)
Seat 5: staviko folded before Flop (didn't bet)
Seat 6: KRITAYA showed [Jd Kd] and won ($0.07) with a pair of Eights



PokerStars Zoom Hand #229232662983:  Hold'em No Limit ($0.01/$0.02) - 2021/08/21 23:00:05 CET [2021/08/21 17:00:05 ET]
Table 'Halley' 6-max Seat #1 is the button
Seat 1: Xlavariable ($2.02 in chips) 
Seat 2: Scaaalll ($2 in chips) 
Seat 3: elmex886 ($2 in chips) 
Seat 4: kboskov123 ($2.43 in chips) 
Seat 5: Shaimiev ($2.51 in chips) 
Seat 6: anes.v. ($2.62 in chips) 
Scaaalll: posts small blind $0.01
elmex886: posts big blind $0.02
*** HOLE CARDS ***
Dealt to Scaaalll [2d 9c]
Shaimiev is disconnected 
kboskov123: folds 
Shaimiev: folds 
anes.v.: raises $0.02 to $0.04
Xlavariable: folds 
Scaaalll: folds 
elmex886: calls $0.02
*** FLOP *** [8d 5h 3d]
elmex886: checks 
anes.v.: checks 
*** TURN *** [8d 5h 3d] [6c]
elmex886: checks 
anes.v.: checks 
*** RIVER *** [8d 5h 3d 6c] [7h]
elmex886: checks 
anes.v.: bets $0.07
elmex886: folds 
Uncalled bet ($0.07) returned to anes.v.
anes.v. collected $0.09 from pot
anes.v.: doesn't show hand 
*** SUMMARY ***
Total pot $0.09 | Rake $0 
Board [8d 5h 3d 6c 7h]
Seat 1: Xlavariable (button) folded before Flop (didn't bet)
Seat 2: Scaaalll (small blind) folded before Flop
Seat 3: elmex886 (big blind) folded on the River
Seat 4: kboskov123 folded before Flop (didn't bet)
Seat 5: Shaimiev folded before Flop (didn't bet)
Seat 6: anes.v. collected ($0.09)



PokerStars Zoom Hand #229232674267:  Hold'em No Limit ($0.01/$0.02) - 2021/08/21 23:00:38 CET [2021/08/21 17:00:38 ET]
Table 'Halley' 6-max Seat #1 is the button
Seat 1: Ogni ($5.26 in chips) 
Seat 2: Scaaalll ($2 in chips) 
Seat 3: GregHarrison ($1.37 in chips) 
Seat 4: PapiMik3 ($3.56 in chips) 
Seat 5: EevAA190 ($2.03 in chips) 
Seat 6: egroj1700 ($2.04 in chips) 
Scaaalll: posts small blind $0.01
GregHarrison: posts big blind $0.02
*** HOLE CARDS ***
Dealt to Scaaalll [Ks Ts]
PapiMik3: folds 
EevAA190: folds 
egroj1700: folds 
Ogni: raises $0.03 to $0.05
Scaaalll: calls $0.04
GregHarrison: calls $0.03
*** FLOP *** [As 7d Td]
Scaaalll: checks 
GregHarrison: checks 
Ogni: bets $0.07
GregHarrison is disconnected 
Scaaalll: calls $0.07
GregHarrison: folds 
*** TURN *** [As 7d Td] [Qs]
Scaaalll: checks 
Ogni: checks 
*** RIVER *** [As 7d Td Qs] [Ah]
Scaaalll: checks 
Ogni: bets $0.14
Scaaalll: folds 
Uncalled bet ($0.14) returned to Ogni
Ogni collected $0.28 from pot
Ogni: doesn't show hand 
*** SUMMARY ***
Total pot $0.29 | Rake $0.01 
Board [As 7d Td Qs Ah]
Seat 1: Ogni (button) collected ($0.28)
Seat 2: Scaaalll (small blind) folded on the River
Seat 3: GregHarrison (big blind) folded on the Flop
Seat 4: PapiMik3 folded before Flop (didn't bet)
Seat 5: EevAA190 folded before Flop (didn't bet)
Seat 6: egroj1700 folded before Flop (didn't bet)



PokerStars Zoom Hand #229232692955:  Hold'em No Limit ($0.01/$0.02) - 2021/08/21 23:01:25 CET [2021/08/21 17:01:25 ET]
Table 'Halley' 6-max Seat #1 is the button
Seat 1: cr@sh test ($2.01 in chips) 
Seat 2: Ck@tih@ ($1.94 in chips) 
Seat 3: Scaaalll ($2 in chips) 
Seat 4: nitzed12 ($2 in chips) 
Seat 5: STE1NBERG ($4.11 in chips) 
Seat 6: joaofred91 ($1.31 in chips) 
Ck@tih@: posts small blind $0.01
Scaaalll: posts big blind $0.02
*** HOLE CARDS ***
Dealt to Scaaalll [8d 7c]
nitzed12: folds 
STE1NBERG: folds 
joaofred91: folds 
joaofred91 is disconnected 
cr@sh test: raises $0.02 to $0.04
Ck@tih@: folds 
Scaaalll: folds 
Uncalled bet ($0.02) returned to cr@sh test
cr@sh test collected $0.05 from pot
cr@sh test: doesn't show hand 
*** SUMMARY ***
Total pot $0.05 | Rake $0 
Seat 1: cr@sh test (button) collected ($0.05)
Seat 2: Ck@tih@ (small blind) folded before Flop
Seat 3: Scaaalll (big blind) folded before Flop
Seat 4: nitzed12 folded before Flop (didn't bet)
Seat 5: STE1NBERG folded before Flop (didn't bet)
Seat 6: joaofred91 folded before Flop (didn't bet)



PokerStars Zoom Hand #229232698628:  Hold'em No Limit ($0.01/$0.02) - 2021/08/21 23:01:39 CET [2021/08/21 17:01:39 ET]
Table 'Halley' 6-max Seat #1 is the button
Seat 1: Scaaalll ($2 in chips) 
Seat 2: HDYD18 ($3.44 in chips) 
Seat 3: Mac9Monty2 ($2 in chips) 
Seat 4: tassy237 ($1.40 in chips) 
Seat 5: Ne0net ($6.61 in chips) 
Seat 6: leeroy818 ($2.14 in chips) 
HDYD18: posts small blind $0.01
Mac9Monty2: posts big blind $0.02
*** HOLE CARDS ***
Dealt to Scaaalll [Js 4s]
tassy237: raises $0.04 to $0.06
Ne0net: folds 
leeroy818: folds 
Scaaalll: folds 
HDYD18: folds 
Mac9Monty2: folds 
Uncalled bet ($0.04) returned to tassy237
tassy237 collected $0.05 from pot
tassy237: doesn't show hand 
*** SUMMARY ***
Total pot $0.05 | Rake $0 
Seat 1: Scaaalll (button) folded before Flop (didn't bet)
Seat 2: HDYD18 (small blind) folded before Flop
Seat 3: Mac9Monty2 (big blind) folded before Flop
Seat 4: tassy237 collected ($0.05)
Seat 5: Ne0net folded before Flop (didn't bet)
Seat 6: leeroy818 folded before Flop (didn't bet)



PokerStars Zoom Hand #229232710528:  Hold'em No Limit ($0.01/$0.02) - 2021/08/21 23:02:07 CET [2021/08/21 17:02:07 ET]
Table 'Halley' 6-max Seat #1 is the button
Seat 1: z3317111711 ($6.30 in chips) 
Seat 2: Scaaalll ($2 in chips) 
Seat 3: NetoFLX ($2 in chips) 
Seat 4: kumanotiger ($1.70 in chips) 
Seat 5: keldh ($3.68 in chips) 
Seat 6: A.luckebeggr ($5.59 in chips) 
Scaaalll: posts small blind $0.01
NetoFLX: posts big blind $0.02
*** HOLE CARDS ***
Dealt to Scaaalll [9s Th]
kumanotiger: folds 
keldh: folds 
A.luckebeggr: folds 
z3317111711: folds 
Scaaalll: folds 
Uncalled bet ($0.01) returned to NetoFLX
NetoFLX collected $0.02 from pot
NetoFLX: doesn't show hand 
*** SUMMARY ***
Total pot $0.02 | Rake $0 
Seat 1: z3317111711 (button) folded before Flop (didn't bet)
Seat 2: Scaaalll (small blind) folded before Flop
Seat 3: NetoFLX (big blind) collected ($0.02)
Seat 4: kumanotiger folded before Flop (didn't bet)
Seat 5: keldh folded before Flop (didn't bet)
Seat 6: A.luckebeggr folded before Flop (didn't bet)



PokerStars Zoom Hand #229232717536:  Hold'em No Limit ($0.01/$0.02) - 2021/08/21 23:02:23 CET [2021/08/21 17:02:23 ET]
Table 'Halley' 6-max Seat #1 is the button
Seat 1: innexplus ($4.87 in chips) 
Seat 2: Ck@tih@ ($1.82 in chips) 
Seat 3: kavli ($1 in chips) 
Seat 4: REDCOBRA 1 ($0.58 in chips) 
Seat 5: Scaaalll ($2 in chips) 
Seat 6: YGrandmaster ($3.02 in chips) 
Ck@tih@: posts small blind $0.01
kavli: posts big blind $0.02
*** HOLE CARDS ***
Dealt to Scaaalll [Qd 4s]
REDCOBRA 1: folds 
Scaaalll: folds 
REDCOBRA 1 is disconnected 
YGrandmaster: folds 
innexplus: folds 
YGrandmaster is disconnected 
Ck@tih@: folds 
Uncalled bet ($0.01) returned to kavli
kavli collected $0.02 from pot
kavli: doesn't show hand 
*** SUMMARY ***
Total pot $0.02 | Rake $0 
Seat 1: innexplus (button) folded before Flop (didn't bet)
Seat 2: Ck@tih@ (small blind) folded before Flop
Seat 3: kavli (big blind) collected ($0.02)
Seat 4: REDCOBRA 1 folded before Flop (didn't bet)
Seat 5: Scaaalll folded before Flop (didn't bet)
Seat 6: YGrandmaster folded before Flop (didn't bet)



PokerStars Zoom Hand #229232715807:  Hold'em No Limit ($0.01/$0.02) - 2021/08/21 23:02:19 CET [2021/08/21 17:02:19 ET]
Table 'Halley' 6-max Seat #1 is the button
Seat 1: EevAA190 ($2.02 in chips) 
Seat 2: NecromiconP ($3.95 in chips) 
Seat 3: Jones278 ($2.35 in chips) 
Seat 4: Scaaalll ($2 in chips) 
Seat 5: abbadol ($0.82 in chips) 
Seat 6: SirBatish ($3.14 in chips) 
NecromiconP: posts small blind $0.01
Jones278: posts big blind $0.02
*** HOLE CARDS ***
Dealt to Scaaalll [8d 6s]
Scaaalll: folds 
abbadol: folds 
SirBatish: raises $0.04 to $0.06
EevAA190: folds 
NecromiconP: folds 
Jones278: folds 
Uncalled bet ($0.04) returned to SirBatish
SirBatish collected $0.05 from pot
SirBatish: doesn't show hand 
*** SUMMARY ***
Total pot $0.05 | Rake $0 
Seat 1: EevAA190 (button) folded before Flop (didn't bet)
Seat 2: NecromiconP (small blind) folded before Flop
Seat 3: Jones278 (big blind) folded before Flop
Seat 4: Scaaalll folded before Flop (didn't bet)
Seat 5: abbadol folded before Flop (didn't bet)
Seat 6: SirBatish collected ($0.05)



PokerStars Zoom Hand #229232712932:  Hold'em No Limit ($0.01/$0.02) - 2021/08/21 23:02:12 CET [2021/08/21 17:02:12 ET]
Table 'Halley' 6-max Seat #1 is the button
Seat 1: Scaaalll ($2 in chips) 
Seat 2: causavera ($1.34 in chips) 
Seat 3: NoEff0rt2w1n ($2.71 in chips) 
Seat 4: oleg12312441 ($0.86 in chips) 
Seat 5: HDYD18 ($2.50 in chips) 
Seat 6: S3XY_PADRE ($3.42 in chips) 
causavera: posts small blind $0.01
NoEff0rt2w1n: posts big blind $0.02
*** HOLE CARDS ***
Dealt to Scaaalll [4s 8h]
oleg12312441: folds 
oleg12312441 is disconnected 
HDYD18: folds 
S3XY_PADRE: folds 
Scaaalll: folds 
causavera: calls $0.01
NoEff0rt2w1n: raises $0.05 to $0.07
causavera: calls $0.05
*** FLOP *** [Qh 3d Ah]
causavera: checks 
NoEff0rt2w1n: bets $0.07
causavera: folds 
Uncalled bet ($0.07) returned to NoEff0rt2w1n
NoEff0rt2w1n collected $0.14 from pot
NoEff0rt2w1n: doesn't show hand 
*** SUMMARY ***
Total pot $0.14 | Rake $0 
Board [Qh 3d Ah]
Seat 1: Scaaalll (button) folded before Flop (didn't bet)
Seat 2: causavera (small blind) folded on the Flop
Seat 3: NoEff0rt2w1n (big blind) collected ($0.14)
Seat 4: oleg12312441 folded before Flop (didn't bet)
Seat 5: HDYD18 folded before Flop (didn't bet)
Seat 6: S3XY_PADRE folded before Flop (didn't bet)



PokerStars Zoom Hand #229232719297:  Hold'em No Limit ($0.01/$0.02) - 2021/08/21 23:02:27 CET [2021/08/21 17:02:27 ET]
Table 'Halley' 6-max Seat #1 is the button
Seat 1: Demidov V.S. ($2.69 in chips) 
Seat 2: gilberto98 ($1.70 in chips) 
Seat 3: leeroy818 ($2.11 in chips) 
Seat 4: Scaaalll ($2 in chips) 
Seat 5: sinkthe8 ($0.30 in chips) 
Seat 6: snowpepsi ($2.31 in chips) 
gilberto98: posts small blind $0.01
leeroy818: posts big blind $0.02
*** HOLE CARDS ***
Dealt to Scaaalll [6c Ah]
Scaaalll: folds 
Demidov V.S. is disconnected 
sinkthe8: raises $0.04 to $0.06
snowpepsi: folds 
Demidov V.S.: folds 
gilberto98: folds 
leeroy818: folds 
Uncalled bet ($0.04) returned to sinkthe8
sinkthe8 collected $0.05 from pot
sinkthe8: doesn't show hand 
*** SUMMARY ***
Total pot $0.05 | Rake $0 
Seat 1: Demidov V.S. (button) folded before Flop (didn't bet)
Seat 2: gilberto98 (small blind) folded before Flop
Seat 3: leeroy818 (big blind) folded before Flop
Seat 4: Scaaalll folded before Flop (didn't bet)
Seat 5: sinkthe8 collected ($0.05)
Seat 6: snowpepsi folded before Flop (didn't bet)



PokerStars Zoom Hand #229232714136:  Hold'em No Limit ($0.01/$0.02) - 2021/08/21 23:02:15 CET [2021/08/21 17:02:15 ET]
Table 'Halley' 6-max Seat #1 is the button
Seat 1: Ck@tih@ ($1.91 in chips) 
Seat 2: worldshare ($2.94 in chips) 
Seat 3: SIGREX ($2.15 in chips) 
Seat 4: Hallyson_23 ($4.79 in chips) 
Seat 5: jribeiros ($1.14 in chips) 
Seat 6: Scaaalll ($2 in chips) 
worldshare: posts small blind $0.01
SIGREX: posts big blind $0.02
*** HOLE CARDS ***
Dealt to Scaaalll [Ts 5c]
Hallyson_23: folds 
jribeiros: folds 
Scaaalll: folds 
Ck@tih@: folds 
worldshare: calls $0.01
SIGREX: raises $0.06 to $0.08
worldshare: calls $0.06
*** FLOP *** [Ad 9c 4h]
worldshare: bets $0.04
SIGREX: raises $0.15 to $0.19
worldshare: folds 
Uncalled bet ($0.15) returned to SIGREX
SIGREX collected $0.23 from pot
SIGREX: doesn't show hand 
*** SUMMARY ***
Total pot $0.24 | Rake $0.01 
Board [Ad 9c 4h]
Seat 1: Ck@tih@ (button) folded before Flop (didn't bet)
Seat 2: worldshare (small blind) folded on the Flop
Seat 3: SIGREX (big blind) collected ($0.23)
Seat 4: Hallyson_23 folded before Flop (didn't bet)
Seat 5: jribeiros folded before Flop (didn't bet)
Seat 6: Scaaalll folded before Flop (didn't bet)



PokerStars Zoom Hand #229232704120:  Hold'em No Limit ($0.01/$0.02) - 2021/08/21 23:01:52 CET [2021/08/21 17:01:52 ET]
Table 'Halley' 6-max Seat #1 is the button
Seat 1: Mr.Kurier ($1.97 in chips) 
Seat 2: FabOliveira9 ($2.05 in chips) 
Seat 3: Scaaalll ($2 in chips) 
Seat 4: Chapaev136 ($7.18 in chips) 
Seat 5: auxy89 ($2.50 in chips) 
Seat 6: egopi ($2.21 in chips) 
FabOliveira9: posts small blind $0.01
Scaaalll: posts big blind $0.02
*** HOLE CARDS ***
Dealt to Scaaalll [6d 5c]
Chapaev136: folds 
egopi is disconnected 
auxy89: folds 
egopi: folds 
auxy89 is disconnected 
Mr.Kurier: raises $0.03 to $0.05
FabOliveira9: raises $0.13 to $0.18
Scaaalll: folds 
Mr.Kurier: calls $0.13
*** FLOP *** [2c 8c 9h]
FabOliveira9: bets $0.14
Mr.Kurier: calls $0.14
*** TURN *** [2c 8c 9h] [2s]
FabOliveira9: checks 
Mr.Kurier: bets $0.22
FabOliveira9: calls $0.22
*** RIVER *** [2c 8c 9h 2s] [8h]
FabOliveira9: checks 
Mr.Kurier: checks 
*** SHOW DOWN ***
FabOliveira9: shows [Kd As] (two pair, Eights and Deuces)
Mr.Kurier: mucks hand 
FabOliveira9 collected $1.06 from pot
*** SUMMARY ***
Total pot $1.10 | Rake $0.04 
Board [2c 8c 9h 2s 8h]
Seat 1: Mr.Kurier (button) mucked [6h Th]
Seat 2: FabOliveira9 (small blind) showed [Kd As] and won ($1.06) with two pair, Eights and Deuces
Seat 3: Scaaalll (big blind) folded before Flop
Seat 4: Chapaev136 folded before Flop (didn't bet)
Seat 5: auxy89 folded before Flop (didn't bet)
Seat 6: egopi folded before Flop (didn't bet)



PokerStars Zoom Hand #229232702033:  Hold'em No Limit ($0.01/$0.02) - 2021/08/21 23:01:47 CET [2021/08/21 17:01:47 ET]
Table 'Halley' 6-max Seat #1 is the button
Seat 1: TTGemi ($2.03 in chips) 
Seat 2: zaharoff74 ($2.08 in chips) 
Seat 3: Iv3rson18 ($2.09 in chips) 
Seat 4: rpycmbEM ($3.25 in chips) 
Seat 5: Scaaalll ($2 in chips) 
Seat 6: kai_inge_mar ($0.97 in chips) 
zaharoff74: posts small blind $0.01
Iv3rson18: posts big blind $0.02
*** HOLE CARDS ***
Dealt to Scaaalll [7c Ad]
rpycmbEM: folds 
Scaaalll: folds 
kai_inge_mar: folds 
TTGemi: raises $0.03 to $0.05
zaharoff74: folds 
Iv3rson18: calls $0.03
*** FLOP *** [Ac As Qc]
Iv3rson18: checks 
TTGemi: checks 
*** TURN *** [Ac As Qc] [5h]
Iv3rson18: bets $0.08
TTGemi: raises $0.18 to $0.26
Iv3rson18: calls $0.18
*** RIVER *** [Ac As Qc 5h] [Td]
Iv3rson18: checks 
TTGemi: bets $0.52
Iv3rson18: calls $0.52
*** SHOW DOWN ***
TTGemi: shows [5c 5d] (a full house, Fives full of Aces)
Iv3rson18: mucks hand 
TTGemi collected $1.61 from pot
*** SUMMARY ***
Total pot $1.67 | Rake $0.06 
Board [Ac As Qc 5h Td]
Seat 1: TTGemi (button) showed [5c 5d] and won ($1.61) with a full house, Fives full of Aces
Seat 2: zaharoff74 (small blind) folded before Flop
Seat 3: Iv3rson18 (big blind) mucked [Jh Ah]
Seat 4: rpycmbEM folded before Flop (didn't bet)
Seat 5: Scaaalll folded before Flop (didn't bet)
Seat 6: kai_inge_mar folded before Flop (didn't bet)



PokerStars Zoom Hand #229232720958:  Hold'em No Limit ($0.01/$0.02) - 2021/08/21 23:02:31 CET [2021/08/21 17:02:31 ET]
Table 'Halley' 6-max Seat #1 is the button
Seat 1: Valansen ($2.06 in chips) 
Seat 2: NetoFLX ($2.04 in chips) 
Seat 3: Scaaalll ($2 in chips) 
Seat 4: Xlavariable ($2 in chips) 
Seat 5: levachok ($3.70 in chips) 
Seat 6: osantos401 ($5.92 in chips) 
NetoFLX: posts small blind $0.01
Scaaalll: posts big blind $0.02
*** HOLE CARDS ***
Dealt to Scaaalll [Qh Ac]
Xlavariable: folds 
levachok: folds 
osantos401: raises $0.04 to $0.06
Valansen: folds 
NetoFLX: folds 
Scaaalll: calls $0.04
*** FLOP *** [Th Ah 4c]
Scaaalll: checks 
osantos401: bets $0.06
Scaaalll: calls $0.06
*** TURN *** [Th Ah 4c] [Qc]
Scaaalll: checks 
osantos401: bets $0.18
Scaaalll: calls $0.18
*** RIVER *** [Th Ah 4c Qc] [Jh]
Scaaalll: checks 
osantos401: checks 
*** SHOW DOWN ***
Scaaalll: shows [Qh Ac] (two pair, Aces and Queens)
osantos401: shows [Kc Jc] (a straight, Ten to Ace)
osantos401 collected $0.59 from pot
*** SUMMARY ***
Total pot $0.61 | Rake $0.02 
Board [Th Ah 4c Qc Jh]
Seat 1: Valansen (button) folded before Flop (didn't bet)
Seat 2: NetoFLX (small blind) folded before Flop
Seat 3: Scaaalll (big blind) showed [Qh Ac] and lost with two pair, Aces and Queens
Seat 4: Xlavariable folded before Flop (didn't bet)
Seat 5: levachok folded before Flop (didn't bet)
Seat 6: osantos401 showed [Kc Jc] and won ($0.59) with a straight, Ten to Ace



PokerStars Zoom Hand #229232742478:  Hold'em No Limit ($0.01/$0.02) - 2021/08/21 23:03:20 CET [2021/08/21 17:03:20 ET]
Table 'Halley' 6-max Seat #1 is the button
Seat 1: YGrandmaster ($3.02 in chips) 
Seat 2: Scaaalll ($2 in chips) 
Seat 3: Andnet ($2.55 in chips) 
Seat 4: RaulacateFolds ($2.64 in chips) 
Seat 5: pavlo8855 ($2 in chips) 
Seat 6: Soko 1381 ($1.95 in chips) 
Scaaalll: posts small blind $0.01
Andnet: posts big blind $0.02
*** HOLE CARDS ***
Dealt to Scaaalll [3s 9c]
RaulacateFolds: folds 
pavlo8855: folds 
Soko 1381: folds 
YGrandmaster: raises $0.04 to $0.06
Scaaalll: folds 
Andnet: folds 
Uncalled bet ($0.04) returned to YGrandmaster
YGrandmaster collected $0.05 from pot
YGrandmaster: doesn't show hand 
*** SUMMARY ***
Total pot $0.05 | Rake $0 
Seat 1: YGrandmaster (button) collected ($0.05)
Seat 2: Scaaalll (small blind) folded before Flop
Seat 3: Andnet (big blind) folded before Flop
Seat 4: RaulacateFolds folded before Flop (didn't bet)
Seat 5: pavlo8855 folded before Flop (didn't bet)
Seat 6: Soko 1381 folded before Flop (didn't bet)



PokerStars Zoom Hand #229232749066:  Hold'em No Limit ($0.01/$0.02) - 2021/08/21 23:03:35 CET [2021/08/21 17:03:35 ET]
Table 'Halley' 6-max Seat #1 is the button
Seat 1: Scaaalll ($2 in chips) 
Seat 2: alphabeta1d ($2.14 in chips) 
Seat 3: tuolau ($4.21 in chips) 
Seat 4: egroj1700 ($2 in chips) 
Seat 5: Kojak34 ($5.74 in chips) 
Seat 6: Ryan Colls ($2.96 in chips) 
alphabeta1d: posts small blind $0.01
tuolau: posts big blind $0.02
*** HOLE CARDS ***
Dealt to Scaaalll [Ah Ad]
egroj1700: folds 
Kojak34: folds 
Ryan Colls: raises $0.02 to $0.04
Scaaalll: raises $0.12 to $0.16
alphabeta1d: folds 
tuolau: folds 
tuolau is disconnected 
Ryan Colls: calls $0.12
*** FLOP *** [2d 4d 2c]
Ryan Colls: checks 
Scaaalll: bets $0.22
Ryan Colls: calls $0.22
*** TURN *** [2d 4d 2c] [As]
Ryan Colls: checks 
Scaaalll: bets $0.45
Ryan Colls: folds 
Uncalled bet ($0.45) returned to Scaaalll
Scaaalll collected $0.75 from pot
Scaaalll: doesn't show hand 
Ryan Colls is disconnected 
*** SUMMARY ***
Total pot $0.79 | Rake $0.04 
Board [2d 4d 2c As]
Seat 1: Scaaalll (button) collected ($0.75)
Seat 2: alphabeta1d (small blind) folded before Flop
Seat 3: tuolau (big blind) folded before Flop
Seat 4: egroj1700 folded before Flop (didn't bet)
Seat 5: Kojak34 folded before Flop (didn't bet)
Seat 6: Ryan Colls folded on the Turn



PokerStars Zoom Hand #229232779028:  Hold'em No Limit ($0.01/$0.02) - 2021/08/21 23:04:43 CET [2021/08/21 17:04:43 ET]
Table 'Halley' 6-max Seat #1 is the button
Seat 1: Billy Beane1 ($1.79 in chips) 
Seat 2: BexleyBoy ($2.37 in chips) 
Seat 3: NoEff0rt2w1n ($6.79 in chips) 
Seat 4: BlackhawKK's ($4.90 in chips) 
Seat 5: so0love ($2.51 in chips) 
Seat 6: Scaaalll ($2.37 in chips) 
BexleyBoy: posts small blind $0.01
NoEff0rt2w1n: posts big blind $0.02
*** HOLE CARDS ***
Dealt to Scaaalll [Jc Kd]
BlackhawKK's: folds 
so0love: folds 
Scaaalll: raises $0.04 to $0.06
Billy Beane1: folds 
BexleyBoy: folds 
NoEff0rt2w1n: calls $0.04
*** FLOP *** [6c Ad Td]
NoEff0rt2w1n: checks 
Scaaalll: bets $0.09
NoEff0rt2w1n: folds 
Uncalled bet ($0.09) returned to Scaaalll
Scaaalll collected $0.13 from pot
Scaaalll: doesn't show hand 
*** SUMMARY ***
Total pot $0.13 | Rake $0 
Board [6c Ad Td]
Seat 1: Billy Beane1 (button) folded before Flop (didn't bet)
Seat 2: BexleyBoy (small blind) folded before Flop
Seat 3: NoEff0rt2w1n (big blind) folded on the Flop
Seat 4: BlackhawKK's folded before Flop (didn't bet)
Seat 5: so0love folded before Flop (didn't bet)
Seat 6: Scaaalll collected ($0.13)



PokerStars Zoom Hand #229232799743:  Hold'em No Limit ($0.01/$0.02) - 2021/08/21 23:05:30 CET [2021/08/21 17:05:30 ET]
Table 'Halley' 6-max Seat #1 is the button
Seat 1: CrazyyParis ($2.03 in chips) 
Seat 2: davidalejag ($2.85 in chips) 
Seat 3: pavlo8855 ($2 in chips) 
Seat 4: maressen ($2.29 in chips) 
Seat 5: Thaleshs ($3.90 in chips) 
Seat 6: Scaaalll ($2.44 in chips) 
davidalejag: posts small blind $0.01
pavlo8855: posts big blind $0.02
*** HOLE CARDS ***
Dealt to Scaaalll [2h 4c]
maressen: folds 
Thaleshs: raises $0.02 to $0.04
Scaaalll: folds 
CrazyyParis: folds 
davidalejag: folds 
pavlo8855: folds 
Uncalled bet ($0.02) returned to Thaleshs
Thaleshs collected $0.05 from pot
Thaleshs: doesn't show hand 
*** SUMMARY ***
Total pot $0.05 | Rake $0 
Seat 1: CrazyyParis (button) folded before Flop (didn't bet)
Seat 2: davidalejag (small blind) folded before Flop
Seat 3: pavlo8855 (big blind) folded before Flop
Seat 4: maressen folded before Flop (didn't bet)
Seat 5: Thaleshs collected ($0.05)
Seat 6: Scaaalll folded before Flop (didn't bet)



PokerStars Zoom Hand #229232808827:  Hold'em No Limit ($0.01/$0.02) - 2021/08/21 23:05:51 CET [2021/08/21 17:05:51 ET]
Table 'Halley' 6-max Seat #1 is the button
Seat 1: Xlavariable ($2.35 in chips) 
Seat 2: Scaaalll ($2.44 in chips) 
Seat 3: 888lifeIS ($2 in chips) 
Seat 4: Ne0net ($6.45 in chips) 
Seat 5: Merlin_Arg ($2 in chips) 
Seat 6: OmahaWheels ($3.62 in chips) 
Scaaalll: posts small blind $0.01
888lifeIS: posts big blind $0.02
*** HOLE CARDS ***
Dealt to Scaaalll [3c Qh]
Ne0net: folds 
Merlin_Arg: folds 
OmahaWheels: folds 
Xlavariable: raises $0.04 to $0.06
Scaaalll: folds 
888lifeIS: folds 
Uncalled bet ($0.04) returned to Xlavariable
Xlavariable collected $0.05 from pot
Xlavariable: doesn't show hand 
*** SUMMARY ***
Total pot $0.05 | Rake $0 
Seat 1: Xlavariable (button) collected ($0.05)
Seat 2: Scaaalll (small blind) folded before Flop
Seat 3: 888lifeIS (big blind) folded before Flop
Seat 4: Ne0net folded before Flop (didn't bet)
Seat 5: Merlin_Arg folded before Flop (didn't bet)
Seat 6: OmahaWheels folded before Flop (didn't bet)



PokerStars Zoom Hand #229232806662:  Hold'em No Limit ($0.01/$0.02) - 2021/08/21 23:05:46 CET [2021/08/21 17:05:46 ET]
Table 'Halley' 6-max Seat #1 is the button
Seat 1: disanddowny ($1.72 in chips) 
Seat 2: Mikeloko182 ($3.14 in chips) 
Seat 3: simensgh ($6.98 in chips) 
Seat 4: Mustang01373 ($1.40 in chips) 
Seat 5: Scaaalll ($2.44 in chips) 
Seat 6: TNTKM ($1.76 in chips) 
Mikeloko182: posts small blind $0.01
simensgh: posts big blind $0.02
*** HOLE CARDS ***
Dealt to Scaaalll [Jh 4c]
Mustang01373: folds 
Scaaalll: folds 
TNTKM has timed out
TNTKM: folds 
disanddowny: folds 
TNTKM is disconnected 
Mikeloko182: raises $0.04 to $0.06
simensgh: calls $0.04
*** FLOP *** [5h Js Ah]
Mikeloko182: bets $0.04
simensgh: calls $0.04
*** TURN *** [5h Js Ah] [6s]
Mikeloko182: checks 
simensgh: checks 
*** RIVER *** [5h Js Ah 6s] [As]
Mikeloko182: checks 
simensgh: checks 
*** SHOW DOWN ***
Mikeloko182: shows [Td 9s] (a pair of Aces)
simensgh: shows [6h 7h] (two pair, Aces and Sixes)
simensgh collected $0.19 from pot
*** SUMMARY ***
Total pot $0.20 | Rake $0.01 
Board [5h Js Ah 6s As]
Seat 1: disanddowny (button) folded before Flop (didn't bet)
Seat 2: Mikeloko182 (small blind) showed [Td 9s] and lost with a pair of Aces
Seat 3: simensgh (big blind) showed [6h 7h] and won ($0.19) with two pair, Aces and Sixes
Seat 4: Mustang01373 folded before Flop (didn't bet)
Seat 5: Scaaalll folded before Flop (didn't bet)
Seat 6: TNTKM folded before Flop (didn't bet)



PokerStars Zoom Hand #229232826456:  Hold'em No Limit ($0.01/$0.02) - 2021/08/21 23:06:31 CET [2021/08/21 17:06:31 ET]
Table 'Halley' 6-max Seat #1 is the button
Seat 1: z3317111711 ($5.78 in chips) 
Seat 2: bananAAbandit ($2.15 in chips) 
Seat 3: fishh_play ($3.10 in chips) 
Seat 4: ARS_POLI13 ($0.49 in chips) 
Seat 5: BriceDo1917 ($4.43 in chips) 
Seat 6: Scaaalll ($2.41 in chips) 
bananAAbandit: posts small blind $0.01
fishh_play: posts big blind $0.02
*** HOLE CARDS ***
Dealt to Scaaalll [Kh 6d]
BriceDo1917 is disconnected 
ARS_POLI13: folds 
BriceDo1917: folds 
Scaaalll: folds 
z3317111711: folds 
bananAAbandit: raises $0.04 to $0.06
fishh_play: calls $0.04
*** FLOP *** [9d 2h 8c]
bananAAbandit: bets $0.04
fishh_play: folds 
Uncalled bet ($0.04) returned to bananAAbandit
bananAAbandit collected $0.12 from pot
bananAAbandit: doesn't show hand 
*** SUMMARY ***
Total pot $0.12 | Rake $0 
Board [9d 2h 8c]
Seat 1: z3317111711 (button) folded before Flop (didn't bet)
Seat 2: bananAAbandit (small blind) collected ($0.12)
Seat 3: fishh_play (big blind) folded on the Flop
Seat 4: ARS_POLI13 folded before Flop (didn't bet)
Seat 5: BriceDo1917 folded before Flop (didn't bet)
Seat 6: Scaaalll folded before Flop (didn't bet)



PokerStars Zoom Hand #229232814594:  Hold'em No Limit ($0.01/$0.02) - 2021/08/21 23:06:04 CET [2021/08/21 17:06:04 ET]
Table 'Halley' 6-max Seat #1 is the button
Seat 1: cr@sh test ($2.09 in chips) 
Seat 2: KonopDima ($2.13 in chips) 
Seat 3: Scaaalll ($2.43 in chips) 
Seat 4: TTGemi ($2.03 in chips) 
Seat 5: PapiMik3 ($3.07 in chips) 
Seat 6: squidy4 ($1 in chips) 
KonopDima: posts small blind $0.01
Scaaalll: posts big blind $0.02
*** HOLE CARDS ***
Dealt to Scaaalll [7c 5h]
TTGemi: folds 
PapiMik3: folds 
squidy4: raises $0.04 to $0.06
cr@sh test: folds 
KonopDima: calls $0.05
Scaaalll: folds 
*** FLOP *** [Ah 3s Th]
KonopDima: checks 
squidy4: bets $0.07
KonopDima: calls $0.07
*** TURN *** [Ah 3s Th] [3d]
KonopDima: checks 
squidy4: bets $0.13
KonopDima: calls $0.13
*** RIVER *** [Ah 3s Th 3d] [4c]
KonopDima: checks 
squidy4: checks 
*** SHOW DOWN ***
KonopDima: shows [5c Ac] (two pair, Aces and Threes)
squidy4: shows [9c As] (two pair, Aces and Threes)
KonopDima collected $0.26 from pot
squidy4 collected $0.26 from pot
*** SUMMARY ***
Total pot $0.54 | Rake $0.02 
Board [Ah 3s Th 3d 4c]
Seat 1: cr@sh test (button) folded before Flop (didn't bet)
Seat 2: KonopDima (small blind) showed [5c Ac] and won ($0.26) with two pair, Aces and Threes
Seat 3: Scaaalll (big blind) folded before Flop
Seat 4: TTGemi folded before Flop (didn't bet)
Seat 5: PapiMik3 folded before Flop (didn't bet)
Seat 6: squidy4 showed [9c As] and won ($0.26) with two pair, Aces and Threes



PokerStars Zoom Hand #229232823368:  Hold'em No Limit ($0.01/$0.02) - 2021/08/21 23:06:24 CET [2021/08/21 17:06:24 ET]
Table 'Halley' 6-max Seat #1 is the button
Seat 1: Scaaalll ($2.41 in chips) 
Seat 2: ivorypiano ($1.39 in chips) 
Seat 3: chigilaci ($5.06 in chips) 
Seat 4: egroj1700 ($2.08 in chips) 
Seat 5: rpycmbEM ($3.35 in chips) 
Seat 6: valet_hai ($1.11 in chips) 
ivorypiano: posts small blind $0.01
chigilaci: posts big blind $0.02
*** HOLE CARDS ***
Dealt to Scaaalll [3s 5s]
egroj1700: raises $0.04 to $0.06
rpycmbEM: folds 
valet_hai: folds 
Scaaalll: folds 
ivorypiano: calls $0.05
chigilaci: folds 
*** FLOP *** [2s 4c 6s]
ivorypiano: checks 
egroj1700: checks 
*** TURN *** [2s 4c 6s] [Ad]
ivorypiano: checks 
egroj1700: checks 
*** RIVER *** [2s 4c 6s Ad] [7h]
ivorypiano: checks 
egroj1700: checks 
*** SHOW DOWN ***
ivorypiano: shows [8h Kh] (high card Ace)
egroj1700: shows [Jc Kc] (high card Ace - King+Jack kicker)
egroj1700 collected $0.14 from pot
*** SUMMARY ***
Total pot $0.14 | Rake $0 
Board [2s 4c 6s Ad 7h]
Seat 1: Scaaalll (button) folded before Flop (didn't bet)
Seat 2: ivorypiano (small blind) showed [8h Kh] and lost with high card Ace
Seat 3: chigilaci (big blind) folded before Flop
Seat 4: egroj1700 showed [Jc Kc] and won ($0.14) with high card Ace
Seat 5: rpycmbEM folded before Flop (didn't bet)
Seat 6: valet_hai folded before Flop (didn't bet)



PokerStars Zoom Hand #229232830329:  Hold'em No Limit ($0.01/$0.02) - 2021/08/21 23:06:40 CET [2021/08/21 17:06:40 ET]
Table 'Halley' 6-max Seat #1 is the button
Seat 1: queen830 ($12.55 in chips) 
Seat 2: Billy Beane1 ($1.75 in chips) 
Seat 3: tuolau ($4.21 in chips) 
Seat 4: nodtress ($2.45 in chips) 
Seat 5: Scaaalll ($2.41 in chips) 
Seat 6: NetoFLX ($2.03 in chips) 
Billy Beane1: posts small blind $0.01
tuolau: posts big blind $0.02
*** HOLE CARDS ***
Dealt to Scaaalll [7h 6d]
nodtress: folds 
Scaaalll: folds 
NetoFLX: raises $0.04 to $0.06
queen830: raises $0.12 to $0.18
Billy Beane1: folds 
tuolau: folds 
tuolau is disconnected 
NetoFLX: folds 
Uncalled bet ($0.12) returned to queen830
queen830 collected $0.15 from pot
queen830: doesn't show hand 
*** SUMMARY ***
Total pot $0.15 | Rake $0 
Seat 1: queen830 (button) collected ($0.15)
Seat 2: Billy Beane1 (small blind) folded before Flop
Seat 3: tuolau (big blind) folded before Flop
Seat 4: nodtress folded before Flop (didn't bet)
Seat 5: Scaaalll folded before Flop (didn't bet)
Seat 6: NetoFLX folded before Flop



PokerStars Zoom Hand #229232828590:  Hold'em No Limit ($0.01/$0.02) - 2021/08/21 23:06:36 CET [2021/08/21 17:06:36 ET]
Table 'Halley' 6-max Seat #1 is the button
Seat 1: Apollonnn_13 ($2.35 in chips) 
Seat 2: Boris_Garich ($2 in chips) 
Seat 3: PEDACIT0 ($2.03 in chips) 
Seat 4: IceTdannyB ($3.50 in chips) 
Seat 5: Scaaalll ($2.41 in chips) 
Seat 6: Billy Beane1 ($1.75 in chips) 
Boris_Garich: posts small blind $0.01
PEDACIT0: posts big blind $0.02
*** HOLE CARDS ***
Dealt to Scaaalll [4h 2c]
IceTdannyB: raises $0.04 to $0.06
Scaaalll: folds 
Billy Beane1: folds 
Apollonnn_13: folds 
Boris_Garich: raises $0.14 to $0.20
PEDACIT0: folds 
IceTdannyB: calls $0.14
*** FLOP *** [Th 4d Js]
Boris_Garich: bets $0.34
IceTdannyB: folds 
Uncalled bet ($0.34) returned to Boris_Garich
Boris_Garich collected $0.41 from pot
Boris_Garich: doesn't show hand 
IceTdannyB is disconnected 
*** SUMMARY ***
Total pot $0.42 | Rake $0.01 
Board [Th 4d Js]
Seat 1: Apollonnn_13 (button) folded before Flop (didn't bet)
Seat 2: Boris_Garich (small blind) collected ($0.41)
Seat 3: PEDACIT0 (big blind) folded before Flop
Seat 4: IceTdannyB folded on the Flop
Seat 5: Scaaalll folded before Flop (didn't bet)
Seat 6: Billy Beane1 folded before Flop (didn't bet)



PokerStars Zoom Hand #229232832534:  Hold'em No Limit ($0.01/$0.02) - 2021/08/21 23:06:45 CET [2021/08/21 17:06:45 ET]
Table 'Halley' 6-max Seat #1 is the button
Seat 1: Phoenixxxxxxxx ($2.01 in chips) 
Seat 2: tisadaisy ($2.24 in chips) 
Seat 3: maliniak75 ($3.68 in chips) 
Seat 4: Scaaalll ($2.41 in chips) 
Seat 5: i.m.bluffing002 ($2.26 in chips) 
Seat 6: BexleyBoy ($3.04 in chips) 
tisadaisy: posts small blind $0.01
maliniak75: posts big blind $0.02
*** HOLE CARDS ***
Dealt to Scaaalll [2d Ad]
Scaaalll: folds 
i.m.bluffing002: raises $0.05 to $0.07
BexleyBoy: folds 
Phoenixxxxxxxx: folds 
tisadaisy: folds 
maliniak75: calls $0.05
*** FLOP *** [Jc 3h 5d]
maliniak75: checks 
i.m.bluffing002: bets $0.07
maliniak75: calls $0.07
*** TURN *** [Jc 3h 5d] [Ac]
maliniak75: checks 
i.m.bluffing002: bets $0.16
maliniak75: calls $0.16
*** RIVER *** [Jc 3h 5d Ac] [9s]
maliniak75: checks 
i.m.bluffing002: bets $0.63
maliniak75: folds 
Uncalled bet ($0.63) returned to i.m.bluffing002
i.m.bluffing002 collected $0.59 from pot
i.m.bluffing002: doesn't show hand 
*** SUMMARY ***
Total pot $0.61 | Rake $0.02 
Board [Jc 3h 5d Ac 9s]
Seat 1: Phoenixxxxxxxx (button) folded before Flop (didn't bet)
Seat 2: tisadaisy (small blind) folded before Flop
Seat 3: maliniak75 (big blind) folded on the River
Seat 4: Scaaalll folded before Flop (didn't bet)
Seat 5: i.m.bluffing002 collected ($0.59)
Seat 6: BexleyBoy folded before Flop (didn't bet)



PokerStars Zoom Hand #229232850882:  Hold'em No Limit ($0.01/$0.02) - 2021/08/21 23:07:27 CET [2021/08/21 17:07:27 ET]
Table 'Halley' 6-max Seat #1 is the button
Seat 1: 48159348 ($5.84 in chips) 
Seat 2: onno978 ($2.72 in chips) 
Seat 3: Scaaalll ($2.35 in chips) 
Seat 4: Dr.stromg ($4.10 in chips) 
Seat 5: dryan04 ($1.19 in chips) 
Seat 6: polymorhp ($3.44 in chips) 
onno978: posts small blind $0.01
Scaaalll: posts big blind $0.02
*** HOLE CARDS ***
Dealt to Scaaalll [Td 7d]
onno978 is disconnected 
Dr.stromg: folds 
dryan04: raises $0.02 to $0.04
polymorhp: folds 
48159348: folds 
onno978: folds 
Scaaalll: calls $0.02
*** FLOP *** [3h 5s 6d]
Scaaalll: bets $0.06
dryan04: folds 
Uncalled bet ($0.06) returned to Scaaalll
Scaaalll collected $0.09 from pot
Scaaalll: doesn't show hand 
dryan04 is disconnected 
*** SUMMARY ***
Total pot $0.09 | Rake $0 
Board [3h 5s 6d]
Seat 1: 48159348 (button) folded before Flop (didn't bet)
Seat 2: onno978 (small blind) folded before Flop
Seat 3: Scaaalll (big blind) collected ($0.09)
Seat 4: Dr.stromg folded before Flop (didn't bet)
Seat 5: dryan04 folded on the Flop
Seat 6: polymorhp folded before Flop (didn't bet)



PokerStars Zoom Hand #229232834674:  Hold'em No Limit ($0.01/$0.02) - 2021/08/21 23:06:50 CET [2021/08/21 17:06:50 ET]
Table 'Halley' 6-max Seat #1 is the button
Seat 1: GrindToGlory ($2 in chips) 
Seat 2: Scaaalll ($2.41 in chips) 
Seat 3: lucksuckdonk ($2.18 in chips) 
Seat 4: Stryda00 ($2.59 in chips) 
Seat 5: TNTKM ($1.76 in chips) 
Seat 6: Yangyang1407 ($2 in chips) 
Scaaalll: posts small blind $0.01
lucksuckdonk: posts big blind $0.02
*** HOLE CARDS ***
Dealt to Scaaalll [Qd As]
Stryda00: raises $0.04 to $0.06
TNTKM: calls $0.06
Yangyang1407: folds 
GrindToGlory: folds 
Scaaalll: calls $0.05
lucksuckdonk: raises $0.22 to $0.28
Stryda00: folds 
TNTKM: calls $0.22
Scaaalll: folds 
*** FLOP *** [5d Tc 2c]
lucksuckdonk: checks 
TNTKM: checks 
*** TURN *** [5d Tc 2c] [Ad]
lucksuckdonk: bets $0.36
TNTKM: calls $0.36
*** RIVER *** [5d Tc 2c Ad] [7d]
lucksuckdonk: bets $1.14
TNTKM: folds 
Uncalled bet ($1.14) returned to lucksuckdonk
lucksuckdonk collected $1.35 from pot
lucksuckdonk: doesn't show hand 
TNTKM is disconnected 
*** SUMMARY ***
Total pot $1.40 | Rake $0.05 
Board [5d Tc 2c Ad 7d]
Seat 1: GrindToGlory (button) folded before Flop (didn't bet)
Seat 2: Scaaalll (small blind) folded before Flop
Seat 3: lucksuckdonk (big blind) collected ($1.35)
Seat 4: Stryda00 folded before Flop
Seat 5: TNTKM folded on the River
Seat 6: Yangyang1407 folded before Flop (didn't bet)



PokerStars Zoom Hand #229232862953:  Hold'em No Limit ($0.01/$0.02) - 2021/08/21 23:07:55 CET [2021/08/21 17:07:55 ET]
Table 'Halley' 6-max Seat #1 is the button
Seat 1: VovaU164 ($1.11 in chips) 
Seat 2: Meskalita ($2 in chips) 
Seat 3: nitzed12 ($2.03 in chips) 
Seat 4: i.m.bluffing002 ($2.55 in chips) 
Seat 5: Scaaalll ($2.40 in chips) 
Seat 6: kai_inge_mar ($1.58 in chips) 
Meskalita: posts small blind $0.01
nitzed12: posts big blind $0.02
*** HOLE CARDS ***
Dealt to Scaaalll [Ad 9d]
VovaU164 is disconnected 
i.m.bluffing002: folds 
i.m.bluffing002 is disconnected 
Scaaalll: raises $0.04 to $0.06
kai_inge_mar: folds 
VovaU164: folds 
Meskalita: folds 
nitzed12: folds 
Uncalled bet ($0.04) returned to Scaaalll
Scaaalll collected $0.05 from pot
Scaaalll: doesn't show hand 
*** SUMMARY ***
Total pot $0.05 | Rake $0 
Seat 1: VovaU164 (button) folded before Flop (didn't bet)
Seat 2: Meskalita (small blind) folded before Flop
Seat 3: nitzed12 (big blind) folded before Flop
Seat 4: i.m.bluffing002 folded before Flop (didn't bet)
Seat 5: Scaaalll collected ($0.05)
Seat 6: kai_inge_mar folded before Flop (didn't bet)



PokerStars Zoom Hand #229232869392:  Hold'em No Limit ($0.01/$0.02) - 2021/08/21 23:08:10 CET [2021/08/21 17:08:10 ET]
Table 'Halley' 6-max Seat #1 is the button
Seat 1: Scaaalll ($2.43 in chips) 
Seat 2: GVMELLO ($1.98 in chips) 
Seat 3: AXXILLES ($3.23 in chips) 
Seat 4: Hejpåre ($2 in chips) 
Seat 5: Recasia ($1.33 in chips) 
Seat 6: sg.32rus ($0.89 in chips) 
GVMELLO: posts small blind $0.01
AXXILLES: posts big blind $0.02
*** HOLE CARDS ***
Dealt to Scaaalll [7s Qs]
Hejpåre: folds 
Recasia: folds 
sg.32rus: folds 
Scaaalll: raises $0.02 to $0.04
GVMELLO: folds 
AXXILLES: raises $0.06 to $0.10
Scaaalll: folds 
Uncalled bet ($0.06) returned to AXXILLES
AXXILLES collected $0.09 from pot
AXXILLES: doesn't show hand 
*** SUMMARY ***
Total pot $0.09 | Rake $0 
Seat 1: Scaaalll (button) folded before Flop
Seat 2: GVMELLO (small blind) folded before Flop
Seat 3: AXXILLES (big blind) collected ($0.09)
Seat 4: Hejpåre folded before Flop (didn't bet)
Seat 5: Recasia folded before Flop (didn't bet)
Seat 6: sg.32rus folded before Flop (didn't bet)



PokerStars Zoom Hand #229232880338:  Hold'em No Limit ($0.01/$0.02) - 2021/08/21 23:08:35 CET [2021/08/21 17:08:35 ET]
Table 'Halley' 6-max Seat #1 is the button
Seat 1: BriceDo1917 ($4.10 in chips) 
Seat 2: yu-guncasi ($2 in chips) 
Seat 3: Caabz ($4.04 in chips) 
Seat 4: fishh_play ($4.01 in chips) 
Seat 5: ibstah ($1.98 in chips) 
Seat 6: Scaaalll ($2.39 in chips) 
yu-guncasi: posts small blind $0.01
Caabz: posts big blind $0.02
*** HOLE CARDS ***
Dealt to Scaaalll [Qd 3d]
fishh_play: folds 
ibstah: folds 
Scaaalll: folds 
BriceDo1917: raises $0.02 to $0.04
yu-guncasi: folds 
yu-guncasi is disconnected 
Caabz: calls $0.02
*** FLOP *** [Ts Qs Jh]
Caabz: checks 
BriceDo1917: bets $0.04
Caabz: folds 
Uncalled bet ($0.04) returned to BriceDo1917
BriceDo1917 collected $0.09 from pot
BriceDo1917: doesn't show hand 
*** SUMMARY ***
Total pot $0.09 | Rake $0 
Board [Ts Qs Jh]
Seat 1: BriceDo1917 (button) collected ($0.09)
Seat 2: yu-guncasi (small blind) folded before Flop
Seat 3: Caabz (big blind) folded on the Flop
Seat 4: fishh_play folded before Flop (didn't bet)
Seat 5: ibstah folded before Flop (didn't bet)
Seat 6: Scaaalll folded before Flop (didn't bet)



PokerStars Zoom Hand #229232878169:  Hold'em No Limit ($0.01/$0.02) - 2021/08/21 23:08:30 CET [2021/08/21 17:08:30 ET]
Table 'Halley' 6-max Seat #1 is the button
Seat 1: Finderra ($4.02 in chips) 
Seat 2: Hejpåre ($2 in chips) 
Seat 3: Stormzilla ($2 in chips) 
Seat 4: Scaaalll ($2.39 in chips) 
Seat 5: gerhavfc ($1.01 in chips) 
Seat 6: fishh_play ($4.97 in chips) 
Hejpåre: posts small blind $0.01
Stormzilla: posts big blind $0.02
*** HOLE CARDS ***
Dealt to Scaaalll [9h 4c]
Scaaalll: folds 
gerhavfc: raises $0.15 to $0.17
fishh_play: calls $0.17
Finderra: folds 
Hejpåre: folds 
Stormzilla: raises $1.83 to $2 and is all-in
gerhavfc: calls $0.84 and is all-in
fishh_play: folds 
Uncalled bet ($0.99) returned to Stormzilla
*** FLOP *** [6s 7d 6d]
*** TURN *** [6s 7d 6d] [Jh]
*** RIVER *** [6s 7d 6d Jh] [4s]
*** SHOW DOWN ***
Stormzilla: shows [Jd Js] (a full house, Jacks full of Sixes)
gerhavfc: shows [9c 9d] (two pair, Nines and Sixes)
Stormzilla cashed out the hand for $1.72 | Cash Out Fee $0.02
gerhavfc cashed out the hand for $0.38
*** SUMMARY ***
Total pot $2.20 | Rake $0.08 
Board [6s 7d 6d Jh 4s]
Seat 1: Finderra (button) folded before Flop (didn't bet)
Seat 2: Hejpåre (small blind) folded before Flop
Seat 3: Stormzilla (big blind) showed [Jd Js] and won ($2.12) with a full house, Jacks full of Sixes (pot not awarded as player cashed out)
Seat 4: Scaaalll folded before Flop (didn't bet)
Seat 5: gerhavfc showed [9c 9d] and lost with two pair, Nines and Sixes (cashed out).
Seat 6: fishh_play folded before Flop



PokerStars Zoom Hand #229232891682:  Hold'em No Limit ($0.01/$0.02) - 2021/08/21 23:09:01 CET [2021/08/21 17:09:01 ET]
Table 'Halley' 6-max Seat #1 is the button
Seat 1: Posaunengodi ($2.46 in chips) 
Seat 2: Scaaalll ($2.39 in chips) 
Seat 3: MattieBOZ ($1.88 in chips) 
Seat 4: Yangyang1407 ($2.14 in chips) 
Seat 5: 48159348 ($5.76 in chips) 
Seat 6: SKV_1985 ($2.78 in chips) 
Scaaalll: posts small blind $0.01
MattieBOZ: posts big blind $0.02
*** HOLE CARDS ***
Dealt to Scaaalll [4d 8s]
Yangyang1407: folds 
48159348: folds 
SKV_1985: folds 
Posaunengodi: folds 
Scaaalll: folds 
Uncalled bet ($0.01) returned to MattieBOZ
MattieBOZ collected $0.02 from pot
MattieBOZ: doesn't show hand 
*** SUMMARY ***
Total pot $0.02 | Rake $0 
Seat 1: Posaunengodi (button) folded before Flop (didn't bet)
Seat 2: Scaaalll (small blind) folded before Flop
Seat 3: MattieBOZ (big blind) collected ($0.02)
Seat 4: Yangyang1407 folded before Flop (didn't bet)
Seat 5: 48159348 folded before Flop (didn't bet)
Seat 6: SKV_1985 folded before Flop (didn't bet)



PokerStars Zoom Hand #229232897316:  Hold'em No Limit ($0.01/$0.02) - 2021/08/21 23:09:14 CET [2021/08/21 17:09:14 ET]
Table 'Halley' 6-max Seat #1 is the button
Seat 1: olga3021221 ($2 in chips) 
Seat 2: REZAKOV72 ($1.59 in chips) 
Seat 3: Scaaalll ($2.38 in chips) 
Seat 4: sg.32rus ($0.89 in chips) 
Seat 5: Xlavariable ($2 in chips) 
Seat 6: SIGREX ($2.48 in chips) 
REZAKOV72: posts small blind $0.01
Scaaalll: posts big blind $0.02
*** HOLE CARDS ***
Dealt to Scaaalll [6c 2s]
sg.32rus: calls $0.02
Xlavariable: raises $0.08 to $0.10
SIGREX: folds 
olga3021221: folds 
REZAKOV72: folds 
Scaaalll: folds 
sg.32rus: folds 
Uncalled bet ($0.08) returned to Xlavariable
Xlavariable collected $0.07 from pot
Xlavariable: doesn't show hand 
*** SUMMARY ***
Total pot $0.07 | Rake $0 
Seat 1: olga3021221 (button) folded before Flop (didn't bet)
Seat 2: REZAKOV72 (small blind) folded before Flop
Seat 3: Scaaalll (big blind) folded before Flop
Seat 4: sg.32rus folded before Flop
Seat 5: Xlavariable collected ($0.07)
Seat 6: SIGREX folded before Flop (didn't bet)



PokerStars Zoom Hand #229232887291:  Hold'em No Limit ($0.01/$0.02) - 2021/08/21 23:08:51 CET [2021/08/21 17:08:51 ET]
Table 'Halley' 6-max Seat #1 is the button
Seat 1: Bol'tazar111 ($3.95 in chips) 
Seat 2: Yangyang1407 ($2.01 in chips) 
Seat 3: kidninja888 ($2.34 in chips) 
Seat 4: Scaaalll ($2.39 in chips) 
Seat 5: SIGREX ($2 in chips) 
Seat 6: Bobathy ($2 in chips) 
Yangyang1407: posts small blind $0.01
kidninja888: posts big blind $0.02
*** HOLE CARDS ***
Dealt to Scaaalll [7h Qs]
Bobathy is disconnected 
Scaaalll: folds 
SIGREX: raises $0.02 to $0.04
Bobathy: folds 
Bol'tazar111: calls $0.04
Yangyang1407: folds 
kidninja888: folds 
*** FLOP *** [2s Js 2d]
SIGREX: checks 
Bol'tazar111: bets $0.06
SIGREX: folds 
Uncalled bet ($0.06) returned to Bol'tazar111
Bol'tazar111 collected $0.11 from pot
Bol'tazar111: doesn't show hand 
*** SUMMARY ***
Total pot $0.11 | Rake $0 
Board [2s Js 2d]
Seat 1: Bol'tazar111 (button) collected ($0.11)
Seat 2: Yangyang1407 (small blind) folded before Flop
Seat 3: kidninja888 (big blind) folded before Flop
Seat 4: Scaaalll folded before Flop (didn't bet)
Seat 5: SIGREX folded on the Flop
Seat 6: Bobathy folded before Flop (didn't bet)



PokerStars Zoom Hand #229232905566:  Hold'em No Limit ($0.01/$0.02) - 2021/08/21 23:09:33 CET [2021/08/21 17:09:33 ET]
Table 'Halley' 6-max Seat #1 is the button
Seat 1: Scaaalll ($2.36 in chips) 
Seat 2: rodrigoasor ($3.70 in chips) 
Seat 3: Chapaev136 ($9.77 in chips) 
Seat 4: Vahenta ($2.37 in chips) 
Seat 5: Xlavariable ($2.33 in chips) 
Seat 6: Richaud ($2.96 in chips) 
rodrigoasor: posts small blind $0.01
Chapaev136: posts big blind $0.02
*** HOLE CARDS ***
Dealt to Scaaalll [7h Jh]
Vahenta: folds 
Vahenta is disconnected 
Xlavariable: folds 
Richaud: folds 
Scaaalll: raises $0.02 to $0.04
rodrigoasor: folds 
Chapaev136: folds 
Uncalled bet ($0.02) returned to Scaaalll
Scaaalll collected $0.05 from pot
Scaaalll: doesn't show hand 
*** SUMMARY ***
Total pot $0.05 | Rake $0 
Seat 1: Scaaalll (button) collected ($0.05)
Seat 2: rodrigoasor (small blind) folded before Flop
Seat 3: Chapaev136 (big blind) folded before Flop
Seat 4: Vahenta folded before Flop (didn't bet)
Seat 5: Xlavariable folded before Flop (didn't bet)
Seat 6: Richaud folded before Flop (didn't bet)



PokerStars Zoom Hand #229232911465:  Hold'em No Limit ($0.01/$0.02) - 2021/08/21 23:09:47 CET [2021/08/21 17:09:47 ET]
Table 'Halley' 6-max Seat #1 is the button
Seat 1: Scaaalll ($2.39 in chips) 
Seat 2: GrindToGlory ($2.07 in chips) 
Seat 3: Bol'tazar111 ($4.02 in chips) 
Seat 4: squidy4 ($1.85 in chips) 
Seat 5: le_vlimeux ($2.03 in chips) 
Seat 6: rekopo203 ($6.55 in chips) 
GrindToGlory: posts small blind $0.01
Bol'tazar111: posts big blind $0.02
*** HOLE CARDS ***
Dealt to Scaaalll [8d Ts]
squidy4: raises $0.04 to $0.06
le_vlimeux: folds 
rekopo203: folds 
Scaaalll: folds 
GrindToGlory: folds 
Bol'tazar111: folds 
Uncalled bet ($0.04) returned to squidy4
squidy4 collected $0.05 from pot
squidy4: doesn't show hand 
*** SUMMARY ***
Total pot $0.05 | Rake $0 
Seat 1: Scaaalll (button) folded before Flop (didn't bet)
Seat 2: GrindToGlory (small blind) folded before Flop
Seat 3: Bol'tazar111 (big blind) folded before Flop
Seat 4: squidy4 collected ($0.05)
Seat 5: le_vlimeux folded before Flop (didn't bet)
Seat 6: rekopo203 folded before Flop (didn't bet)



PokerStars Zoom Hand #229232915837:  Hold'em No Limit ($0.01/$0.02) - 2021/08/21 23:09:57 CET [2021/08/21 17:09:57 ET]
Table 'Halley' 6-max Seat #1 is the button
Seat 1: BlackhawKK's ($5.41 in chips) 
Seat 2: shingo594 ($5.05 in chips) 
Seat 3: Soko 1381 ($2.20 in chips) 
Seat 4: guappa007 ($1.35 in chips) 
Seat 5: Scaaalll ($2.39 in chips) 
Seat 6: vovan100157 ($2.68 in chips) 
shingo594: posts small blind $0.01
Soko 1381: posts big blind $0.02
*** HOLE CARDS ***
Dealt to Scaaalll [3d 8d]
guappa007: folds 
shingo594 is disconnected 
Scaaalll: folds 
vovan100157: folds 
BlackhawKK's: folds 
shingo594: folds 
Uncalled bet ($0.01) returned to Soko 1381
Soko 1381 collected $0.02 from pot
Soko 1381: doesn't show hand 
*** SUMMARY ***
Total pot $0.02 | Rake $0 
Seat 1: BlackhawKK's (button) folded before Flop (didn't bet)
Seat 2: shingo594 (small blind) folded before Flop
Seat 3: Soko 1381 (big blind) collected ($0.02)
Seat 4: guappa007 folded before Flop (didn't bet)
Seat 5: Scaaalll folded before Flop (didn't bet)
Seat 6: vovan100157 folded before Flop (didn't bet)



PokerStars Zoom Hand #229232918904:  Hold'em No Limit ($0.01/$0.02) - 2021/08/21 23:10:04 CET [2021/08/21 17:10:04 ET]
Table 'Halley' 6-max Seat #1 is the button
Seat 1: MattieBOZ ($2.06 in chips) 
Seat 2: pipecmolodec ($2 in chips) 
Seat 3: cbbbka ($3.82 in chips) 
Seat 4: Billy Beane1 ($2 in chips) 
Seat 5: Apollonnn_13 ($1.84 in chips) 
Seat 6: Scaaalll ($2.39 in chips) 
pipecmolodec: posts small blind $0.01
cbbbka: posts big blind $0.02
*** HOLE CARDS ***
Dealt to Scaaalll [Ks 4c]
Billy Beane1: folds 
Apollonnn_13: folds 
MattieBOZ is disconnected 
Scaaalll: folds 
MattieBOZ: folds 
pipecmolodec: folds 
Uncalled bet ($0.01) returned to cbbbka
cbbbka collected $0.02 from pot
cbbbka: doesn't show hand 
*** SUMMARY ***
Total pot $0.02 | Rake $0 
Seat 1: MattieBOZ (button) folded before Flop (didn't bet)
Seat 2: pipecmolodec (small blind) folded before Flop
Seat 3: cbbbka (big blind) collected ($0.02)
Seat 4: Billy Beane1 folded before Flop (didn't bet)
Seat 5: Apollonnn_13 folded before Flop (didn't bet)
Seat 6: Scaaalll folded before Flop (didn't bet)



PokerStars Zoom Hand #229232931505:  Hold'em No Limit ($0.01/$0.02) - 2021/08/21 23:10:33 CET [2021/08/21 17:10:33 ET]
Table 'Halley' 6-max Seat #1 is the button
Seat 1: IceTdannyB ($3.48 in chips) 
Seat 2: HDYD18 ($3.22 in chips) 
Seat 3: pavlo8855 ($2.34 in chips) 
Seat 4: Scaaalll ($2.36 in chips) 
Seat 5: ladi59 ($3.82 in chips) 
Seat 6: Keltu :D ($5.53 in chips) 
HDYD18: posts small blind $0.01
pavlo8855: posts big blind $0.02
*** HOLE CARDS ***
Dealt to Scaaalll [Td Kc]
IceTdannyB is disconnected 
ladi59 is disconnected 
Scaaalll: folds 
ladi59: folds 
Keltu :D: folds 
IceTdannyB: folds 
HDYD18: folds 
Uncalled bet ($0.01) returned to pavlo8855
pavlo8855 collected $0.02 from pot
pavlo8855: doesn't show hand 
*** SUMMARY ***
Total pot $0.02 | Rake $0 
Seat 1: IceTdannyB (button) folded before Flop (didn't bet)
Seat 2: HDYD18 (small blind) folded before Flop
Seat 3: pavlo8855 (big blind) collected ($0.02)
Seat 4: Scaaalll folded before Flop (didn't bet)
Seat 5: ladi59 folded before Flop (didn't bet)
Seat 6: Keltu :D folded before Flop (didn't bet)



PokerStars Zoom Hand #229232928013:  Hold'em No Limit ($0.01/$0.02) - 2021/08/21 23:10:25 CET [2021/08/21 17:10:25 ET]
Table 'Halley' 6-max Seat #1 is the button
Seat 1: Koldun 2636 ($3.50 in chips) 
Seat 2: davidalejag ($3.36 in chips) 
Seat 3: Scaaalll ($2.38 in chips) 
Seat 4: cr@sh test ($2 in chips) 
Seat 5: ctaceo ($2.70 in chips) 
Seat 6: olga3021221 ($2 in chips) 
davidalejag: posts small blind $0.01
Scaaalll: posts big blind $0.02
*** HOLE CARDS ***
Dealt to Scaaalll [Ts 2s]
cr@sh test: folds 
ctaceo: folds 
olga3021221: raises $0.04 to $0.06
Koldun 2636: folds 
davidalejag: calls $0.05
Scaaalll: folds 
*** FLOP *** [2h 6s 3s]
davidalejag: checks 
olga3021221: bets $0.08
davidalejag: folds 
Uncalled bet ($0.08) returned to olga3021221
olga3021221 collected $0.14 from pot
olga3021221: doesn't show hand 
*** SUMMARY ***
Total pot $0.14 | Rake $0 
Board [2h 6s 3s]
Seat 1: Koldun 2636 (button) folded before Flop (didn't bet)
Seat 2: davidalejag (small blind) folded on the Flop
Seat 3: Scaaalll (big blind) folded before Flop
Seat 4: cr@sh test folded before Flop (didn't bet)
Seat 5: ctaceo folded before Flop (didn't bet)
Seat 6: olga3021221 collected ($0.14)



PokerStars Zoom Hand #229232933174:  Hold'em No Limit ($0.01/$0.02) - 2021/08/21 23:10:37 CET [2021/08/21 17:10:37 ET]
Table 'Halley' 6-max Seat #1 is the button
Seat 1: Leonpy92 ($2.61 in chips) 
Seat 2: adrianh2002 ($2 in chips) 
Seat 3: TTGemi ($2.60 in chips) 
Seat 4: Scaaalll ($2.36 in chips) 
Seat 5: Habarovs18 ($2.14 in chips) 
Seat 6: Kergie ($15.57 in chips) 
adrianh2002: posts small blind $0.01
TTGemi: posts big blind $0.02
*** HOLE CARDS ***
Dealt to Scaaalll [Kc 9h]
Habarovs18 is disconnected 
Scaaalll: folds 
Habarovs18: folds 
Kergie: folds 
Leonpy92: folds 
adrianh2002: raises $0.04 to $0.06
TTGemi: folds 
Uncalled bet ($0.04) returned to adrianh2002
adrianh2002 collected $0.04 from pot
adrianh2002: doesn't show hand 
*** SUMMARY ***
Total pot $0.04 | Rake $0 
Seat 1: Leonpy92 (button) folded before Flop (didn't bet)
Seat 2: adrianh2002 (small blind) collected ($0.04)
Seat 3: TTGemi (big blind) folded before Flop
Seat 4: Scaaalll folded before Flop (didn't bet)
Seat 5: Habarovs18 folded before Flop (didn't bet)
Seat 6: Kergie folded before Flop (didn't bet)



PokerStars Zoom Hand #229232935357:  Hold'em No Limit ($0.01/$0.02) - 2021/08/21 23:10:42 CET [2021/08/21 17:10:42 ET]
Table 'Halley' 6-max Seat #1 is the button
Seat 1: Axel201388 ($0.98 in chips) 
Seat 2: BexleyBoy ($2.85 in chips) 
Seat 3: CrazyyParis ($2.06 in chips) 
Seat 4: bananAAbandit ($4.82 in chips) 
Seat 5: XaMpLEr ($2.06 in chips) 
Seat 6: Scaaalll ($2.36 in chips) 
BexleyBoy: posts small blind $0.01
CrazyyParis: posts big blind $0.02
*** HOLE CARDS ***
Dealt to Scaaalll [5s 3c]
bananAAbandit: folds 
XaMpLEr: folds 
Scaaalll: folds 
Axel201388: folds 
BexleyBoy: folds 
Uncalled bet ($0.01) returned to CrazyyParis
CrazyyParis collected $0.02 from pot
CrazyyParis: doesn't show hand 
*** SUMMARY ***
Total pot $0.02 | Rake $0 
Seat 1: Axel201388 (button) folded before Flop (didn't bet)
Seat 2: BexleyBoy (small blind) folded before Flop
Seat 3: CrazyyParis (big blind) collected ($0.02)
Seat 4: bananAAbandit folded before Flop (didn't bet)
Seat 5: XaMpLEr folded before Flop (didn't bet)
Seat 6: Scaaalll folded before Flop (didn't bet)



PokerStars Zoom Hand #229232921998:  Hold'em No Limit ($0.01/$0.02) - 2021/08/21 23:10:11 CET [2021/08/21 17:10:11 ET]
Table 'Halley' 6-max Seat #1 is the button
Seat 1: snowpepsi ($4.36 in chips) 
Seat 2: Scaaalll ($2.39 in chips) 
Seat 3: RrriotGrrrl ($7 in chips) 
Seat 4: OFSHOR ($2.16 in chips) 
Seat 5: Uncle-V0 ($1.83 in chips) 
Seat 6: Feliciano16 ($3.04 in chips) 
Scaaalll: posts small blind $0.01
RrriotGrrrl: posts big blind $0.02
*** HOLE CARDS ***
Dealt to Scaaalll [6s 8c]
OFSHOR: folds 
Uncle-V0: raises $0.04 to $0.06
Feliciano16: calls $0.06
snowpepsi: folds 
Scaaalll: folds 
RrriotGrrrl: folds 
*** FLOP *** [Td 6c 4s]
Uncle-V0: bets $0.07
Feliciano16: calls $0.07
*** TURN *** [Td 6c 4s] [Jh]
Uncle-V0: bets $0.14
Feliciano16: calls $0.14
*** RIVER *** [Td 6c 4s Jh] [5c]
Uncle-V0: checks 
Feliciano16: checks 
*** SHOW DOWN ***
Uncle-V0: shows [7d Ad] (high card Ace)
Feliciano16: shows [As Ks] (high card Ace - King kicker)
Feliciano16 collected $0.55 from pot
*** SUMMARY ***
Total pot $0.57 | Rake $0.02 
Board [Td 6c 4s Jh 5c]
Seat 1: snowpepsi (button) folded before Flop (didn't bet)
Seat 2: Scaaalll (small blind) folded before Flop
Seat 3: RrriotGrrrl (big blind) folded before Flop
Seat 4: OFSHOR folded before Flop (didn't bet)
Seat 5: Uncle-V0 showed [7d Ad] and lost with high card Ace
Seat 6: Feliciano16 showed [As Ks] and won ($0.55) with high card Ace



PokerStars Zoom Hand #229232924151:  Hold'em No Limit ($0.01/$0.02) - 2021/08/21 23:10:16 CET [2021/08/21 17:10:16 ET]
Table 'Halley' 6-max Seat #1 is the button
Seat 1: 9 All Inn 9 ($4.15 in chips) 
Seat 2: Tabitaji ($2.12 in chips) 
Seat 3: Ne0net ($2.79 in chips) 
Seat 4: Soko 1381 ($2.21 in chips) 
Seat 5: Scaaalll ($2.38 in chips) 
Seat 6: rpycmbEM ($4.85 in chips) 
Tabitaji: posts small blind $0.01
Ne0net: posts big blind $0.02
*** HOLE CARDS ***
Dealt to Scaaalll [2c 5h]
Soko 1381: folds 
Scaaalll: folds 
rpycmbEM: folds 
9 All Inn 9: folds 
Tabitaji: raises $0.04 to $0.06
Ne0net: raises $0.12 to $0.18
Tabitaji: calls $0.12
*** FLOP *** [2s 9c 6h]
Tabitaji: checks 
Ne0net: checks 
*** TURN *** [2s 9c 6h] [2h]
Tabitaji: bets $0.26
Ne0net: calls $0.26
*** RIVER *** [2s 9c 6h 2h] [2d]
Tabitaji: checks 
Ne0net: checks 
*** SHOW DOWN ***
Tabitaji: shows [9h 7h] (a full house, Deuces full of Nines)
Ne0net: mucks hand 
Tabitaji collected $0.85 from pot
*** SUMMARY ***
Total pot $0.88 | Rake $0.03 
Board [2s 9c 6h 2h 2d]
Seat 1: 9 All Inn 9 (button) folded before Flop (didn't bet)
Seat 2: Tabitaji (small blind) showed [9h 7h] and won ($0.85) with a full house, Deuces full of Nines
Seat 3: Ne0net (big blind) mucked [Kc Ad]
Seat 4: Soko 1381 folded before Flop (didn't bet)
Seat 5: Scaaalll folded before Flop (didn't bet)
Seat 6: rpycmbEM folded before Flop (didn't bet)



PokerStars Zoom Hand #229232943678:  Hold'em No Limit ($0.01/$0.02) - 2021/08/21 23:11:01 CET [2021/08/21 17:11:01 ET]
Table 'Halley' 6-max Seat #1 is the button
Seat 1: adrianh2002 ($2.02 in chips) 
Seat 2: Scaaalll ($2.34 in chips) 
Seat 3: Trembon ($0.86 in chips) 
Seat 4: Caabz ($3.92 in chips) 
Seat 5: Apollonnn_13 ($2.30 in chips) 
Seat 6: Goingold77 ($0.68 in chips) 
Scaaalll: posts small blind $0.01
Trembon: posts big blind $0.02
*** HOLE CARDS ***
Dealt to Scaaalll [8c Ac]
Caabz: folds 
Goingold77 is disconnected 
Apollonnn_13: raises $0.04 to $0.06
Goingold77: folds 
adrianh2002: folds 
Scaaalll: raises $0.14 to $0.20
Trembon: folds 
Apollonnn_13: folds 
Uncalled bet ($0.14) returned to Scaaalll
Scaaalll collected $0.14 from pot
Scaaalll: doesn't show hand 
*** SUMMARY ***
Total pot $0.14 | Rake $0 
Seat 1: adrianh2002 (button) folded before Flop (didn't bet)
Seat 2: Scaaalll (small blind) collected ($0.14)
Seat 3: Trembon (big blind) folded before Flop
Seat 4: Caabz folded before Flop (didn't bet)
Seat 5: Apollonnn_13 folded before Flop
Seat 6: Goingold77 folded before Flop (didn't bet)



PokerStars Zoom Hand #229232937127:  Hold'em No Limit ($0.01/$0.02) - 2021/08/21 23:10:46 CET [2021/08/21 17:10:46 ET]
Table 'Halley' 6-max Seat #1 is the button
Seat 1: BORODA-X ($3.70 in chips) 
Seat 2: bananAAbandit ($6.18 in chips) 
Seat 3: Scaaalll ($2.36 in chips) 
Seat 4: Bluff2WlN ($3.18 in chips) 
Seat 5: maliniak75 ($3.21 in chips) 
Seat 6: Shaimiev ($2.46 in chips) 
bananAAbandit: posts small blind $0.01
Scaaalll: posts big blind $0.02
*** HOLE CARDS ***
Dealt to Scaaalll [Tc 5s]
Bluff2WlN: folds 
maliniak75: calls $0.02
Shaimiev: raises $0.02 to $0.04
BORODA-X: calls $0.04
bananAAbandit: folds 
Scaaalll: folds 
maliniak75: calls $0.02
*** FLOP *** [2d Jc Ah]
maliniak75: checks 
Shaimiev: bets $0.02
BORODA-X: calls $0.02
maliniak75: folds 
*** TURN *** [2d Jc Ah] [4c]
Shaimiev: bets $0.02
BORODA-X: calls $0.02
*** RIVER *** [2d Jc Ah 4c] [6c]
Shaimiev: bets $2.38 and is all-in
BORODA-X: calls $2.38
*** SHOW DOWN ***
Shaimiev: shows [8c Jd] (a pair of Jacks)
BORODA-X: shows [Ac 9c] (a flush, Ace high)
BORODA-X collected $4.82 from pot
*** SUMMARY ***
Total pot $4.99 | Rake $0.17 
Board [2d Jc Ah 4c 6c]
Seat 1: BORODA-X (button) showed [Ac 9c] and won ($4.82) with a flush, Ace high
Seat 2: bananAAbandit (small blind) folded before Flop
Seat 3: Scaaalll (big blind) folded before Flop
Seat 4: Bluff2WlN folded before Flop (didn't bet)
Seat 5: maliniak75 folded on the Flop
Seat 6: Shaimiev showed [8c Jd] and lost with a pair of Jacks



PokerStars Zoom Hand #229232953269:  Hold'em No Limit ($0.01/$0.02) - 2021/08/21 23:11:23 CET [2021/08/21 17:11:23 ET]
Table 'Halley' 6-max Seat #1 is the button
Seat 1: Gamer577 ($2.08 in chips) 
Seat 2: FabOliveira9 ($2.41 in chips) 
Seat 3: dominik7315 ($2.03 in chips) 
Seat 4: bananAAbandit ($2.45 in chips) 
Seat 5: z3317111711 ($2.09 in chips) 
Seat 6: Scaaalll ($2.42 in chips) 
FabOliveira9: posts small blind $0.01
dominik7315: posts big blind $0.02
*** HOLE CARDS ***
Dealt to Scaaalll [6d 3d]
bananAAbandit: folds 
z3317111711: folds 
Scaaalll: folds 
Gamer577: folds 
FabOliveira9: folds 
Uncalled bet ($0.01) returned to dominik7315
dominik7315 collected $0.02 from pot
dominik7315: doesn't show hand 
*** SUMMARY ***
Total pot $0.02 | Rake $0 
Seat 1: Gamer577 (button) folded before Flop (didn't bet)
Seat 2: FabOliveira9 (small blind) folded before Flop
Seat 3: dominik7315 (big blind) collected ($0.02)
Seat 4: bananAAbandit folded before Flop (didn't bet)
Seat 5: z3317111711 folded before Flop (didn't bet)
Seat 6: Scaaalll folded before Flop (didn't bet)



PokerStars Zoom Hand #229232951496:  Hold'em No Limit ($0.01/$0.02) - 2021/08/21 23:11:19 CET [2021/08/21 17:11:19 ET]
Table 'Halley' 6-max Seat #1 is the button
Seat 1: Scaaalll ($2.42 in chips) 
Seat 2: Reipinguimm ($2 in chips) 
Seat 3: wrfregati ($2.18 in chips) 
Seat 4: Dr.stromg ($5.69 in chips) 
Seat 5: Umnik_M ($3.28 in chips) 
Seat 6: Mac9Monty2 ($2.52 in chips) 
Reipinguimm: posts small blind $0.01
wrfregati: posts big blind $0.02
*** HOLE CARDS ***
Dealt to Scaaalll [Td 8c]
Dr.stromg: raises $0.03 to $0.05
Umnik_M: folds 
Mac9Monty2: folds 
Scaaalll: folds 
Reipinguimm: folds 
wrfregati: calls $0.03
*** FLOP *** [9d 6c 3h]
wrfregati: checks 
Dr.stromg: bets $0.04
wrfregati: calls $0.04
*** TURN *** [9d 6c 3h] [9h]
wrfregati: checks 
Dr.stromg: bets $0.10
wrfregati: calls $0.10
*** RIVER *** [9d 6c 3h 9h] [8h]
wrfregati: checks 
Dr.stromg: checks 
*** SHOW DOWN ***
wrfregati: shows [3d As] (two pair, Nines and Threes)
Dr.stromg: shows [7c 7d] (two pair, Nines and Sevens)
Dr.stromg collected $0.38 from pot
*** SUMMARY ***
Total pot $0.39 | Rake $0.01 
Board [9d 6c 3h 9h 8h]
Seat 1: Scaaalll (button) folded before Flop (didn't bet)
Seat 2: Reipinguimm (small blind) folded before Flop
Seat 3: wrfregati (big blind) showed [3d As] and lost with two pair, Nines and Threes
Seat 4: Dr.stromg showed [7c 7d] and won ($0.38) with two pair, Nines and Sevens
Seat 5: Umnik_M folded before Flop (didn't bet)
Seat 6: Mac9Monty2 folded before Flop (didn't bet)



PokerStars Zoom Hand #229232963934:  Hold'em No Limit ($0.01/$0.02) - 2021/08/21 23:11:48 CET [2021/08/21 17:11:48 ET]
Table 'Halley' 6-max Seat #1 is the button
Seat 1: ziggystarpoker ($1.22 in chips) 
Seat 2: kahzura ($2 in chips) 
Seat 3: Gamer577 ($2.91 in chips) 
Seat 4: Scaaalll ($2.42 in chips) 
Seat 5: MATIdf365 ($4.23 in chips) 
Seat 6: REDCOBRA 1 ($0.74 in chips) 
kahzura: posts small blind $0.01
Gamer577: posts big blind $0.02
*** HOLE CARDS ***
Dealt to Scaaalll [5s 2h]
Scaaalll: folds 
REDCOBRA 1 is disconnected 
MATIdf365: folds 
REDCOBRA 1: folds 
ziggystarpoker: folds 
ziggystarpoker is disconnected 
kahzura: folds 
Uncalled bet ($0.01) returned to Gamer577
Gamer577 collected $0.02 from pot
Gamer577: doesn't show hand 
*** SUMMARY ***
Total pot $0.02 | Rake $0 
Seat 1: ziggystarpoker (button) folded before Flop (didn't bet)
Seat 2: kahzura (small blind) folded before Flop
Seat 3: Gamer577 (big blind) collected ($0.02)
Seat 4: Scaaalll folded before Flop (didn't bet)
Seat 5: MATIdf365 folded before Flop (didn't bet)
Seat 6: REDCOBRA 1 folded before Flop (didn't bet)



PokerStars Zoom Hand #229232965688:  Hold'em No Limit ($0.01/$0.02) - 2021/08/21 23:11:52 CET [2021/08/21 17:11:52 ET]
Table 'Halley' 6-max Seat #1 is the button
Seat 1: fishh_play ($4.02 in chips) 
Seat 2: Scaaalll ($2.42 in chips) 
Seat 3: Den198443 ($2 in chips) 
Seat 4: tolstii906 ($4.20 in chips) 
Seat 5: PapiMik3 ($5.75 in chips) 
Seat 6: hotbud77 ($1.82 in chips) 
Scaaalll: posts small blind $0.01
Den198443: posts big blind $0.02
*** HOLE CARDS ***
Dealt to Scaaalll [Ts Qd]
tolstii906: folds 
PapiMik3: raises $0.04 to $0.06
hotbud77: calls $0.06
fishh_play: calls $0.06
Scaaalll: folds 
Den198443: folds 
*** FLOP *** [6h Kd Th]
PapiMik3: bets $0.07
hotbud77: folds 
fishh_play: folds 
Uncalled bet ($0.07) returned to PapiMik3
PapiMik3 collected $0.20 from pot
PapiMik3: doesn't show hand 
*** SUMMARY ***
Total pot $0.21 | Rake $0.01 
Board [6h Kd Th]
Seat 1: fishh_play (button) folded on the Flop
Seat 2: Scaaalll (small blind) folded before Flop
Seat 3: Den198443 (big blind) folded before Flop
Seat 4: tolstii906 folded before Flop (didn't bet)
Seat 5: PapiMik3 collected ($0.20)
Seat 6: hotbud77 folded on the Flop



PokerStars Zoom Hand #229232958750:  Hold'em No Limit ($0.01/$0.02) - 2021/08/21 23:11:36 CET [2021/08/21 17:11:36 ET]
Table 'Halley' 6-max Seat #1 is the button
Seat 1: trickywizard64 ($1.74 in chips) 
Seat 2: onno978 ($2.66 in chips) 
Seat 3: NoEff0rt2w1n ($7.03 in chips) 
Seat 4: castrosis ($3.07 in chips) 
Seat 5: Scaaalll ($2.42 in chips) 
Seat 6: samn102 ($2.02 in chips) 
onno978: posts small blind $0.01
NoEff0rt2w1n: posts big blind $0.02
*** HOLE CARDS ***
Dealt to Scaaalll [6s Td]
castrosis: raises $0.04 to $0.06
Scaaalll: folds 
samn102: folds 
trickywizard64: folds 
onno978: calls $0.05
NoEff0rt2w1n: calls $0.04
*** FLOP *** [9c Ks 2h]
onno978: bets $0.08
NoEff0rt2w1n: calls $0.08
castrosis: folds 
*** TURN *** [9c Ks 2h] [9h]
onno978: bets $0.16
NoEff0rt2w1n: folds 
Uncalled bet ($0.16) returned to onno978
onno978 collected $0.33 from pot
onno978: doesn't show hand 
*** SUMMARY ***
Total pot $0.34 | Rake $0.01 
Board [9c Ks 2h 9h]
Seat 1: trickywizard64 (button) folded before Flop (didn't bet)
Seat 2: onno978 (small blind) collected ($0.33)
Seat 3: NoEff0rt2w1n (big blind) folded on the Turn
Seat 4: castrosis folded on the Flop
Seat 5: Scaaalll folded before Flop (didn't bet)
Seat 6: samn102 folded before Flop (didn't bet)



PokerStars Zoom Hand #229232972119:  Hold'em No Limit ($0.01/$0.02) - 2021/08/21 23:12:07 CET [2021/08/21 17:12:07 ET]
Table 'Halley' 6-max Seat #1 is the button
Seat 1: vot-tebe888 ($3.79 in chips) 
Seat 2: Thaleshs ($3.78 in chips) 
Seat 3: Scaaalll ($2.41 in chips) 
Seat 4: Koldun 2636 ($3.42 in chips) 
Seat 5: Earl_greyPL ($1.47 in chips) 
Seat 6: AbuLeyla42 ($2.02 in chips) 
Thaleshs: posts small blind $0.01
Scaaalll: posts big blind $0.02
*** HOLE CARDS ***
Dealt to Scaaalll [Ac 9c]
Koldun 2636: folds 
Earl_greyPL: folds 
AbuLeyla42: folds 
vot-tebe888: raises $0.02 to $0.04
Thaleshs: calls $0.03
Scaaalll: calls $0.02
*** FLOP *** [5c 4d Ks]
Thaleshs: checks 
Scaaalll: checks 
vot-tebe888: checks 
*** TURN *** [5c 4d Ks] [5d]
Thaleshs: bets $0.08
Scaaalll: folds 
vot-tebe888: calls $0.08
*** RIVER *** [5c 4d Ks 5d] [7d]
Thaleshs: bets $0.27
vot-tebe888: calls $0.27
*** SHOW DOWN ***
Thaleshs: shows [5s 4s] (a full house, Fives full of Fours)
vot-tebe888: mucks hand 
Thaleshs collected $0.79 from pot
*** SUMMARY ***
Total pot $0.82 | Rake $0.03 
Board [5c 4d Ks 5d 7d]
Seat 1: vot-tebe888 (button) mucked [6s 3s]
Seat 2: Thaleshs (small blind) showed [5s 4s] and won ($0.79) with a full house, Fives full of Fours
Seat 3: Scaaalll (big blind) folded on the Turn
Seat 4: Koldun 2636 folded before Flop (didn't bet)
Seat 5: Earl_greyPL folded before Flop (didn't bet)
Seat 6: AbuLeyla42 folded before Flop (didn't bet)



PokerStars Zoom Hand #229232988844:  Hold'em No Limit ($0.01/$0.02) - 2021/08/21 23:12:46 CET [2021/08/21 17:12:46 ET]
Table 'Halley' 6-max Seat #1 is the button
Seat 1: baxprom ($2.45 in chips) 
Seat 2: MKIronCrAAzy ($3.48 in chips) 
Seat 3: rpycmbEM ($5.22 in chips) 
Seat 4: pavlo8855 ($2.03 in chips) 
Seat 5: NecromiconP ($2 in chips) 
Seat 6: Scaaalll ($2.37 in chips) 
MKIronCrAAzy: posts small blind $0.01
rpycmbEM: posts big blind $0.02
*** HOLE CARDS ***
Dealt to Scaaalll [6c Ks]
pavlo8855: folds 
NecromiconP: folds 
Scaaalll: folds 
baxprom: raises $0.02 to $0.04
MKIronCrAAzy: folds 
rpycmbEM: folds 
Uncalled bet ($0.02) returned to baxprom
baxprom collected $0.05 from pot
baxprom: doesn't show hand 
*** SUMMARY ***
Total pot $0.05 | Rake $0 
Seat 1: baxprom (button) collected ($0.05)
Seat 2: MKIronCrAAzy (small blind) folded before Flop
Seat 3: rpycmbEM (big blind) folded before Flop
Seat 4: pavlo8855 folded before Flop (didn't bet)
Seat 5: NecromiconP folded before Flop (didn't bet)
Seat 6: Scaaalll folded before Flop (didn't bet)



PokerStars Zoom Hand #229232993220:  Hold'em No Limit ($0.01/$0.02) - 2021/08/21 23:12:56 CET [2021/08/21 17:12:56 ET]
Table 'Halley' 6-max Seat #1 is the button
Seat 1: cutter2468 ($2.02 in chips) 
Seat 2: Dr.stromg ($5.36 in chips) 
Seat 3: KissingTheSun ($2 in chips) 
Seat 4: Scaaalll ($2.37 in chips) 
Seat 5: Chapaev136 ($6.15 in chips) 
Seat 6: kukulagosleep ($2.06 in chips) 
Dr.stromg: posts small blind $0.01
KissingTheSun: posts big blind $0.02
*** HOLE CARDS ***
Dealt to Scaaalll [8c 4c]
Scaaalll has timed out
Scaaalll: folds 
Chapaev136: folds 
kukulagosleep: folds 
cutter2468: folds 
Dr.stromg: folds 
Uncalled bet ($0.01) returned to KissingTheSun
KissingTheSun collected $0.02 from pot
KissingTheSun: doesn't show hand 
*** SUMMARY ***
Total pot $0.02 | Rake $0 
Seat 1: cutter2468 (button) folded before Flop (didn't bet)
Seat 2: Dr.stromg (small blind) folded before Flop
Seat 3: KissingTheSun (big blind) collected ($0.02)
Seat 4: Scaaalll folded before Flop (didn't bet)
Seat 5: Chapaev136 folded before Flop (didn't bet)
Seat 6: kukulagosleep folded before Flop (didn't bet)



PokerStars Zoom Hand #229232987196:  Hold'em No Limit ($0.01/$0.02) - 2021/08/21 23:12:42 CET [2021/08/21 17:12:42 ET]
Table 'Halley' 6-max Seat #1 is the button
Seat 1: Scaaalll ($2.37 in chips) 
Seat 2: Bol'tazar111 ($5.18 in chips) 
Seat 3: KKARMELO ($2.28 in chips) 
Seat 4: wrfregati ($1.91 in chips) 
Seat 5: Larson_mfk ($0.70 in chips) 
Seat 6: nodtress ($2.28 in chips) 
Bol'tazar111: posts small blind $0.01
KKARMELO: posts big blind $0.02
*** HOLE CARDS ***
Dealt to Scaaalll [Jh 6h]
wrfregati: folds 
Larson_mfk: raises $0.02 to $0.04
nodtress: folds 
Scaaalll: folds 
Bol'tazar111: folds 
KKARMELO: calls $0.02
*** FLOP *** [5c Kc 8h]
KKARMELO: checks 
Larson_mfk: checks 
*** TURN *** [5c Kc 8h] [Kd]
KKARMELO: bets $0.05
Larson_mfk: calls $0.05
*** RIVER *** [5c Kc 8h Kd] [9h]
KKARMELO: checks 
Larson_mfk: checks 
*** SHOW DOWN ***
KKARMELO: shows [Ad 8d] (two pair, Kings and Eights)
Larson_mfk: shows [Ac 9c] (two pair, Kings and Nines)
Larson_mfk collected $0.18 from pot
*** SUMMARY ***
Total pot $0.19 | Rake $0.01 
Board [5c Kc 8h Kd 9h]
Seat 1: Scaaalll (button) folded before Flop (didn't bet)
Seat 2: Bol'tazar111 (small blind) folded before Flop
Seat 3: KKARMELO (big blind) showed [Ad 8d] and lost with two pair, Kings and Eights
Seat 4: wrfregati folded before Flop (didn't bet)
Seat 5: Larson_mfk showed [Ac 9c] and won ($0.18) with two pair, Kings and Nines
Seat 6: nodtress folded before Flop (didn't bet)



PokerStars Zoom Hand #229232991464:  Hold'em No Limit ($0.01/$0.02) - 2021/08/21 23:12:52 CET [2021/08/21 17:12:52 ET]
Table 'Halley' 6-max Seat #1 is the button
Seat 1: juan24655 ($1.93 in chips) 
Seat 2: snowpepsi ($2.08 in chips) 
Seat 3: shingo594 ($4.90 in chips) 
Seat 4: VadimSaratov ($1.36 in chips) 
Seat 5: Scaaalll ($2.37 in chips) 
Seat 6: Keltu :D ($5.78 in chips) 
snowpepsi: posts small blind $0.01
shingo594: posts big blind $0.02
*** HOLE CARDS ***
Dealt to Scaaalll [3c 2s]
VadimSaratov: folds 
Scaaalll: folds 
Keltu :D: raises $0.03 to $0.05
juan24655: folds 
shingo594 is disconnected 
snowpepsi: calls $0.04
shingo594: folds 
*** FLOP *** [4c 5h 8s]
snowpepsi: checks 
Keltu :D: bets $0.06
snowpepsi: calls $0.06
*** TURN *** [4c 5h 8s] [Jd]
snowpepsi: checks 
Keltu :D: bets $0.18
snowpepsi: calls $0.18
*** RIVER *** [4c 5h 8s Jd] [Kc]
snowpepsi: checks 
Keltu :D: checks 
*** SHOW DOWN ***
snowpepsi: shows [Jh Ac] (a pair of Jacks)
Keltu :D: mucks hand 
snowpepsi collected $0.58 from pot
*** SUMMARY ***
Total pot $0.60 | Rake $0.02 
Board [4c 5h 8s Jd Kc]
Seat 1: juan24655 (button) folded before Flop (didn't bet)
Seat 2: snowpepsi (small blind) showed [Jh Ac] and won ($0.58) with a pair of Jacks
Seat 3: shingo594 (big blind) folded before Flop
Seat 4: VadimSaratov folded before Flop (didn't bet)
Seat 5: Scaaalll folded before Flop (didn't bet)
Seat 6: Keltu :D mucked [Tc Qc]



PokerStars Zoom Hand #229233098023:  Hold'em No Limit ($0.01/$0.02) - 2021/08/21 23:17:00 CET [2021/08/21 17:17:00 ET]
Table 'Halley' 6-max Seat #1 is the button
Seat 1: RrriotGrrrl ($7.20 in chips) 
Seat 2: Cid s2 ($2.21 in chips) 
Seat 3: Scaaalll ($2.37 in chips) 
Seat 4: alexmpokes ($2.65 in chips) 
Seat 5: Ne0net ($2.51 in chips) 
Seat 6: estelionat171 ($0.97 in chips) 
Cid s2: posts small blind $0.01
Scaaalll: posts big blind $0.02
*** HOLE CARDS ***
Dealt to Scaaalll [Ad Td]
alexmpokes: calls $0.02
Ne0net: folds 
estelionat171: folds 
RrriotGrrrl: folds 
Cid s2: folds 
Scaaalll: raises $0.08 to $0.10
alexmpokes: calls $0.08
*** FLOP *** [9s Ac As]
Scaaalll: bets $0.12
alexmpokes: calls $0.12
*** TURN *** [9s Ac As] [8h]
Scaaalll: bets $0.26
alexmpokes: calls $0.26
*** RIVER *** [9s Ac As 8h] [Kd]
Scaaalll: bets $0.62
alexmpokes: folds 
Uncalled bet ($0.62) returned to Scaaalll
Scaaalll collected $0.93 from pot
Scaaalll: doesn't show hand 
alexmpokes is disconnected 
*** SUMMARY ***
Total pot $0.97 | Rake $0.04 
Board [9s Ac As 8h Kd]
Seat 1: RrriotGrrrl (button) folded before Flop (didn't bet)
Seat 2: Cid s2 (small blind) folded before Flop
Seat 3: Scaaalll (big blind) collected ($0.93)
Seat 4: alexmpokes folded on the River
Seat 5: Ne0net folded before Flop (didn't bet)
Seat 6: estelionat171 folded before Flop (didn't bet)



PokerStars Zoom Hand #229233122391:  Hold'em No Limit ($0.01/$0.02) - 2021/08/21 23:17:57 CET [2021/08/21 17:17:57 ET]
Table 'Halley' 6-max Seat #1 is the button
Seat 1: johnpa89 ($2.38 in chips) 
Seat 2: Scaaalll ($2.82 in chips) 
Seat 3: HDYD18 ($2.01 in chips) 
Seat 4: giselerebelo ($1.67 in chips) 
Seat 5: z3317111711 ($2.24 in chips) 
Seat 6: disanddowny ($1.94 in chips) 
Scaaalll: posts small blind $0.01
HDYD18: posts big blind $0.02
*** HOLE CARDS ***
Dealt to Scaaalll [Tc As]
giselerebelo: raises $0.04 to $0.06
z3317111711: folds 
disanddowny: folds 
johnpa89: calls $0.06
Scaaalll: folds 
HDYD18: folds 
*** FLOP *** [5c 4d 5d]
giselerebelo: checks 
johnpa89: bets $0.08
giselerebelo: folds 
Uncalled bet ($0.08) returned to johnpa89
johnpa89 collected $0.14 from pot
johnpa89: doesn't show hand 
*** SUMMARY ***
Total pot $0.15 | Rake $0.01 
Board [5c 4d 5d]
Seat 1: johnpa89 (button) collected ($0.14)
Seat 2: Scaaalll (small blind) folded before Flop
Seat 3: HDYD18 (big blind) folded before Flop
Seat 4: giselerebelo folded on the Flop
Seat 5: z3317111711 folded before Flop (didn't bet)
Seat 6: disanddowny folded before Flop (didn't bet)



PokerStars Zoom Hand #229233132884:  Hold'em No Limit ($0.01/$0.02) - 2021/08/21 23:18:22 CET [2021/08/21 17:18:22 ET]
Table 'Halley' 6-max Seat #1 is the button
Seat 1: Scaaalll ($2.81 in chips) 
Seat 2: new face onl ($1.23 in chips) 
Seat 3: babiloniaxxx ($2 in chips) 
Seat 4: The-End-snglr ($1.73 in chips) 
Seat 5: didiclavi777 ($2.21 in chips) 
Seat 6: SIGREX ($2.10 in chips) 
new face onl: posts small blind $0.01
babiloniaxxx: posts big blind $0.02
*** HOLE CARDS ***
Dealt to Scaaalll [Qs 8h]
The-End-snglr: folds 
didiclavi777: folds 
SIGREX: folds 
Scaaalll: raises $0.02 to $0.04
new face onl: calls $0.03
babiloniaxxx: calls $0.02
*** FLOP *** [4h 9s 7h]
new face onl: checks 
babiloniaxxx: checks 
Scaaalll: checks 
*** TURN *** [4h 9s 7h] [Jc]
new face onl: checks 
babiloniaxxx: checks 
Scaaalll: checks 
*** RIVER *** [4h 9s 7h Jc] [6h]
new face onl: checks 
babiloniaxxx: bets $0.06
Scaaalll: folds 
new face onl: folds 
Uncalled bet ($0.06) returned to babiloniaxxx
babiloniaxxx collected $0.12 from pot
babiloniaxxx: doesn't show hand 
*** SUMMARY ***
Total pot $0.12 | Rake $0 
Board [4h 9s 7h Jc 6h]
Seat 1: Scaaalll (button) folded on the River
Seat 2: new face onl (small blind) folded on the River
Seat 3: babiloniaxxx (big blind) collected ($0.12)
Seat 4: The-End-snglr folded before Flop (didn't bet)
Seat 5: didiclavi777 folded before Flop (didn't bet)
Seat 6: SIGREX folded before Flop (didn't bet)



PokerStars Zoom Hand #229233159717:  Hold'em No Limit ($0.01/$0.02) - 2021/08/21 23:19:16 CET [2021/08/21 17:19:16 ET]
Table 'Halley' 6-max Seat #1 is the button
Seat 1: Thaleshs ($3.77 in chips) 
Seat 2: queen830 ($14.37 in chips) 
Seat 3: rabbitmeat73 ($1.12 in chips) 
Seat 4: Scaaalll ($2.77 in chips) 
Seat 5: Zigsol ($0.72 in chips) 
Seat 6: 21041956 ($0.67 in chips) 
queen830: posts small blind $0.01
rabbitmeat73: posts big blind $0.02
*** HOLE CARDS ***
Dealt to Scaaalll [9d 2c]
Zigsol is disconnected 
Scaaalll has timed out
Scaaalll: folds 
Zigsol: folds 
21041956: folds 
Thaleshs: raises $0.04 to $0.06
queen830: raises $0.12 to $0.18
rabbitmeat73: folds 
Thaleshs: calls $0.12
*** FLOP *** [Qh 8c Jh]
queen830: bets $0.19
Thaleshs: folds 
Uncalled bet ($0.19) returned to queen830
queen830 collected $0.37 from pot
queen830: doesn't show hand 
*** SUMMARY ***
Total pot $0.38 | Rake $0.01 
Board [Qh 8c Jh]
Seat 1: Thaleshs (button) folded on the Flop
Seat 2: queen830 (small blind) collected ($0.37)
Seat 3: rabbitmeat73 (big blind) folded before Flop
Seat 4: Scaaalll folded before Flop (didn't bet)
Seat 5: Zigsol folded before Flop (didn't bet)
Seat 6: 21041956 folded before Flop (didn't bet)



PokerStars Zoom Hand #229233179860:  Hold'em No Limit ($0.01/$0.02) - 2021/08/21 23:20:03 CET [2021/08/21 17:20:03 ET]
Table 'Halley' 6-max Seat #1 is the button
Seat 1: ctaceo ($2 in chips) 
Seat 2: Scaaalll ($2.77 in chips) 
Seat 3: XHerrTUMNUSX ($8.67 in chips) 
Seat 4: kcyxa ($1.94 in chips) 
Seat 5: Demidov V.S. ($2.54 in chips) 
Seat 6: Krysz007 ($1.07 in chips) 
Scaaalll: posts small blind $0.01
XHerrTUMNUSX: posts big blind $0.02
*** HOLE CARDS ***
Dealt to Scaaalll [5s Ac]
Demidov V.S. is disconnected 
kcyxa: folds 
Demidov V.S.: folds 
kcyxa is disconnected 
Krysz007: raises $0.04 to $0.06
ctaceo: folds 
Scaaalll: folds 
XHerrTUMNUSX: calls $0.04
*** FLOP *** [2s 6c Td]
XHerrTUMNUSX: checks 
Krysz007: bets $0.08
XHerrTUMNUSX: calls $0.08
*** TURN *** [2s 6c Td] [6h]
XHerrTUMNUSX: checks 
Krysz007: checks 
*** RIVER *** [2s 6c Td 6h] [6s]
XHerrTUMNUSX: checks 
Krysz007: bets $0.14
XHerrTUMNUSX: calls $0.14
*** SHOW DOWN ***
Krysz007: shows [7c 5h] (three of a kind, Sixes)
XHerrTUMNUSX: shows [9c 9d] (a full house, Sixes full of Nines)
XHerrTUMNUSX collected $0.55 from pot
*** SUMMARY ***
Total pot $0.57 | Rake $0.02 
Board [2s 6c Td 6h 6s]
Seat 1: ctaceo (button) folded before Flop (didn't bet)
Seat 2: Scaaalll (small blind) folded before Flop
Seat 3: XHerrTUMNUSX (big blind) showed [9c 9d] and won ($0.55) with a full house, Sixes full of Nines
Seat 4: kcyxa folded before Flop (didn't bet)
Seat 5: Demidov V.S. folded before Flop (didn't bet)
Seat 6: Krysz007 showed [7c 5h] and lost with three of a kind, Sixes



PokerStars Zoom Hand #229233183728:  Hold'em No Limit ($0.01/$0.02) - 2021/08/21 23:20:12 CET [2021/08/21 17:20:12 ET]
Table 'Halley' 6-max Seat #1 is the button
Seat 1: NetoFLX ($2 in chips) 
Seat 2: TTGemi ($2.70 in chips) 
Seat 3: cr@sh test ($2.28 in chips) 
Seat 4: Smirandal ($3.79 in chips) 
Seat 5: Dr.stromg ($6.44 in chips) 
Seat 6: Scaaalll ($2.76 in chips) 
TTGemi: posts small blind $0.01
cr@sh test: posts big blind $0.02
*** HOLE CARDS ***
Dealt to Scaaalll [Ac Jd]
Smirandal: folds 
Dr.stromg: folds 
Scaaalll: raises $0.04 to $0.06
NetoFLX: folds 
TTGemi: folds 
cr@sh test: calls $0.04
*** FLOP *** [9d 4c 8s]
cr@sh test: checks 
Scaaalll: bets $0.08
cr@sh test: raises $0.10 to $0.18
Scaaalll: folds 
Uncalled bet ($0.10) returned to cr@sh test
cr@sh test collected $0.28 from pot
cr@sh test: doesn't show hand 
*** SUMMARY ***
Total pot $0.29 | Rake $0.01 
Board [9d 4c 8s]
Seat 1: NetoFLX (button) folded before Flop (didn't bet)
Seat 2: TTGemi (small blind) folded before Flop
Seat 3: cr@sh test (big blind) collected ($0.28)
Seat 4: Smirandal folded before Flop (didn't bet)
Seat 5: Dr.stromg folded before Flop (didn't bet)
Seat 6: Scaaalll folded on the Flop



PokerStars Zoom Hand #229233202284:  Hold'em No Limit ($0.01/$0.02) - 2021/08/21 23:20:56 CET [2021/08/21 17:20:56 ET]
Table 'Halley' 6-max Seat #1 is the button
Seat 1: WITKOW_AV ($2 in chips) 
Seat 2: Vanekakqj ($4.30 in chips) 
Seat 3: Scaaalll ($2.62 in chips) 
Seat 4: Ryan Colls ($1.83 in chips) 
Seat 5: new face onl ($1.96 in chips) 
Seat 6: Pizotifen ($2.96 in chips) 
Vanekakqj: posts small blind $0.01
Scaaalll: posts big blind $0.02
*** HOLE CARDS ***
Dealt to Scaaalll [4s 7d]
Ryan Colls: raises $0.02 to $0.04
new face onl: folds 
Pizotifen: folds 
WITKOW_AV: folds 
Vanekakqj: folds 
Scaaalll: folds 
Uncalled bet ($0.02) returned to Ryan Colls
Ryan Colls collected $0.05 from pot
Ryan Colls: doesn't show hand 
*** SUMMARY ***
Total pot $0.05 | Rake $0 
Seat 1: WITKOW_AV (button) folded before Flop (didn't bet)
Seat 2: Vanekakqj (small blind) folded before Flop
Seat 3: Scaaalll (big blind) folded before Flop
Seat 4: Ryan Colls collected ($0.05)
Seat 5: new face onl folded before Flop (didn't bet)
Seat 6: Pizotifen folded before Flop (didn't bet)



PokerStars Zoom Hand #229233207817:  Hold'em No Limit ($0.01/$0.02) - 2021/08/21 23:21:09 CET [2021/08/21 17:21:09 ET]
Table 'Halley' 6-max Seat #1 is the button
Seat 1: ladi59 ($3.96 in chips) 
Seat 2: volt_by ($0.81 in chips) 
Seat 3: LSDenny ($2.58 in chips) 
Seat 4: martinob11 ($1.97 in chips) 
Seat 5: Scaaalll ($2.60 in chips) 
Seat 6: samyr1111 ($1.99 in chips) 
volt_by: posts small blind $0.01
LSDenny: posts big blind $0.02
*** HOLE CARDS ***
Dealt to Scaaalll [7s 8h]
martinob11: folds 
Scaaalll: folds 
samyr1111: raises $0.04 to $0.06
ladi59: calls $0.06
volt_by: folds 
LSDenny: folds 
*** FLOP *** [Js Kh 8c]
LSDenny is disconnected 
samyr1111: checks 
ladi59: checks 
*** TURN *** [Js Kh 8c] [Qd]
samyr1111: checks 
ladi59: bets $0.04
samyr1111: calls $0.04
*** RIVER *** [Js Kh 8c Qd] [9c]
samyr1111: checks 
ladi59: checks 
*** SHOW DOWN ***
samyr1111: shows [Jc Ah] (a pair of Jacks)
ladi59: shows [Qh 5h] (a pair of Queens)
ladi59 collected $0.22 from pot
*** SUMMARY ***
Total pot $0.23 | Rake $0.01 
Board [Js Kh 8c Qd 9c]
Seat 1: ladi59 (button) showed [Qh 5h] and won ($0.22) with a pair of Queens
Seat 2: volt_by (small blind) folded before Flop
Seat 3: LSDenny (big blind) folded before Flop
Seat 4: martinob11 folded before Flop (didn't bet)
Seat 5: Scaaalll folded before Flop (didn't bet)
Seat 6: samyr1111 showed [Jc Ah] and lost with a pair of Jacks



PokerStars Zoom Hand #229233212519:  Hold'em No Limit ($0.01/$0.02) - 2021/08/21 23:21:20 CET [2021/08/21 17:21:20 ET]
Table 'Halley' 6-max Seat #1 is the button
Seat 1: Scaaalll ($2.60 in chips) 
Seat 2: nAfEd585 ($1.11 in chips) 
Seat 3: ChuckGaylordIII ($3.68 in chips) 
Seat 4: KissingTheSun ($2.23 in chips) 
Seat 5: dinoVIEIRA ($3.31 in chips) 
Seat 6: Iv3rson18 ($2.03 in chips) 
nAfEd585: posts small blind $0.01
ChuckGaylordIII: posts big blind $0.02
*** HOLE CARDS ***
Dealt to Scaaalll [4c Qs]
KissingTheSun: folds 
dinoVIEIRA: folds 
Iv3rson18: folds 
Scaaalll: folds 
nAfEd585: calls $0.01
ChuckGaylordIII: raises $0.02 to $0.04
nAfEd585: calls $0.02
*** FLOP *** [Ks Kc 4s]
nAfEd585: checks 
ChuckGaylordIII: bets $0.04
nAfEd585: calls $0.04
*** TURN *** [Ks Kc 4s] [Ac]
nAfEd585: checks 
ChuckGaylordIII: bets $0.07
nAfEd585: raises $0.07 to $0.14
ChuckGaylordIII: calls $0.07
*** RIVER *** [Ks Kc 4s Ac] [Jh]
nAfEd585: checks 
ChuckGaylordIII: bets $0.21
nAfEd585: raises $0.21 to $0.42
ChuckGaylordIII: calls $0.21
*** SHOW DOWN ***
nAfEd585: shows [As Kh] (a full house, Kings full of Aces)
ChuckGaylordIII: mucks hand 
nAfEd585 collected $1.23 from pot
*** SUMMARY ***
Total pot $1.28 | Rake $0.05 
Board [Ks Kc 4s Ac Jh]
Seat 1: Scaaalll (button) folded before Flop (didn't bet)
Seat 2: nAfEd585 (small blind) showed [As Kh] and won ($1.23) with a full house, Kings full of Aces
Seat 3: ChuckGaylordIII (big blind) mucked [9c Ah]
Seat 4: KissingTheSun folded before Flop (didn't bet)
Seat 5: dinoVIEIRA folded before Flop (didn't bet)
Seat 6: Iv3rson18 folded before Flop (didn't bet)



PokerStars Zoom Hand #229233218976:  Hold'em No Limit ($0.01/$0.02) - 2021/08/21 23:21:35 CET [2021/08/21 17:21:35 ET]
Table 'Halley' 6-max Seat #1 is the button
Seat 1: Gamer577 ($3.59 in chips) 
Seat 2: Pechorin.G ($2.11 in chips) 
Seat 3: botyesz999 ($1.02 in chips) 
Seat 4: ctaceo ($2.11 in chips) 
Seat 5: WITKOW_AV ($2.03 in chips) 
Seat 6: Scaaalll ($2.60 in chips) 
Pechorin.G: posts small blind $0.01
botyesz999: posts big blind $0.02
*** HOLE CARDS ***
Dealt to Scaaalll [Kc Ad]
ctaceo: folds 
WITKOW_AV: folds 
Scaaalll: raises $0.04 to $0.06
Gamer577: folds 
Pechorin.G: folds 
botyesz999: calls $0.04
*** FLOP *** [As 4c 4d]
botyesz999: checks 
Scaaalll: bets $0.08
botyesz999: calls $0.08
*** TURN *** [As 4c 4d] [5h]
botyesz999: checks 
Scaaalll: bets $0.19
botyesz999: calls $0.19
*** RIVER *** [As 4c 4d 5h] [Ac]
botyesz999: checks 
Scaaalll: bets $0.38
botyesz999: folds 
Uncalled bet ($0.38) returned to Scaaalll
Scaaalll collected $0.65 from pot
Scaaalll: doesn't show hand 
*** SUMMARY ***
Total pot $0.67 | Rake $0.02 
Board [As 4c 4d 5h Ac]
Seat 1: Gamer577 (button) folded before Flop (didn't bet)
Seat 2: Pechorin.G (small blind) folded before Flop
Seat 3: botyesz999 (big blind) folded on the River
Seat 4: ctaceo folded before Flop (didn't bet)
Seat 5: WITKOW_AV folded before Flop (didn't bet)
Seat 6: Scaaalll collected ($0.65)



PokerStars Zoom Hand #229233245142:  Hold'em No Limit ($0.01/$0.02) - 2021/08/21 23:22:37 CET [2021/08/21 17:22:37 ET]
Table 'Halley' 6-max Seat #1 is the button
Seat 1: z3317111711 ($4.11 in chips) 
Seat 2: Goingold77 ($1.97 in chips) 
Seat 3: Stormzilla ($2 in chips) 
Seat 4: Z0omer_420 ($2 in chips) 
Seat 5: Scaaalll ($2.92 in chips) 
Seat 6: Cineva81 ($2 in chips) 
Goingold77: posts small blind $0.01
Stormzilla: posts big blind $0.02
*** HOLE CARDS ***
Dealt to Scaaalll [Jc 2c]
Z0omer_420: folds 
Scaaalll: folds 
Cineva81: folds 
z3317111711: folds 
Goingold77: calls $0.01
Stormzilla: checks 
*** FLOP *** [7d Ad 8c]
Goingold77: bets $0.02
Stormzilla: folds 
Uncalled bet ($0.02) returned to Goingold77
Goingold77 collected $0.04 from pot
Goingold77: doesn't show hand 
*** SUMMARY ***
Total pot $0.04 | Rake $0 
Board [7d Ad 8c]
Seat 1: z3317111711 (button) folded before Flop (didn't bet)
Seat 2: Goingold77 (small blind) collected ($0.04)
Seat 3: Stormzilla (big blind) folded on the Flop
Seat 4: Z0omer_420 folded before Flop (didn't bet)
Seat 5: Scaaalll folded before Flop (didn't bet)
Seat 6: Cineva81 folded before Flop (didn't bet)



PokerStars Zoom Hand #229233247658:  Hold'em No Limit ($0.01/$0.02) - 2021/08/21 23:22:43 CET [2021/08/21 17:22:43 ET]
Table 'Halley' 6-max Seat #1 is the button
Seat 1: pipecmolodec ($2.06 in chips) 
Seat 2: Bol'tazar111 ($2.49 in chips) 
Seat 3: I.P.BAYANOV ($2.48 in chips) 
Seat 4: Scaaalll ($2.92 in chips) 
Seat 5: Gamer577 ($10.51 in chips) 
Seat 6: kcyxa ($1.98 in chips) 
Bol'tazar111: posts small blind $0.01
I.P.BAYANOV: posts big blind $0.02
*** HOLE CARDS ***
Dealt to Scaaalll [7s 3d]
kcyxa is disconnected 
Scaaalll: folds 
Gamer577: folds 
kcyxa: folds 
pipecmolodec: raises $0.02 to $0.04
Bol'tazar111: folds 
I.P.BAYANOV: folds 
Uncalled bet ($0.02) returned to pipecmolodec
pipecmolodec collected $0.05 from pot
pipecmolodec: doesn't show hand 
*** SUMMARY ***
Total pot $0.05 | Rake $0 
Seat 1: pipecmolodec (button) collected ($0.05)
Seat 2: Bol'tazar111 (small blind) folded before Flop
Seat 3: I.P.BAYANOV (big blind) folded before Flop
Seat 4: Scaaalll folded before Flop (didn't bet)
Seat 5: Gamer577 folded before Flop (didn't bet)
Seat 6: kcyxa folded before Flop (didn't bet)



PokerStars Zoom Hand #229233249316:  Hold'em No Limit ($0.01/$0.02) - 2021/08/21 23:22:47 CET [2021/08/21 17:22:47 ET]
Table 'Halley' 6-max Seat #1 is the button
Seat 1: JTbukowski ($2.60 in chips) 
Seat 2: ctaceo ($2.08 in chips) 
Seat 3: Scaaalll ($2.92 in chips) 
Seat 4: pavlo8855 ($2.45 in chips) 
Seat 5: KKARMELO ($3.37 in chips) 
Seat 6: roukoun1984 ($1.83 in chips) 
ctaceo: posts small blind $0.01
Scaaalll: posts big blind $0.02
*** HOLE CARDS ***
Dealt to Scaaalll [6s Qc]
roukoun1984 is disconnected 
pavlo8855: folds 
KKARMELO: folds 
roukoun1984: folds 
JTbukowski: folds 
ctaceo: folds 
Uncalled bet ($0.01) returned to Scaaalll
Scaaalll collected $0.02 from pot
Scaaalll: doesn't show hand 
*** SUMMARY ***
Total pot $0.02 | Rake $0 
Seat 1: JTbukowski (button) folded before Flop (didn't bet)
Seat 2: ctaceo (small blind) folded before Flop
Seat 3: Scaaalll (big blind) collected ($0.02)
Seat 4: pavlo8855 folded before Flop (didn't bet)
Seat 5: KKARMELO folded before Flop (didn't bet)
Seat 6: roukoun1984 folded before Flop (didn't bet)



PokerStars Zoom Hand #229233254321:  Hold'em No Limit ($0.01/$0.02) - 2021/08/21 23:22:59 CET [2021/08/21 17:22:59 ET]
Table 'Halley' 6-max Seat #1 is the button
Seat 1: danteesq ($2.02 in chips) 
Seat 2: Scaaalll ($2.93 in chips) 
Seat 3: cutter2468 ($2 in chips) 
Seat 4: Phoenixxxxxxxx ($2 in chips) 
Seat 5: sg.32rus ($1.94 in chips) 
Seat 6: fishh_play ($3.26 in chips) 
Scaaalll: posts small blind $0.01
cutter2468: posts big blind $0.02
*** HOLE CARDS ***
Dealt to Scaaalll [9h 9c]
Phoenixxxxxxxx: folds 
sg.32rus: folds 
fishh_play: folds 
danteesq: folds 
Scaaalll: raises $0.04 to $0.06
cutter2468: folds 
Uncalled bet ($0.04) returned to Scaaalll
Scaaalll collected $0.04 from pot
Scaaalll: doesn't show hand 
*** SUMMARY ***
Total pot $0.04 | Rake $0 
Seat 1: danteesq (button) folded before Flop (didn't bet)
Seat 2: Scaaalll (small blind) collected ($0.04)
Seat 3: cutter2468 (big blind) folded before Flop
Seat 4: Phoenixxxxxxxx folded before Flop (didn't bet)
Seat 5: sg.32rus folded before Flop (didn't bet)
Seat 6: fishh_play folded before Flop (didn't bet)



PokerStars Zoom Hand #229233263533:  Hold'em No Limit ($0.01/$0.02) - 2021/08/21 23:23:21 CET [2021/08/21 17:23:21 ET]
Table 'Halley' 6-max Seat #1 is the button
Seat 1: Scaaalll ($2.95 in chips) 
Seat 2: WITKOW_AV ($2 in chips) 
Seat 3: AtZ3899 ($3.21 in chips) 
Seat 4: kukulagosleep ($3.71 in chips) 
Seat 5: MattieBOZ ($1.65 in chips) 
Seat 6: Healthys07 ($2.89 in chips) 
WITKOW_AV: posts small blind $0.01
AtZ3899: posts big blind $0.02
*** HOLE CARDS ***
Dealt to Scaaalll [6h 7d]
kukulagosleep: folds 
MattieBOZ: folds 
Healthys07: folds 
MattieBOZ is disconnected 
Scaaalll: folds 
WITKOW_AV: folds 
Uncalled bet ($0.01) returned to AtZ3899
AtZ3899 collected $0.02 from pot
AtZ3899: doesn't show hand 
*** SUMMARY ***
Total pot $0.02 | Rake $0 
Seat 1: Scaaalll (button) folded before Flop (didn't bet)
Seat 2: WITKOW_AV (small blind) folded before Flop
Seat 3: AtZ3899 (big blind) collected ($0.02)
Seat 4: kukulagosleep folded before Flop (didn't bet)
Seat 5: MattieBOZ folded before Flop (didn't bet)
Seat 6: Healthys07 folded before Flop (didn't bet)



PokerStars Zoom Hand #229233269819:  Hold'em No Limit ($0.01/$0.02) - 2021/08/21 23:23:36 CET [2021/08/21 17:23:36 ET]
Table 'Halley' 6-max Seat #1 is the button
Seat 1: Marcus579 ($3.18 in chips) 
Seat 2: Scaaalll ($2.95 in chips) 
Seat 3: olga3021221 ($2.32 in chips) 
Seat 4: *88VIC88* ($0.60 in chips) 
Seat 5: LSDenny ($2.73 in chips) 
Seat 6: fishh_play ($3.16 in chips) 
Scaaalll: posts small blind $0.01
olga3021221: posts big blind $0.02
*** HOLE CARDS ***
Dealt to Scaaalll [9c 5c]
LSDenny is disconnected 
*88VIC88*: raises $0.58 to $0.60 and is all-in
LSDenny: folds 
fishh_play: folds 
Marcus579: folds 
Scaaalll: folds 
olga3021221: folds 
Uncalled bet ($0.58) returned to *88VIC88*
*88VIC88* collected $0.05 from pot
*88VIC88*: doesn't show hand 
*** SUMMARY ***
Total pot $0.05 | Rake $0 
Seat 1: Marcus579 (button) folded before Flop (didn't bet)
Seat 2: Scaaalll (small blind) folded before Flop
Seat 3: olga3021221 (big blind) folded before Flop
Seat 4: *88VIC88* collected ($0.05)
Seat 5: LSDenny folded before Flop (didn't bet)
Seat 6: fishh_play folded before Flop (didn't bet)



PokerStars Zoom Hand #229233268148:  Hold'em No Limit ($0.01/$0.02) - 2021/08/21 23:23:32 CET [2021/08/21 17:23:32 ET]
Table 'Halley' 6-max Seat #1 is the button
Seat 1: ZermeloFraenkel ($2.14 in chips) 
Seat 2: vovan100157 ($2.24 in chips) 
Seat 3: zergmiky ($2 in chips) 
Seat 4: Posaunengodi ($2.72 in chips) 
Seat 5: Scaaalll ($2.95 in chips) 
Seat 6: lucksuckdonk ($5.96 in chips) 
vovan100157: posts small blind $0.01
zergmiky: posts big blind $0.02
*** HOLE CARDS ***
Dealt to Scaaalll [3c Ad]
Posaunengodi: raises $0.04 to $0.06
Scaaalll: folds 
lucksuckdonk: folds 
ZermeloFraenkel: folds 
vovan100157: folds 
zergmiky: folds 
Uncalled bet ($0.04) returned to Posaunengodi
Posaunengodi collected $0.05 from pot
Posaunengodi: doesn't show hand 
*** SUMMARY ***
Total pot $0.05 | Rake $0 
Seat 1: ZermeloFraenkel (button) folded before Flop (didn't bet)
Seat 2: vovan100157 (small blind) folded before Flop
Seat 3: zergmiky (big blind) folded before Flop
Seat 4: Posaunengodi collected ($0.05)
Seat 5: Scaaalll folded before Flop (didn't bet)
Seat 6: lucksuckdonk folded before Flop (didn't bet)



PokerStars Zoom Hand #229233279442:  Hold'em No Limit ($0.01/$0.02) - 2021/08/21 23:23:59 CET [2021/08/21 17:23:59 ET]
Table 'Halley' 6-max Seat #1 is the button
Seat 1: Umnik_M ($2 in chips) 
Seat 2: nightwacher ($1.98 in chips) 
Seat 3: Goingold77 ($1.94 in chips) 
Seat 4: Feliciano16 ($5.49 in chips) 
Seat 5: Kb013497 ($2.13 in chips) 
Seat 6: Scaaalll ($2.94 in chips) 
nightwacher: posts small blind $0.01
Goingold77: posts big blind $0.02
*** HOLE CARDS ***
Dealt to Scaaalll [Kc 6c]
Feliciano16: folds 
Kb013497: folds 
Scaaalll: folds 
Umnik_M: folds 
nightwacher: folds 
Uncalled bet ($0.01) returned to Goingold77
Goingold77 collected $0.02 from pot
Goingold77: doesn't show hand 
*** SUMMARY ***
Total pot $0.02 | Rake $0 
Seat 1: Umnik_M (button) folded before Flop (didn't bet)
Seat 2: nightwacher (small blind) folded before Flop
Seat 3: Goingold77 (big blind) collected ($0.02)
Seat 4: Feliciano16 folded before Flop (didn't bet)
Seat 5: Kb013497 folded before Flop (didn't bet)
Seat 6: Scaaalll folded before Flop (didn't bet)



PokerStars Zoom Hand #229233274427:  Hold'em No Limit ($0.01/$0.02) - 2021/08/21 23:23:47 CET [2021/08/21 17:23:47 ET]
Table 'Halley' 6-max Seat #1 is the button
Seat 1: Den198443 ($2.42 in chips) 
Seat 2: lucksuckdonk ($5.94 in chips) 
Seat 3: yorkoss ($3.09 in chips) 
Seat 4: Scaaalll ($2.94 in chips) 
Seat 5: Jones278 ($2.40 in chips) 
Seat 6: BexleyBoy ($1.78 in chips) 
lucksuckdonk: posts small blind $0.01
yorkoss: posts big blind $0.02
*** HOLE CARDS ***
Dealt to Scaaalll [Qh 5c]
Scaaalll: folds 
Jones278: folds 
BexleyBoy: raises $0.03 to $0.05
Den198443: folds 
lucksuckdonk: folds 
yorkoss: calls $0.03
*** FLOP *** [Ad Kc Jd]
yorkoss: bets $0.02
BexleyBoy: calls $0.02
*** TURN *** [Ad Kc Jd] [3c]
yorkoss: bets $0.02
BexleyBoy: calls $0.02
*** RIVER *** [Ad Kc Jd 3c] [3s]
yorkoss: bets $0.02
BexleyBoy: calls $0.02
*** SHOW DOWN ***
yorkoss: shows [9d 9s] (two pair, Nines and Threes)
BexleyBoy: shows [9h Ah] (two pair, Aces and Threes)
BexleyBoy collected $0.22 from pot
*** SUMMARY ***
Total pot $0.23 | Rake $0.01 
Board [Ad Kc Jd 3c 3s]
Seat 1: Den198443 (button) folded before Flop (didn't bet)
Seat 2: lucksuckdonk (small blind) folded before Flop
Seat 3: yorkoss (big blind) showed [9d 9s] and lost with two pair, Nines and Threes
Seat 4: Scaaalll folded before Flop (didn't bet)
Seat 5: Jones278 folded before Flop (didn't bet)
Seat 6: BexleyBoy showed [9h Ah] and won ($0.22) with two pair, Aces and Threes



PokerStars Zoom Hand #229233283615:  Hold'em No Limit ($0.01/$0.02) - 2021/08/21 23:24:09 CET [2021/08/21 17:24:09 ET]
Table 'Halley' 6-max Seat #1 is the button
Seat 1: Scaaalll ($2.94 in chips) 
Seat 2: SIGREX ($2.13 in chips) 
Seat 3: WITKOW_AV ($2.02 in chips) 
Seat 4: Phoenixxxxxxxx ($3.53 in chips) 
Seat 5: Umnik_M ($2 in chips) 
Seat 6: WaiT4U ($2.34 in chips) 
SIGREX: posts small blind $0.01
WITKOW_AV: posts big blind $0.02
*** HOLE CARDS ***
Dealt to Scaaalll [2c Kd]
Phoenixxxxxxxx: folds 
Umnik_M: folds 
WaiT4U: folds 
Scaaalll has timed out
Scaaalll: folds 
SIGREX: folds 
Uncalled bet ($0.01) returned to WITKOW_AV
WITKOW_AV collected $0.02 from pot
WITKOW_AV: doesn't show hand 
*** SUMMARY ***
Total pot $0.02 | Rake $0 
Seat 1: Scaaalll (button) folded before Flop (didn't bet)
Seat 2: SIGREX (small blind) folded before Flop
Seat 3: WITKOW_AV (big blind) collected ($0.02)
Seat 4: Phoenixxxxxxxx folded before Flop (didn't bet)
Seat 5: Umnik_M folded before Flop (didn't bet)
Seat 6: WaiT4U folded before Flop (didn't bet)



PokerStars Zoom Hand #229233294931:  Hold'em No Limit ($0.01/$0.02) - 2021/08/21 23:24:36 CET [2021/08/21 17:24:36 ET]
Table 'Halley' 6-max Seat #1 is the button
Seat 1: rpycmbEM ($3.65 in chips) 
Seat 2: MattieBOZ ($2.90 in chips) 
Seat 3: Scaaalll ($2.94 in chips) 
Seat 4: Tabitaji ($2.21 in chips) 
Seat 5: alphabeta1d ($2.09 in chips) 
Seat 6: Den198443 ($2.46 in chips) 
MattieBOZ: posts small blind $0.01
Scaaalll: posts big blind $0.02
*** HOLE CARDS ***
Dealt to Scaaalll [2h 4s]
MattieBOZ is disconnected 
Tabitaji: folds 
alphabeta1d: folds 
Den198443: folds 
rpycmbEM: raises $0.03 to $0.05
MattieBOZ: folds 
Scaaalll: folds 
Uncalled bet ($0.03) returned to rpycmbEM
rpycmbEM collected $0.05 from pot
rpycmbEM: doesn't show hand 
*** SUMMARY ***
Total pot $0.05 | Rake $0 
Seat 1: rpycmbEM (button) collected ($0.05)
Seat 2: MattieBOZ (small blind) folded before Flop
Seat 3: Scaaalll (big blind) folded before Flop
Seat 4: Tabitaji folded before Flop (didn't bet)
Seat 5: alphabeta1d folded before Flop (didn't bet)
Seat 6: Den198443 folded before Flop (didn't bet)



PokerStars Zoom Hand #229233303231:  Hold'em No Limit ($0.01/$0.02) - 2021/08/21 23:24:56 CET [2021/08/21 17:24:56 ET]
Table 'Halley' 6-max Seat #1 is the button
Seat 1: znak312 ($2 in chips) 
Seat 2: lucksuckdonk ($3.71 in chips) 
Seat 3: Reipinguimm ($2.94 in chips) 
Seat 4: tolstii906 ($4.63 in chips) 
Seat 5: Dr.stromg ($2 in chips) 
Seat 6: Scaaalll ($2.92 in chips) 
lucksuckdonk: posts small blind $0.01
Reipinguimm: posts big blind $0.02
*** HOLE CARDS ***
Dealt to Scaaalll [9c 3h]
tolstii906: folds 
Dr.stromg: folds 
Scaaalll: folds 
znak312: folds 
lucksuckdonk: folds 
Uncalled bet ($0.01) returned to Reipinguimm
Reipinguimm collected $0.02 from pot
Reipinguimm: doesn't show hand 
*** SUMMARY ***
Total pot $0.02 | Rake $0 
Seat 1: znak312 (button) folded before Flop (didn't bet)
Seat 2: lucksuckdonk (small blind) folded before Flop
Seat 3: Reipinguimm (big blind) collected ($0.02)
Seat 4: tolstii906 folded before Flop (didn't bet)
Seat 5: Dr.stromg folded before Flop (didn't bet)
Seat 6: Scaaalll folded before Flop (didn't bet)



PokerStars Zoom Hand #229233314346:  Hold'em No Limit ($0.01/$0.02) - 2021/08/21 23:25:09 CET [2021/08/21 17:25:09 ET]
Table 'Halley' 6-max Seat #1 is the button
Seat 1: keb1981 ($2.01 in chips) 
Seat 2: SIGREX ($2 in chips) 
Seat 3: Pechorin.G ($2.14 in chips) 
Seat 4: Scaaalll ($2.92 in chips) 
Seat 5: Larson_mfk ($0.97 in chips) 
Seat 6: AXXILLES ($4.12 in chips) 
SIGREX: posts small blind $0.01
Pechorin.G: posts big blind $0.02
*** HOLE CARDS ***
Dealt to Scaaalll [As 4s]
Larson_mfk is disconnected 
Scaaalll: folds 
Larson_mfk: folds 
AXXILLES: folds 
keb1981: folds 
SIGREX: folds 
Uncalled bet ($0.01) returned to Pechorin.G
Pechorin.G collected $0.02 from pot
Pechorin.G: doesn't show hand 
*** SUMMARY ***
Total pot $0.02 | Rake $0 
Seat 1: keb1981 (button) folded before Flop (didn't bet)
Seat 2: SIGREX (small blind) folded before Flop
Seat 3: Pechorin.G (big blind) collected ($0.02)
Seat 4: Scaaalll folded before Flop (didn't bet)
Seat 5: Larson_mfk folded before Flop (didn't bet)
Seat 6: AXXILLES folded before Flop (didn't bet)



PokerStars Zoom Hand #229233310675:  Hold'em No Limit ($0.01/$0.02) - 2021/08/21 23:25:00 CET [2021/08/21 17:25:00 ET]
Table 'Halley' 6-max Seat #1 is the button
Seat 1: GVMELLO ($2.49 in chips) 
Seat 2: isaeg ($2.18 in chips) 
Seat 3: jaamonra ($2.14 in chips) 
Seat 4: heynckes18 ($2.31 in chips) 
Seat 5: Scaaalll ($2.92 in chips) 
Seat 6: egopi ($0.80 in chips) 
isaeg: posts small blind $0.01
jaamonra: posts big blind $0.02
*** HOLE CARDS ***
Dealt to Scaaalll [7d Ks]
egopi is disconnected 
isaeg is disconnected 
heynckes18: folds 
Scaaalll: folds 
egopi: folds 
GVMELLO: raises $0.03 to $0.05
isaeg: folds 
jaamonra: folds 
Uncalled bet ($0.03) returned to GVMELLO
GVMELLO collected $0.05 from pot
GVMELLO: doesn't show hand 
*** SUMMARY ***
Total pot $0.05 | Rake $0 
Seat 1: GVMELLO (button) collected ($0.05)
Seat 2: isaeg (small blind) folded before Flop
Seat 3: jaamonra (big blind) folded before Flop
Seat 4: heynckes18 folded before Flop (didn't bet)
Seat 5: Scaaalll folded before Flop (didn't bet)
Seat 6: egopi folded before Flop (didn't bet)



PokerStars Zoom Hand #229233316034:  Hold'em No Limit ($0.01/$0.02) - 2021/08/21 23:25:13 CET [2021/08/21 17:25:13 ET]
Table 'Halley' 6-max Seat #1 is the button
Seat 1: AXXILLES ($4.12 in chips) 
Seat 2: Koldun 2636 ($3.52 in chips) 
Seat 3: Scaaalll ($2.92 in chips) 
Seat 4: johnpa89 ($2 in chips) 
Seat 5: kingdieter1 ($1.88 in chips) 
Seat 6: keb1981 ($2.01 in chips) 
Koldun 2636: posts small blind $0.01
Scaaalll: posts big blind $0.02
*** HOLE CARDS ***
Dealt to Scaaalll [3c Th]
kingdieter1 is disconnected 
johnpa89: raises $0.02 to $0.04
kingdieter1: folds 
keb1981: folds 
AXXILLES: folds 
Koldun 2636: folds 
Scaaalll: folds 
Uncalled bet ($0.02) returned to johnpa89
johnpa89 collected $0.05 from pot
johnpa89: doesn't show hand 
*** SUMMARY ***
Total pot $0.05 | Rake $0 
Seat 1: AXXILLES (button) folded before Flop (didn't bet)
Seat 2: Koldun 2636 (small blind) folded before Flop
Seat 3: Scaaalll (big blind) folded before Flop
Seat 4: johnpa89 collected ($0.05)
Seat 5: kingdieter1 folded before Flop (didn't bet)
Seat 6: keb1981 folded before Flop (didn't bet)



PokerStars Zoom Hand #229233323688:  Hold'em No Limit ($0.01/$0.02) - 2021/08/21 23:25:31 CET [2021/08/21 17:25:31 ET]
Table 'Halley' 6-max Seat #1 is the button
Seat 1: alexchamps ($1.68 in chips) 
Seat 2: Scaaalll ($2.90 in chips) 
Seat 3: 9 All Inn 9 ($1.84 in chips) 
Seat 4: PapiMik3 ($3.21 in chips) 
Seat 5: Merlin_Arg ($2.09 in chips) 
Seat 6: fishh_play ($2.96 in chips) 
Scaaalll: posts small blind $0.01
9 All Inn 9: posts big blind $0.02
*** HOLE CARDS ***
Dealt to Scaaalll [2s Ah]
PapiMik3: folds 
Merlin_Arg: folds 
fishh_play: folds 
alexchamps: raises $0.06 to $0.08
Scaaalll: folds 
9 All Inn 9: folds 
Uncalled bet ($0.06) returned to alexchamps
alexchamps collected $0.05 from pot
alexchamps: doesn't show hand 
*** SUMMARY ***
Total pot $0.05 | Rake $0 
Seat 1: alexchamps (button) collected ($0.05)
Seat 2: Scaaalll (small blind) folded before Flop
Seat 3: 9 All Inn 9 (big blind) folded before Flop
Seat 4: PapiMik3 folded before Flop (didn't bet)
Seat 5: Merlin_Arg folded before Flop (didn't bet)
Seat 6: fishh_play folded before Flop (didn't bet)



PokerStars Zoom Hand #229233330812:  Hold'em No Limit ($0.01/$0.02) - 2021/08/21 23:25:48 CET [2021/08/21 17:25:48 ET]
Table 'Halley' 6-max Seat #1 is the button
Seat 1: Scaaalll ($2.89 in chips) 
Seat 2: Bina_sweety ($2.01 in chips) 
Seat 3: Solarios ($1.24 in chips) 
Seat 4: Dr.stromg ($5.32 in chips) 
Seat 5: Yangyang1407 ($2.23 in chips) 
Seat 6: SIGREX ($2.30 in chips) 
Bina_sweety: posts small blind $0.01
Solarios: posts big blind $0.02
*** HOLE CARDS ***
Dealt to Scaaalll [4c Qs]
Dr.stromg: raises $0.03 to $0.05
Yangyang1407: folds 
SIGREX: folds 
Scaaalll: folds 
Bina_sweety: folds 
Solarios: folds 
Uncalled bet ($0.03) returned to Dr.stromg
Dr.stromg collected $0.05 from pot
Dr.stromg: doesn't show hand 
*** SUMMARY ***
Total pot $0.05 | Rake $0 
Seat 1: Scaaalll (button) folded before Flop (didn't bet)
Seat 2: Bina_sweety (small blind) folded before Flop
Seat 3: Solarios (big blind) folded before Flop
Seat 4: Dr.stromg collected ($0.05)
Seat 5: Yangyang1407 folded before Flop (didn't bet)
Seat 6: SIGREX folded before Flop (didn't bet)



PokerStars Zoom Hand #229233332835:  Hold'em No Limit ($0.01/$0.02) - 2021/08/21 23:25:53 CET [2021/08/21 17:25:53 ET]
Table 'Halley' 6-max Seat #1 is the button
Seat 1: kcyxa ($2 in chips) 
Seat 2: Brigistul ($2.49 in chips) 
Seat 3: The-End-snglr ($1.60 in chips) 
Seat 4: znak312 ($2.04 in chips) 
Seat 5: Scaaalll ($2.89 in chips) 
Seat 6: Yangyang1407 ($2.15 in chips) 
Brigistul: posts small blind $0.01
The-End-snglr: posts big blind $0.02
*** HOLE CARDS ***
Dealt to Scaaalll [8s Ks]
znak312: folds 
Scaaalll: folds 
Yangyang1407: raises $0.03 to $0.05
kcyxa: folds 
Brigistul: folds 
The-End-snglr: folds 
Uncalled bet ($0.03) returned to Yangyang1407
kcyxa is disconnected 
Yangyang1407 collected $0.05 from pot
Yangyang1407: doesn't show hand 
*** SUMMARY ***
Total pot $0.05 | Rake $0 
Seat 1: kcyxa (button) folded before Flop (didn't bet)
Seat 2: Brigistul (small blind) folded before Flop
Seat 3: The-End-snglr (big blind) folded before Flop
Seat 4: znak312 folded before Flop (didn't bet)
Seat 5: Scaaalll folded before Flop (didn't bet)
Seat 6: Yangyang1407 collected ($0.05)



PokerStars Zoom Hand #229233334578:  Hold'em No Limit ($0.01/$0.02) - 2021/08/21 23:25:57 CET [2021/08/21 17:25:57 ET]
Table 'Halley' 6-max Seat #1 is the button
Seat 1: isaeg ($2.09 in chips) 
Seat 2: PapiMik3 ($7.25 in chips) 
Seat 3: ctaceo ($2 in chips) 
Seat 4: Red Sky 15 ($11.54 in chips) 
Seat 5: Tzunnamy ($1.81 in chips) 
Seat 6: Scaaalll ($2.89 in chips) 
PapiMik3: posts small blind $0.01
ctaceo: posts big blind $0.02
*** HOLE CARDS ***
Dealt to Scaaalll [2s Ah]
isaeg is disconnected 
Tzunnamy is disconnected 
Red Sky 15: raises $0.04 to $0.06
Tzunnamy: folds 
Scaaalll: folds 
isaeg: folds 
PapiMik3: folds 
ctaceo: folds 
Uncalled bet ($0.04) returned to Red Sky 15
Red Sky 15 collected $0.05 from pot
Red Sky 15: doesn't show hand 
*** SUMMARY ***
Total pot $0.05 | Rake $0 
Seat 1: isaeg (button) folded before Flop (didn't bet)
Seat 2: PapiMik3 (small blind) folded before Flop
Seat 3: ctaceo (big blind) folded before Flop
Seat 4: Red Sky 15 collected ($0.05)
Seat 5: Tzunnamy folded before Flop (didn't bet)
Seat 6: Scaaalll folded before Flop (didn't bet)



PokerStars Zoom Hand #229233338248:  Hold'em No Limit ($0.01/$0.02) - 2021/08/21 23:26:06 CET [2021/08/21 17:26:06 ET]
Table 'Halley' 6-max Seat #1 is the button
Seat 1: rancing87 ($2.14 in chips) 
Seat 2: olga3021221 ($2.70 in chips) 
Seat 3: Scaaalll ($2.89 in chips) 
Seat 4: Gamer577 ($2.36 in chips) 
Seat 5: Trembon ($1.53 in chips) 
Seat 6: WaiT4U ($4.35 in chips) 
olga3021221: posts small blind $0.01
Scaaalll: posts big blind $0.02
*** HOLE CARDS ***
Dealt to Scaaalll [9d 2s]
Gamer577: folds 
Trembon has timed out
Trembon: folds 
WaiT4U: folds 
rancing87: folds 
olga3021221: folds 
Uncalled bet ($0.01) returned to Scaaalll
Scaaalll collected $0.02 from pot
Scaaalll: doesn't show hand 
*** SUMMARY ***
Total pot $0.02 | Rake $0 
Seat 1: rancing87 (button) folded before Flop (didn't bet)
Seat 2: olga3021221 (small blind) folded before Flop
Seat 3: Scaaalll (big blind) collected ($0.02)
Seat 4: Gamer577 folded before Flop (didn't bet)
Seat 5: Trembon folded before Flop (didn't bet)
Seat 6: WaiT4U folded before Flop (didn't bet)



PokerStars Zoom Hand #229233336569:  Hold'em No Limit ($0.01/$0.02) - 2021/08/21 23:26:02 CET [2021/08/21 17:26:02 ET]
Table 'Halley' 6-max Seat #1 is the button
Seat 1: Solarios ($1.22 in chips) 
Seat 2: Dr.stromg ($4.80 in chips) 
Seat 3: amario89 ($2.07 in chips) 
Seat 4: Scaaalll ($2.89 in chips) 
Seat 5: Valansen ($2.09 in chips) 
Seat 6: SIGREX ($2.03 in chips) 
Dr.stromg: posts small blind $0.01
amario89: posts big blind $0.02
*** HOLE CARDS ***
Dealt to Scaaalll [Kh 5h]
Scaaalll: folds 
Valansen: folds 
SIGREX: folds 
Solarios: raises $0.02 to $0.04
Dr.stromg: folds 
amario89: calls $0.02
*** FLOP *** [Qs 5s 2c]
amario89: checks 
Solarios: bets $0.05
amario89: folds 
Uncalled bet ($0.05) returned to Solarios
Solarios collected $0.09 from pot
Solarios: doesn't show hand 
*** SUMMARY ***
Total pot $0.09 | Rake $0 
Board [Qs 5s 2c]
Seat 1: Solarios (button) collected ($0.09)
Seat 2: Dr.stromg (small blind) folded before Flop
Seat 3: amario89 (big blind) folded on the Flop
Seat 4: Scaaalll folded before Flop (didn't bet)
Seat 5: Valansen folded before Flop (didn't bet)
Seat 6: SIGREX folded before Flop (didn't bet)



PokerStars Zoom Hand #229233345872:  Hold'em No Limit ($0.01/$0.02) - 2021/08/21 23:26:24 CET [2021/08/21 17:26:24 ET]
Table 'Halley' 6-max Seat #1 is the button
Seat 1: trasi1e ($2.24 in chips) 
Seat 2: Carlos_glaza ($2.03 in chips) 
Seat 3: 48159348 ($7.49 in chips) 
Seat 4: lucksuckdonk ($3.68 in chips) 
Seat 5: 888lifeIS ($2.11 in chips) 
Seat 6: Scaaalll ($2.90 in chips) 
Carlos_glaza: posts small blind $0.01
48159348: posts big blind $0.02
*** HOLE CARDS ***
Dealt to Scaaalll [Kd 7s]
lucksuckdonk: folds 
trasi1e is disconnected 
888lifeIS: raises $0.02 to $0.04
Scaaalll: folds 
trasi1e: folds 
Carlos_glaza: folds 
48159348: folds 
Uncalled bet ($0.02) returned to 888lifeIS
888lifeIS collected $0.05 from pot
888lifeIS: doesn't show hand 
*** SUMMARY ***
Total pot $0.05 | Rake $0 
Seat 1: trasi1e (button) folded before Flop (didn't bet)
Seat 2: Carlos_glaza (small blind) folded before Flop
Seat 3: 48159348 (big blind) folded before Flop
Seat 4: lucksuckdonk folded before Flop (didn't bet)
Seat 5: 888lifeIS collected ($0.05)
Seat 6: Scaaalll folded before Flop (didn't bet)



PokerStars Zoom Hand #229233356821:  Hold'em No Limit ($0.01/$0.02) - 2021/08/21 23:26:50 CET [2021/08/21 17:26:50 ET]
Table 'Halley' 6-max Seat #1 is the button
Seat 1: Scaaalll ($2.89 in chips) 
Seat 2: Ryota 8 Suzui ($2 in chips) 
Seat 3: kidninja888 ($2.13 in chips) 
Seat 4: plmanuelpl ($0.34 in chips) 
Seat 5: Feyqdoi ($2.09 in chips) 
Seat 6: Mac9Monty2 ($2.03 in chips) 
Ryota 8 Suzui: posts small blind $0.01
kidninja888: posts big blind $0.02
*** HOLE CARDS ***
Dealt to Scaaalll [6s Js]
plmanuelpl: folds 
plmanuelpl is disconnected 
Feyqdoi: folds 
Mac9Monty2: folds 
Scaaalll: raises $0.03 to $0.05
Ryota 8 Suzui: raises $0.11 to $0.16
kidninja888: folds 
Scaaalll: folds 
Uncalled bet ($0.11) returned to Ryota 8 Suzui
Ryota 8 Suzui collected $0.12 from pot
Ryota 8 Suzui: doesn't show hand 
*** SUMMARY ***
Total pot $0.12 | Rake $0 
Seat 1: Scaaalll (button) folded before Flop
Seat 2: Ryota 8 Suzui (small blind) collected ($0.12)
Seat 3: kidninja888 (big blind) folded before Flop
Seat 4: plmanuelpl folded before Flop (didn't bet)
Seat 5: Feyqdoi folded before Flop (didn't bet)
Seat 6: Mac9Monty2 folded before Flop (didn't bet)



PokerStars Zoom Hand #229233369899:  Hold'em No Limit ($0.01/$0.02) - 2021/08/21 23:27:21 CET [2021/08/21 17:27:21 ET]
Table 'Halley' 6-max Seat #1 is the button
Seat 1: Sadikson ($2.28 in chips) 
Seat 2: Feliciano16 ($4.67 in chips) 
Seat 3: Shoxuzb ($1.60 in chips) 
Seat 4: ffffj ($0.71 in chips) 
Seat 5: Scaaalll ($2.84 in chips) 
Seat 6: estelionat171 ($0.53 in chips) 
Feliciano16: posts small blind $0.01
Shoxuzb: posts big blind $0.02
*** HOLE CARDS ***
Dealt to Scaaalll [7s Qd]
Sadikson is disconnected 
ffffj: folds 
Scaaalll: folds 
estelionat171: folds 
Sadikson: folds 
Feliciano16: folds 
Uncalled bet ($0.01) returned to Shoxuzb
Shoxuzb collected $0.02 from pot
Shoxuzb: doesn't show hand 
*** SUMMARY ***
Total pot $0.02 | Rake $0 
Seat 1: Sadikson (button) folded before Flop (didn't bet)
Seat 2: Feliciano16 (small blind) folded before Flop
Seat 3: Shoxuzb (big blind) collected ($0.02)
Seat 4: ffffj folded before Flop (didn't bet)
Seat 5: Scaaalll folded before Flop (didn't bet)
Seat 6: estelionat171 folded before Flop (didn't bet)



PokerStars Zoom Hand #229233349519:  Hold'em No Limit ($0.01/$0.02) - 2021/08/21 23:26:33 CET [2021/08/21 17:26:33 ET]
Table 'Halley' 6-max Seat #1 is the button
Seat 1: nAfEd585 ($2.69 in chips) 
Seat 2: Scaaalll ($2.90 in chips) 
Seat 3: Mac9Monty2 ($2.05 in chips) 
Seat 4: ZermeloFraenkel ($2.28 in chips) 
Seat 5: pavlo8855 ($2 in chips) 
Seat 6: heynckes18 ($2.31 in chips) 
Scaaalll: posts small blind $0.01
Mac9Monty2: posts big blind $0.02
*** HOLE CARDS ***
Dealt to Scaaalll [Ah 5h]
ZermeloFraenkel: folds 
pavlo8855: folds 
heynckes18: raises $0.03 to $0.05
nAfEd585: calls $0.05
Scaaalll: folds 
Mac9Monty2: folds 
*** FLOP *** [As 4c 2c]
heynckes18: checks 
nAfEd585: checks 
*** TURN *** [As 4c 2c] [7s]
heynckes18: bets $0.07
nAfEd585: calls $0.07
*** RIVER *** [As 4c 2c 7s] [Tc]
heynckes18: bets $0.19
nAfEd585: folds 
Uncalled bet ($0.19) returned to heynckes18
heynckes18 collected $0.26 from pot
heynckes18: doesn't show hand 
*** SUMMARY ***
Total pot $0.27 | Rake $0.01 
Board [As 4c 2c 7s Tc]
Seat 1: nAfEd585 (button) folded on the River
Seat 2: Scaaalll (small blind) folded before Flop
Seat 3: Mac9Monty2 (big blind) folded before Flop
Seat 4: ZermeloFraenkel folded before Flop (didn't bet)
Seat 5: pavlo8855 folded before Flop (didn't bet)
Seat 6: heynckes18 collected ($0.26)



PokerStars Zoom Hand #229233371964:  Hold'em No Limit ($0.01/$0.02) - 2021/08/21 23:27:26 CET [2021/08/21 17:27:26 ET]
Table 'Halley' 6-max Seat #1 is the button
Seat 1: Hejpåre ($2 in chips) 
Seat 2: Scaaalll ($2.84 in chips) 
Seat 3: ash1448 ($7.46 in chips) 
Seat 4: nightwacher ($1.79 in chips) 
Seat 5: new face onl ($1.78 in chips) 
Seat 6: pavlo8855 ($2 in chips) 
Scaaalll: posts small blind $0.01
ash1448: posts big blind $0.02
*** HOLE CARDS ***
Dealt to Scaaalll [Td 7d]
nightwacher: folds 
new face onl: folds 
pavlo8855: folds 
Hejpåre: folds 
Scaaalll: folds 
Uncalled bet ($0.01) returned to ash1448
ash1448 collected $0.02 from pot
ash1448: doesn't show hand 
*** SUMMARY ***
Total pot $0.02 | Rake $0 
Seat 1: Hejpåre (button) folded before Flop (didn't bet)
Seat 2: Scaaalll (small blind) folded before Flop
Seat 3: ash1448 (big blind) collected ($0.02)
Seat 4: nightwacher folded before Flop (didn't bet)
Seat 5: new face onl folded before Flop (didn't bet)
Seat 6: pavlo8855 folded before Flop (didn't bet)



PokerStars Zoom Hand #229233378718:  Hold'em No Limit ($0.01/$0.02) - 2021/08/21 23:27:42 CET [2021/08/21 17:27:42 ET]
Table 'Halley' 6-max Seat #1 is the button
Seat 1: FrancoOlmedo ($1.93 in chips) 
Seat 2: Ogni ($5 in chips) 
Seat 3: MattieBOZ ($2.86 in chips) 
Seat 4: Bol'tazar111 ($1.23 in chips) 
Seat 5: Scaaalll ($2.83 in chips) 
Seat 6: Stormzilla ($2 in chips) 
Ogni: posts small blind $0.01
MattieBOZ: posts big blind $0.02
*** HOLE CARDS ***
Dealt to Scaaalll [3h 6c]
Bol'tazar111: folds 
Scaaalll: folds 
Stormzilla: folds 
FrancoOlmedo: raises $0.04 to $0.06
Ogni: folds 
MattieBOZ: folds 
Uncalled bet ($0.04) returned to FrancoOlmedo
FrancoOlmedo collected $0.05 from pot
FrancoOlmedo: doesn't show hand 
MattieBOZ is disconnected 
*** SUMMARY ***
Total pot $0.05 | Rake $0 
Seat 1: FrancoOlmedo (button) collected ($0.05)
Seat 2: Ogni (small blind) folded before Flop
Seat 3: MattieBOZ (big blind) folded before Flop
Seat 4: Bol'tazar111 folded before Flop (didn't bet)
Seat 5: Scaaalll folded before Flop (didn't bet)
Seat 6: Stormzilla folded before Flop (didn't bet)



PokerStars Zoom Hand #229233367457:  Hold'em No Limit ($0.01/$0.02) - 2021/08/21 23:27:15 CET [2021/08/21 17:27:15 ET]
Table 'Halley' 6-max Seat #1 is the button
Seat 1: NickAlex18 ($2 in chips) 
Seat 2: znak312 ($2 in chips) 
Seat 3: 888lifeIS ($2 in chips) 
Seat 4: Scaaalll ($2.84 in chips) 
Seat 5: TTGemi ($2.68 in chips) 
Seat 6: Den198443 ($2.03 in chips) 
znak312: posts small blind $0.01
888lifeIS: posts big blind $0.02
*** HOLE CARDS ***
Dealt to Scaaalll [9h 3h]
Scaaalll: folds 
TTGemi: folds 
Den198443: folds 
NickAlex18: raises $0.03 to $0.05
znak312: raises $0.15 to $0.20
888lifeIS: folds 
NickAlex18: calls $0.15
*** FLOP *** [3d Ad 2c]
znak312: checks 
NickAlex18: bets $0.18
znak312: calls $0.18
*** TURN *** [3d Ad 2c] [Th]
znak312: checks 
NickAlex18: bets $0.50
znak312: folds 
Uncalled bet ($0.50) returned to NickAlex18
NickAlex18 collected $0.75 from pot
NickAlex18: doesn't show hand 
*** SUMMARY ***
Total pot $0.78 | Rake $0.03 
Board [3d Ad 2c Th]
Seat 1: NickAlex18 (button) collected ($0.75)
Seat 2: znak312 (small blind) folded on the Turn
Seat 3: 888lifeIS (big blind) folded before Flop
Seat 4: Scaaalll folded before Flop (didn't bet)
Seat 5: TTGemi folded before Flop (didn't bet)
Seat 6: Den198443 folded before Flop (didn't bet)



PokerStars Zoom Hand #229233383729:  Hold'em No Limit ($0.01/$0.02) - 2021/08/21 23:27:54 CET [2021/08/21 17:27:54 ET]
Table 'Halley' 6-max Seat #1 is the button
Seat 1: Cineva81 ($2 in chips) 
Seat 2: Mr.Kurier ($4.53 in chips) 
Seat 3: Scaaalll ($2.83 in chips) 
Seat 4: castrosis ($3.24 in chips) 
Seat 5: prosto lili ($1 in chips) 
Seat 6: cutter2468 ($6.74 in chips) 
Mr.Kurier: posts small blind $0.01
Scaaalll: posts big blind $0.02
*** HOLE CARDS ***
Dealt to Scaaalll [7s 9h]
castrosis: folds 
prosto lili: folds 
cutter2468: folds 
Cineva81: folds 
Mr.Kurier: raises $0.04 to $0.06
Scaaalll: folds 
Uncalled bet ($0.04) returned to Mr.Kurier
Mr.Kurier collected $0.04 from pot
Mr.Kurier: doesn't show hand 
*** SUMMARY ***
Total pot $0.04 | Rake $0 
Seat 1: Cineva81 (button) folded before Flop (didn't bet)
Seat 2: Mr.Kurier (small blind) collected ($0.04)
Seat 3: Scaaalll (big blind) folded before Flop
Seat 4: castrosis folded before Flop (didn't bet)
Seat 5: prosto lili folded before Flop (didn't bet)
Seat 6: cutter2468 folded before Flop (didn't bet)



PokerStars Zoom Hand #229233390040:  Hold'em No Limit ($0.01/$0.02) - 2021/08/21 23:28:09 CET [2021/08/21 17:28:09 ET]
Table 'Halley' 6-max Seat #1 is the button
Seat 1: Scaaalll ($2.81 in chips) 
Seat 2: NeckCarp ($1.88 in chips) 
Seat 3: Gamer577 ($5.83 in chips) 
Seat 4: Kb013497 ($2.05 in chips) 
Seat 5: pavlo8855 ($2.23 in chips) 
Seat 6: Phoenixxxxxxxx ($2.01 in chips) 
NeckCarp: posts small blind $0.01
Gamer577: posts big blind $0.02
*** HOLE CARDS ***
Dealt to Scaaalll [Kh Qh]
Kb013497: folds 
pavlo8855: folds 
Phoenixxxxxxxx: folds 
Scaaalll: raises $0.03 to $0.05
NeckCarp: calls $0.04
Gamer577: folds 
*** FLOP *** [3d Ad Qc]
NeckCarp: bets $0.06
Scaaalll: calls $0.06
*** TURN *** [3d Ad Qc] [7h]
NeckCarp: bets $0.09
Scaaalll: calls $0.09
*** RIVER *** [3d Ad Qc 7h] [5d]
NeckCarp: checks 
Scaaalll: checks 
*** SHOW DOWN ***
NeckCarp: shows [Ac 9s] (a pair of Aces)
Scaaalll: mucks hand 
NeckCarp collected $0.41 from pot
*** SUMMARY ***
Total pot $0.42 | Rake $0.01 
Board [3d Ad Qc 7h 5d]
Seat 1: Scaaalll (button) mucked [Kh Qh]
Seat 2: NeckCarp (small blind) showed [Ac 9s] and won ($0.41) with a pair of Aces
Seat 3: Gamer577 (big blind) folded before Flop
Seat 4: Kb013497 folded before Flop (didn't bet)
Seat 5: pavlo8855 folded before Flop (didn't bet)
Seat 6: Phoenixxxxxxxx folded before Flop (didn't bet)



PokerStars Zoom Hand #229233407482:  Hold'em No Limit ($0.01/$0.02) - 2021/08/21 23:28:50 CET [2021/08/21 17:28:50 ET]
Table 'Halley' 6-max Seat #1 is the button
Seat 1: egroj1700 ($2 in chips) 
Seat 2: Habarovs18 ($2.65 in chips) 
Seat 3: NoEff0rt2w1n ($7.68 in chips) 
Seat 4: Scaaalll ($2.61 in chips) 
Seat 5: FabOliveira9 ($2.04 in chips) 
Seat 6: WaiT4U ($4.35 in chips) 
Habarovs18: posts small blind $0.01
NoEff0rt2w1n: posts big blind $0.02
*** HOLE CARDS ***
Dealt to Scaaalll [2h 3c]
Scaaalll: folds 
FabOliveira9: raises $0.03 to $0.05
WaiT4U: folds 
Habarovs18 is disconnected 
egroj1700: folds 
Habarovs18: folds 
NoEff0rt2w1n: folds 
Uncalled bet ($0.03) returned to FabOliveira9
FabOliveira9 collected $0.05 from pot
FabOliveira9: doesn't show hand 
*** SUMMARY ***
Total pot $0.05 | Rake $0 
Seat 1: egroj1700 (button) folded before Flop (didn't bet)
Seat 2: Habarovs18 (small blind) folded before Flop
Seat 3: NoEff0rt2w1n (big blind) folded before Flop
Seat 4: Scaaalll folded before Flop (didn't bet)
Seat 5: FabOliveira9 collected ($0.05)
Seat 6: WaiT4U folded before Flop (didn't bet)



PokerStars Zoom Hand #229233409153:  Hold'em No Limit ($0.01/$0.02) - 2021/08/21 23:28:54 CET [2021/08/21 17:28:54 ET]
Table 'Halley' 6-max Seat #1 is the button
Seat 1: josealfredonino ($1.78 in chips) 
Seat 2: Solarios ($5.45 in chips) 
Seat 3: MetalCrüe ($1.84 in chips) 
Seat 4: olga3021221 ($2.75 in chips) 
Seat 5: Cineva81 ($2 in chips) 
Seat 6: Scaaalll ($2.61 in chips) 
Solarios: posts small blind $0.01
MetalCrüe: posts big blind $0.02
*** HOLE CARDS ***
Dealt to Scaaalll [Kc As]
olga3021221: folds 
Cineva81: folds 
Scaaalll: raises $0.04 to $0.06
josealfredonino: folds 
Solarios: folds 
MetalCrüe: folds 
Uncalled bet ($0.04) returned to Scaaalll
Scaaalll collected $0.05 from pot
Scaaalll: doesn't show hand 
*** SUMMARY ***
Total pot $0.05 | Rake $0 
Seat 1: josealfredonino (button) folded before Flop (didn't bet)
Seat 2: Solarios (small blind) folded before Flop
Seat 3: MetalCrüe (big blind) folded before Flop
Seat 4: olga3021221 folded before Flop (didn't bet)
Seat 5: Cineva81 folded before Flop (didn't bet)
Seat 6: Scaaalll collected ($0.05)



PokerStars Zoom Hand #229233420575:  Hold'em No Limit ($0.01/$0.02) - 2021/08/21 23:29:21 CET [2021/08/21 17:29:21 ET]
Table 'Halley' 6-max Seat #1 is the button
Seat 1: dkno77 ($1.78 in chips) 
Seat 2: Bina_sweety ($2.14 in chips) 
Seat 3: Nihility77 ($2 in chips) 
Seat 4: Cineva81 ($2.23 in chips) 
Seat 5: Scaaalll ($2.63 in chips) 
Seat 6: GGopenBet ($2.79 in chips) 
Bina_sweety: posts small blind $0.01
Nihility77: posts big blind $0.02
*** HOLE CARDS ***
Dealt to Scaaalll [2h 6d]
GGopenBet is disconnected 
Cineva81: folds 
Scaaalll: folds 
GGopenBet: folds 
dkno77: folds 
Bina_sweety: folds 
Uncalled bet ($0.01) returned to Nihility77
Nihility77 collected $0.02 from pot
Nihility77: doesn't show hand 
*** SUMMARY ***
Total pot $0.02 | Rake $0 
Seat 1: dkno77 (button) folded before Flop (didn't bet)
Seat 2: Bina_sweety (small blind) folded before Flop
Seat 3: Nihility77 (big blind) collected ($0.02)
Seat 4: Cineva81 folded before Flop (didn't bet)
Seat 5: Scaaalll folded before Flop (didn't bet)
Seat 6: GGopenBet folded before Flop (didn't bet)



PokerStars Zoom Hand #229233423131:  Hold'em No Limit ($0.01/$0.02) - 2021/08/21 23:29:27 CET [2021/08/21 17:29:27 ET]
Table 'Halley' 6-max Seat #1 is the button
Seat 1: lucksuckdonk ($6.64 in chips) 
Seat 2: Healthys07 ($3.37 in chips) 
Seat 3: Scaaalll ($2.63 in chips) 
Seat 4: Fenix888888 ($0.99 in chips) 
Seat 5: Jimor Marlow ($2.20 in chips) 
Seat 6: johnpa89 ($2.10 in chips) 
Healthys07: posts small blind $0.01
Scaaalll: posts big blind $0.02
*** HOLE CARDS ***
Dealt to Scaaalll [6c 4c]
Fenix888888: folds 
Jimor Marlow: folds 
Jimor Marlow is disconnected 
johnpa89 has timed out
johnpa89: folds 
lucksuckdonk: folds 
Healthys07: folds 
Uncalled bet ($0.01) returned to Scaaalll
Scaaalll collected $0.02 from pot
Scaaalll: doesn't show hand 
*** SUMMARY ***
Total pot $0.02 | Rake $0 
Seat 1: lucksuckdonk (button) folded before Flop (didn't bet)
Seat 2: Healthys07 (small blind) folded before Flop
Seat 3: Scaaalll (big blind) collected ($0.02)
Seat 4: Fenix888888 folded before Flop (didn't bet)
Seat 5: Jimor Marlow folded before Flop (didn't bet)
Seat 6: johnpa89 folded before Flop (didn't bet)



PokerStars Zoom Hand #229233430614:  Hold'em No Limit ($0.01/$0.02) - 2021/08/21 23:29:45 CET [2021/08/21 17:29:45 ET]
Table 'Halley' 6-max Seat #1 is the button
Seat 1: Scaaalll ($2.64 in chips) 
Seat 2: Feyqdoi ($2.01 in chips) 
Seat 3: LSDenny ($2.68 in chips) 
Seat 4: alphabeta1d ($2.34 in chips) 
Seat 5: AlienMdeo ($2.63 in chips) 
Seat 6: KM2splashy ($1.11 in chips) 
Feyqdoi: posts small blind $0.01
LSDenny: posts big blind $0.02
*** HOLE CARDS ***
Dealt to Scaaalll [8h 5h]
alphabeta1d: folds 
AlienMdeo: folds 
KM2splashy: raises $0.02 to $0.04
Scaaalll: folds 
Feyqdoi: folds 
LSDenny: folds 
Uncalled bet ($0.02) returned to KM2splashy
KM2splashy collected $0.05 from pot
KM2splashy: doesn't show hand 
LSDenny is disconnected 
*** SUMMARY ***
Total pot $0.05 | Rake $0 
Seat 1: Scaaalll (button) folded before Flop (didn't bet)
Seat 2: Feyqdoi (small blind) folded before Flop
Seat 3: LSDenny (big blind) folded before Flop
Seat 4: alphabeta1d folded before Flop (didn't bet)
Seat 5: AlienMdeo folded before Flop (didn't bet)
Seat 6: KM2splashy collected ($0.05)



PokerStars Zoom Hand #229233414611:  Hold'em No Limit ($0.01/$0.02) - 2021/08/21 23:29:07 CET [2021/08/21 17:29:07 ET]
Table 'Halley' 6-max Seat #1 is the button
Seat 1: FrancoOlmedo ($1.93 in chips) 
Seat 2: Scaaalll ($2.64 in chips) 
Seat 3: Demidov V.S. ($2.77 in chips) 
Seat 4: Sadikson ($2.20 in chips) 
Seat 5: rodrigoasor ($5.28 in chips) 
Seat 6: Dr.stromg ($2 in chips) 
Scaaalll: posts small blind $0.01
Demidov V.S.: posts big blind $0.02
*** HOLE CARDS ***
Dealt to Scaaalll [3d Ts]
Sadikson: folds 
Sadikson is disconnected 
rodrigoasor: raises $0.04 to $0.06
Dr.stromg: folds 
FrancoOlmedo: raises $0.15 to $0.21
Scaaalll: folds 
Demidov V.S.: folds 
Demidov V.S. is disconnected 
rodrigoasor: calls $0.15
*** FLOP *** [Jc 2d Ah]
rodrigoasor: checks 
FrancoOlmedo: bets $0.15
rodrigoasor: calls $0.15
*** TURN *** [Jc 2d Ah] [Kh]
rodrigoasor: bets $0.36
FrancoOlmedo: calls $0.36
*** RIVER *** [Jc 2d Ah Kh] [7d]
rodrigoasor: bets $0.71
FrancoOlmedo: folds 
Uncalled bet ($0.71) returned to rodrigoasor
rodrigoasor collected $1.42 from pot
rodrigoasor: doesn't show hand 
*** SUMMARY ***
Total pot $1.47 | Rake $0.05 
Board [Jc 2d Ah Kh 7d]
Seat 1: FrancoOlmedo (button) folded on the River
Seat 2: Scaaalll (small blind) folded before Flop
Seat 3: Demidov V.S. (big blind) folded before Flop
Seat 4: Sadikson folded before Flop (didn't bet)
Seat 5: rodrigoasor collected ($1.42)
Seat 6: Dr.stromg folded before Flop (didn't bet)



PokerStars Zoom Hand #229233436803:  Hold'em No Limit ($0.01/$0.02) - 2021/08/21 23:30:00 CET [2021/08/21 17:30:00 ET]
Table 'Halley' 6-max Seat #1 is the button
Seat 1: estelionat171 ($1.24 in chips) 
Seat 2: le_vlimeux ($2.37 in chips) 
Seat 3: Mikeloko182 ($3.07 in chips) 
Seat 4: zergmiky ($2.09 in chips) 
Seat 5: ChuckGaylordIII ($2.93 in chips) 
Seat 6: Scaaalll ($2.64 in chips) 
le_vlimeux: posts small blind $0.01
Mikeloko182: posts big blind $0.02
*** HOLE CARDS ***
Dealt to Scaaalll [2d Qd]
ChuckGaylordIII is disconnected 
zergmiky: folds 
ChuckGaylordIII: folds 
Scaaalll: folds 
estelionat171: raises $0.02 to $0.04
le_vlimeux: folds 
Mikeloko182: folds 
Uncalled bet ($0.02) returned to estelionat171
estelionat171 collected $0.05 from pot
estelionat171: doesn't show hand 
*** SUMMARY ***
Total pot $0.05 | Rake $0 
Seat 1: estelionat171 (button) collected ($0.05)
Seat 2: le_vlimeux (small blind) folded before Flop
Seat 3: Mikeloko182 (big blind) folded before Flop
Seat 4: zergmiky folded before Flop (didn't bet)
Seat 5: ChuckGaylordIII folded before Flop (didn't bet)
Seat 6: Scaaalll folded before Flop (didn't bet)



PokerStars Zoom Hand #229233435146:  Hold'em No Limit ($0.01/$0.02) - 2021/08/21 23:29:56 CET [2021/08/21 17:29:56 ET]
Table 'Halley' 6-max Seat #1 is the button
Seat 1: OLKOG ($2.21 in chips) 
Seat 2: ash1448 ($14.27 in chips) 
Seat 3: Mac9Monty2 ($2.64 in chips) 
Seat 4: Scaaalll ($2.64 in chips) 
Seat 5: Mikeloko182 ($6.44 in chips) 
Seat 6: El Chicha.CL ($2.07 in chips) 
ash1448: posts small blind $0.01
Mac9Monty2: posts big blind $0.02
*** HOLE CARDS ***
Dealt to Scaaalll [5c As]
Scaaalll: folds 
Mikeloko182: folds 
El Chicha.CL: folds 
OLKOG: raises $0.02 to $0.04
ash1448: folds 
Mac9Monty2: folds 
Uncalled bet ($0.02) returned to OLKOG
OLKOG collected $0.05 from pot
OLKOG: doesn't show hand 
*** SUMMARY ***
Total pot $0.05 | Rake $0 
Seat 1: OLKOG (button) collected ($0.05)
Seat 2: ash1448 (small blind) folded before Flop
Seat 3: Mac9Monty2 (big blind) folded before Flop
Seat 4: Scaaalll folded before Flop (didn't bet)
Seat 5: Mikeloko182 folded before Flop (didn't bet)
Seat 6: El Chicha.CL folded before Flop (didn't bet)



PokerStars Zoom Hand #229233438466:  Hold'em No Limit ($0.01/$0.02) - 2021/08/21 23:30:04 CET [2021/08/21 17:30:04 ET]
Table 'Halley' 6-max Seat #1 is the button
Seat 1: Fenix888888 ($0.38 in chips) 
Seat 2: Scaaalll ($2.64 in chips) 
Seat 3: ChuckGaylordIII ($2.93 in chips) 
Seat 4: Ruben-M. PY ($2.25 in chips) 
Seat 5: KKARMELO ($3.33 in chips) 
Seat 6: Koldun 2636 ($3.15 in chips) 
Scaaalll: posts small blind $0.01
ChuckGaylordIII: posts big blind $0.02
*** HOLE CARDS ***
Dealt to Scaaalll [8h Jh]
Ruben-M. PY: folds 
KKARMELO: raises $0.03 to $0.05
Koldun 2636: folds 
ChuckGaylordIII is disconnected 
Fenix888888: folds 
Scaaalll: folds 
ChuckGaylordIII: folds 
Uncalled bet ($0.03) returned to KKARMELO
KKARMELO collected $0.05 from pot
KKARMELO: doesn't show hand 
*** SUMMARY ***
Total pot $0.05 | Rake $0 
Seat 1: Fenix888888 (button) folded before Flop (didn't bet)
Seat 2: Scaaalll (small blind) folded before Flop
Seat 3: ChuckGaylordIII (big blind) folded before Flop
Seat 4: Ruben-M. PY folded before Flop (didn't bet)
Seat 5: KKARMELO collected ($0.05)
Seat 6: Koldun 2636 folded before Flop (didn't bet)



PokerStars Zoom Hand #229233444872:  Hold'em No Limit ($0.01/$0.02) - 2021/08/21 23:30:19 CET [2021/08/21 17:30:19 ET]
Table 'Halley' 6-max Seat #1 is the button
Seat 1: Hejpåre ($2 in chips) 
Seat 2: Lekcey05 ($2.35 in chips) 
Seat 3: KM2splashy ($1.16 in chips) 
Seat 4: Zaarh ($3.67 in chips) 
Seat 5: Scaaalll ($2.63 in chips) 
Seat 6: keb1981 ($2.01 in chips) 
Lekcey05: posts small blind $0.01
KM2splashy: posts big blind $0.02
*** HOLE CARDS ***
Dealt to Scaaalll [4s Ah]
Zaarh: raises $0.02 to $0.04
Scaaalll: folds 
keb1981: folds 
Hejpåre: raises $0.14 to $0.18
Lekcey05: folds 
Zaarh is disconnected 
KM2splashy: folds 
Zaarh: folds 
Uncalled bet ($0.14) returned to Hejpåre
KM2splashy is disconnected 
Hejpåre collected $0.11 from pot
Hejpåre: doesn't show hand 
*** SUMMARY ***
Total pot $0.11 | Rake $0 
Seat 1: Hejpåre (button) collected ($0.11)
Seat 2: Lekcey05 (small blind) folded before Flop
Seat 3: KM2splashy (big blind) folded before Flop
Seat 4: Zaarh folded before Flop
Seat 5: Scaaalll folded before Flop (didn't bet)
Seat 6: keb1981 folded before Flop (didn't bet)



PokerStars Zoom Hand #229233447412:  Hold'em No Limit ($0.01/$0.02) - 2021/08/21 23:30:25 CET [2021/08/21 17:30:25 ET]
Table 'Halley' 6-max Seat #1 is the button
Seat 1: Mustang01373 ($1.40 in chips) 
Seat 2: Posaunengodi ($4.58 in chips) 
Seat 3: Scaaalll ($2.63 in chips) 
Seat 4: sg.32rus ($3.40 in chips) 
Seat 5: tolstii906 ($4.61 in chips) 
Seat 6: deldanlee ($2.02 in chips) 
Posaunengodi: posts small blind $0.01
Scaaalll: posts big blind $0.02
*** HOLE CARDS ***
Dealt to Scaaalll [3h 8s]
sg.32rus: calls $0.02
tolstii906: folds 
deldanlee: folds 
Mustang01373: folds 
Posaunengodi: folds 
Scaaalll: checks 
*** FLOP *** [As Td 2h]
Scaaalll: checks 
sg.32rus: checks 
*** TURN *** [As Td 2h] [2c]
Scaaalll: checks 
sg.32rus: checks 
*** RIVER *** [As Td 2h 2c] [8h]
Scaaalll: checks 
sg.32rus: bets $0.08
Scaaalll: folds 
Uncalled bet ($0.08) returned to sg.32rus
sg.32rus collected $0.05 from pot
sg.32rus: doesn't show hand 
*** SUMMARY ***
Total pot $0.05 | Rake $0 
Board [As Td 2h 2c 8h]
Seat 1: Mustang01373 (button) folded before Flop (didn't bet)
Seat 2: Posaunengodi (small blind) folded before Flop
Seat 3: Scaaalll (big blind) folded on the River
Seat 4: sg.32rus collected ($0.05)
Seat 5: tolstii906 folded before Flop (didn't bet)
Seat 6: deldanlee folded before Flop (didn't bet)



PokerStars Zoom Hand #229233461317:  Hold'em No Limit ($0.01/$0.02) - 2021/08/21 23:30:58 CET [2021/08/21 17:30:58 ET]
Table 'Halley' 6-max Seat #1 is the button
Seat 1: Canoinhas37 ($6.81 in chips) 
Seat 2: Carlos_glaza ($2.36 in chips) 
Seat 3: REZAKOV72 ($3.46 in chips) 
Seat 4: Scaaalll ($2.61 in chips) 
Seat 5: NickAlex18 ($2 in chips) 
Seat 6: PapiMik3 ($8.32 in chips) 
Carlos_glaza: posts small blind $0.01
REZAKOV72: posts big blind $0.02
*** HOLE CARDS ***
Dealt to Scaaalll [Tc Ts]
Scaaalll: raises $0.04 to $0.06
NickAlex18: folds 
PapiMik3: folds 
Canoinhas37: folds 
Carlos_glaza: folds 
REZAKOV72: calls $0.04
*** FLOP *** [3s 8h Qc]
REZAKOV72: checks 
Scaaalll: bets $0.08
REZAKOV72: folds 
Uncalled bet ($0.08) returned to Scaaalll
Scaaalll collected $0.13 from pot
Scaaalll: doesn't show hand 
*** SUMMARY ***
Total pot $0.13 | Rake $0 
Board [3s 8h Qc]
Seat 1: Canoinhas37 (button) folded before Flop (didn't bet)
Seat 2: Carlos_glaza (small blind) folded before Flop
Seat 3: REZAKOV72 (big blind) folded on the Flop
Seat 4: Scaaalll collected ($0.13)
Seat 5: NickAlex18 folded before Flop (didn't bet)
Seat 6: PapiMik3 folded before Flop (didn't bet)



PokerStars Zoom Hand #229233470868:  Hold'em No Limit ($0.01/$0.02) - 2021/08/21 23:31:21 CET [2021/08/21 17:31:21 ET]
Table 'Halley' 6-max Seat #1 is the button
Seat 1: Scaaalll ($2.68 in chips) 
Seat 2: vovan100157 ($2.08 in chips) 
Seat 3: egroj1700 ($2.26 in chips) 
Seat 4: SIGREX ($2.80 in chips) 
Seat 5: Hallyson_23 ($4.63 in chips) 
Seat 6: porcorosso23 ($4.23 in chips) 
vovan100157: posts small blind $0.01
egroj1700: posts big blind $0.02
*** HOLE CARDS ***
Dealt to Scaaalll [2s 9h]
SIGREX: folds 
Hallyson_23: folds 
porcorosso23: folds 
Scaaalll: folds 
vovan100157: folds 
Uncalled bet ($0.01) returned to egroj1700
egroj1700 collected $0.02 from pot
egroj1700: doesn't show hand 
*** SUMMARY ***
Total pot $0.02 | Rake $0 
Seat 1: Scaaalll (button) folded before Flop (didn't bet)
Seat 2: vovan100157 (small blind) folded before Flop
Seat 3: egroj1700 (big blind) collected ($0.02)
Seat 4: SIGREX folded before Flop (didn't bet)
Seat 5: Hallyson_23 folded before Flop (didn't bet)
Seat 6: porcorosso23 folded before Flop (didn't bet)



PokerStars Zoom Hand #229233476295:  Hold'em No Limit ($0.01/$0.02) - 2021/08/21 23:31:34 CET [2021/08/21 17:31:34 ET]
Table 'Halley' 6-max Seat #1 is the button
Seat 1: TTGemi ($2.15 in chips) 
Seat 2: Scaaalll ($2.68 in chips) 
Seat 3: prosto lili ($0.98 in chips) 
Seat 4: gasmar_29 ($2 in chips) 
Seat 5: hairy navel ($1.94 in chips) 
Seat 6: cheddarspreada ($1.47 in chips) 
Scaaalll: posts small blind $0.01
prosto lili: posts big blind $0.02
*** HOLE CARDS ***
Dealt to Scaaalll [3c Ts]
cheddarspreada is disconnected 
gasmar_29: folds 
hairy navel: calls $0.02
cheddarspreada: folds 
TTGemi: folds 
Scaaalll: folds 
prosto lili: checks 
*** FLOP *** [6c Js 4s]
prosto lili: bets $0.04
hairy navel: calls $0.04
*** TURN *** [6c Js 4s] [6h]
prosto lili: bets $0.07
hairy navel: calls $0.07
*** RIVER *** [6c Js 4s 6h] [4d]
prosto lili: checks 
hairy navel: bets $0.02
prosto lili: calls $0.02
*** SHOW DOWN ***
hairy navel: shows [Jd Ks] (two pair, Jacks and Sixes)
prosto lili: mucks hand 
hairy navel collected $0.30 from pot
*** SUMMARY ***
Total pot $0.31 | Rake $0.01 
Board [6c Js 4s 6h 4d]
Seat 1: TTGemi (button) folded before Flop (didn't bet)
Seat 2: Scaaalll (small blind) folded before Flop
Seat 3: prosto lili (big blind) mucked [Jh Tc]
Seat 4: gasmar_29 folded before Flop (didn't bet)
Seat 5: hairy navel showed [Jd Ks] and won ($0.30) with two pair, Jacks and Sixes
Seat 6: cheddarspreada folded before Flop (didn't bet)



PokerStars Zoom Hand #229233494547:  Hold'em No Limit ($0.01/$0.02) - 2021/08/21 23:32:17 CET [2021/08/21 17:32:17 ET]
Table 'Halley' 6-max Seat #1 is the button
Seat 1: PapiMik3 ($7.54 in chips) 
Seat 2: BRESTORY ($0.51 in chips) 
Seat 3: Scaaalll ($2.40 in chips) 
Seat 4: kidninja888 ($2.96 in chips) 
Seat 5: AtZ3899 ($2.21 in chips) 
Seat 6: Jimor Marlow ($2 in chips) 
BRESTORY: posts small blind $0.01
Scaaalll: posts big blind $0.02
*** HOLE CARDS ***
Dealt to Scaaalll [4h 7d]
kidninja888: folds 
BRESTORY is disconnected 
Jimor Marlow is disconnected 
AtZ3899: raises $0.05 to $0.07
Jimor Marlow: folds 
PapiMik3: folds 
BRESTORY: folds 
Scaaalll: folds 
Uncalled bet ($0.05) returned to AtZ3899
AtZ3899 collected $0.05 from pot
AtZ3899: doesn't show hand 
*** SUMMARY ***
Total pot $0.05 | Rake $0 
Seat 1: PapiMik3 (button) folded before Flop (didn't bet)
Seat 2: BRESTORY (small blind) folded before Flop
Seat 3: Scaaalll (big blind) folded before Flop
Seat 4: kidninja888 folded before Flop (didn't bet)
Seat 5: AtZ3899 collected ($0.05)
Seat 6: Jimor Marlow folded before Flop (didn't bet)



PokerStars Zoom Hand #229233492366:  Hold'em No Limit ($0.01/$0.02) - 2021/08/21 23:32:12 CET [2021/08/21 17:32:12 ET]
Table 'Halley' 6-max Seat #1 is the button
Seat 1: Fenix888888 ($0.45 in chips) 
Seat 2: Nihility77 ($2.12 in chips) 
Seat 3: gaturamard ($2.02 in chips) 
Seat 4: Scaaalll ($2.40 in chips) 
Seat 5: Sha.Le.Ol. ($1.96 in chips) 
Seat 6: kboskov123 ($2.29 in chips) 
Nihility77: posts small blind $0.01
gaturamard: posts big blind $0.02
*** HOLE CARDS ***
Dealt to Scaaalll [Jh 2d]
Scaaalll: folds 
Sha.Le.Ol.: folds 
kboskov123: folds 
Fenix888888: raises $0.03 to $0.05
Nihility77: folds 
gaturamard: folds 
Uncalled bet ($0.03) returned to Fenix888888
Fenix888888 collected $0.05 from pot
Fenix888888: doesn't show hand 
*** SUMMARY ***
Total pot $0.05 | Rake $0 
Seat 1: Fenix888888 (button) collected ($0.05)
Seat 2: Nihility77 (small blind) folded before Flop
Seat 3: gaturamard (big blind) folded before Flop
Seat 4: Scaaalll folded before Flop (didn't bet)
Seat 5: Sha.Le.Ol. folded before Flop (didn't bet)
Seat 6: kboskov123 folded before Flop (didn't bet)



PokerStars Zoom Hand #229233481039:  Hold'em No Limit ($0.01/$0.02) - 2021/08/21 23:31:45 CET [2021/08/21 17:31:45 ET]
Table 'Halley' 6-max Seat #1 is the button
Seat 1: babiloniaxxx ($2.83 in chips) 
Seat 2: WITKOW_AV ($6.02 in chips) 
Seat 3: Fenix888888 ($0.64 in chips) 
Seat 4: REZAKOV72 ($3.44 in chips) 
Seat 5: Ck@tih@ ($1.02 in chips) 
Seat 6: Scaaalll ($2.67 in chips) 
WITKOW_AV: posts small blind $0.01
Fenix888888: posts big blind $0.02
*** HOLE CARDS ***
Dealt to Scaaalll [7s 7c]
REZAKOV72: raises $0.05 to $0.07
Ck@tih@: folds 
Scaaalll: calls $0.07
babiloniaxxx: folds 
WITKOW_AV: raises $0.20 to $0.27
Fenix888888: folds 
REZAKOV72: calls $0.20
Scaaalll: calls $0.20
*** FLOP *** [9s 2d 4s]
WITKOW_AV: bets $0.26
REZAKOV72: calls $0.26
Scaaalll: folds 
*** TURN *** [9s 2d 4s] [3h]
WITKOW_AV: checks 
REZAKOV72: bets $0.02
WITKOW_AV: calls $0.02
*** RIVER *** [9s 2d 4s 3h] [Ac]
WITKOW_AV: checks 
REZAKOV72: checks 
*** SHOW DOWN ***
WITKOW_AV: shows [As Qc] (a pair of Aces)
REZAKOV72: mucks hand 
WITKOW_AV collected $1.34 from pot
*** SUMMARY ***
Total pot $1.39 | Rake $0.05 
Board [9s 2d 4s 3h Ac]
Seat 1: babiloniaxxx (button) folded before Flop (didn't bet)
Seat 2: WITKOW_AV (small blind) showed [As Qc] and won ($1.34) with a pair of Aces
Seat 3: Fenix888888 (big blind) folded before Flop
Seat 4: REZAKOV72 mucked [Js Jh]
Seat 5: Ck@tih@ folded before Flop (didn't bet)
Seat 6: Scaaalll folded on the Flop



PokerStars Zoom Hand #229233499416:  Hold'em No Limit ($0.01/$0.02) - 2021/08/21 23:32:29 CET [2021/08/21 17:32:29 ET]
Table 'Halley' 6-max Seat #1 is the button
Seat 1: Scaaalll ($2.38 in chips) 
Seat 2: FabOliveira9 ($2.02 in chips) 
Seat 3: olga3021221 ($2.67 in chips) 
Seat 4: Jones278 ($2.33 in chips) 
Seat 5: roukoun1984 ($2.21 in chips) 
Seat 6: bart8612 ($2.52 in chips) 
FabOliveira9: posts small blind $0.01
olga3021221: posts big blind $0.02
*** HOLE CARDS ***
Dealt to Scaaalll [5d Kc]
Jones278: folds 
roukoun1984: calls $0.02
bart8612: raises $0.08 to $0.10
Scaaalll: folds 
FabOliveira9: folds 
olga3021221: folds 
roukoun1984: calls $0.08
*** FLOP *** [4d 3c Qd]
roukoun1984: checks 
bart8612: bets $0.14
roukoun1984: folds 
Uncalled bet ($0.14) returned to bart8612
bart8612 collected $0.22 from pot
bart8612: doesn't show hand 
*** SUMMARY ***
Total pot $0.23 | Rake $0.01 
Board [4d 3c Qd]
Seat 1: Scaaalll (button) folded before Flop (didn't bet)
Seat 2: FabOliveira9 (small blind) folded before Flop
Seat 3: olga3021221 (big blind) folded before Flop
Seat 4: Jones278 folded before Flop (didn't bet)
Seat 5: roukoun1984 folded on the Flop
Seat 6: bart8612 collected ($0.22)



PokerStars Zoom Hand #229233504006:  Hold'em No Limit ($0.01/$0.02) - 2021/08/21 23:32:40 CET [2021/08/21 17:32:40 ET]
Table 'Halley' 6-max Seat #1 is the button
Seat 1: LijanaV ($5.36 in chips) 
Seat 2: dominiusGT ($1.38 in chips) 
Seat 3: rekopo203 ($6.87 in chips) 
Seat 4: OLKOG ($2.28 in chips) 
Seat 5: Mustang01373 ($1.29 in chips) 
Seat 6: Scaaalll ($2.38 in chips) 
dominiusGT: posts small blind $0.01
rekopo203: posts big blind $0.02
*** HOLE CARDS ***
Dealt to Scaaalll [Kc Ks]
dominiusGT is disconnected 
OLKOG: raises $0.04 to $0.06
Mustang01373: folds 
Scaaalll: calls $0.06
LijanaV: calls $0.06
dominiusGT: folds 
rekopo203: folds 
*** FLOP *** [Td 6h 5s]
OLKOG: bets $0.10
Scaaalll: calls $0.10
LijanaV: folds 
*** TURN *** [Td 6h 5s] [5d]
LijanaV is disconnected 
OLKOG: bets $0.24
Scaaalll: calls $0.24
*** RIVER *** [Td 6h 5s 5d] [6d]
OLKOG: checks 
Scaaalll: bets $0.53
OLKOG: calls $0.53
*** SHOW DOWN ***
Scaaalll: shows [Kc Ks] (two pair, Kings and Sixes)
OLKOG: mucks hand 
Scaaalll collected $1.86 from pot
*** SUMMARY ***
Total pot $1.95 | Rake $0.09 
Board [Td 6h 5s 5d 6d]
Seat 1: LijanaV (button) folded on the Flop
Seat 2: dominiusGT (small blind) folded before Flop
Seat 3: rekopo203 (big blind) folded before Flop
Seat 4: OLKOG mucked [Qc Qd]
Seat 5: Mustang01373 folded before Flop (didn't bet)
Seat 6: Scaaalll showed [Kc Ks] and won ($1.86) with two pair, Kings and Sixes



PokerStars Zoom Hand #229233526690:  Hold'em No Limit ($0.01/$0.02) - 2021/08/21 23:33:35 CET [2021/08/21 17:33:35 ET]
Table 'Halley' 6-max Seat #1 is the button
Seat 1: Scaaalll ($3.31 in chips) 
Seat 2: TTGemi ($2.19 in chips) 
Seat 3: kboskov123 ($1.68 in chips) 
Seat 4: RrriotGrrrl ($3.33 in chips) 
Seat 5: vovan100157 ($4.98 in chips) 
Seat 6: Cineva81 ($2 in chips) 
TTGemi: posts small blind $0.01
kboskov123: posts big blind $0.02
*** HOLE CARDS ***
Dealt to Scaaalll [2h 8h]
RrriotGrrrl: folds 
vovan100157: folds 
Cineva81: folds 
Scaaalll: folds 
TTGemi: folds 
Uncalled bet ($0.01) returned to kboskov123
kboskov123 collected $0.02 from pot
kboskov123: doesn't show hand 
*** SUMMARY ***
Total pot $0.02 | Rake $0 
Seat 1: Scaaalll (button) folded before Flop (didn't bet)
Seat 2: TTGemi (small blind) folded before Flop
Seat 3: kboskov123 (big blind) collected ($0.02)
Seat 4: RrriotGrrrl folded before Flop (didn't bet)
Seat 5: vovan100157 folded before Flop (didn't bet)
Seat 6: Cineva81 folded before Flop (didn't bet)



PokerStars Zoom Hand #229233534610:  Hold'em No Limit ($0.01/$0.02) - 2021/08/21 23:33:54 CET [2021/08/21 17:33:54 ET]
Table 'Halley' 6-max Seat #1 is the button
Seat 1: isaeg ($2.63 in chips) 
Seat 2: kidninja888 ($2.78 in chips) 
Seat 3: Marcelo17184 ($1 in chips) 
Seat 4: GGopenBet ($2.53 in chips) 
Seat 5: Scaaalll ($3.28 in chips) 
Seat 6: kboskov123 ($1.98 in chips) 
kidninja888: posts small blind $0.01
Marcelo17184: posts big blind $0.02
*** HOLE CARDS ***
Dealt to Scaaalll [5h 3s]
isaeg is disconnected 
GGopenBet: folds 
Scaaalll: folds 
kboskov123: folds 
isaeg: folds 
GGopenBet is disconnected 
kidninja888: raises $0.03 to $0.05
Marcelo17184: calls $0.03
*** FLOP *** [Th 8h 6c]
kidninja888: checks 
Marcelo17184: bets $0.06
kidninja888: folds 
Uncalled bet ($0.06) returned to Marcelo17184
Marcelo17184 collected $0.10 from pot
Marcelo17184: doesn't show hand 
*** SUMMARY ***
Total pot $0.10 | Rake $0 
Board [Th 8h 6c]
Seat 1: isaeg (button) folded before Flop (didn't bet)
Seat 2: kidninja888 (small blind) folded on the Flop
Seat 3: Marcelo17184 (big blind) collected ($0.10)
Seat 4: GGopenBet folded before Flop (didn't bet)
Seat 5: Scaaalll folded before Flop (didn't bet)
Seat 6: kboskov123 folded before Flop (didn't bet)



PokerStars Zoom Hand #229233528839:  Hold'em No Limit ($0.01/$0.02) - 2021/08/21 23:33:40 CET [2021/08/21 17:33:40 ET]
Table 'Halley' 6-max Seat #1 is the button
Seat 1: TM 69 UIE ($2 in chips) 
Seat 2: Scaaalll ($3.31 in chips) 
Seat 3: Demidov V.S. ($3.91 in chips) 
Seat 4: MattieBOZ ($1.39 in chips) 
Seat 5: Sha.Le.Ol. ($2.05 in chips) 
Seat 6: Hallyson_23 ($4.66 in chips) 
Scaaalll: posts small blind $0.01
Demidov V.S.: posts big blind $0.02
*** HOLE CARDS ***
Dealt to Scaaalll [Qh 5c]
MattieBOZ: calls $0.02
Sha.Le.Ol.: folds 
Hallyson_23: folds 
TM 69 UIE: raises $0.07 to $0.09
Scaaalll: folds 
Demidov V.S.: folds 
Demidov V.S. is disconnected 
MattieBOZ: calls $0.07
*** FLOP *** [9s 9d 5d]
MattieBOZ: checks 
TM 69 UIE: bets $0.12
MattieBOZ: folds 
Uncalled bet ($0.12) returned to TM 69 UIE
TM 69 UIE collected $0.20 from pot
TM 69 UIE: doesn't show hand 
MattieBOZ is disconnected 
*** SUMMARY ***
Total pot $0.21 | Rake $0.01 
Board [9s 9d 5d]
Seat 1: TM 69 UIE (button) collected ($0.20)
Seat 2: Scaaalll (small blind) folded before Flop
Seat 3: Demidov V.S. (big blind) folded before Flop
Seat 4: MattieBOZ folded on the Flop
Seat 5: Sha.Le.Ol. folded before Flop (didn't bet)
Seat 6: Hallyson_23 folded before Flop (didn't bet)



PokerStars Zoom Hand #229233541660:  Hold'em No Limit ($0.01/$0.02) - 2021/08/21 23:34:11 CET [2021/08/21 17:34:11 ET]
Table 'Halley' 6-max Seat #1 is the button
Seat 1: AXXILLES ($4.36 in chips) 
Seat 2: hairy navel ($2.07 in chips) 
Seat 3: PapiMik3 ($3.02 in chips) 
Seat 4: Scaaalll ($3.28 in chips) 
Seat 5: lucksuckdonk ($7.54 in chips) 
Seat 6: Valansen ($2.08 in chips) 
hairy navel: posts small blind $0.01
PapiMik3: posts big blind $0.02
*** HOLE CARDS ***
Dealt to Scaaalll [Ad Kd]
Scaaalll: raises $0.04 to $0.06
lucksuckdonk: folds 
Valansen: folds 
AXXILLES: folds 
hairy navel: folds 
PapiMik3: folds 
Uncalled bet ($0.04) returned to Scaaalll
Scaaalll collected $0.05 from pot
Scaaalll: doesn't show hand 
*** SUMMARY ***
Total pot $0.05 | Rake $0 
Seat 1: AXXILLES (button) folded before Flop (didn't bet)
Seat 2: hairy navel (small blind) folded before Flop
Seat 3: PapiMik3 (big blind) folded before Flop
Seat 4: Scaaalll collected ($0.05)
Seat 5: lucksuckdonk folded before Flop (didn't bet)
Seat 6: Valansen folded before Flop (didn't bet)



PokerStars Zoom Hand #229233530895:  Hold'em No Limit ($0.01/$0.02) - 2021/08/21 23:33:45 CET [2021/08/21 17:33:45 ET]
Table 'Halley' 6-max Seat #1 is the button
Seat 1: 0ofreeo0 ($2.08 in chips) 
Seat 2: BORODA-X ($2.73 in chips) 
Seat 3: Scaaalll ($3.30 in chips) 
Seat 4: ulisessoria ($2.06 in chips) 
Seat 5: Reipinguimm ($3.45 in chips) 
Seat 6: samn102 ($2 in chips) 
BORODA-X: posts small blind $0.01
Scaaalll: posts big blind $0.02
*** HOLE CARDS ***
Dealt to Scaaalll [9s Jd]
ulisessoria: folds 
Reipinguimm: folds 
samn102: folds 
0ofreeo0: raises $0.03 to $0.05
BORODA-X: calls $0.04
Scaaalll: folds 
*** FLOP *** [3d Ks Qh]
BORODA-X: bets $0.06
0ofreeo0: calls $0.06
*** TURN *** [3d Ks Qh] [6c]
BORODA-X: bets $0.11
0ofreeo0: raises $0.29 to $0.40
BORODA-X: calls $0.29
*** RIVER *** [3d Ks Qh 6c] [5c]
BORODA-X: checks 
0ofreeo0: checks 
*** SHOW DOWN ***
BORODA-X: shows [Kc 8h] (a pair of Kings)
0ofreeo0: mucks hand 
BORODA-X collected $1 from pot
*** SUMMARY ***
Total pot $1.04 | Rake $0.04 
Board [3d Ks Qh 6c 5c]
Seat 1: 0ofreeo0 (button) mucked [Ad Js]
Seat 2: BORODA-X (small blind) showed [Kc 8h] and won ($1) with a pair of Kings
Seat 3: Scaaalll (big blind) folded before Flop
Seat 4: ulisessoria folded before Flop (didn't bet)
Seat 5: Reipinguimm folded before Flop (didn't bet)
Seat 6: samn102 folded before Flop (didn't bet)



PokerStars Zoom Hand #229233538367:  Hold'em No Limit ($0.01/$0.02) - 2021/08/21 23:34:03 CET [2021/08/21 17:34:03 ET]
Table 'Halley' 6-max Seat #1 is the button
Seat 1: disanddowny ($1.83 in chips) 
Seat 2: nish1319 ($0.98 in chips) 
Seat 3: Tibeau21 ($0.94 in chips) 
Seat 4: KKARMELO ($2.21 in chips) 
Seat 5: kcyxa ($1.70 in chips) 
Seat 6: Scaaalll ($3.28 in chips) 
nish1319: posts small blind $0.01
Tibeau21: posts big blind $0.02
*** HOLE CARDS ***
Dealt to Scaaalll [Js 8d]
kcyxa is disconnected 
KKARMELO: folds 
kcyxa: folds 
Scaaalll: folds 
disanddowny: folds 
nish1319: calls $0.01
Tibeau21: checks 
*** FLOP *** [Jc Ad Jd]
nish1319: checks 
Tibeau21: bets $0.02
nish1319: calls $0.02
*** TURN *** [Jc Ad Jd] [5d]
nish1319: checks 
Tibeau21: bets $0.02
nish1319: calls $0.02
*** RIVER *** [Jc Ad Jd 5d] [Qs]
nish1319: checks 
Tibeau21: checks 
*** SHOW DOWN ***
nish1319: shows [Qd 4c] (two pair, Queens and Jacks)
Tibeau21: mucks hand 
nish1319 collected $0.12 from pot
*** SUMMARY ***
Total pot $0.12 | Rake $0 
Board [Jc Ad Jd 5d Qs]
Seat 1: disanddowny (button) folded before Flop (didn't bet)
Seat 2: nish1319 (small blind) showed [Qd 4c] and won ($0.12) with two pair, Queens and Jacks
Seat 3: Tibeau21 (big blind) mucked [Tc 7h]
Seat 4: KKARMELO folded before Flop (didn't bet)
Seat 5: kcyxa folded before Flop (didn't bet)
Seat 6: Scaaalll folded before Flop (didn't bet)



PokerStars Zoom Hand #229233553389:  Hold'em No Limit ($0.01/$0.02) - 2021/08/21 23:34:24 CET [2021/08/21 17:34:24 ET]
Table 'Halley' 6-max Seat #1 is the button
Seat 1: tarogame ($2.01 in chips) 
Seat 2: MetalCrüe ($1.59 in chips) 
Seat 3: Scaaalll ($3.31 in chips) 
Seat 4: NoEff0rt2w1n ($6.87 in chips) 
Seat 5: ash1448 ($6.69 in chips) 
Seat 6: 365p2eva ($2 in chips) 
MetalCrüe: posts small blind $0.01
Scaaalll: posts big blind $0.02
*** HOLE CARDS ***
Dealt to Scaaalll [9c Jc]
NoEff0rt2w1n: folds 
ash1448: folds 
365p2eva: raises $0.04 to $0.06
tarogame: folds 
MetalCrüe: folds 
Scaaalll: folds 
Uncalled bet ($0.04) returned to 365p2eva
365p2eva collected $0.05 from pot
365p2eva: doesn't show hand 
*** SUMMARY ***
Total pot $0.05 | Rake $0 
Seat 1: tarogame (button) folded before Flop (didn't bet)
Seat 2: MetalCrüe (small blind) folded before Flop
Seat 3: Scaaalll (big blind) folded before Flop
Seat 4: NoEff0rt2w1n folded before Flop (didn't bet)
Seat 5: ash1448 folded before Flop (didn't bet)
Seat 6: 365p2eva collected ($0.05)



PokerStars Zoom Hand #229233539983:  Hold'em No Limit ($0.01/$0.02) - 2021/08/21 23:34:07 CET [2021/08/21 17:34:07 ET]
Table 'Halley' 6-max Seat #1 is the button
Seat 1: kukulagosleep ($3.98 in chips) 
Seat 2: djovex ($1.99 in chips) 
Seat 3: Reipinguimm ($2.13 in chips) 
Seat 4: Scaaalll ($3.28 in chips) 
Seat 5: osantos401 ($9.40 in chips) 
Seat 6: 888lifeIS ($2 in chips) 
djovex: posts small blind $0.01
Reipinguimm: posts big blind $0.02
*** HOLE CARDS ***
Dealt to Scaaalll [Td 7s]
Scaaalll: folds 
osantos401: raises $0.04 to $0.06
888lifeIS: folds 
kukulagosleep: folds 
djovex: calls $0.05
Reipinguimm: folds 
*** FLOP *** [Th 6d 3s]
djovex: checks 
osantos401: bets $0.07
djovex: folds 
Uncalled bet ($0.07) returned to osantos401
osantos401 collected $0.14 from pot
osantos401: doesn't show hand 
djovex is disconnected 
*** SUMMARY ***
Total pot $0.14 | Rake $0 
Board [Th 6d 3s]
Seat 1: kukulagosleep (button) folded before Flop (didn't bet)
Seat 2: djovex (small blind) folded on the Flop
Seat 3: Reipinguimm (big blind) folded before Flop
Seat 4: Scaaalll folded before Flop (didn't bet)
Seat 5: osantos401 collected ($0.14)
Seat 6: 888lifeIS folded before Flop (didn't bet)



PokerStars Zoom Hand #229233536749:  Hold'em No Limit ($0.01/$0.02) - 2021/08/21 23:33:59 CET [2021/08/21 17:33:59 ET]
Table 'Halley' 6-max Seat #1 is the button
Seat 1: Ape$apiens ($2 in chips) 
Seat 2: queen830 ($16.17 in chips) 
Seat 3: MEZz828 ($4.05 in chips) 
Seat 4: tisadaisy ($2.56 in chips) 
Seat 5: Scaaalll ($3.28 in chips) 
Seat 6: fabor1303 ($3.40 in chips) 
queen830: posts small blind $0.01
MEZz828: posts big blind $0.02
*** HOLE CARDS ***
Dealt to Scaaalll [4c Tc]
tisadaisy: raises $0.02 to $0.04
Scaaalll: folds 
fabor1303: folds 
Ape$apiens: calls $0.04
queen830: folds 
MEZz828: calls $0.02
*** FLOP *** [Kd 7h Qh]
MEZz828: checks 
tisadaisy: checks 
Ape$apiens: checks 
*** TURN *** [Kd 7h Qh] [Ks]
MEZz828: checks 
tisadaisy: bets $0.07
Ape$apiens: calls $0.07
MEZz828: folds 
*** RIVER *** [Kd 7h Qh Ks] [5d]
tisadaisy: bets $0.13
Ape$apiens: folds 
Uncalled bet ($0.13) returned to tisadaisy
tisadaisy collected $0.26 from pot
tisadaisy: doesn't show hand 
Ape$apiens is disconnected 
*** SUMMARY ***
Total pot $0.27 | Rake $0.01 
Board [Kd 7h Qh Ks 5d]
Seat 1: Ape$apiens (button) folded on the River
Seat 2: queen830 (small blind) folded before Flop
Seat 3: MEZz828 (big blind) folded on the Turn
Seat 4: tisadaisy collected ($0.26)
Seat 5: Scaaalll folded before Flop (didn't bet)
Seat 6: fabor1303 folded before Flop (didn't bet)



PokerStars Zoom Hand #229233559549:  Hold'em No Limit ($0.01/$0.02) - 2021/08/21 23:34:39 CET [2021/08/21 17:34:39 ET]
Table 'Halley' 6-max Seat #1 is the button
Seat 1: dkno77 ($1.52 in chips) 
Seat 2: rancing87 ($2.15 in chips) 
Seat 3: Alexasha78 ($3.11 in chips) 
Seat 4: Sul07 ($1.11 in chips) 
Seat 5: FreddyFlips ($1.86 in chips) 
Seat 6: Scaaalll ($3.29 in chips) 
rancing87: posts small blind $0.01
Alexasha78: posts big blind $0.02
*** HOLE CARDS ***
Dealt to Scaaalll [Ah 4d]
Sul07: folds 
FreddyFlips: folds 
FreddyFlips is disconnected 
Scaaalll: folds 
dkno77: folds 
rancing87: folds 
Uncalled bet ($0.01) returned to Alexasha78
Alexasha78 collected $0.02 from pot
Alexasha78: doesn't show hand 
*** SUMMARY ***
Total pot $0.02 | Rake $0 
Seat 1: dkno77 (button) folded before Flop (didn't bet)
Seat 2: rancing87 (small blind) folded before Flop
Seat 3: Alexasha78 (big blind) collected ($0.02)
Seat 4: Sul07 folded before Flop (didn't bet)
Seat 5: FreddyFlips folded before Flop (didn't bet)
Seat 6: Scaaalll folded before Flop (didn't bet)



PokerStars Zoom Hand #229233568661:  Hold'em No Limit ($0.01/$0.02) - 2021/08/21 23:35:01 CET [2021/08/21 17:35:01 ET]
Table 'Halley' 6-max Seat #1 is the button
Seat 1: Scaaalll ($3.28 in chips) 
Seat 2: byakuda ($2.04 in chips) 
Seat 3: Vanekakqj ($3.26 in chips) 
Seat 4: TTGemi ($2.03 in chips) 
Seat 5: KKARMELO ($2.21 in chips) 
Seat 6: BeastBoy18 ($2.98 in chips) 
byakuda: posts small blind $0.01
Vanekakqj: posts big blind $0.02
*** HOLE CARDS ***
Dealt to Scaaalll [9c 9h]
TTGemi: folds 
KKARMELO: folds 
BeastBoy18: folds 
Scaaalll: raises $0.03 to $0.05
byakuda: folds 
Vanekakqj: calls $0.03
*** FLOP *** [2h Jh Ks]
Vanekakqj: checks 
Scaaalll: checks 
*** TURN *** [2h Jh Ks] [6d]
Vanekakqj: bets $0.06
Scaaalll: calls $0.06
*** RIVER *** [2h Jh Ks 6d] [2s]
Vanekakqj: checks 
Scaaalll: checks 
*** SHOW DOWN ***
Vanekakqj: shows [6s 7s] (two pair, Sixes and Deuces)
Scaaalll: shows [9c 9h] (two pair, Nines and Deuces)
Scaaalll collected $0.22 from pot
*** SUMMARY ***
Total pot $0.23 | Rake $0.01 
Board [2h Jh Ks 6d 2s]
Seat 1: Scaaalll (button) showed [9c 9h] and won ($0.22) with two pair, Nines and Deuces
Seat 2: byakuda (small blind) folded before Flop
Seat 3: Vanekakqj (big blind) showed [6s 7s] and lost with two pair, Sixes and Deuces
Seat 4: TTGemi folded before Flop (didn't bet)
Seat 5: KKARMELO folded before Flop (didn't bet)
Seat 6: BeastBoy18 folded before Flop (didn't bet)



PokerStars Zoom Hand #229233583425:  Hold'em No Limit ($0.01/$0.02) - 2021/08/21 23:35:37 CET [2021/08/21 17:35:37 ET]
Table 'Halley' 6-max Seat #1 is the button
Seat 1: prosto lili ($0.97 in chips) 
Seat 2: Mikeloko182 ($4.16 in chips) 
Seat 3: H0mmer99 ($3.01 in chips) 
Seat 4: Scaaalll ($3.39 in chips) 
Seat 5: causavera ($0.38 in chips) 
Seat 6: HubertFroh ($4.33 in chips) 
Mikeloko182: posts small blind $0.01
H0mmer99: posts big blind $0.02
*** HOLE CARDS ***
Dealt to Scaaalll [Qs Kc]
Scaaalll: raises $0.04 to $0.06
causavera: folds 
HubertFroh: folds 
prosto lili: folds 
Mikeloko182: folds 
H0mmer99: folds 
Uncalled bet ($0.04) returned to Scaaalll
Scaaalll collected $0.05 from pot
Scaaalll: doesn't show hand 
*** SUMMARY ***
Total pot $0.05 | Rake $0 
Seat 1: prosto lili (button) folded before Flop (didn't bet)
Seat 2: Mikeloko182 (small blind) folded before Flop
Seat 3: H0mmer99 (big blind) folded before Flop
Seat 4: Scaaalll collected ($0.05)
Seat 5: causavera folded before Flop (didn't bet)
Seat 6: HubertFroh folded before Flop (didn't bet)



PokerStars Zoom Hand #229233563719:  Hold'em No Limit ($0.01/$0.02) - 2021/08/21 23:34:49 CET [2021/08/21 17:34:49 ET]
Table 'Halley' 6-max Seat #1 is the button
Seat 1: rabbitmeat73 ($0.71 in chips) 
Seat 2: Scaaalll ($3.29 in chips) 
Seat 3: Xlavariable ($2.20 in chips) 
Seat 4: didiclavi777 ($3.63 in chips) 
Seat 5: zergmiky ($2.11 in chips) 
Seat 6: TTGemi ($2.03 in chips) 
Scaaalll: posts small blind $0.01
Xlavariable: posts big blind $0.02
*** HOLE CARDS ***
Dealt to Scaaalll [4c Ah]
didiclavi777: raises $0.04 to $0.06
zergmiky: folds 
TTGemi: folds 
rabbitmeat73: folds 
Scaaalll: folds 
Xlavariable: calls $0.04
*** FLOP *** [Qc 5d 9d]
Xlavariable: checks 
didiclavi777: bets $0.06
Xlavariable: raises $0.16 to $0.22
didiclavi777: calls $0.16
*** TURN *** [Qc 5d 9d] [6s]
Xlavariable: bets $0.41
didiclavi777: calls $0.41
*** RIVER *** [Qc 5d 9d 6s] [8s]
Xlavariable: bets $0.67
didiclavi777: folds 
Uncalled bet ($0.67) returned to Xlavariable
Xlavariable collected $1.34 from pot
Xlavariable: doesn't show hand 
*** SUMMARY ***
Total pot $1.39 | Rake $0.05 
Board [Qc 5d 9d 6s 8s]
Seat 1: rabbitmeat73 (button) folded before Flop (didn't bet)
Seat 2: Scaaalll (small blind) folded before Flop
Seat 3: Xlavariable (big blind) collected ($1.34)
Seat 4: didiclavi777 folded on the River
Seat 5: zergmiky folded before Flop (didn't bet)
Seat 6: TTGemi folded before Flop (didn't bet)



PokerStars Zoom Hand #229233594992:  Hold'em No Limit ($0.01/$0.02) - 2021/08/21 23:36:05 CET [2021/08/21 17:36:05 ET]
Table 'Halley' 6-max Seat #1 is the button
Seat 1: FreddyFlips ($1.80 in chips) 
Seat 2: Scaaalll ($3.42 in chips) 
Seat 3: Feliciano16 ($3.32 in chips) 
Seat 4: Mikeloko182 ($2.86 in chips) 
Seat 5: Dr.stromg ($3.01 in chips) 
Seat 6: pizzaroni159 ($3.46 in chips) 
Scaaalll: posts small blind $0.01
Feliciano16: posts big blind $0.02
*** HOLE CARDS ***
Dealt to Scaaalll [Kh 8h]
Mikeloko182: folds 
Dr.stromg: folds 
pizzaroni159: folds 
FreddyFlips: raises $0.02 to $0.04
Scaaalll: folds 
Feliciano16: calls $0.02
*** FLOP *** [Jd Qh 3c]
Feliciano16: checks 
FreddyFlips: bets $0.04
Feliciano16: calls $0.04
*** TURN *** [Jd Qh 3c] [3s]
Feliciano16: checks 
FreddyFlips: checks 
*** RIVER *** [Jd Qh 3c 3s] [6s]
Feliciano16: bets $0.09
FreddyFlips: folds 
Uncalled bet ($0.09) returned to Feliciano16
Feliciano16 collected $0.16 from pot
Feliciano16: doesn't show hand 
FreddyFlips is disconnected 
*** SUMMARY ***
Total pot $0.17 | Rake $0.01 
Board [Jd Qh 3c 3s 6s]
Seat 1: FreddyFlips (button) folded on the River
Seat 2: Scaaalll (small blind) folded before Flop
Seat 3: Feliciano16 (big blind) collected ($0.16)
Seat 4: Mikeloko182 folded before Flop (didn't bet)
Seat 5: Dr.stromg folded before Flop (didn't bet)
Seat 6: pizzaroni159 folded before Flop (didn't bet)



PokerStars Zoom Hand #229233587555:  Hold'em No Limit ($0.01/$0.02) - 2021/08/21 23:35:47 CET [2021/08/21 17:35:47 ET]
Table 'Halley' 6-max Seat #1 is the button
Seat 1: Scaaalll ($3.42 in chips) 
Seat 2: BeastBoy18 ($2.96 in chips) 
Seat 3: Lekcey05 ($2 in chips) 
Seat 4: Koldun 2636 ($3.29 in chips) 
Seat 5: Reipinguimm ($2.55 in chips) 
Seat 6: samn102 ($2.13 in chips) 
BeastBoy18: posts small blind $0.01
Lekcey05: posts big blind $0.02
*** HOLE CARDS ***
Dealt to Scaaalll [Qh 8d]
Koldun 2636: folds 
Reipinguimm: folds 
samn102: raises $0.06 to $0.08
Scaaalll: folds 
BeastBoy18: raises $0.22 to $0.30
Lekcey05: folds 
samn102: raises $0.44 to $0.74
BeastBoy18: calls $0.44
*** FLOP *** [6d 2h 4s]
BeastBoy18: checks 
samn102: bets $1.39 and is all-in
BeastBoy18: folds 
Uncalled bet ($1.39) returned to samn102
samn102 collected $1.45 from pot
samn102: doesn't show hand 
*** SUMMARY ***
Total pot $1.50 | Rake $0.05 
Board [6d 2h 4s]
Seat 1: Scaaalll (button) folded before Flop (didn't bet)
Seat 2: BeastBoy18 (small blind) folded on the Flop
Seat 3: Lekcey05 (big blind) folded before Flop
Seat 4: Koldun 2636 folded before Flop (didn't bet)
Seat 5: Reipinguimm folded before Flop (didn't bet)
Seat 6: samn102 collected ($1.45)



PokerStars Zoom Hand #229233608433:  Hold'em No Limit ($0.01/$0.02) - 2021/08/21 23:36:38 CET [2021/08/21 17:36:38 ET]
Table 'Halley' 6-max Seat #1 is the button
Seat 1: rpycmbEM ($5.74 in chips) 
Seat 2: hustlehero ($2.06 in chips) 
Seat 3: KonopDima ($2.30 in chips) 
Seat 4: Pechorin.G ($2.04 in chips) 
Seat 5: Scaaalll ($3.39 in chips) 
Seat 6: kboskov123 ($2.34 in chips) 
hustlehero: posts small blind $0.01
KonopDima: posts big blind $0.02
*** HOLE CARDS ***
Dealt to Scaaalll [3d 8c]
Pechorin.G: folds 
Scaaalll: folds 
kboskov123: folds 
rpycmbEM: raises $0.03 to $0.05
hustlehero: folds 
KonopDima: folds 
Uncalled bet ($0.03) returned to rpycmbEM
rpycmbEM collected $0.05 from pot
rpycmbEM: doesn't show hand 
*** SUMMARY ***
Total pot $0.05 | Rake $0 
Seat 1: rpycmbEM (button) collected ($0.05)
Seat 2: hustlehero (small blind) folded before Flop
Seat 3: KonopDima (big blind) folded before Flop
Seat 4: Pechorin.G folded before Flop (didn't bet)
Seat 5: Scaaalll folded before Flop (didn't bet)
Seat 6: kboskov123 folded before Flop (didn't bet)



PokerStars Zoom Hand #229233606734:  Hold'em No Limit ($0.01/$0.02) - 2021/08/21 23:36:34 CET [2021/08/21 17:36:34 ET]
Table 'Halley' 6-max Seat #1 is the button
Seat 1: QuienEsDezzed ($1.82 in chips) 
Seat 2: kukulagosleep ($4.14 in chips) 
Seat 3: Hejpåre ($3.80 in chips) 
Seat 4: hairy navel ($2.21 in chips) 
Seat 5: Scaaalll ($3.39 in chips) 
Seat 6: KonopDima ($2.30 in chips) 
kukulagosleep: posts small blind $0.01
Hejpåre: posts big blind $0.02
*** HOLE CARDS ***
Dealt to Scaaalll [2s 4s]
hairy navel: calls $0.02
Scaaalll: folds 
KonopDima: folds 
QuienEsDezzed: folds 
kukulagosleep: raises $0.04 to $0.06
Hejpåre: folds 
hairy navel: calls $0.04
*** FLOP *** [7h Js 9s]
kukulagosleep: bets $0.06
hairy navel: folds 
Uncalled bet ($0.06) returned to kukulagosleep
kukulagosleep collected $0.14 from pot
kukulagosleep: doesn't show hand 
*** SUMMARY ***
Total pot $0.14 | Rake $0 
Board [7h Js 9s]
Seat 1: QuienEsDezzed (button) folded before Flop (didn't bet)
Seat 2: kukulagosleep (small blind) collected ($0.14)
Seat 3: Hejpåre (big blind) folded before Flop
Seat 4: hairy navel folded on the Flop
Seat 5: Scaaalll folded before Flop (didn't bet)
Seat 6: KonopDima folded before Flop (didn't bet)



PokerStars Zoom Hand #229233612886:  Hold'em No Limit ($0.01/$0.02) - 2021/08/21 23:36:49 CET [2021/08/21 17:36:49 ET]
Table 'Halley' 6-max Seat #1 is the button
Seat 1: Scaaalll ($3.39 in chips) 
Seat 2: gasmar_29 ($2.38 in chips) 
Seat 3: jaamonra ($2.52 in chips) 
Seat 4: OneFaw ($2.84 in chips) 
Seat 5: kboskov123 ($2.34 in chips) 
Seat 6: prosto lili ($0.74 in chips) 
gasmar_29: posts small blind $0.01
jaamonra: posts big blind $0.02
*** HOLE CARDS ***
Dealt to Scaaalll [2s 7s]
OneFaw: folds 
OneFaw is disconnected 
kboskov123: folds 
prosto lili: folds 
Scaaalll: folds 
gasmar_29: folds 
Uncalled bet ($0.01) returned to jaamonra
jaamonra collected $0.02 from pot
jaamonra: doesn't show hand 
*** SUMMARY ***
Total pot $0.02 | Rake $0 
Seat 1: Scaaalll (button) folded before Flop (didn't bet)
Seat 2: gasmar_29 (small blind) folded before Flop
Seat 3: jaamonra (big blind) collected ($0.02)
Seat 4: OneFaw folded before Flop (didn't bet)
Seat 5: kboskov123 folded before Flop (didn't bet)
Seat 6: prosto lili folded before Flop (didn't bet)



PokerStars Zoom Hand #229233621916:  Hold'em No Limit ($0.01/$0.02) - 2021/08/21 23:37:11 CET [2021/08/21 17:37:11 ET]
Table 'Halley' 6-max Seat #1 is the button
Seat 1: rancing87 ($2.06 in chips) 
Seat 2: Scaaalll ($3.37 in chips) 
Seat 3: KissingTheSun ($3.28 in chips) 
Seat 4: GambleNinjaEX ($4.97 in chips) 
Seat 5: PEDACIT0 ($2.17 in chips) 
Seat 6: sulcinob ($1.97 in chips) 
Scaaalll: posts small blind $0.01
KissingTheSun: posts big blind $0.02
*** HOLE CARDS ***
Dealt to Scaaalll [7h 6d]
GambleNinjaEX: folds 
PEDACIT0: folds 
sulcinob: folds 
rancing87: folds 
Scaaalll: folds 
Uncalled bet ($0.01) returned to KissingTheSun
KissingTheSun collected $0.02 from pot
KissingTheSun: doesn't show hand 
*** SUMMARY ***
Total pot $0.02 | Rake $0 
Seat 1: rancing87 (button) folded before Flop (didn't bet)
Seat 2: Scaaalll (small blind) folded before Flop
Seat 3: KissingTheSun (big blind) collected ($0.02)
Seat 4: GambleNinjaEX folded before Flop (didn't bet)
Seat 5: PEDACIT0 folded before Flop (didn't bet)
Seat 6: sulcinob folded before Flop (didn't bet)



PokerStars Zoom Hand #229233601452:  Hold'em No Limit ($0.01/$0.02) - 2021/08/21 23:36:21 CET [2021/08/21 17:36:21 ET]
Table 'Halley' 6-max Seat #1 is the button
Seat 1: adrianh2002 ($4.58 in chips) 
Seat 2: tassy237 ($1.21 in chips) 
Seat 3: Scaaalll ($3.41 in chips) 
Seat 4: plmanuelpl ($1.06 in chips) 
Seat 5: gilberto98 ($1.79 in chips) 
Seat 6: GGopenBet ($2.39 in chips) 
tassy237: posts small blind $0.01
Scaaalll: posts big blind $0.02
*** HOLE CARDS ***
Dealt to Scaaalll [Qc Th]
tassy237 is disconnected 
plmanuelpl: calls $0.02
gilberto98: folds 
GGopenBet: folds 
GGopenBet is disconnected 
adrianh2002: raises $0.05 to $0.07
tassy237: folds 
Scaaalll: folds 
plmanuelpl: calls $0.05
*** FLOP *** [5d 3s Kd]
plmanuelpl: checks 
adrianh2002: bets $0.05
plmanuelpl: calls $0.05
*** TURN *** [5d 3s Kd] [7h]
plmanuelpl: checks 
adrianh2002: checks 
*** RIVER *** [5d 3s Kd 7h] [5c]
plmanuelpl: checks 
adrianh2002: bets $0.19
plmanuelpl: folds 
Uncalled bet ($0.19) returned to adrianh2002
adrianh2002 collected $0.26 from pot
adrianh2002: doesn't show hand 
*** SUMMARY ***
Total pot $0.27 | Rake $0.01 
Board [5d 3s Kd 7h 5c]
Seat 1: adrianh2002 (button) collected ($0.26)
Seat 2: tassy237 (small blind) folded before Flop
Seat 3: Scaaalll (big blind) folded before Flop
Seat 4: plmanuelpl folded on the River
Seat 5: gilberto98 folded before Flop (didn't bet)
Seat 6: GGopenBet folded before Flop (didn't bet)



PokerStars Zoom Hand #229233610499:  Hold'em No Limit ($0.01/$0.02) - 2021/08/21 23:36:43 CET [2021/08/21 17:36:43 ET]
Table 'Halley' 6-max Seat #1 is the button
Seat 1: tarogame ($2 in chips) 
Seat 2: baileyduck ($2.02 in chips) 
Seat 3: karkal1990 ($0.74 in chips) 
Seat 4: Bol'tazar111 ($2.38 in chips) 
Seat 5: QuienEsDezzed ($1.82 in chips) 
Seat 6: Scaaalll ($3.39 in chips) 
baileyduck: posts small blind $0.01
karkal1990: posts big blind $0.02
*** HOLE CARDS ***
Dealt to Scaaalll [5c 9s]
Bol'tazar111: raises $0.02 to $0.04
karkal1990 is disconnected 
QuienEsDezzed: calls $0.04
Scaaalll: folds 
tarogame: calls $0.04
baileyduck: calls $0.03
karkal1990: folds 
*** FLOP *** [Qd Tc Ks]
baileyduck: checks 
Bol'tazar111: checks 
QuienEsDezzed: checks 
tarogame: checks 
*** TURN *** [Qd Tc Ks] [Qc]
baileyduck: checks 
Bol'tazar111: checks 
QuienEsDezzed: checks 
tarogame: checks 
*** RIVER *** [Qd Tc Ks Qc] [9h]
baileyduck: checks 
Bol'tazar111: checks 
QuienEsDezzed: bets $0.17
tarogame: folds 
baileyduck: folds 
baileyduck is disconnected 
Bol'tazar111: folds 
Uncalled bet ($0.17) returned to QuienEsDezzed
QuienEsDezzed collected $0.17 from pot
QuienEsDezzed: doesn't show hand 
*** SUMMARY ***
Total pot $0.18 | Rake $0.01 
Board [Qd Tc Ks Qc 9h]
Seat 1: tarogame (button) folded on the River
Seat 2: baileyduck (small blind) folded on the River
Seat 3: karkal1990 (big blind) folded before Flop
Seat 4: Bol'tazar111 folded on the River
Seat 5: QuienEsDezzed collected ($0.17)
Seat 6: Scaaalll folded before Flop (didn't bet)



PokerStars Zoom Hand #229233630045:  Hold'em No Limit ($0.01/$0.02) - 2021/08/21 23:37:31 CET [2021/08/21 17:37:31 ET]
Table 'Halley' 6-max Seat #1 is the button
Seat 1: lucky1529 ($0.97 in chips) 
Seat 2: mitsou brux ($2.72 in chips) 
Seat 3: kukulagosleep ($4.16 in chips) 
Seat 4: 365p2eva ($2.12 in chips) 
Seat 5: El Chicha.CL ($3.75 in chips) 
Seat 6: Scaaalll ($3.36 in chips) 
mitsou brux: posts small blind $0.01
kukulagosleep: posts big blind $0.02
*** HOLE CARDS ***
Dealt to Scaaalll [2d Qd]
365p2eva: folds 
El Chicha.CL: folds 
Scaaalll: folds 
lucky1529: calls $0.02
mitsou brux: folds 
kukulagosleep: checks 
*** FLOP *** [Tc As 6h]
kukulagosleep: checks 
lucky1529: bets $0.04
kukulagosleep: folds 
Uncalled bet ($0.04) returned to lucky1529
lucky1529 collected $0.05 from pot
lucky1529: doesn't show hand 
*** SUMMARY ***
Total pot $0.05 | Rake $0 
Board [Tc As 6h]
Seat 1: lucky1529 (button) collected ($0.05)
Seat 2: mitsou brux (small blind) folded before Flop
Seat 3: kukulagosleep (big blind) folded on the Flop
Seat 4: 365p2eva folded before Flop (didn't bet)
Seat 5: El Chicha.CL folded before Flop (didn't bet)
Seat 6: Scaaalll folded before Flop (didn't bet)



PokerStars Zoom Hand #229233615006:  Hold'em No Limit ($0.01/$0.02) - 2021/08/21 23:36:54 CET [2021/08/21 17:36:54 ET]
Table 'Halley' 6-max Seat #1 is the button
Seat 1: Recasia ($1.05 in chips) 
Seat 2: lauti214 ($2.01 in chips) 
Seat 3: Scaaalll ($3.39 in chips) 
Seat 4: rotfei02 ($2.84 in chips) 
Seat 5: Luisit0_aqp ($1 in chips) 
Seat 6: so0love ($5.23 in chips) 
lauti214: posts small blind $0.01
Scaaalll: posts big blind $0.02
*** HOLE CARDS ***
Dealt to Scaaalll [6h Ah]
rotfei02: folds 
Luisit0_aqp: raises $0.04 to $0.06
so0love: calls $0.06
Recasia: folds 
lauti214: folds 
Scaaalll: folds 
*** FLOP *** [3c 6d 4c]
Luisit0_aqp: bets $0.14
so0love: raises $0.17 to $0.31
Luisit0_aqp: raises $0.63 to $0.94 and is all-in
so0love: calls $0.63
so0love has timed out
*** TURN *** [3c 6d 4c] [Ac]
*** RIVER *** [3c 6d 4c Ac] [Jd]
*** SHOW DOWN ***
Luisit0_aqp: shows [Kc Ks] (a pair of Kings)
so0love: shows [5h 5s] (a pair of Fives)
Luisit0_aqp collected $1.96 from pot
*** SUMMARY ***
Total pot $2.03 | Rake $0.07 
Board [3c 6d 4c Ac Jd]
Seat 1: Recasia (button) folded before Flop (didn't bet)
Seat 2: lauti214 (small blind) folded before Flop
Seat 3: Scaaalll (big blind) folded before Flop
Seat 4: rotfei02 folded before Flop (didn't bet)
Seat 5: Luisit0_aqp showed [Kc Ks] and won ($1.96) with a pair of Kings
Seat 6: so0love showed [5h 5s] and lost with a pair of Fives



PokerStars Zoom Hand #229233634188:  Hold'em No Limit ($0.01/$0.02) - 2021/08/21 23:37:41 CET [2021/08/21 17:37:41 ET]
Table 'Halley' 6-max Seat #1 is the button
Seat 1: Mrajax-Beardman ($2.39 in chips) 
Seat 2: pipecmolodec ($2 in chips) 
Seat 3: rancing87 ($2.05 in chips) 
Seat 4: Taran0001 ($5.01 in chips) 
Seat 5: Scaaalll ($3.36 in chips) 
Seat 6: Finderra ($3.01 in chips) 
pipecmolodec: posts small blind $0.01
rancing87: posts big blind $0.02
*** HOLE CARDS ***
Dealt to Scaaalll [9h Th]
Taran0001: folds 
Scaaalll: raises $0.04 to $0.06
Finderra: folds 
Mrajax-Beardman: calls $0.06
pipecmolodec: folds 
rancing87: folds 
*** FLOP *** [6s 9s Qc]
Scaaalll: bets $0.08
Mrajax-Beardman: calls $0.08
*** TURN *** [6s 9s Qc] [8c]
Scaaalll: checks 
Mrajax-Beardman: bets $0.15
Scaaalll: calls $0.15
*** RIVER *** [6s 9s Qc 8c] [Jh]
Scaaalll: bets $0.36
Mrajax-Beardman: calls $0.36
*** SHOW DOWN ***
Scaaalll: shows [9h Th] (a straight, Eight to Queen)
Mrajax-Beardman: mucks hand 
Scaaalll collected $1.27 from pot
*** SUMMARY ***
Total pot $1.33 | Rake $0.06 
Board [6s 9s Qc 8c Jh]
Seat 1: Mrajax-Beardman (button) mucked [Qd 8h]
Seat 2: pipecmolodec (small blind) folded before Flop
Seat 3: rancing87 (big blind) folded before Flop
Seat 4: Taran0001 folded before Flop (didn't bet)
Seat 5: Scaaalll showed [9h Th] and won ($1.27) with a straight, Eight to Queen
Seat 6: Finderra folded before Flop (didn't bet)



PokerStars Zoom Hand #229233652861:  Hold'em No Limit ($0.01/$0.02) - 2021/08/21 23:38:27 CET [2021/08/21 17:38:27 ET]
Table 'Halley' 6-max Seat #1 is the button
Seat 1: Bol'tazar111 ($1.63 in chips) 
Seat 2: Finderra ($2.99 in chips) 
Seat 3: Koldun 2636 ($2.59 in chips) 
Seat 4: Scaaalll ($3.98 in chips) 
Seat 5: ChowMangao ($2.97 in chips) 
Seat 6: polymorhp ($3.58 in chips) 
Finderra: posts small blind $0.01
Koldun 2636: posts big blind $0.02
*** HOLE CARDS ***
Dealt to Scaaalll [6d As]
Scaaalll: folds 
ChowMangao: folds 
polymorhp: folds 
Bol'tazar111: folds 
Finderra: folds 
Uncalled bet ($0.01) returned to Koldun 2636
Koldun 2636 collected $0.02 from pot
Koldun 2636: doesn't show hand 
*** SUMMARY ***
Total pot $0.02 | Rake $0 
Seat 1: Bol'tazar111 (button) folded before Flop (didn't bet)
Seat 2: Finderra (small blind) folded before Flop
Seat 3: Koldun 2636 (big blind) collected ($0.02)
Seat 4: Scaaalll folded before Flop (didn't bet)
Seat 5: ChowMangao folded before Flop (didn't bet)
Seat 6: polymorhp folded before Flop (didn't bet)



PokerStars Zoom Hand #229233656960:  Hold'em No Limit ($0.01/$0.02) - 2021/08/21 23:38:37 CET [2021/08/21 17:38:37 ET]
Table 'Halley' 6-max Seat #1 is the button
Seat 1: Gremlipoo ($2.03 in chips) 
Seat 2: Ne0net ($2 in chips) 
Seat 3: gabgordula ($2 in chips) 
Seat 4: hustlehero ($2.05 in chips) 
Seat 5: Scaaalll ($3.98 in chips) 
Seat 6: fishh_play ($4.99 in chips) 
Ne0net: posts small blind $0.01
gabgordula: posts big blind $0.02
*** HOLE CARDS ***
Dealt to Scaaalll [Td Ad]
hustlehero: raises $0.04 to $0.06
Scaaalll: calls $0.06
fishh_play: calls $0.06
Gremlipoo: calls $0.06
Ne0net: folds 
gabgordula: folds 
*** FLOP *** [Jh Ac 7s]
hustlehero: checks 
Scaaalll: bets $0.14
Gremlipoo is disconnected 
fishh_play: folds 
Gremlipoo: folds 
hustlehero: folds 
Uncalled bet ($0.14) returned to Scaaalll
Scaaalll collected $0.26 from pot
Scaaalll: doesn't show hand 
*** SUMMARY ***
Total pot $0.27 | Rake $0.01 
Board [Jh Ac 7s]
Seat 1: Gremlipoo (button) folded on the Flop
Seat 2: Ne0net (small blind) folded before Flop
Seat 3: gabgordula (big blind) folded before Flop
Seat 4: hustlehero folded on the Flop
Seat 5: Scaaalll collected ($0.26)
Seat 6: fishh_play folded on the Flop



PokerStars Zoom Hand #229233669405:  Hold'em No Limit ($0.01/$0.02) - 2021/08/21 23:39:08 CET [2021/08/21 17:39:08 ET]
Table 'Halley' 6-max Seat #1 is the button
Seat 1: nagibatorali ($0.65 in chips) 
Seat 2: Baldisback ($1.23 in chips) 
Seat 3: S3XY_PADRE ($5.53 in chips) 
Seat 4: ciucibaby ($2.06 in chips) 
Seat 5: Luisit0_aqp ($1.03 in chips) 
Seat 6: Scaaalll ($4.18 in chips) 
Baldisback: posts small blind $0.01
S3XY_PADRE: posts big blind $0.02
*** HOLE CARDS ***
Dealt to Scaaalll [Ad 2c]
ciucibaby: folds 
Luisit0_aqp: folds 
Scaaalll: folds 
nagibatorali: raises $0.06 to $0.08
Baldisback: folds 
S3XY_PADRE: folds 
Uncalled bet ($0.06) returned to nagibatorali
nagibatorali collected $0.05 from pot
nagibatorali: doesn't show hand 
*** SUMMARY ***
Total pot $0.05 | Rake $0 
Seat 1: nagibatorali (button) collected ($0.05)
Seat 2: Baldisback (small blind) folded before Flop
Seat 3: S3XY_PADRE (big blind) folded before Flop
Seat 4: ciucibaby folded before Flop (didn't bet)
Seat 5: Luisit0_aqp folded before Flop (didn't bet)
Seat 6: Scaaalll folded before Flop (didn't bet)



PokerStars Zoom Hand #229233676680:  Hold'em No Limit ($0.01/$0.02) - 2021/08/21 23:39:26 CET [2021/08/21 17:39:26 ET]
Table 'Halley' 6-max Seat #1 is the button
Seat 1: afreak93 ($2.66 in chips) 
Seat 2: Scaaalll ($4.16 in chips) 
Seat 3: Doktor Yes ($2.16 in chips) 
Seat 4: kumka8812 ($1.56 in chips) 
Seat 5: 365p2eva ($2 in chips) 
Seat 6: egroj1700 ($2.10 in chips) 
Scaaalll: posts small blind $0.01
Doktor Yes: posts big blind $0.02
*** HOLE CARDS ***
Dealt to Scaaalll [7s 7d]
kumka8812: folds 
365p2eva: folds 
kumka8812 is disconnected 
egroj1700: folds 
afreak93: folds 
Scaaalll: raises $0.04 to $0.06
Doktor Yes: folds 
Uncalled bet ($0.04) returned to Scaaalll
Scaaalll collected $0.04 from pot
Scaaalll: doesn't show hand 
*** SUMMARY ***
Total pot $0.04 | Rake $0 
Seat 1: afreak93 (button) folded before Flop (didn't bet)
Seat 2: Scaaalll (small blind) collected ($0.04)
Seat 3: Doktor Yes (big blind) folded before Flop
Seat 4: kumka8812 folded before Flop (didn't bet)
Seat 5: 365p2eva folded before Flop (didn't bet)
Seat 6: egroj1700 folded before Flop (didn't bet)



PokerStars Zoom Hand #229233670966:  Hold'em No Limit ($0.01/$0.02) - 2021/08/21 23:39:12 CET [2021/08/21 17:39:12 ET]
Table 'Halley' 6-max Seat #1 is the button
Seat 1: Fenix888888 ($0.71 in chips) 
Seat 2: QuienEsDezzed ($1.83 in chips) 
Seat 3: Scaaalll ($4.18 in chips) 
Seat 4: danteesq ($2.02 in chips) 
Seat 5: Cineva81 ($2.25 in chips) 
Seat 6: Pizotifen ($2 in chips) 
QuienEsDezzed: posts small blind $0.01
Scaaalll: posts big blind $0.02
*** HOLE CARDS ***
Dealt to Scaaalll [7h 5c]
danteesq: folds 
Cineva81: folds 
Pizotifen: raises $0.04 to $0.06
Fenix888888: folds 
QuienEsDezzed: calls $0.05
Scaaalll: folds 
*** FLOP *** [Js 3d 5s]
QuienEsDezzed: checks 
Pizotifen: bets $0.05
QuienEsDezzed: calls $0.05
*** TURN *** [Js 3d 5s] [5d]
QuienEsDezzed: checks 
Pizotifen: checks 
*** RIVER *** [Js 3d 5s 5d] [7d]
QuienEsDezzed: bets $0.12
Pizotifen: folds 
Uncalled bet ($0.12) returned to QuienEsDezzed
QuienEsDezzed collected $0.23 from pot
QuienEsDezzed: doesn't show hand 
*** SUMMARY ***
Total pot $0.24 | Rake $0.01 
Board [Js 3d 5s 5d 7d]
Seat 1: Fenix888888 (button) folded before Flop (didn't bet)
Seat 2: QuienEsDezzed (small blind) collected ($0.23)
Seat 3: Scaaalll (big blind) folded before Flop
Seat 4: danteesq folded before Flop (didn't bet)
Seat 5: Cineva81 folded before Flop (didn't bet)
Seat 6: Pizotifen folded on the River



PokerStars Zoom Hand #229233682800:  Hold'em No Limit ($0.01/$0.02) - 2021/08/21 23:39:41 CET [2021/08/21 17:39:41 ET]
Table 'Halley' 6-max Seat #1 is the button
Seat 1: Scaaalll ($4.18 in chips) 
Seat 2: Xlavariable ($3.03 in chips) 
Seat 3: Mdnexoc ($1.22 in chips) 
Seat 4: lauti214 ($1.97 in chips) 
Seat 5: Jmapih ($1 in chips) 
Seat 6: Fenix888888 ($1.92 in chips) 
Xlavariable: posts small blind $0.01
Mdnexoc: posts big blind $0.02
*** HOLE CARDS ***
Dealt to Scaaalll [8c Tc]
lauti214: folds 
Jmapih: folds 
Fenix888888: folds 
Scaaalll: raises $0.02 to $0.04
Xlavariable: folds 
Mdnexoc: raises $0.09 to $0.13
Scaaalll: folds 
Uncalled bet ($0.09) returned to Mdnexoc
Mdnexoc collected $0.09 from pot
Mdnexoc: doesn't show hand 
*** SUMMARY ***
Total pot $0.09 | Rake $0 
Seat 1: Scaaalll (button) folded before Flop
Seat 2: Xlavariable (small blind) folded before Flop
Seat 3: Mdnexoc (big blind) collected ($0.09)
Seat 4: lauti214 folded before Flop (didn't bet)
Seat 5: Jmapih folded before Flop (didn't bet)
Seat 6: Fenix888888 folded before Flop (didn't bet)



PokerStars Zoom Hand #229233694880:  Hold'em No Limit ($0.01/$0.02) - 2021/08/21 23:40:11 CET [2021/08/21 17:40:11 ET]
Table 'Halley' 6-max Seat #1 is the button
Seat 1: bennodiem ($2.17 in chips) 
Seat 2: Scaaalll ($4.14 in chips) 
Seat 3: OmahaWheels ($3.54 in chips) 
Seat 4: Spinatstrudel ($2.63 in chips) 
Seat 5: Sadikson ($2.24 in chips) 
Seat 6: fabor1303 ($10.15 in chips) 
Scaaalll: posts small blind $0.01
OmahaWheels: posts big blind $0.02
*** HOLE CARDS ***
Dealt to Scaaalll [Jd 2c]
Sadikson is disconnected 
Spinatstrudel: raises $0.03 to $0.05
Sadikson: folds 
fabor1303: folds 
bennodiem: folds 
Scaaalll: folds 
OmahaWheels: folds 
Uncalled bet ($0.03) returned to Spinatstrudel
Spinatstrudel collected $0.05 from pot
Spinatstrudel: doesn't show hand 
*** SUMMARY ***
Total pot $0.05 | Rake $0 
Seat 1: bennodiem (button) folded before Flop (didn't bet)
Seat 2: Scaaalll (small blind) folded before Flop
Seat 3: OmahaWheels (big blind) folded before Flop
Seat 4: Spinatstrudel collected ($0.05)
Seat 5: Sadikson folded before Flop (didn't bet)
Seat 6: fabor1303 folded before Flop (didn't bet)



PokerStars Zoom Hand #229233693305:  Hold'em No Limit ($0.01/$0.02) - 2021/08/21 23:40:07 CET [2021/08/21 17:40:07 ET]
Table 'Halley' 6-max Seat #1 is the button
Seat 1: rotfei02 ($2.98 in chips) 
Seat 2: Luisit0_aqp ($0.58 in chips) 
Seat 3: Luchazo103 ($2.04 in chips) 
Seat 4: Scaaalll ($4.14 in chips) 
Seat 5: A.Khodyakov ($2.38 in chips) 
Seat 6: handrowan ($0.92 in chips) 
Luisit0_aqp: posts small blind $0.01
Luchazo103: posts big blind $0.02
*** HOLE CARDS ***
Dealt to Scaaalll [8h 3c]
Scaaalll: folds 
A.Khodyakov: raises $0.03 to $0.05
handrowan: folds 
rotfei02: folds 
Luisit0_aqp: folds 
Luchazo103: calls $0.03
*** FLOP *** [Jh 6h 6c]
Luchazo103: checks 
A.Khodyakov: checks 
*** TURN *** [Jh 6h 6c] [7h]
Luchazo103: bets $0.04
A.Khodyakov: folds 
Uncalled bet ($0.04) returned to Luchazo103
Luchazo103 collected $0.11 from pot
Luchazo103: doesn't show hand 
*** SUMMARY ***
Total pot $0.11 | Rake $0 
Board [Jh 6h 6c 7h]
Seat 1: rotfei02 (button) folded before Flop (didn't bet)
Seat 2: Luisit0_aqp (small blind) folded before Flop
Seat 3: Luchazo103 (big blind) collected ($0.11)
Seat 4: Scaaalll folded before Flop (didn't bet)
Seat 5: A.Khodyakov folded on the Turn
Seat 6: handrowan folded before Flop (didn't bet)



PokerStars Zoom Hand #229233698955:  Hold'em No Limit ($0.01/$0.02) - 2021/08/21 23:40:21 CET [2021/08/21 17:40:21 ET]
Table 'Halley' 6-max Seat #1 is the button
Seat 1: Scaaalll ($4.13 in chips) 
Seat 2: Tabitaji ($6.98 in chips) 
Seat 3: HitEmUpWatz9420 ($2.08 in chips) 
Seat 4: Baldisback ($1.06 in chips) 
Seat 5: StayFunky ($2.19 in chips) 
Seat 6: Dron1985 ($3.70 in chips) 
Tabitaji: posts small blind $0.01
HitEmUpWatz9420: posts big blind $0.02
*** HOLE CARDS ***
Dealt to Scaaalll [3s 4c]
Baldisback: folds 
StayFunky: folds 
Dron1985: folds 
Scaaalll: folds 
Dron1985 is disconnected 
Tabitaji: raises $0.04 to $0.06
HitEmUpWatz9420: folds 
Uncalled bet ($0.04) returned to Tabitaji
Tabitaji collected $0.04 from pot
Tabitaji: doesn't show hand 
HitEmUpWatz9420 is disconnected 
*** SUMMARY ***
Total pot $0.04 | Rake $0 
Seat 1: Scaaalll (button) folded before Flop (didn't bet)
Seat 2: Tabitaji (small blind) collected ($0.04)
Seat 3: HitEmUpWatz9420 (big blind) folded before Flop
Seat 4: Baldisback folded before Flop (didn't bet)
Seat 5: StayFunky folded before Flop (didn't bet)
Seat 6: Dron1985 folded before Flop (didn't bet)



PokerStars Zoom Hand #229233700958:  Hold'em No Limit ($0.01/$0.02) - 2021/08/21 23:40:26 CET [2021/08/21 17:40:26 ET]
Table 'Halley' 6-max Seat #1 is the button
Seat 1: 21041956 ($0.89 in chips) 
Seat 2: hustlehero ($2 in chips) 
Seat 3: Scaaalll ($4.13 in chips) 
Seat 4: nikos803 ($3.74 in chips) 
Seat 5: auxy89 ($3.28 in chips) 
Seat 6: CYBOPOB66 ($2 in chips) 
hustlehero: posts small blind $0.01
Scaaalll: posts big blind $0.02
*** HOLE CARDS ***
Dealt to Scaaalll [8s 4d]
auxy89 is disconnected 
nikos803: folds 
auxy89: folds 
CYBOPOB66: raises $0.04 to $0.06
21041956: folds 
hustlehero: folds 
Scaaalll: folds 
Uncalled bet ($0.04) returned to CYBOPOB66
CYBOPOB66 collected $0.05 from pot
CYBOPOB66: doesn't show hand 
*** SUMMARY ***
Total pot $0.05 | Rake $0 
Seat 1: 21041956 (button) folded before Flop (didn't bet)
Seat 2: hustlehero (small blind) folded before Flop
Seat 3: Scaaalll (big blind) folded before Flop
Seat 4: nikos803 folded before Flop (didn't bet)
Seat 5: auxy89 folded before Flop (didn't bet)
Seat 6: CYBOPOB66 collected ($0.05)



PokerStars Zoom Hand #229233711498:  Hold'em No Limit ($0.01/$0.02) - 2021/08/21 23:40:52 CET [2021/08/21 17:40:52 ET]
Table 'Halley' 6-max Seat #1 is the button
Seat 1: comptonBL ($2.02 in chips) 
Seat 2: kidninja888 ($2.79 in chips) 
Seat 3: Nihility77 ($2 in chips) 
Seat 4: dkno77 ($3.44 in chips) 
Seat 5: Scaaalll ($4.11 in chips) 
Seat 6: LSDenny ($2.40 in chips) 
kidninja888: posts small blind $0.01
Nihility77: posts big blind $0.02
*** HOLE CARDS ***
Dealt to Scaaalll [5s Td]
LSDenny is disconnected 
dkno77: folds 
Scaaalll: folds 
LSDenny: folds 
comptonBL: folds 
kidninja888: raises $0.03 to $0.05
Nihility77: folds 
Uncalled bet ($0.03) returned to kidninja888
kidninja888 collected $0.04 from pot
kidninja888: doesn't show hand 
*** SUMMARY ***
Total pot $0.04 | Rake $0 
Seat 1: comptonBL (button) folded before Flop (didn't bet)
Seat 2: kidninja888 (small blind) collected ($0.04)
Seat 3: Nihility77 (big blind) folded before Flop
Seat 4: dkno77 folded before Flop (didn't bet)
Seat 5: Scaaalll folded before Flop (didn't bet)
Seat 6: LSDenny folded before Flop (didn't bet)



PokerStars Zoom Hand #229233713130:  Hold'em No Limit ($0.01/$0.02) - 2021/08/21 23:40:56 CET [2021/08/21 17:40:56 ET]
Table 'Halley' 6-max Seat #1 is the button
Seat 1: johnpa89 ($4.41 in chips) 
Seat 2: SHALOMandKAT ($1.71 in chips) 
Seat 3: Mac9Monty2 ($2.33 in chips) 
Seat 4: Scaaalll ($4.11 in chips) 
Seat 5: LSDenny ($2.40 in chips) 
Seat 6: STE1NBERG ($2 in chips) 
SHALOMandKAT: posts small blind $0.01
Mac9Monty2: posts big blind $0.02
*** HOLE CARDS ***
Dealt to Scaaalll [3s 6d]
LSDenny is disconnected 
Scaaalll: folds 
LSDenny: folds 
STE1NBERG: folds 
johnpa89: folds 
SHALOMandKAT: folds 
Uncalled bet ($0.01) returned to Mac9Monty2
Mac9Monty2 collected $0.02 from pot
Mac9Monty2: doesn't show hand 
*** SUMMARY ***
Total pot $0.02 | Rake $0 
Seat 1: johnpa89 (button) folded before Flop (didn't bet)
Seat 2: SHALOMandKAT (small blind) folded before Flop
Seat 3: Mac9Monty2 (big blind) collected ($0.02)
Seat 4: Scaaalll folded before Flop (didn't bet)
Seat 5: LSDenny folded before Flop (didn't bet)
Seat 6: STE1NBERG folded before Flop (didn't bet)



PokerStars Zoom Hand #229233709854:  Hold'em No Limit ($0.01/$0.02) - 2021/08/21 23:40:48 CET [2021/08/21 17:40:48 ET]
Table 'Halley' 6-max Seat #1 is the button
Seat 1: KonopDima ($2.46 in chips) 
Seat 2: EdwardF95 ($2.01 in chips) 
Seat 3: Espartacus5222 ($2.61 in chips) 
Seat 4: WITKOW_AV ($6.80 in chips) 
Seat 5: ash1448 ($13.93 in chips) 
Seat 6: Scaaalll ($4.11 in chips) 
EdwardF95: posts small blind $0.01
Espartacus5222: posts big blind $0.02
*** HOLE CARDS ***
Dealt to Scaaalll [2s 6d]
WITKOW_AV: raises $0.04 to $0.06
ash1448: raises $0.12 to $0.18
Scaaalll: folds 
KonopDima: folds 
EdwardF95: folds 
Espartacus5222: folds 
WITKOW_AV: calls $0.12
*** FLOP *** [2c Ah Qs]
WITKOW_AV: checks 
ash1448: bets $0.11
WITKOW_AV: calls $0.11
*** TURN *** [2c Ah Qs] [4d]
WITKOW_AV: checks 
ash1448: checks 
*** RIVER *** [2c Ah Qs 4d] [6h]
WITKOW_AV: checks 
ash1448: checks 
*** SHOW DOWN ***
WITKOW_AV: shows [Ad 5d] (a pair of Aces)
ash1448: mucks hand 
WITKOW_AV collected $0.59 from pot
*** SUMMARY ***
Total pot $0.61 | Rake $0.02 
Board [2c Ah Qs 4d 6h]
Seat 1: KonopDima (button) folded before Flop (didn't bet)
Seat 2: EdwardF95 (small blind) folded before Flop
Seat 3: Espartacus5222 (big blind) folded before Flop
Seat 4: WITKOW_AV showed [Ad 5d] and won ($0.59) with a pair of Aces
Seat 5: ash1448 mucked [Jd Js]
Seat 6: Scaaalll folded before Flop (didn't bet)



PokerStars Zoom Hand #229233719641:  Hold'em No Limit ($0.01/$0.02) - 2021/08/21 23:41:12 CET [2021/08/21 17:41:12 ET]
Table 'Halley' 6-max Seat #1 is the button
Seat 1: adrianh2002 ($2 in chips) 
Seat 2: maressen ($3.80 in chips) 
Seat 3: Scaaalll ($4.11 in chips) 
Seat 4: plmanuelpl ($1.16 in chips) 
Seat 5: Mikeloko182 ($3.88 in chips) 
Seat 6: Hallyson_23 ($3.63 in chips) 
maressen: posts small blind $0.01
Scaaalll: posts big blind $0.02
*** HOLE CARDS ***
Dealt to Scaaalll [2c Qh]
plmanuelpl: folds 
plmanuelpl is disconnected 
Mikeloko182: folds 
Hallyson_23: folds 
adrianh2002: folds 
maressen: raises $0.03 to $0.05
Scaaalll: folds 
Uncalled bet ($0.03) returned to maressen
maressen collected $0.04 from pot
maressen: doesn't show hand 
*** SUMMARY ***
Total pot $0.04 | Rake $0 
Seat 1: adrianh2002 (button) folded before Flop (didn't bet)
Seat 2: maressen (small blind) collected ($0.04)
Seat 3: Scaaalll (big blind) folded before Flop
Seat 4: plmanuelpl folded before Flop (didn't bet)
Seat 5: Mikeloko182 folded before Flop (didn't bet)
Seat 6: Hallyson_23 folded before Flop (didn't bet)



PokerStars Zoom Hand #229233717113:  Hold'em No Limit ($0.01/$0.02) - 2021/08/21 23:41:06 CET [2021/08/21 17:41:06 ET]
Table 'Halley' 6-max Seat #1 is the button
Seat 1: Scaaalll ($4.11 in chips) 
Seat 2: FrancoOlmedo ($1.81 in chips) 
Seat 3: Espartacus5222 ($2 in chips) 
Seat 4: danteesq ($2.06 in chips) 
Seat 5: Nihility77 ($2.77 in chips) 
Seat 6: franek369 ($5.50 in chips) 
FrancoOlmedo: posts small blind $0.01
Espartacus5222: posts big blind $0.02
*** HOLE CARDS ***
Dealt to Scaaalll [5c 7s]
danteesq: folds 
Nihility77: folds 
franek369: folds 
Scaaalll: folds 
FrancoOlmedo: raises $0.03 to $0.05
Espartacus5222: raises $0.13 to $0.18
FrancoOlmedo: folds 
Uncalled bet ($0.13) returned to Espartacus5222
Espartacus5222 collected $0.10 from pot
Espartacus5222: doesn't show hand 
*** SUMMARY ***
Total pot $0.10 | Rake $0 
Seat 1: Scaaalll (button) folded before Flop (didn't bet)
Seat 2: FrancoOlmedo (small blind) folded before Flop
Seat 3: Espartacus5222 (big blind) collected ($0.10)
Seat 4: danteesq folded before Flop (didn't bet)
Seat 5: Nihility77 folded before Flop (didn't bet)
Seat 6: franek369 folded before Flop (didn't bet)



PokerStars Zoom Hand #229233728858:  Hold'em No Limit ($0.01/$0.02) - 2021/08/21 23:41:35 CET [2021/08/21 17:41:35 ET]
Table 'Halley' 6-max Seat #1 is the button
Seat 1: owtwilldo ($2.46 in chips) 
Seat 2: Mr.Kurier ($3.50 in chips) 
Seat 3: 1nTeresT ($2 in chips) 
Seat 4: LijanaV ($5.09 in chips) 
Seat 5: Scaaalll ($4.08 in chips) 
Seat 6: deldanlee ($0.92 in chips) 
Mr.Kurier: posts small blind $0.01
1nTeresT: posts big blind $0.02
*** HOLE CARDS ***
Dealt to Scaaalll [Kc 8d]
LijanaV: folds 
LijanaV is disconnected 
Scaaalll: folds 
deldanlee: folds 
owtwilldo: raises $0.02 to $0.04
Mr.Kurier: folds 
1nTeresT: folds 
Uncalled bet ($0.02) returned to owtwilldo
owtwilldo collected $0.05 from pot
owtwilldo: doesn't show hand 
*** SUMMARY ***
Total pot $0.05 | Rake $0 
Seat 1: owtwilldo (button) collected ($0.05)
Seat 2: Mr.Kurier (small blind) folded before Flop
Seat 3: 1nTeresT (big blind) folded before Flop
Seat 4: LijanaV folded before Flop (didn't bet)
Seat 5: Scaaalll folded before Flop (didn't bet)
Seat 6: deldanlee folded before Flop (didn't bet)



PokerStars Zoom Hand #229233727247:  Hold'em No Limit ($0.01/$0.02) - 2021/08/21 23:41:31 CET [2021/08/21 17:41:31 ET]
Table 'Halley' 6-max Seat #1 is the button
Seat 1: Nihility77 ($2 in chips) 
Seat 2: Scaaalll ($4.09 in chips) 
Seat 3: El Chicha.CL ($2 in chips) 
Seat 4: Bol'tazar111 ($2.22 in chips) 
Seat 5: Grenen1999 ($1.28 in chips) 
Seat 6: yorkoss ($2.70 in chips) 
Scaaalll: posts small blind $0.01
El Chicha.CL: posts big blind $0.02
*** HOLE CARDS ***
Dealt to Scaaalll [9h 4s]
Bol'tazar111: folds 
Grenen1999: folds 
yorkoss: raises $0.02 to $0.04
Nihility77: calls $0.04
Scaaalll: folds 
El Chicha.CL: folds 
*** FLOP *** [3c 9d 9c]
yorkoss: checks 
Nihility77: bets $0.06
yorkoss: folds 
Uncalled bet ($0.06) returned to Nihility77
Nihility77 collected $0.11 from pot
Nihility77: doesn't show hand 
*** SUMMARY ***
Total pot $0.11 | Rake $0 
Board [3c 9d 9c]
Seat 1: Nihility77 (button) collected ($0.11)
Seat 2: Scaaalll (small blind) folded before Flop
Seat 3: El Chicha.CL (big blind) folded before Flop
Seat 4: Bol'tazar111 folded before Flop (didn't bet)
Seat 5: Grenen1999 folded before Flop (didn't bet)
Seat 6: yorkoss folded on the Flop



PokerStars Zoom Hand #229233743455:  Hold'em No Limit ($0.01/$0.02) - 2021/08/21 23:42:11 CET [2021/08/21 17:42:11 ET]
Table 'Halley' 6-max Seat #1 is the button
Seat 1: Vladimir1954 ($2.16 in chips) 
Seat 2: BriceDo1917 ($4.22 in chips) 
Seat 3: Scaaalll ($4.08 in chips) 
Seat 4: punkosk8 ($7.10 in chips) 
Seat 5: ussr246 ($2.73 in chips) 
Seat 6: EdwardF95 ($2 in chips) 
BriceDo1917: posts small blind $0.01
Scaaalll: posts big blind $0.02
*** HOLE CARDS ***
Dealt to Scaaalll [5c 9d]
BriceDo1917 is disconnected 
punkosk8: folds 
ussr246: folds 
EdwardF95: folds 
Vladimir1954: folds 
BriceDo1917: folds 
Uncalled bet ($0.01) returned to Scaaalll
punkosk8 is disconnected 
Scaaalll collected $0.02 from pot
Scaaalll: doesn't show hand 
*** SUMMARY ***
Total pot $0.02 | Rake $0 
Seat 1: Vladimir1954 (button) folded before Flop (didn't bet)
Seat 2: BriceDo1917 (small blind) folded before Flop
Seat 3: Scaaalll (big blind) collected ($0.02)
Seat 4: punkosk8 folded before Flop (didn't bet)
Seat 5: ussr246 folded before Flop (didn't bet)
Seat 6: EdwardF95 folded before Flop (didn't bet)



PokerStars Zoom Hand #229233740575:  Hold'em No Limit ($0.01/$0.02) - 2021/08/21 23:42:04 CET [2021/08/21 17:42:04 ET]
Table 'Halley' 6-max Seat #1 is the button
Seat 1: Hallyson_23 ($6.50 in chips) 
Seat 2: kcyxa ($0.99 in chips) 
Seat 3: lucksuckdonk ($7.56 in chips) 
Seat 4: Scaaalll ($4.08 in chips) 
Seat 5: Busya777 ($4.90 in chips) 
Seat 6: heynckes18 ($5.67 in chips) 
kcyxa: posts small blind $0.01
lucksuckdonk: posts big blind $0.02
*** HOLE CARDS ***
Dealt to Scaaalll [2c Td]
Scaaalll: folds 
kcyxa is disconnected 
Busya777: calls $0.02
heynckes18: folds 
Hallyson_23: folds 
kcyxa: folds 
lucksuckdonk: checks 
*** FLOP *** [7h Ad 9h]
lucksuckdonk: checks 
Busya777: checks 
*** TURN *** [7h Ad 9h] [Th]
lucksuckdonk: checks 
Busya777: checks 
*** RIVER *** [7h Ad 9h Th] [Qh]
lucksuckdonk: checks 
Busya777: checks 
*** SHOW DOWN ***
lucksuckdonk: shows [4d Ks] (high card Ace)
Busya777: shows [Qc Jc] (a pair of Queens)
Busya777 collected $0.05 from pot
*** SUMMARY ***
Total pot $0.05 | Rake $0 
Board [7h Ad 9h Th Qh]
Seat 1: Hallyson_23 (button) folded before Flop (didn't bet)
Seat 2: kcyxa (small blind) folded before Flop
Seat 3: lucksuckdonk (big blind) showed [4d Ks] and lost with high card Ace
Seat 4: Scaaalll folded before Flop (didn't bet)
Seat 5: Busya777 showed [Qc Jc] and won ($0.05) with a pair of Queens
Seat 6: heynckes18 folded before Flop (didn't bet)



PokerStars Zoom Hand #229233734930:  Hold'em No Limit ($0.01/$0.02) - 2021/08/21 23:41:50 CET [2021/08/21 17:41:50 ET]
Table 'Halley' 6-max Seat #1 is the button
Seat 1: Chapaev136 ($2.48 in chips) 
Seat 2: hustlehero ($2.03 in chips) 
Seat 3: Feyqdoi ($2 in chips) 
Seat 4: GambleNinjaEX ($5.16 in chips) 
Seat 5: solosigueme ($4.71 in chips) 
Seat 6: Scaaalll ($4.08 in chips) 
hustlehero: posts small blind $0.01
Feyqdoi: posts big blind $0.02
*** HOLE CARDS ***
Dealt to Scaaalll [4s 6d]
GambleNinjaEX: raises $0.03 to $0.05
solosigueme: folds 
Scaaalll: folds 
Chapaev136: folds 
hustlehero: folds 
Feyqdoi: calls $0.03
*** FLOP *** [Ah Ks As]
Feyqdoi: checks 
GambleNinjaEX: checks 
*** TURN *** [Ah Ks As] [5d]
Feyqdoi: bets $0.06
GambleNinjaEX: calls $0.06
*** RIVER *** [Ah Ks As 5d] [3c]
Feyqdoi: checks 
GambleNinjaEX: bets $0.17
Feyqdoi: calls $0.17
*** SHOW DOWN ***
GambleNinjaEX: shows [Ac Qd] (three of a kind, Aces)
Feyqdoi: mucks hand 
GambleNinjaEX collected $0.55 from pot
*** SUMMARY ***
Total pot $0.57 | Rake $0.02 
Board [Ah Ks As 5d 3c]
Seat 1: Chapaev136 (button) folded before Flop (didn't bet)
Seat 2: hustlehero (small blind) folded before Flop
Seat 3: Feyqdoi (big blind) mucked [Kd Td]
Seat 4: GambleNinjaEX showed [Ac Qd] and won ($0.55) with three of a kind, Aces
Seat 5: solosigueme folded before Flop (didn't bet)
Seat 6: Scaaalll folded before Flop (didn't bet)



PokerStars Zoom Hand #229233747076:  Hold'em No Limit ($0.01/$0.02) - 2021/08/21 23:42:20 CET [2021/08/21 17:42:20 ET]
Table 'Halley' 6-max Seat #1 is the button
Seat 1: ibstah ($6.90 in chips) 
Seat 2: Scaaalll ($4.09 in chips) 
Seat 3: Dr.stromg ($3.12 in chips) 
Seat 4: KonopDima ($2.50 in chips) 
Seat 5: gasmar_29 ($2.69 in chips) 
Seat 6: OmahaWheels ($3.56 in chips) 
Scaaalll: posts small blind $0.01
Dr.stromg: posts big blind $0.02
*** HOLE CARDS ***
Dealt to Scaaalll [5c Ks]
KonopDima: folds 
gasmar_29: folds 
OmahaWheels: folds 
ibstah: folds 
Scaaalll: folds 
Uncalled bet ($0.01) returned to Dr.stromg
Dr.stromg collected $0.02 from pot
Dr.stromg: doesn't show hand 
*** SUMMARY ***
Total pot $0.02 | Rake $0 
Seat 1: ibstah (button) folded before Flop (didn't bet)
Seat 2: Scaaalll (small blind) folded before Flop
Seat 3: Dr.stromg (big blind) collected ($0.02)
Seat 4: KonopDima folded before Flop (didn't bet)
Seat 5: gasmar_29 folded before Flop (didn't bet)
Seat 6: OmahaWheels folded before Flop (didn't bet)



PokerStars Zoom Hand #229233749106:  Hold'em No Limit ($0.01/$0.02) - 2021/08/21 23:42:25 CET [2021/08/21 17:42:25 ET]
Table 'Halley' 6-max Seat #1 is the button
Seat 1: Scaaalll ($4.08 in chips) 
Seat 2: Ogni ($4.97 in chips) 
Seat 3: xoen ($2.04 in chips) 
Seat 4: Ck@tih@ ($1.54 in chips) 
Seat 5: ibstah ($6.90 in chips) 
Seat 6: babuin72 ($1.87 in chips) 
Ogni: posts small blind $0.01
xoen: posts big blind $0.02
*** HOLE CARDS ***
Dealt to Scaaalll [4s Qd]
Ck@tih@: folds 
ibstah: folds 
babuin72: folds 
Scaaalll: folds 
Ogni: folds 
Uncalled bet ($0.01) returned to xoen
xoen collected $0.02 from pot
xoen: doesn't show hand 
*** SUMMARY ***
Total pot $0.02 | Rake $0 
Seat 1: Scaaalll (button) folded before Flop (didn't bet)
Seat 2: Ogni (small blind) folded before Flop
Seat 3: xoen (big blind) collected ($0.02)
Seat 4: Ck@tih@ folded before Flop (didn't bet)
Seat 5: ibstah folded before Flop (didn't bet)
Seat 6: babuin72 folded before Flop (didn't bet)



PokerStars Zoom Hand #229233751066:  Hold'em No Limit ($0.01/$0.02) - 2021/08/21 23:42:30 CET [2021/08/21 17:42:30 ET]
Table 'Halley' 6-max Seat #1 is the button
Seat 1: osantos401 ($9.84 in chips) 
Seat 2: orlovac1995 ($5.45 in chips) 
Seat 3: estelionat171 ($1 in chips) 
Seat 4: Feliciano16 ($7 in chips) 
Seat 5: Chapaev136 ($1.62 in chips) 
Seat 6: Scaaalll ($4.08 in chips) 
orlovac1995: posts small blind $0.01
estelionat171: posts big blind $0.02
*** HOLE CARDS ***
Dealt to Scaaalll [Kh 5d]
Feliciano16: folds 
Chapaev136: folds 
Scaaalll: folds 
osantos401: folds 
orlovac1995: folds 
Uncalled bet ($0.01) returned to estelionat171
estelionat171 collected $0.02 from pot
estelionat171: doesn't show hand 
*** SUMMARY ***
Total pot $0.02 | Rake $0 
Seat 1: osantos401 (button) folded before Flop (didn't bet)
Seat 2: orlovac1995 (small blind) folded before Flop
Seat 3: estelionat171 (big blind) collected ($0.02)
Seat 4: Feliciano16 folded before Flop (didn't bet)
Seat 5: Chapaev136 folded before Flop (didn't bet)
Seat 6: Scaaalll folded before Flop (didn't bet)



PokerStars Zoom Hand #229233753964:  Hold'em No Limit ($0.01/$0.02) - 2021/08/21 23:42:37 CET [2021/08/21 17:42:37 ET]
Table 'Halley' 6-max Seat #1 is the button
Seat 1: Gamer577 ($2.04 in chips) 
Seat 2: egroj1700 ($2.02 in chips) 
Seat 3: kahzura ($2.21 in chips) 
Seat 4: nikos803 ($3.70 in chips) 
Seat 5: Scaaalll ($4.08 in chips) 
Seat 6: baksu12 ($3.84 in chips) 
egroj1700: posts small blind $0.01
kahzura: posts big blind $0.02
*** HOLE CARDS ***
Dealt to Scaaalll [Th Ts]
nikos803: folds 
Scaaalll: raises $0.04 to $0.06
baksu12: folds 
Gamer577: folds 
egroj1700: folds 
kahzura: folds 
Uncalled bet ($0.04) returned to Scaaalll
Scaaalll collected $0.05 from pot
Scaaalll: doesn't show hand 
*** SUMMARY ***
Total pot $0.05 | Rake $0 
Seat 1: Gamer577 (button) folded before Flop (didn't bet)
Seat 2: egroj1700 (small blind) folded before Flop
Seat 3: kahzura (big blind) folded before Flop
Seat 4: nikos803 folded before Flop (didn't bet)
Seat 5: Scaaalll collected ($0.05)
Seat 6: baksu12 folded before Flop (didn't bet)



PokerStars Zoom Hand #229233731688:  Hold'em No Limit ($0.01/$0.02) - 2021/08/21 23:41:42 CET [2021/08/21 17:41:42 ET]
Table 'Halley' 6-max Seat #1 is the button
Seat 1: lucky1529 ($0.92 in chips) 
Seat 2: JTbukowski ($2.85 in chips) 
Seat 3: Naraterre1 ($0.20 in chips) 
Seat 4: Fabi151312 ($3.07 in chips) 
Seat 5: Scaaalll ($4.08 in chips) 
Seat 6: gasmar_29 ($2.02 in chips) 
JTbukowski: posts small blind $0.01
Naraterre1: posts big blind $0.02
*** HOLE CARDS ***
Dealt to Scaaalll [6c 7c]
Naraterre1 is disconnected 
Fabi151312: calls $0.02
Scaaalll: folds 
gasmar_29: folds 
lucky1529: folds 
JTbukowski: folds 
Naraterre1 has timed out while disconnected
Naraterre1: checks 
*** FLOP *** [4d Qd Kc]
Naraterre1 has timed out while disconnected
Naraterre1: checks 
Fabi151312: bets $0.18
Naraterre1 has timed out while disconnected
Naraterre1: folds 
Uncalled bet ($0.18) returned to Fabi151312
Fabi151312 collected $0.05 from pot
Fabi151312: doesn't show hand 
*** SUMMARY ***
Total pot $0.05 | Rake $0 
Board [4d Qd Kc]
Seat 1: lucky1529 (button) folded before Flop (didn't bet)
Seat 2: JTbukowski (small blind) folded before Flop
Seat 3: Naraterre1 (big blind) folded on the Flop
Seat 4: Fabi151312 collected ($0.05)
Seat 5: Scaaalll folded before Flop (didn't bet)
Seat 6: gasmar_29 folded before Flop (didn't bet)



PokerStars Zoom Hand #229233765714:  Hold'em No Limit ($0.01/$0.02) - 2021/08/21 23:43:06 CET [2021/08/21 17:43:06 ET]
Table 'Halley' 6-max Seat #1 is the button
Seat 1: lucky1529 ($0.69 in chips) 
Seat 2: MKIronCrAAzy ($6.37 in chips) 
Seat 3: ulisessoria ($4.06 in chips) 
Seat 4: Scaaalll ($4.11 in chips) 
Seat 5: BlackhawKK's ($2 in chips) 
Seat 6: Feliciano16 ($3.27 in chips) 
MKIronCrAAzy: posts small blind $0.01
ulisessoria: posts big blind $0.02
*** HOLE CARDS ***
Dealt to Scaaalll [3d Qd]
Scaaalll: folds 
BlackhawKK's: folds 
Feliciano16: folds 
lucky1529: folds 
MKIronCrAAzy: raises $0.04 to $0.06
ulisessoria: folds 
Uncalled bet ($0.04) returned to MKIronCrAAzy
MKIronCrAAzy collected $0.04 from pot
MKIronCrAAzy: doesn't show hand 
*** SUMMARY ***
Total pot $0.04 | Rake $0 
Seat 1: lucky1529 (button) folded before Flop (didn't bet)
Seat 2: MKIronCrAAzy (small blind) collected ($0.04)
Seat 3: ulisessoria (big blind) folded before Flop
Seat 4: Scaaalll folded before Flop (didn't bet)
Seat 5: BlackhawKK's folded before Flop (didn't bet)
Seat 6: Feliciano16 folded before Flop (didn't bet)



PokerStars Zoom Hand #229233764111:  Hold'em No Limit ($0.01/$0.02) - 2021/08/21 23:43:02 CET [2021/08/21 17:43:02 ET]
Table 'Halley' 6-max Seat #1 is the button
Seat 1: vovan100157 ($5.25 in chips) 
Seat 2: 1nTeresT ($2 in chips) 
Seat 3: lalon22 ($2.04 in chips) 
Seat 4: Scaaalll ($4.11 in chips) 
Seat 5: estelionat171 ($0.95 in chips) 
Seat 6: becolea ($1.01 in chips) 
1nTeresT: posts small blind $0.01
lalon22: posts big blind $0.02
*** HOLE CARDS ***
Dealt to Scaaalll [5d 8s]
Scaaalll: folds 
estelionat171: folds 
becolea: raises $0.05 to $0.07
vovan100157: calls $0.07
1nTeresT: folds 
lalon22: folds 
*** FLOP *** [Jd As 9s]
becolea: checks 
vovan100157: checks 
*** TURN *** [Jd As 9s] [9h]
becolea: bets $0.08
vovan100157: calls $0.08
*** RIVER *** [Jd As 9s 9h] [2c]
becolea: bets $0.16
vovan100157: folds 
Uncalled bet ($0.16) returned to becolea
becolea collected $0.32 from pot
becolea: doesn't show hand 
*** SUMMARY ***
Total pot $0.33 | Rake $0.01 
Board [Jd As 9s 9h 2c]
Seat 1: vovan100157 (button) folded on the River
Seat 2: 1nTeresT (small blind) folded before Flop
Seat 3: lalon22 (big blind) folded before Flop
Seat 4: Scaaalll folded before Flop (didn't bet)
Seat 5: estelionat171 folded before Flop (didn't bet)
Seat 6: becolea collected ($0.32)



PokerStars Zoom Hand #229233767337:  Hold'em No Limit ($0.01/$0.02) - 2021/08/21 23:43:10 CET [2021/08/21 17:43:10 ET]
Table 'Halley' 6-max Seat #1 is the button
Seat 1: S3XY_PADRE ($5.69 in chips) 
Seat 2: Scaaalll ($4.11 in chips) 
Seat 3: Feliciano16 ($7.02 in chips) 
Seat 4: Koldun 2636 ($4.59 in chips) 
Seat 5: zzooll 9 ($3.19 in chips) 
Seat 6: LeoZ77755 ($2.37 in chips) 
Scaaalll: posts small blind $0.01
Feliciano16: posts big blind $0.02
*** HOLE CARDS ***
Dealt to Scaaalll [2h 2d]
LeoZ77755 is disconnected 
Koldun 2636: folds 
zzooll 9: calls $0.02
LeoZ77755: folds 
S3XY_PADRE: folds 
Scaaalll: calls $0.01
Feliciano16: checks 
*** FLOP *** [7d 6d Kh]
Scaaalll: checks 
Feliciano16: checks 
zzooll 9: checks 
*** TURN *** [7d 6d Kh] [Jc]
Scaaalll: checks 
Feliciano16: bets $0.04
zzooll 9: calls $0.04
Scaaalll: folds 
*** RIVER *** [7d 6d Kh Jc] [8c]
Feliciano16: checks 
zzooll 9: bets $0.14
Feliciano16: folds 
Uncalled bet ($0.14) returned to zzooll 9
zzooll 9 collected $0.14 from pot
zzooll 9: doesn't show hand 
*** SUMMARY ***
Total pot $0.14 | Rake $0 
Board [7d 6d Kh Jc 8c]
Seat 1: S3XY_PADRE (button) folded before Flop (didn't bet)
Seat 2: Scaaalll (small blind) folded on the Turn
Seat 3: Feliciano16 (big blind) folded on the River
Seat 4: Koldun 2636 folded before Flop (didn't bet)
Seat 5: zzooll 9 collected ($0.14)
Seat 6: LeoZ77755 folded before Flop (didn't bet)



PokerStars Zoom Hand #229233783332:  Hold'em No Limit ($0.01/$0.02) - 2021/08/21 23:43:50 CET [2021/08/21 17:43:50 ET]
Table 'Halley' 6-max Seat #1 is the button
Seat 1: Scaaalll ($4.09 in chips) 
Seat 2: kidninja888 ($2.18 in chips) 
Seat 3: Chapaev136 ($2.32 in chips) 
Seat 4: hustlehero ($2.44 in chips) 
Seat 5: WITKOW_AV ($2.27 in chips) 
Seat 6: spirosz1000 ($1.94 in chips) 
kidninja888: posts small blind $0.01
Chapaev136: posts big blind $0.02
*** HOLE CARDS ***
Dealt to Scaaalll [Jd Ad]
hustlehero: raises $0.04 to $0.06
WITKOW_AV: folds 
spirosz1000: folds 
Scaaalll: calls $0.06
kidninja888: folds 
Chapaev136: folds 
*** FLOP *** [Kd Kh 5h]
hustlehero: bets $0.08
Scaaalll: folds 
Uncalled bet ($0.08) returned to hustlehero
hustlehero collected $0.14 from pot
hustlehero: doesn't show hand 
*** SUMMARY ***
Total pot $0.15 | Rake $0.01 
Board [Kd Kh 5h]
Seat 1: Scaaalll (button) folded on the Flop
Seat 2: kidninja888 (small blind) folded before Flop
Seat 3: Chapaev136 (big blind) folded before Flop
Seat 4: hustlehero collected ($0.14)
Seat 5: WITKOW_AV folded before Flop (didn't bet)
Seat 6: spirosz1000 folded before Flop (didn't bet)



PokerStars Zoom Hand #229233791749:  Hold'em No Limit ($0.01/$0.02) - 2021/08/21 23:44:11 CET [2021/08/21 17:44:11 ET]
Table 'Halley' 6-max Seat #1 is the button
Seat 1: owtwilldo ($2.18 in chips) 
Seat 2: rekopo203 ($8.55 in chips) 
Seat 3: Scaaalll ($4.03 in chips) 
Seat 4: Bina_sweety ($2.48 in chips) 
Seat 5: castrosis ($3.65 in chips) 
Seat 6: EdwardF95 ($2 in chips) 
rekopo203: posts small blind $0.01
Scaaalll: posts big blind $0.02
*** HOLE CARDS ***
Dealt to Scaaalll [7h 2s]
Bina_sweety: folds 
castrosis: folds 
EdwardF95: folds 
owtwilldo: folds 
rekopo203: folds 
Uncalled bet ($0.01) returned to Scaaalll
Scaaalll collected $0.02 from pot
Scaaalll: doesn't show hand 
*** SUMMARY ***
Total pot $0.02 | Rake $0 
Seat 1: owtwilldo (button) folded before Flop (didn't bet)
Seat 2: rekopo203 (small blind) folded before Flop
Seat 3: Scaaalll (big blind) collected ($0.02)
Seat 4: Bina_sweety folded before Flop (didn't bet)
Seat 5: castrosis folded before Flop (didn't bet)
Seat 6: EdwardF95 folded before Flop (didn't bet)



PokerStars Zoom Hand #229233795427:  Hold'em No Limit ($0.01/$0.02) - 2021/08/21 23:44:20 CET [2021/08/21 17:44:20 ET]
Table 'Halley' 6-max Seat #1 is the button
Seat 1: BautiMang ($2.10 in chips) 
Seat 2: danteesq ($2.28 in chips) 
Seat 3: Iv3rson18 ($2.02 in chips) 
Seat 4: Scaaalll ($4.04 in chips) 
Seat 5: NFPrates ($1.10 in chips) 
Seat 6: AlienMdeo ($2.80 in chips) 
danteesq: posts small blind $0.01
Iv3rson18: posts big blind $0.02
*** HOLE CARDS ***
Dealt to Scaaalll [As Kc]
Scaaalll: raises $0.04 to $0.06
NFPrates: folds 
AlienMdeo: folds 
BautiMang: folds 
danteesq: folds 
Iv3rson18: folds 
Uncalled bet ($0.04) returned to Scaaalll
Scaaalll collected $0.05 from pot
Scaaalll: doesn't show hand 
*** SUMMARY ***
Total pot $0.05 | Rake $0 
Seat 1: BautiMang (button) folded before Flop (didn't bet)
Seat 2: danteesq (small blind) folded before Flop
Seat 3: Iv3rson18 (big blind) folded before Flop
Seat 4: Scaaalll collected ($0.05)
Seat 5: NFPrates folded before Flop (didn't bet)
Seat 6: AlienMdeo folded before Flop (didn't bet)



PokerStars Zoom Hand #229233803109:  Hold'em No Limit ($0.01/$0.02) - 2021/08/21 23:44:39 CET [2021/08/21 17:44:39 ET]
Table 'Halley' 6-max Seat #1 is the button
Seat 1: NoEff0rt2w1n ($3.59 in chips) 
Seat 2: spirosz1000 ($2.12 in chips) 
Seat 3: solosigueme ($4.95 in chips) 
Seat 4: thfc12325 ($1.24 in chips) 
Seat 5: Merlin_Arg ($4.17 in chips) 
Seat 6: Scaaalll ($4.07 in chips) 
spirosz1000: posts small blind $0.01
solosigueme: posts big blind $0.02
*** HOLE CARDS ***
Dealt to Scaaalll [2h 9s]
thfc12325: folds 
thfc12325 is disconnected 
Merlin_Arg: folds 
Scaaalll: folds 
NoEff0rt2w1n: folds 
spirosz1000: folds 
Uncalled bet ($0.01) returned to solosigueme
solosigueme collected $0.02 from pot
solosigueme: doesn't show hand 
*** SUMMARY ***
Total pot $0.02 | Rake $0 
Seat 1: NoEff0rt2w1n (button) folded before Flop (didn't bet)
Seat 2: spirosz1000 (small blind) folded before Flop
Seat 3: solosigueme (big blind) collected ($0.02)
Seat 4: thfc12325 folded before Flop (didn't bet)
Seat 5: Merlin_Arg folded before Flop (didn't bet)
Seat 6: Scaaalll folded before Flop (didn't bet)



PokerStars Zoom Hand #229233805131:  Hold'em No Limit ($0.01/$0.02) - 2021/08/21 23:44:44 CET [2021/08/21 17:44:44 ET]
Table 'Halley' 6-max Seat #1 is the button
Seat 1: qqqqqqqqq966 ($2.14 in chips) 
Seat 2: pavel play pay ($7.93 in chips) 
Seat 3: 3@RAZZA.BLR ($1.61 in chips) 
Seat 4: Hallyson_23 ($3.27 in chips) 
Seat 5: Scaaalll ($4.07 in chips) 
Seat 6: Pizotifen ($2.07 in chips) 
pavel play pay: posts small blind $0.01
3@RAZZA.BLR: posts big blind $0.02
*** HOLE CARDS ***
Dealt to Scaaalll [4c 9s]
pavel play pay is disconnected 
Hallyson_23: folds 
qqqqqqqqq966 is disconnected 
Scaaalll: folds 
Pizotifen: folds 
qqqqqqqqq966: folds 
pavel play pay: folds 
Uncalled bet ($0.01) returned to 3@RAZZA.BLR
3@RAZZA.BLR collected $0.02 from pot
3@RAZZA.BLR: doesn't show hand 
*** SUMMARY ***
Total pot $0.02 | Rake $0 
Seat 1: qqqqqqqqq966 (button) folded before Flop (didn't bet)
Seat 2: pavel play pay (small blind) folded before Flop
Seat 3: 3@RAZZA.BLR (big blind) collected ($0.02)
Seat 4: Hallyson_23 folded before Flop (didn't bet)
Seat 5: Scaaalll folded before Flop (didn't bet)
Seat 6: Pizotifen folded before Flop (didn't bet)



PokerStars Zoom Hand #229233809542:  Hold'em No Limit ($0.01/$0.02) - 2021/08/21 23:44:55 CET [2021/08/21 17:44:55 ET]
Table 'Halley' 6-max Seat #1 is the button
Seat 1: Spinatstrudel ($2 in chips) 
Seat 2: didiclavi777 ($2.86 in chips) 
Seat 3: Scaaalll ($4.07 in chips) 
Seat 4: El Chicha.CL ($2.07 in chips) 
Seat 5: gasmar_29 ($2.26 in chips) 
Seat 6: JacekSoplica ($2.19 in chips) 
didiclavi777: posts small blind $0.01
Scaaalll: posts big blind $0.02
*** HOLE CARDS ***
Dealt to Scaaalll [5h 2s]
El Chicha.CL: folds 
JacekSoplica is disconnected 
gasmar_29: folds 
JacekSoplica: folds 
Spinatstrudel: folds 
didiclavi777: raises $0.04 to $0.06
Scaaalll: folds 
Uncalled bet ($0.04) returned to didiclavi777
didiclavi777 collected $0.04 from pot
didiclavi777: doesn't show hand 
*** SUMMARY ***
Total pot $0.04 | Rake $0 
Seat 1: Spinatstrudel (button) folded before Flop (didn't bet)
Seat 2: didiclavi777 (small blind) collected ($0.04)
Seat 3: Scaaalll (big blind) folded before Flop
Seat 4: El Chicha.CL folded before Flop (didn't bet)
Seat 5: gasmar_29 folded before Flop (didn't bet)
Seat 6: JacekSoplica folded before Flop (didn't bet)



PokerStars Zoom Hand #229233831919:  Hold'em No Limit ($0.01/$0.02) - 2021/08/21 23:45:51 CET [2021/08/21 17:45:51 ET]
Table 'Halley' 6-max Seat #1 is the button
Seat 1: Gamer577 ($4.98 in chips) 
Seat 2: Dabovic ($2.13 in chips) 
Seat 3: tarogame ($2.08 in chips) 
Seat 4: kidninja888 ($2.20 in chips) 
Seat 5: Reipinguimm ($3.47 in chips) 
Seat 6: Scaaalll ($4.04 in chips) 
Dabovic: posts small blind $0.01
tarogame: posts big blind $0.02
*** HOLE CARDS ***
Dealt to Scaaalll [9s Qs]
kidninja888: folds 
Dabovic is disconnected 
Reipinguimm: folds 
Scaaalll: raises $0.04 to $0.06
Gamer577: folds 
Dabovic: folds 
tarogame: folds 
Uncalled bet ($0.04) returned to Scaaalll
Scaaalll collected $0.05 from pot
Scaaalll: doesn't show hand 
*** SUMMARY ***
Total pot $0.05 | Rake $0 
Seat 1: Gamer577 (button) folded before Flop (didn't bet)
Seat 2: Dabovic (small blind) folded before Flop
Seat 3: tarogame (big blind) folded before Flop
Seat 4: kidninja888 folded before Flop (didn't bet)
Seat 5: Reipinguimm folded before Flop (didn't bet)
Seat 6: Scaaalll collected ($0.05)



PokerStars Zoom Hand #229233820420:  Hold'em No Limit ($0.01/$0.02) - 2021/08/21 23:45:22 CET [2021/08/21 17:45:22 ET]
Table 'Halley' 6-max Seat #1 is the button
Seat 1: Agneobr ($1 in chips) 
Seat 2: Scaaalll ($4.05 in chips) 
Seat 3: morpheus206 ($1.62 in chips) 
Seat 4: Reipinguimm ($2.51 in chips) 
Seat 5: BlackhawKK's ($2.03 in chips) 
Seat 6: rodrigoasor ($5.79 in chips) 
Scaaalll: posts small blind $0.01
morpheus206: posts big blind $0.02
*** HOLE CARDS ***
Dealt to Scaaalll [8s Th]
Reipinguimm: folds 
BlackhawKK's: folds 
rodrigoasor: raises $0.04 to $0.06
Agneobr: calls $0.06
Scaaalll: folds 
morpheus206: calls $0.04
*** FLOP *** [3d Jd Qs]
morpheus206: checks 
rodrigoasor: checks 
Agneobr: checks 
*** TURN *** [3d Jd Qs] [7s]
morpheus206: checks 
rodrigoasor: checks 
Agneobr: bets $0.05
morpheus206: calls $0.05
rodrigoasor: folds 
*** RIVER *** [3d Jd Qs 7s] [7h]
morpheus206: checks 
Agneobr: checks 
*** SHOW DOWN ***
morpheus206: shows [5c 6c] (a pair of Sevens)
Agneobr: shows [Ks 3s] (two pair, Sevens and Threes)
Agneobr collected $0.28 from pot
*** SUMMARY ***
Total pot $0.29 | Rake $0.01 
Board [3d Jd Qs 7s 7h]
Seat 1: Agneobr (button) showed [Ks 3s] and won ($0.28) with two pair, Sevens and Threes
Seat 2: Scaaalll (small blind) folded before Flop
Seat 3: morpheus206 (big blind) showed [5c 6c] and lost with a pair of Sevens
Seat 4: Reipinguimm folded before Flop (didn't bet)
Seat 5: BlackhawKK's folded before Flop (didn't bet)
Seat 6: rodrigoasor folded on the Turn



PokerStars Zoom Hand #229233827553:  Hold'em No Limit ($0.01/$0.02) - 2021/08/21 23:45:40 CET [2021/08/21 17:45:40 ET]
Table 'Halley' 6-max Seat #1 is the button
Seat 1: Scaaalll ($4.04 in chips) 
Seat 2: ciucibaby ($2.02 in chips) 
Seat 3: Bachkasa ($1.18 in chips) 
Seat 4: nbarreiro021 ($2.09 in chips) 
Seat 5: ash1448 ($7.33 in chips) 
Seat 6: Hiury5 ($1.97 in chips) 
ciucibaby: posts small blind $0.01
Bachkasa: posts big blind $0.02
*** HOLE CARDS ***
Dealt to Scaaalll [Jd 4h]
nbarreiro021: folds 
ash1448: folds 
Hiury5: folds 
Scaaalll: folds 
ciucibaby: raises $0.05 to $0.07
Bachkasa: calls $0.05
*** FLOP *** [Qh Ad As]
ciucibaby: bets $0.05
Bachkasa: calls $0.05
*** TURN *** [Qh Ad As] [3c]
ciucibaby: bets $0.14
Bachkasa: calls $0.14
*** RIVER *** [Qh Ad As 3c] [5c]
ciucibaby: bets $1.76 and is all-in
Bachkasa: folds 
Uncalled bet ($1.76) returned to ciucibaby
ciucibaby collected $0.50 from pot
ciucibaby: doesn't show hand 
Bachkasa is disconnected 
*** SUMMARY ***
Total pot $0.52 | Rake $0.02 
Board [Qh Ad As 3c 5c]
Seat 1: Scaaalll (button) folded before Flop (didn't bet)
Seat 2: ciucibaby (small blind) collected ($0.50)
Seat 3: Bachkasa (big blind) folded on the River
Seat 4: nbarreiro021 folded before Flop (didn't bet)
Seat 5: ash1448 folded before Flop (didn't bet)
Seat 6: Hiury5 folded before Flop (didn't bet)



PokerStars Zoom Hand #229233837917:  Hold'em No Limit ($0.01/$0.02) - 2021/08/21 23:46:06 CET [2021/08/21 17:46:06 ET]
Table 'Halley' 6-max Seat #1 is the button
Seat 1: Scaaalll ($4.07 in chips) 
Seat 2: 1nTeresT ($2.10 in chips) 
Seat 3: KissingTheSun ($2.49 in chips) 
Seat 4: kukulagosleep ($6.13 in chips) 
Seat 5: keldh ($7.34 in chips) 
Seat 6: jaamonra ($2.39 in chips) 
1nTeresT: posts small blind $0.01
KissingTheSun: posts big blind $0.02
*** HOLE CARDS ***
Dealt to Scaaalll [4d 4c]
kukulagosleep: folds 
keldh: folds 
jaamonra: folds 
Scaaalll: raises $0.02 to $0.04
1nTeresT: raises $0.16 to $0.20
KissingTheSun: folds 
Scaaalll: folds 
Uncalled bet ($0.16) returned to 1nTeresT
1nTeresT collected $0.10 from pot
1nTeresT: doesn't show hand 
*** SUMMARY ***
Total pot $0.10 | Rake $0 
Seat 1: Scaaalll (button) folded before Flop
Seat 2: 1nTeresT (small blind) collected ($0.10)
Seat 3: KissingTheSun (big blind) folded before Flop
Seat 4: kukulagosleep folded before Flop (didn't bet)
Seat 5: keldh folded before Flop (didn't bet)
Seat 6: jaamonra folded before Flop (didn't bet)



PokerStars Zoom Hand #229233844793:  Hold'em No Limit ($0.01/$0.02) - 2021/08/21 23:46:23 CET [2021/08/21 17:46:23 ET]
Table 'Halley' 6-max Seat #1 is the button
Seat 1: didiclavi777 ($2.66 in chips) 
Seat 2: rancing87 ($2.32 in chips) 
Seat 3: padik35 ($1.95 in chips) 
Seat 4: Tabitaji ($6.76 in chips) 
Seat 5: Scaaalll ($4.03 in chips) 
Seat 6: kukulagosleep ($4.17 in chips) 
rancing87: posts small blind $0.01
padik35: posts big blind $0.02
*** HOLE CARDS ***
Dealt to Scaaalll [Ad 5c]
Tabitaji: raises $0.04 to $0.06
Scaaalll: folds 
kukulagosleep: folds 
didiclavi777: folds 
rancing87: folds 
padik35: folds 
Uncalled bet ($0.04) returned to Tabitaji
Tabitaji collected $0.05 from pot
Tabitaji: doesn't show hand 
padik35 is disconnected 
*** SUMMARY ***
Total pot $0.05 | Rake $0 
Seat 1: didiclavi777 (button) folded before Flop (didn't bet)
Seat 2: rancing87 (small blind) folded before Flop
Seat 3: padik35 (big blind) folded before Flop
Seat 4: Tabitaji collected ($0.05)
Seat 5: Scaaalll folded before Flop (didn't bet)
Seat 6: kukulagosleep folded before Flop (didn't bet)



PokerStars Zoom Hand #229233848678:  Hold'em No Limit ($0.01/$0.02) - 2021/08/21 23:46:33 CET [2021/08/21 17:46:33 ET]
Table 'Halley' 6-max Seat #1 is the button
Seat 1: kingdieter1 ($1.75 in chips) 
Seat 2: kahzura ($2.14 in chips) 
Seat 3: vovan100157 ($2.01 in chips) 
Seat 4: Scaaalll ($4.03 in chips) 
Seat 5: GambleNinjaEX ($5.44 in chips) 
Seat 6: bmnev ($1.89 in chips) 
kahzura: posts small blind $0.01
vovan100157: posts big blind $0.02
*** HOLE CARDS ***
Dealt to Scaaalll [5d 6c]
kingdieter1 is disconnected 
Scaaalll: folds 
bmnev is disconnected 
GambleNinjaEX: raises $0.03 to $0.05
bmnev: folds 
kingdieter1: folds 
kahzura: raises $0.15 to $0.20
vovan100157: folds 
GambleNinjaEX: folds 
Uncalled bet ($0.15) returned to kahzura
kahzura collected $0.12 from pot
kahzura: doesn't show hand 
*** SUMMARY ***
Total pot $0.12 | Rake $0 
Seat 1: kingdieter1 (button) folded before Flop (didn't bet)
Seat 2: kahzura (small blind) collected ($0.12)
Seat 3: vovan100157 (big blind) folded before Flop
Seat 4: Scaaalll folded before Flop (didn't bet)
Seat 5: GambleNinjaEX folded before Flop
Seat 6: bmnev folded before Flop (didn't bet)



PokerStars Zoom Hand #229233851411:  Hold'em No Limit ($0.01/$0.02) - 2021/08/21 23:46:40 CET [2021/08/21 17:46:40 ET]
Table 'Halley' 6-max Seat #1 is the button
Seat 1: bmnev ($1.89 in chips) 
Seat 2: CowboyNicky ($1.98 in chips) 
Seat 3: bt710 ($5.60 in chips) 
Seat 4: El Chicha.CL ($2.63 in chips) 
Seat 5: 1nTeresT ($2.16 in chips) 
Seat 6: Scaaalll ($4.03 in chips) 
CowboyNicky: posts small blind $0.01
bt710: posts big blind $0.02
*** HOLE CARDS ***
Dealt to Scaaalll [9c Kc]
El Chicha.CL: raises $0.04 to $0.06
CowboyNicky is disconnected 
bmnev is disconnected 
1nTeresT: folds 
Scaaalll: folds 
bmnev: folds 
CowboyNicky: folds 
bt710: folds 
Uncalled bet ($0.04) returned to El Chicha.CL
El Chicha.CL collected $0.05 from pot
El Chicha.CL: doesn't show hand 
*** SUMMARY ***
Total pot $0.05 | Rake $0 
Seat 1: bmnev (button) folded before Flop (didn't bet)
Seat 2: CowboyNicky (small blind) folded before Flop
Seat 3: bt710 (big blind) folded before Flop
Seat 4: El Chicha.CL collected ($0.05)
Seat 5: 1nTeresT folded before Flop (didn't bet)
Seat 6: Scaaalll folded before Flop (didn't bet)



PokerStars Zoom Hand #229233860920:  Hold'em No Limit ($0.01/$0.02) - 2021/08/21 23:47:04 CET [2021/08/21 17:47:04 ET]
Table 'Halley' 6-max Seat #1 is the button
Seat 1: KonopDima ($2 in chips) 
Seat 2: Gamer577 ($4.95 in chips) 
Seat 3: Scaaalll ($4.03 in chips) 
Seat 4: maressen ($5.44 in chips) 
Seat 5: lucksuckdonk ($9.14 in chips) 
Seat 6: Mikeloko182 ($3.61 in chips) 
Gamer577: posts small blind $0.01
Scaaalll: posts big blind $0.02
*** HOLE CARDS ***
Dealt to Scaaalll [2d 8s]
maressen: folds 
lucksuckdonk: raises $0.04 to $0.06
Mikeloko182: folds 
KonopDima: folds 
Gamer577: folds 
Scaaalll: folds 
Uncalled bet ($0.04) returned to lucksuckdonk
lucksuckdonk collected $0.05 from pot
lucksuckdonk: doesn't show hand 
*** SUMMARY ***
Total pot $0.05 | Rake $0 
Seat 1: KonopDima (button) folded before Flop (didn't bet)
Seat 2: Gamer577 (small blind) folded before Flop
Seat 3: Scaaalll (big blind) folded before Flop
Seat 4: maressen folded before Flop (didn't bet)
Seat 5: lucksuckdonk collected ($0.05)
Seat 6: Mikeloko182 folded before Flop (didn't bet)



PokerStars Zoom Hand #229233866014:  Hold'em No Limit ($0.01/$0.02) - 2021/08/21 23:47:17 CET [2021/08/21 17:47:17 ET]
Table 'Halley' 6-max Seat #1 is the button
Seat 1: H0mmer99 ($3.73 in chips) 
Seat 2: Scaaalll ($4.01 in chips) 
Seat 3: xoen ($2 in chips) 
Seat 4: ZermeloFraenkel ($2.12 in chips) 
Seat 5: Zamin Khan ($2.18 in chips) 
Seat 6: Nihility77 ($3.95 in chips) 
Scaaalll: posts small blind $0.01
xoen: posts big blind $0.02
*** HOLE CARDS ***
Dealt to Scaaalll [9h 6d]
ZermeloFraenkel: folds 
Zamin Khan: folds 
Zamin Khan is disconnected 
Nihility77: raises $0.03 to $0.05
H0mmer99: folds 
Scaaalll: folds 
xoen: folds 
Uncalled bet ($0.03) returned to Nihility77
Nihility77 collected $0.05 from pot
Nihility77: doesn't show hand 
*** SUMMARY ***
Total pot $0.05 | Rake $0 
Seat 1: H0mmer99 (button) folded before Flop (didn't bet)
Seat 2: Scaaalll (small blind) folded before Flop
Seat 3: xoen (big blind) folded before Flop
Seat 4: ZermeloFraenkel folded before Flop (didn't bet)
Seat 5: Zamin Khan folded before Flop (didn't bet)
Seat 6: Nihility77 collected ($0.05)



PokerStars Zoom Hand #229233868771:  Hold'em No Limit ($0.01/$0.02) - 2021/08/21 23:47:24 CET [2021/08/21 17:47:24 ET]
Table 'Halley' 6-max Seat #1 is the button
Seat 1: unior321 ($0.94 in chips) 
Seat 2: HubertFroh ($3.62 in chips) 
Seat 3: ussr246 ($2.55 in chips) 
Seat 4: tarogame ($3.54 in chips) 
Seat 5: Scaaalll ($4 in chips) 
Seat 6: BossTH4 ($4.05 in chips) 
HubertFroh: posts small blind $0.01
ussr246: posts big blind $0.02
*** HOLE CARDS ***
Dealt to Scaaalll [Th Jh]
unior321 is disconnected 
tarogame: folds 
Scaaalll: raises $0.04 to $0.06
BossTH4: calls $0.06
unior321: folds 
HubertFroh: folds 
ussr246: folds 
*** FLOP *** [4h Qh Qd]
Scaaalll: bets $0.08
BossTH4: raises $0.43 to $0.51
Scaaalll: folds 
Uncalled bet ($0.43) returned to BossTH4
BossTH4 collected $0.30 from pot
BossTH4: doesn't show hand 
*** SUMMARY ***
Total pot $0.31 | Rake $0.01 
Board [4h Qh Qd]
Seat 1: unior321 (button) folded before Flop (didn't bet)
Seat 2: HubertFroh (small blind) folded before Flop
Seat 3: ussr246 (big blind) folded before Flop
Seat 4: tarogame folded before Flop (didn't bet)
Seat 5: Scaaalll folded on the Flop
Seat 6: BossTH4 collected ($0.30)



PokerStars Zoom Hand #229233877513:  Hold'em No Limit ($0.01/$0.02) - 2021/08/21 23:47:46 CET [2021/08/21 17:47:46 ET]
Table 'Halley' 6-max Seat #1 is the button
Seat 1: YgovAndrey ($1.86 in chips) 
Seat 2: Scaaalll ($3.86 in chips) 
Seat 3: Merlin_Arg ($3.84 in chips) 
Seat 4: Luisit0_aqp ($0.60 in chips) 
Seat 5: fabor1303 ($5.64 in chips) 
Seat 6: 3rian cARc ($2.14 in chips) 
Scaaalll: posts small blind $0.01
Merlin_Arg: posts big blind $0.02
*** HOLE CARDS ***
Dealt to Scaaalll [Qh 7h]
Luisit0_aqp: folds 
fabor1303: folds 
3rian cARc: raises $0.03 to $0.05
YgovAndrey: calls $0.05
Scaaalll: folds 
Merlin_Arg: folds 
*** FLOP *** [Th Jd Qs]
3rian cARc: bets $0.04
YgovAndrey: calls $0.04
*** TURN *** [Th Jd Qs] [9h]
3rian cARc: bets $0.15
YgovAndrey: folds 
Uncalled bet ($0.15) returned to 3rian cARc
3rian cARc collected $0.20 from pot
3rian cARc: doesn't show hand 
*** SUMMARY ***
Total pot $0.21 | Rake $0.01 
Board [Th Jd Qs 9h]
Seat 1: YgovAndrey (button) folded on the Turn
Seat 2: Scaaalll (small blind) folded before Flop
Seat 3: Merlin_Arg (big blind) folded before Flop
Seat 4: Luisit0_aqp folded before Flop (didn't bet)
Seat 5: fabor1303 folded before Flop (didn't bet)
Seat 6: 3rian cARc collected ($0.20)



PokerStars Zoom Hand #229233882637:  Hold'em No Limit ($0.01/$0.02) - 2021/08/21 23:47:59 CET [2021/08/21 17:47:59 ET]
Table 'Halley' 6-max Seat #1 is the button
Seat 1: BogoJIa3_77 ($2.04 in chips) 
Seat 2: Dr.stromg ($3.21 in chips) 
Seat 3: Scaaalll ($3.85 in chips) 
Seat 4: fabor1303 ($10.42 in chips) 
Seat 5: Sadikson ($1.97 in chips) 
Seat 6: Doktor Yes ($2.12 in chips) 
Dr.stromg: posts small blind $0.01
Scaaalll: posts big blind $0.02
*** HOLE CARDS ***
Dealt to Scaaalll [8c Jd]
fabor1303: folds 
Sadikson: raises $0.04 to $0.06
Doktor Yes: folds 
BogoJIa3_77: raises $0.14 to $0.20
Dr.stromg: folds 
Scaaalll: folds 
Sadikson: raises $0.32 to $0.52
BogoJIa3_77: calls $0.32
*** FLOP *** [6h 8d Js]
Sadikson: checks 
BogoJIa3_77: checks 
*** TURN *** [6h 8d Js] [5s]
Sadikson: bets $1.45 and is all-in
BogoJIa3_77: folds 
Uncalled bet ($1.45) returned to Sadikson
Sadikson collected $1.03 from pot
Sadikson: doesn't show hand 
*** SUMMARY ***
Total pot $1.07 | Rake $0.04 
Board [6h 8d Js 5s]
Seat 1: BogoJIa3_77 (button) folded on the Turn
Seat 2: Dr.stromg (small blind) folded before Flop
Seat 3: Scaaalll (big blind) folded before Flop
Seat 4: fabor1303 folded before Flop (didn't bet)
Seat 5: Sadikson collected ($1.03)
Seat 6: Doktor Yes folded before Flop (didn't bet)



PokerStars Zoom Hand #229233885335:  Hold'em No Limit ($0.01/$0.02) - 2021/08/21 23:48:06 CET [2021/08/21 17:48:06 ET]
Table 'Halley' 6-max Seat #1 is the button
Seat 1: Scaaalll ($3.83 in chips) 
Seat 2: 0Jarek ($1.22 in chips) 
Seat 3: gabgordula ($2.23 in chips) 
Seat 4: ronald1982 ($1.93 in chips) 
Seat 5: gilberto98 ($4.17 in chips) 
Seat 6: Hiury5 ($3.14 in chips) 
0Jarek: posts small blind $0.01
gabgordula: posts big blind $0.02
*** HOLE CARDS ***
Dealt to Scaaalll [8d 8c]
ronald1982: folds 
gilberto98: folds 
Hiury5: raises $0.04 to $0.06
Scaaalll: calls $0.06
0Jarek: folds 
gabgordula: folds 
*** FLOP *** [7s 9s Tc]
Hiury5: checks 
Scaaalll: bets $0.08
Hiury5: calls $0.08
*** TURN *** [7s 9s Tc] [Jc]
Hiury5: checks 
Scaaalll: bets $0.20
Hiury5: raises $0.42 to $0.62
Scaaalll: folds 
Uncalled bet ($0.42) returned to Hiury5
Hiury5 collected $0.69 from pot
Hiury5: doesn't show hand 
*** SUMMARY ***
Total pot $0.71 | Rake $0.02 
Board [7s 9s Tc Jc]
Seat 1: Scaaalll (button) folded on the Turn
Seat 2: 0Jarek (small blind) folded before Flop
Seat 3: gabgordula (big blind) folded before Flop
Seat 4: ronald1982 folded before Flop (didn't bet)
Seat 5: gilberto98 folded before Flop (didn't bet)
Seat 6: Hiury5 collected ($0.69)



PokerStars Zoom Hand #229233914167:  Hold'em No Limit ($0.01/$0.02) - 2021/08/21 23:49:20 CET [2021/08/21 17:49:20 ET]
Table 'Halley' 6-max Seat #1 is the button
Seat 1: Hallyson_23 ($3.51 in chips) 
Seat 2: Mr.Kurier ($4.72 in chips) 
Seat 3: debbykene ($2.40 in chips) 
Seat 4: Scaaalll ($3.49 in chips) 
Seat 5: MattieBOZ ($1.99 in chips) 
Seat 6: xmaksimus ($2.19 in chips) 
Mr.Kurier: posts small blind $0.01
debbykene: posts big blind $0.02
*** HOLE CARDS ***
Dealt to Scaaalll [3s 4h]
Scaaalll: folds 
MattieBOZ: folds 
xmaksimus: folds 
Hallyson_23: folds 
Mr.Kurier: folds 
Uncalled bet ($0.01) returned to debbykene
MattieBOZ is disconnected 
debbykene collected $0.02 from pot
debbykene: doesn't show hand 
*** SUMMARY ***
Total pot $0.02 | Rake $0 
Seat 1: Hallyson_23 (button) folded before Flop (didn't bet)
Seat 2: Mr.Kurier (small blind) folded before Flop
Seat 3: debbykene (big blind) collected ($0.02)
Seat 4: Scaaalll folded before Flop (didn't bet)
Seat 5: MattieBOZ folded before Flop (didn't bet)
Seat 6: xmaksimus folded before Flop (didn't bet)



PokerStars Zoom Hand #229233916899:  Hold'em No Limit ($0.01/$0.02) - 2021/08/21 23:49:27 CET [2021/08/21 17:49:27 ET]
Table 'Halley' 6-max Seat #1 is the button
Seat 1: lucky1529 ($0.75 in chips) 
Seat 2: ibstah ($7.89 in chips) 
Seat 3: Mac9Monty2 ($2.56 in chips) 
Seat 4: KonopDima ($2.18 in chips) 
Seat 5: Scaaalll ($3.49 in chips) 
Seat 6: Ne0net ($2.71 in chips) 
ibstah: posts small blind $0.01
Mac9Monty2: posts big blind $0.02
*** HOLE CARDS ***
Dealt to Scaaalll [4c Kh]
KonopDima: folds 
Scaaalll: folds 
Ne0net: folds 
lucky1529: calls $0.02
ibstah: folds 
Mac9Monty2: checks 
*** FLOP *** [6s Kd 8c]
Mac9Monty2: checks 
lucky1529: bets $0.05
Mac9Monty2: folds 
Uncalled bet ($0.05) returned to lucky1529
lucky1529 collected $0.05 from pot
lucky1529: doesn't show hand 
*** SUMMARY ***
Total pot $0.05 | Rake $0 
Board [6s Kd 8c]
Seat 1: lucky1529 (button) collected ($0.05)
Seat 2: ibstah (small blind) folded before Flop
Seat 3: Mac9Monty2 (big blind) folded on the Flop
Seat 4: KonopDima folded before Flop (didn't bet)
Seat 5: Scaaalll folded before Flop (didn't bet)
Seat 6: Ne0net folded before Flop (didn't bet)



PokerStars Zoom Hand #229233911436:  Hold'em No Limit ($0.01/$0.02) - 2021/08/21 23:49:13 CET [2021/08/21 17:49:13 ET]
Table 'Halley' 6-max Seat #1 is the button
Seat 1: Blackwood567 ($2.17 in chips) 
Seat 2: osantos401 ($9.94 in chips) 
Seat 3: CYBOPOB66 ($3.60 in chips) 
Seat 4: StaffsUni ($2 in chips) 
Seat 5: BautiMang ($2 in chips) 
Seat 6: Scaaalll ($3.49 in chips) 
osantos401: posts small blind $0.01
CYBOPOB66: posts big blind $0.02
*** HOLE CARDS ***
Dealt to Scaaalll [Kh 7s]
StaffsUni: folds 
BautiMang: folds 
Scaaalll: folds 
Blackwood567: calls $0.02
osantos401: folds 
CYBOPOB66: checks 
*** FLOP *** [6c 8h Qh]
CYBOPOB66: checks 
Blackwood567: bets $0.02
CYBOPOB66: calls $0.02
*** TURN *** [6c 8h Qh] [4d]
CYBOPOB66: bets $0.06
Blackwood567: calls $0.06
*** RIVER *** [6c 8h Qh 4d] [Qc]
CYBOPOB66: checks 
Blackwood567: checks 
*** SHOW DOWN ***
CYBOPOB66: shows [8s 4h] (two pair, Queens and Eights)
Blackwood567: mucks hand 
CYBOPOB66 collected $0.20 from pot
*** SUMMARY ***
Total pot $0.21 | Rake $0.01 
Board [6c 8h Qh 4d Qc]
Seat 1: Blackwood567 (button) mucked [9c Th]
Seat 2: osantos401 (small blind) folded before Flop
Seat 3: CYBOPOB66 (big blind) showed [8s 4h] and won ($0.20) with two pair, Queens and Eights
Seat 4: StaffsUni folded before Flop (didn't bet)
Seat 5: BautiMang folded before Flop (didn't bet)
Seat 6: Scaaalll folded before Flop (didn't bet)



PokerStars Zoom Hand #229233923974:  Hold'em No Limit ($0.01/$0.02) - 2021/08/21 23:49:45 CET [2021/08/21 17:49:45 ET]
Table 'Halley' 6-max Seat #1 is the button
Seat 1: hustlehero ($2.03 in chips) 
Seat 2: Scaaalll ($3.49 in chips) 
Seat 3: Sul07 ($2.27 in chips) 
Seat 4: Agneobr ($1.94 in chips) 
Seat 5: BlackhawKK's ($2.17 in chips) 
Seat 6: pavlo8855 ($2.07 in chips) 
Scaaalll: posts small blind $0.01
Sul07: posts big blind $0.02
*** HOLE CARDS ***
Dealt to Scaaalll [7h 7s]
Agneobr: folds 
BlackhawKK's: folds 
pavlo8855: folds 
hustlehero: folds 
Scaaalll: raises $0.04 to $0.06
Sul07: folds 
Uncalled bet ($0.04) returned to Scaaalll
Scaaalll collected $0.04 from pot
Scaaalll: doesn't show hand 
*** SUMMARY ***
Total pot $0.04 | Rake $0 
Seat 1: hustlehero (button) folded before Flop (didn't bet)
Seat 2: Scaaalll (small blind) collected ($0.04)
Seat 3: Sul07 (big blind) folded before Flop
Seat 4: Agneobr folded before Flop (didn't bet)
Seat 5: BlackhawKK's folded before Flop (didn't bet)
Seat 6: pavlo8855 folded before Flop (didn't bet)



PokerStars Zoom Hand #229233920872:  Hold'em No Limit ($0.01/$0.02) - 2021/08/21 23:49:37 CET [2021/08/21 17:49:37 ET]
Table 'Halley' 6-max Seat #1 is the button
Seat 1: PapiMik3 ($2.96 in chips) 
Seat 2: adilsonjunioryt ($2.56 in chips) 
Seat 3: $w4y ($2.22 in chips) 
Seat 4: Jmapih ($1.30 in chips) 
Seat 5: egroj1700 ($2.02 in chips) 
Seat 6: Scaaalll ($3.49 in chips) 
adilsonjunioryt: posts small blind $0.01
$w4y: posts big blind $0.02
*** HOLE CARDS ***
Dealt to Scaaalll [6c 7h]
Jmapih: folds 
egroj1700: raises $0.04 to $0.06
Scaaalll: folds 
PapiMik3: folds 
adilsonjunioryt: folds 
$w4y: raises $0.13 to $0.19
egroj1700: folds 
Uncalled bet ($0.13) returned to $w4y
$w4y collected $0.13 from pot
$w4y: doesn't show hand 
*** SUMMARY ***
Total pot $0.13 | Rake $0 
Seat 1: PapiMik3 (button) folded before Flop (didn't bet)
Seat 2: adilsonjunioryt (small blind) folded before Flop
Seat 3: $w4y (big blind) collected ($0.13)
Seat 4: Jmapih folded before Flop (didn't bet)
Seat 5: egroj1700 folded before Flop
Seat 6: Scaaalll folded before Flop (didn't bet)



PokerStars Zoom Hand #229233931676:  Hold'em No Limit ($0.01/$0.02) - 2021/08/21 23:50:05 CET [2021/08/21 17:50:05 ET]
Table 'Halley' 6-max Seat #1 is the button
Seat 1: Jackb9908 ($0.91 in chips) 
Seat 2: fatedsuperior ($1.21 in chips) 
Seat 3: Scaaalll ($3.51 in chips) 
Seat 4: willmorel ($2.52 in chips) 
Seat 5: ust001 ($2.60 in chips) 
Seat 6: cutter2468 ($6.88 in chips) 
fatedsuperior: posts small blind $0.01
Scaaalll: posts big blind $0.02
*** HOLE CARDS ***
Dealt to Scaaalll [3d 4c]
willmorel: folds 
ust001: folds 
cutter2468: folds 
Jackb9908: folds 
fatedsuperior: folds 
Uncalled bet ($0.01) returned to Scaaalll
fatedsuperior is disconnected 
Scaaalll collected $0.02 from pot
Scaaalll: doesn't show hand 
*** SUMMARY ***
Total pot $0.02 | Rake $0 
Seat 1: Jackb9908 (button) folded before Flop (didn't bet)
Seat 2: fatedsuperior (small blind) folded before Flop
Seat 3: Scaaalll (big blind) collected ($0.02)
Seat 4: willmorel folded before Flop (didn't bet)
Seat 5: ust001 folded before Flop (didn't bet)
Seat 6: cutter2468 folded before Flop (didn't bet)



PokerStars Zoom Hand #229233936368:  Hold'em No Limit ($0.01/$0.02) - 2021/08/21 23:50:17 CET [2021/08/21 17:50:17 ET]
Table 'Halley' 6-max Seat #1 is the button
Seat 1: Dr.stromg ($4.88 in chips) 
Seat 2: chtes777 ($1.98 in chips) 
Seat 3: kukulagosleep ($6.85 in chips) 
Seat 4: ctaceo ($2 in chips) 
Seat 5: Scaaalll ($3.52 in chips) 
Seat 6: jjLG99 ($1.77 in chips) 
chtes777: posts small blind $0.01
kukulagosleep: posts big blind $0.02
*** HOLE CARDS ***
Dealt to Scaaalll [Kh 6d]
ctaceo: folds 
Scaaalll: folds 
jjLG99: raises $0.07 to $0.09
Dr.stromg: folds 
chtes777: folds 
kukulagosleep: folds 
Uncalled bet ($0.07) returned to jjLG99
jjLG99 collected $0.05 from pot
jjLG99: doesn't show hand 
*** SUMMARY ***
Total pot $0.05 | Rake $0 
Seat 1: Dr.stromg (button) folded before Flop (didn't bet)
Seat 2: chtes777 (small blind) folded before Flop
Seat 3: kukulagosleep (big blind) folded before Flop
Seat 4: ctaceo folded before Flop (didn't bet)
Seat 5: Scaaalll folded before Flop (didn't bet)
Seat 6: jjLG99 collected ($0.05)



PokerStars Zoom Hand #229233938324:  Hold'em No Limit ($0.01/$0.02) - 2021/08/21 23:50:22 CET [2021/08/21 17:50:22 ET]
Table 'Halley' 6-max Seat #1 is the button
Seat 1: Scaaalll ($3.52 in chips) 
Seat 2: botyesz999 ($1.23 in chips) 
Seat 3: RrriotGrrrl ($3.23 in chips) 
Seat 4: nagibatorali ($1.39 in chips) 
Seat 5: xoen ($2 in chips) 
Seat 6: jaamonra ($2.06 in chips) 
botyesz999: posts small blind $0.01
RrriotGrrrl: posts big blind $0.02
*** HOLE CARDS ***
Dealt to Scaaalll [8h 2s]
nagibatorali: raises $0.02 to $0.04
xoen: folds 
jaamonra: folds 
Scaaalll: folds 
botyesz999: folds 
RrriotGrrrl: folds 
Uncalled bet ($0.02) returned to nagibatorali
nagibatorali collected $0.05 from pot
nagibatorali: doesn't show hand 
*** SUMMARY ***
Total pot $0.05 | Rake $0 
Seat 1: Scaaalll (button) folded before Flop (didn't bet)
Seat 2: botyesz999 (small blind) folded before Flop
Seat 3: RrriotGrrrl (big blind) folded before Flop
Seat 4: nagibatorali collected ($0.05)
Seat 5: xoen folded before Flop (didn't bet)
Seat 6: jaamonra folded before Flop (didn't bet)



PokerStars Zoom Hand #229233942988:  Hold'em No Limit ($0.01/$0.02) - 2021/08/21 23:50:34 CET [2021/08/21 17:50:34 ET]
Table 'Halley' 6-max Seat #1 is the button
Seat 1: gasmar_29 ($2.58 in chips) 
Seat 2: alphabeta1d ($2.25 in chips) 
Seat 3: GGopenBet ($1.16 in chips) 
Seat 4: Scaaalll ($3.52 in chips) 
Seat 5: Iv3rson18 ($2.03 in chips) 
Seat 6: spirosz1000 ($2.19 in chips) 
alphabeta1d: posts small blind $0.01
GGopenBet: posts big blind $0.02
*** HOLE CARDS ***
Dealt to Scaaalll [9d Jc]
Scaaalll: folds 
Iv3rson18: raises $0.03 to $0.05
spirosz1000: folds 
gasmar_29: folds 
alphabeta1d: folds 
GGopenBet: calls $0.03
*** FLOP *** [3c 9c Ts]
GGopenBet: checks 
Iv3rson18: checks 
*** TURN *** [3c 9c Ts] [6c]
GGopenBet: bets $0.05
Iv3rson18: folds 
Uncalled bet ($0.05) returned to GGopenBet
GGopenBet collected $0.11 from pot
GGopenBet: doesn't show hand 
*** SUMMARY ***
Total pot $0.11 | Rake $0 
Board [3c 9c Ts 6c]
Seat 1: gasmar_29 (button) folded before Flop (didn't bet)
Seat 2: alphabeta1d (small blind) folded before Flop
Seat 3: GGopenBet (big blind) collected ($0.11)
Seat 4: Scaaalll folded before Flop (didn't bet)
Seat 5: Iv3rson18 folded on the Turn
Seat 6: spirosz1000 folded before Flop (didn't bet)



PokerStars Zoom Hand #229233944518:  Hold'em No Limit ($0.01/$0.02) - 2021/08/21 23:50:38 CET [2021/08/21 17:50:38 ET]
Table 'Halley' 6-max Seat #1 is the button
Seat 1: Scaaalll ($3.52 in chips) 
Seat 2: Agneobr ($1.43 in chips) 
Seat 3: geo8787891 ($3.18 in chips) 
Seat 4: jorgemolga ($1.14 in chips) 
Seat 5: Sergio Rigel ($2.18 in chips) 
Seat 6: Spinatstrudel ($2 in chips) 
Agneobr: posts small blind $0.01
geo8787891: posts big blind $0.02
*** HOLE CARDS ***
Dealt to Scaaalll [Qc Kc]
jorgemolga: folds 
Sergio Rigel: folds 
Spinatstrudel: raises $0.03 to $0.05
Scaaalll: calls $0.05
Agneobr: folds 
geo8787891: raises $0.03 to $0.08
Spinatstrudel: calls $0.03
Scaaalll: calls $0.03
*** FLOP *** [2d Kh 4d]
geo8787891: checks 
Spinatstrudel: checks 
Scaaalll: bets $0.13
geo8787891: calls $0.13
Spinatstrudel: folds 
*** TURN *** [2d Kh 4d] [Js]
geo8787891: checks 
Scaaalll: checks 
*** RIVER *** [2d Kh 4d Js] [Jd]
geo8787891: checks 
Scaaalll: bets $0.22
geo8787891: calls $0.22
*** SHOW DOWN ***
Scaaalll: shows [Qc Kc] (two pair, Kings and Jacks)
geo8787891: mucks hand 
Scaaalll collected $0.91 from pot
*** SUMMARY ***
Total pot $0.95 | Rake $0.04 
Board [2d Kh 4d Js Jd]
Seat 1: Scaaalll (button) showed [Qc Kc] and won ($0.91) with two pair, Kings and Jacks
Seat 2: Agneobr (small blind) folded before Flop
Seat 3: geo8787891 (big blind) mucked [Ts Tc]
Seat 4: jorgemolga folded before Flop (didn't bet)
Seat 5: Sergio Rigel folded before Flop (didn't bet)
Seat 6: Spinatstrudel folded on the Flop



PokerStars Zoom Hand #229233979636:  Hold'em No Limit ($0.01/$0.02) - 2021/08/21 23:51:58 CET [2021/08/21 17:51:58 ET]
Table 'Halley' 6-max Seat #1 is the button
Seat 1: Doktor Yes ($4.06 in chips) 
Seat 2: GGopenBet ($1.22 in chips) 
Seat 3: IIDARKROBOTII ($2.02 in chips) 
Seat 4: Scaaalll ($3.99 in chips) 
Seat 5: Ck@tih@ ($1.49 in chips) 
Seat 6: WolvegastL ($1 in chips) 
GGopenBet: posts small blind $0.01
IIDARKROBOTII: posts big blind $0.02
*** HOLE CARDS ***
Dealt to Scaaalll [As 6s]
GGopenBet is disconnected 
Scaaalll: folds 
Ck@tih@: folds 
WolvegastL: folds 
Doktor Yes: raises $0.04 to $0.06
GGopenBet: folds 
IIDARKROBOTII: calls $0.04
*** FLOP *** [Ad 7d 2c]
IIDARKROBOTII: checks 
Doktor Yes: checks 
*** TURN *** [Ad 7d 2c] [9c]
IIDARKROBOTII: bets $0.13
Doktor Yes: folds 
Uncalled bet ($0.13) returned to IIDARKROBOTII
IIDARKROBOTII collected $0.13 from pot
IIDARKROBOTII: doesn't show hand 
*** SUMMARY ***
Total pot $0.13 | Rake $0 
Board [Ad 7d 2c 9c]
Seat 1: Doktor Yes (button) folded on the Turn
Seat 2: GGopenBet (small blind) folded before Flop
Seat 3: IIDARKROBOTII (big blind) collected ($0.13)
Seat 4: Scaaalll folded before Flop (didn't bet)
Seat 5: Ck@tih@ folded before Flop (didn't bet)
Seat 6: WolvegastL folded before Flop (didn't bet)



PokerStars Zoom Hand #229233975402:  Hold'em No Limit ($0.01/$0.02) - 2021/08/21 23:51:47 CET [2021/08/21 17:51:47 ET]
Table 'Halley' 6-max Seat #1 is the button
Seat 1: HirasawaYuiP ($2.33 in chips) 
Seat 2: Scaaalll ($4 in chips) 
Seat 3: pipecmolodec ($2.03 in chips) 
Seat 4: geo8787891 ($2.75 in chips) 
Seat 5: KonopDima ($2.08 in chips) 
Seat 6: YgovAndrey ($1.31 in chips) 
Scaaalll: posts small blind $0.01
pipecmolodec: posts big blind $0.02
*** HOLE CARDS ***
Dealt to Scaaalll [6s Kd]
geo8787891: calls $0.02
KonopDima: folds 
YgovAndrey: folds 
HirasawaYuiP: raises $0.06 to $0.08
Scaaalll: folds 
pipecmolodec: folds 
geo8787891: calls $0.06
*** FLOP *** [9c 2d 4d]
geo8787891: checks 
HirasawaYuiP: checks 
*** TURN *** [9c 2d 4d] [6d]
geo8787891: bets $0.06
HirasawaYuiP: raises $0.14 to $0.20
geo8787891: raises $0.14 to $0.34
HirasawaYuiP: calls $0.14
*** RIVER *** [9c 2d 4d 6d] [Ks]
geo8787891: bets $0.36
HirasawaYuiP: calls $0.36
*** SHOW DOWN ***
geo8787891: shows [4c Ad] (a pair of Fours)
HirasawaYuiP: shows [9d Ts] (a pair of Nines)
HirasawaYuiP collected $1.53 from pot
*** SUMMARY ***
Total pot $1.59 | Rake $0.06 
Board [9c 2d 4d 6d Ks]
Seat 1: HirasawaYuiP (button) showed [9d Ts] and won ($1.53) with a pair of Nines
Seat 2: Scaaalll (small blind) folded before Flop
Seat 3: pipecmolodec (big blind) folded before Flop
Seat 4: geo8787891 showed [4c Ad] and lost with a pair of Fours
Seat 5: KonopDima folded before Flop (didn't bet)
Seat 6: YgovAndrey folded before Flop (didn't bet)



PokerStars Zoom Hand #229233983096:  Hold'em No Limit ($0.01/$0.02) - 2021/08/21 23:52:07 CET [2021/08/21 17:52:07 ET]
Table 'Halley' 6-max Seat #1 is the button
Seat 1: viktoldo ($1.61 in chips) 
Seat 2: nagiloR ($1.82 in chips) 
Seat 3: Scaaalll ($3.99 in chips) 
Seat 4: gaturamard ($2.97 in chips) 
Seat 5: Sha.Le.Ol. ($1.41 in chips) 
Seat 6: davidalejag ($2.38 in chips) 
nagiloR: posts small blind $0.01
Scaaalll: posts big blind $0.02
*** HOLE CARDS ***
Dealt to Scaaalll [Td Kc]
gaturamard: folds 
Sha.Le.Ol.: folds 
davidalejag: folds 
viktoldo: folds 
viktoldo is disconnected 
nagiloR: raises $0.04 to $0.06
Scaaalll: calls $0.04
*** FLOP *** [Ac Js Jd]
nagiloR: bets $0.04
Scaaalll: calls $0.04
*** TURN *** [Ac Js Jd] [4d]
nagiloR: checks 
Scaaalll: checks 
*** RIVER *** [Ac Js Jd 4d] [Ad]
nagiloR: checks 
Scaaalll: checks 
*** SHOW DOWN ***
nagiloR: shows [9h 6d] (two pair, Aces and Jacks)
Scaaalll: shows [Td Kc] (two pair, Aces and Jacks - King kicker)
Scaaalll collected $0.19 from pot
*** SUMMARY ***
Total pot $0.20 | Rake $0.01 
Board [Ac Js Jd 4d Ad]
Seat 1: viktoldo (button) folded before Flop (didn't bet)
Seat 2: nagiloR (small blind) showed [9h 6d] and lost with two pair, Aces and Jacks
Seat 3: Scaaalll (big blind) showed [Td Kc] and won ($0.19) with two pair, Aces and Jacks
Seat 4: gaturamard folded before Flop (didn't bet)
Seat 5: Sha.Le.Ol. folded before Flop (didn't bet)
Seat 6: davidalejag folded before Flop (didn't bet)



PokerStars Zoom Hand #229233999735:  Hold'em No Limit ($0.01/$0.02) - 2021/08/21 23:52:50 CET [2021/08/21 17:52:50 ET]
Table 'Halley' 6-max Seat #1 is the button
Seat 1: S.P.S...99 ($2.17 in chips) 
Seat 2: cutter2468 ($4.56 in chips) 
Seat 3: kidninja888 ($3.21 in chips) 
Seat 4: GVMELLO ($4.23 in chips) 
Seat 5: Scaaalll ($4.08 in chips) 
Seat 6: A.Khodyakov ($2.13 in chips) 
cutter2468: posts small blind $0.01
kidninja888: posts big blind $0.02
*** HOLE CARDS ***
Dealt to Scaaalll [9s Ts]
S.P.S...99 is disconnected 
GVMELLO: folds 
Scaaalll: raises $0.04 to $0.06
A.Khodyakov: raises $0.19 to $0.25
S.P.S...99: folds 
cutter2468: folds 
kidninja888: folds 
Scaaalll: folds 
Uncalled bet ($0.19) returned to A.Khodyakov
A.Khodyakov collected $0.15 from pot
A.Khodyakov: doesn't show hand 
*** SUMMARY ***
Total pot $0.15 | Rake $0 
Seat 1: S.P.S...99 (button) folded before Flop (didn't bet)
Seat 2: cutter2468 (small blind) folded before Flop
Seat 3: kidninja888 (big blind) folded before Flop
Seat 4: GVMELLO folded before Flop (didn't bet)
Seat 5: Scaaalll folded before Flop
Seat 6: A.Khodyakov collected ($0.15)



PokerStars Zoom Hand #229234008130:  Hold'em No Limit ($0.01/$0.02) - 2021/08/21 23:53:12 CET [2021/08/21 17:53:12 ET]
Table 'Halley' 6-max Seat #1 is the button
Seat 1: Zamin Khan ($2.21 in chips) 
Seat 2: chtes777 ($3.34 in chips) 
Seat 3: 888lifeIS ($2 in chips) 
Seat 4: xoen ($2.24 in chips) 
Seat 5: H0mmer99 ($4.02 in chips) 
Seat 6: Scaaalll ($4.02 in chips) 
chtes777: posts small blind $0.01
888lifeIS: posts big blind $0.02
*** HOLE CARDS ***
Dealt to Scaaalll [6d Js]
xoen: folds 
H0mmer99: raises $0.02 to $0.04
Zamin Khan is disconnected 
Scaaalll: folds 
Zamin Khan: folds 
chtes777: raises $0.02 to $0.06
888lifeIS: folds 
H0mmer99: calls $0.02
*** FLOP *** [8d Qh 3h]
chtes777: bets $0.14
H0mmer99: raises $0.14 to $0.28
chtes777: folds 
Uncalled bet ($0.14) returned to H0mmer99
H0mmer99 collected $0.41 from pot
H0mmer99: doesn't show hand 
*** SUMMARY ***
Total pot $0.42 | Rake $0.01 
Board [8d Qh 3h]
Seat 1: Zamin Khan (button) folded before Flop (didn't bet)
Seat 2: chtes777 (small blind) folded on the Flop
Seat 3: 888lifeIS (big blind) folded before Flop
Seat 4: xoen folded before Flop (didn't bet)
Seat 5: H0mmer99 collected ($0.41)
Seat 6: Scaaalll folded before Flop (didn't bet)



PokerStars Zoom Hand #229234011888:  Hold'em No Limit ($0.01/$0.02) - 2021/08/21 23:53:22 CET [2021/08/21 17:53:22 ET]
Table 'Halley' 6-max Seat #1 is the button
Seat 1: Red Sky 15 ($7.86 in chips) 
Seat 2: AtZ3899 ($1.86 in chips) 
Seat 3: Scaaalll ($4.02 in chips) 
Seat 4: willmorel ($2.31 in chips) 
Seat 5: rpycmbEM ($5.74 in chips) 
Seat 6: egroj1700 ($2.04 in chips) 
AtZ3899: posts small blind $0.01
Scaaalll: posts big blind $0.02
*** HOLE CARDS ***
Dealt to Scaaalll [Jh Jc]
willmorel: folds 
Red Sky 15 is disconnected 
rpycmbEM: folds 
egroj1700: raises $0.04 to $0.06
Red Sky 15: folds 
AtZ3899: calls $0.05
Scaaalll: raises $0.18 to $0.24
egroj1700: raises $0.26 to $0.50
AtZ3899: folds 
Scaaalll: folds 
Uncalled bet ($0.26) returned to egroj1700
egroj1700 collected $0.54 from pot
egroj1700: doesn't show hand 
*** SUMMARY ***
Total pot $0.54 | Rake $0 
Seat 1: Red Sky 15 (button) folded before Flop (didn't bet)
Seat 2: AtZ3899 (small blind) folded before Flop
Seat 3: Scaaalll (big blind) folded before Flop
Seat 4: willmorel folded before Flop (didn't bet)
Seat 5: rpycmbEM folded before Flop (didn't bet)
Seat 6: egroj1700 collected ($0.54)



PokerStars Zoom Hand #229234028763:  Hold'em No Limit ($0.01/$0.02) - 2021/08/21 23:54:06 CET [2021/08/21 17:54:06 ET]
Table 'Halley' 6-max Seat #1 is the button
Seat 1: Luis Rdz25 ($1.02 in chips) 
Seat 2: Scaaalll ($3.78 in chips) 
Seat 3: Ck@tih@ ($2.17 in chips) 
Seat 4: RaulacateFolds ($2.44 in chips) 
Seat 5: Jimor Marlow ($2.25 in chips) 
Seat 6: diegohgmelo ($1.70 in chips) 
Scaaalll: posts small blind $0.01
Ck@tih@: posts big blind $0.02
*** HOLE CARDS ***
Dealt to Scaaalll [4h 3d]
RaulacateFolds: folds 
Jimor Marlow: folds 
Jimor Marlow is disconnected 
diegohgmelo is disconnected 
Luis Rdz25 is disconnected 
diegohgmelo has timed out while disconnected
diegohgmelo: folds 
Luis Rdz25: folds 
Scaaalll: folds 
Uncalled bet ($0.01) returned to Ck@tih@
Ck@tih@ collected $0.02 from pot
Ck@tih@: doesn't show hand 
*** SUMMARY ***
Total pot $0.02 | Rake $0 
Seat 1: Luis Rdz25 (button) folded before Flop (didn't bet)
Seat 2: Scaaalll (small blind) folded before Flop
Seat 3: Ck@tih@ (big blind) collected ($0.02)
Seat 4: RaulacateFolds folded before Flop (didn't bet)
Seat 5: Jimor Marlow folded before Flop (didn't bet)
Seat 6: diegohgmelo folded before Flop (didn't bet)



PokerStars Zoom Hand #229234036110:  Hold'em No Limit ($0.01/$0.02) - 2021/08/21 23:54:25 CET [2021/08/21 17:54:25 ET]
Table 'Halley' 6-max Seat #1 is the button
Seat 1: new face onl ($2.45 in chips) 
Seat 2: Pere Ubu ($1.78 in chips) 
Seat 3: zergmiky ($2.11 in chips) 
Seat 4: polymorhp ($2.31 in chips) 
Seat 5: Scaaalll ($3.77 in chips) 
Seat 6: xoen ($2.15 in chips) 
Pere Ubu: posts small blind $0.01
zergmiky: posts big blind $0.02
*** HOLE CARDS ***
Dealt to Scaaalll [Jh Ks]
Pere Ubu is disconnected 
polymorhp: folds 
Scaaalll: raises $0.04 to $0.06
xoen: folds 
new face onl: folds 
Pere Ubu: folds 
zergmiky: folds 
Uncalled bet ($0.04) returned to Scaaalll
Scaaalll collected $0.05 from pot
Scaaalll: doesn't show hand 
*** SUMMARY ***
Total pot $0.05 | Rake $0 
Seat 1: new face onl (button) folded before Flop (didn't bet)
Seat 2: Pere Ubu (small blind) folded before Flop
Seat 3: zergmiky (big blind) folded before Flop
Seat 4: polymorhp folded before Flop (didn't bet)
Seat 5: Scaaalll collected ($0.05)
Seat 6: xoen folded before Flop (didn't bet)



PokerStars Zoom Hand #229234041437:  Hold'em No Limit ($0.01/$0.02) - 2021/08/21 23:54:39 CET [2021/08/21 17:54:39 ET]
Table 'Halley' 6-max Seat #1 is the button
Seat 1: Scaaalll ($3.80 in chips) 
Seat 2: EstiBan18 ($2.12 in chips) 
Seat 3: VisjePaktJe ($4.14 in chips) 
Seat 4: jaamonra ($2.24 in chips) 
Seat 5: spirosz1000 ($2.27 in chips) 
Seat 6: lucksuckdonk ($9.25 in chips) 
EstiBan18: posts small blind $0.01
VisjePaktJe: posts big blind $0.02
*** HOLE CARDS ***
Dealt to Scaaalll [4h Qh]
jaamonra: folds 
spirosz1000: folds 
lucksuckdonk: folds 
Scaaalll: raises $0.02 to $0.04
EstiBan18: folds 
VisjePaktJe: raises $0.09 to $0.13
Scaaalll: folds 
Uncalled bet ($0.09) returned to VisjePaktJe
VisjePaktJe collected $0.09 from pot
VisjePaktJe: doesn't show hand 
*** SUMMARY ***
Total pot $0.09 | Rake $0 
Seat 1: Scaaalll (button) folded before Flop
Seat 2: EstiBan18 (small blind) folded before Flop
Seat 3: VisjePaktJe (big blind) collected ($0.09)
Seat 4: jaamonra folded before Flop (didn't bet)
Seat 5: spirosz1000 folded before Flop (didn't bet)
Seat 6: lucksuckdonk folded before Flop (didn't bet)



PokerStars Zoom Hand #229234049866:  Hold'em No Limit ($0.01/$0.02) - 2021/08/21 23:55:01 CET [2021/08/21 17:55:01 ET]
Table 'Halley' 6-max Seat #1 is the button
Seat 1: GVMELLO ($2.05 in chips) 
Seat 2: pipecmolodec ($2.04 in chips) 
Seat 3: gizum17 ($3.33 in chips) 
Seat 4: Scaaalll ($3.76 in chips) 
Seat 5: Bol'tazar111 ($1.89 in chips) 
Seat 6: TM 69 UIE ($2.16 in chips) 
pipecmolodec: posts small blind $0.01
gizum17: posts big blind $0.02
*** HOLE CARDS ***
Dealt to Scaaalll [7c 8d]
TM 69 UIE is disconnected 
Scaaalll: folds 
Bol'tazar111: folds 
TM 69 UIE: folds 
GVMELLO: raises $0.03 to $0.05
pipecmolodec: raises $0.15 to $0.20
gizum17: folds 
GVMELLO: folds 
Uncalled bet ($0.15) returned to pipecmolodec
pipecmolodec collected $0.12 from pot
pipecmolodec: doesn't show hand 
*** SUMMARY ***
Total pot $0.12 | Rake $0 
Seat 1: GVMELLO (button) folded before Flop
Seat 2: pipecmolodec (small blind) collected ($0.12)
Seat 3: gizum17 (big blind) folded before Flop
Seat 4: Scaaalll folded before Flop (didn't bet)
Seat 5: Bol'tazar111 folded before Flop (didn't bet)
Seat 6: TM 69 UIE folded before Flop (didn't bet)



PokerStars Zoom Hand #229234053012:  Hold'em No Limit ($0.01/$0.02) - 2021/08/21 23:55:11 CET [2021/08/21 17:55:11 ET]
Table 'Halley' 6-max Seat #1 is the button
Seat 1: Kattiavr ($1.22 in chips) 
Seat 2: Hiury5 ($2.34 in chips) 
Seat 3: lucksuckdonk ($9.19 in chips) 
Seat 4: Reipinguimm ($2.04 in chips) 
Seat 5: tuolau ($4.41 in chips) 
Seat 6: Scaaalll ($3.76 in chips) 
Hiury5: posts small blind $0.01
lucksuckdonk: posts big blind $0.02
*** HOLE CARDS ***
Dealt to Scaaalll [9s Td]
Reipinguimm: raises $0.03 to $0.05
tuolau: raises $0.15 to $0.20
Scaaalll: folds 
Kattiavr: folds 
Hiury5: folds 
lucksuckdonk: folds 
Kattiavr is disconnected 
Reipinguimm: folds 
Uncalled bet ($0.15) returned to tuolau
tuolau collected $0.13 from pot
tuolau: doesn't show hand 
*** SUMMARY ***
Total pot $0.13 | Rake $0 
Seat 1: Kattiavr (button) folded before Flop (didn't bet)
Seat 2: Hiury5 (small blind) folded before Flop
Seat 3: lucksuckdonk (big blind) folded before Flop
Seat 4: Reipinguimm folded before Flop
Seat 5: tuolau collected ($0.13)
Seat 6: Scaaalll folded before Flop (didn't bet)



PokerStars Zoom Hand #229234054212:  Hold'em No Limit ($0.01/$0.02) - 2021/08/21 23:55:15 CET [2021/08/21 17:55:15 ET]
Table 'Halley' 6-max Seat #1 is the button
Seat 1: boa juice ($1.97 in chips) 
Seat 2: Scaaalll ($3.76 in chips) 
Seat 3: Dr.stromg ($6.90 in chips) 
Seat 4: El Chicha.CL ($2.56 in chips) 
Seat 5: KonopDima ($2 in chips) 
Seat 6: vovan100157 ($5.58 in chips) 
Scaaalll: posts small blind $0.01
Dr.stromg: posts big blind $0.02
*** HOLE CARDS ***
Dealt to Scaaalll [9c Qd]
El Chicha.CL: raises $0.04 to $0.06
KonopDima: folds 
boa juice is disconnected 
vovan100157: folds 
boa juice: folds 
Scaaalll: folds 
Dr.stromg: folds 
Uncalled bet ($0.04) returned to El Chicha.CL
El Chicha.CL collected $0.05 from pot
El Chicha.CL: doesn't show hand 
*** SUMMARY ***
Total pot $0.05 | Rake $0 
Seat 1: boa juice (button) folded before Flop (didn't bet)
Seat 2: Scaaalll (small blind) folded before Flop
Seat 3: Dr.stromg (big blind) folded before Flop
Seat 4: El Chicha.CL collected ($0.05)
Seat 5: KonopDima folded before Flop (didn't bet)
Seat 6: vovan100157 folded before Flop (didn't bet)



PokerStars Zoom Hand #229234058916:  Hold'em No Limit ($0.01/$0.02) - 2021/08/21 23:55:31 CET [2021/08/21 17:55:31 ET]
Table 'Halley' 6-max Seat #1 is the button
Seat 1: Finderra ($3.07 in chips) 
Seat 2: Busya777 ($5.06 in chips) 
Seat 3: Demidov V.S. ($2.85 in chips) 
Seat 4: Scaaalll ($3.75 in chips) 
Seat 5: Reipinguimm ($2.03 in chips) 
Seat 6: Bol'tazar111 ($2.44 in chips) 
Busya777: posts small blind $0.01
Demidov V.S.: posts big blind $0.02
*** HOLE CARDS ***
Dealt to Scaaalll [Ac 8c]
Scaaalll: raises $0.04 to $0.06
Demidov V.S. is disconnected 
Reipinguimm: folds 
Bol'tazar111: folds 
Finderra: folds 
Busya777: calls $0.05
Demidov V.S.: folds 
*** FLOP *** [4h 4c 4s]
Busya777: checks 
Scaaalll: bets $0.09
Busya777: folds 
Uncalled bet ($0.09) returned to Scaaalll
Scaaalll collected $0.14 from pot
Scaaalll: doesn't show hand 
Busya777 is disconnected 
*** SUMMARY ***
Total pot $0.14 | Rake $0 
Board [4h 4c 4s]
Seat 1: Finderra (button) folded before Flop (didn't bet)
Seat 2: Busya777 (small blind) folded on the Flop
Seat 3: Demidov V.S. (big blind) folded before Flop
Seat 4: Scaaalll collected ($0.14)
Seat 5: Reipinguimm folded before Flop (didn't bet)
Seat 6: Bol'tazar111 folded before Flop (didn't bet)



PokerStars Zoom Hand #229234067165:  Hold'em No Limit ($0.01/$0.02) - 2021/08/21 23:55:59 CET [2021/08/21 17:55:59 ET]
Table 'Halley' 6-max Seat #1 is the button
Seat 1: Scaaalll ($3.83 in chips) 
Seat 2: BasTidChiken ($2.48 in chips) 
Seat 3: A.Khodyakov ($2 in chips) 
Seat 4: Treadero ($2 in chips) 
Seat 5: elmex886 ($2 in chips) 
Seat 6: hallowed_0 ($2.09 in chips) 
BasTidChiken: posts small blind $0.01
A.Khodyakov: posts big blind $0.02
*** HOLE CARDS ***
Dealt to Scaaalll [4s 7h]
Treadero: folds 
elmex886: folds 
hallowed_0: folds 
Scaaalll: folds 
BasTidChiken: folds 
Uncalled bet ($0.01) returned to A.Khodyakov
A.Khodyakov collected $0.02 from pot
A.Khodyakov: doesn't show hand 
*** SUMMARY ***
Total pot $0.02 | Rake $0 
Seat 1: Scaaalll (button) folded before Flop (didn't bet)
Seat 2: BasTidChiken (small blind) folded before Flop
Seat 3: A.Khodyakov (big blind) collected ($0.02)
Seat 4: Treadero folded before Flop (didn't bet)
Seat 5: elmex886 folded before Flop (didn't bet)
Seat 6: hallowed_0 folded before Flop (didn't bet)



PokerStars Zoom Hand #229234070372:  Hold'em No Limit ($0.01/$0.02) - 2021/08/21 23:56:10 CET [2021/08/21 17:56:10 ET]
Table 'Halley' 6-max Seat #1 is the button
Seat 1: kifa612 ($2.15 in chips) 
Seat 2: OmahaWheels ($3.76 in chips) 
Seat 3: Scaaalll ($3.83 in chips) 
Seat 4: Sadikson ($2.64 in chips) 
Seat 5: Ck@tih@ ($2.29 in chips) 
Seat 6: Dr.stromg ($2.46 in chips) 
OmahaWheels: posts small blind $0.01
Scaaalll: posts big blind $0.02
*** HOLE CARDS ***
Dealt to Scaaalll [Js Jc]
Sadikson: folds 
Sadikson is disconnected 
Ck@tih@: calls $0.02
Dr.stromg: folds 
kifa612: calls $0.02
OmahaWheels: calls $0.01
Scaaalll: raises $0.10 to $0.12
Ck@tih@: calls $0.10
kifa612: calls $0.10
OmahaWheels: folds 
*** FLOP *** [8s 3s Qs]
Scaaalll: checks 
Ck@tih@: checks 
kifa612: bets $0.14
Scaaalll: calls $0.14
Ck@tih@: folds 
*** TURN *** [8s 3s Qs] [7c]
Scaaalll: checks 
kifa612: checks 
*** RIVER *** [8s 3s Qs 7c] [7d]
Scaaalll: checks 
kifa612: checks 
*** SHOW DOWN ***
Scaaalll: shows [Js Jc] (two pair, Jacks and Sevens)
kifa612: mucks hand 
Scaaalll collected $0.64 from pot
*** SUMMARY ***
Total pot $0.66 | Rake $0.02 
Board [8s 3s Qs 7c 7d]
Seat 1: kifa612 (button) mucked [4s 4c]
Seat 2: OmahaWheels (small blind) folded before Flop
Seat 3: Scaaalll (big blind) showed [Js Jc] and won ($0.64) with two pair, Jacks and Sevens
Seat 4: Sadikson folded before Flop (didn't bet)
Seat 5: Ck@tih@ folded on the Flop
Seat 6: Dr.stromg folded before Flop (didn't bet)



PokerStars Zoom Hand #229234091689:  Hold'em No Limit ($0.01/$0.02) - 2021/08/21 23:57:22 CET [2021/08/21 17:57:22 ET]
Table 'Halley' 6-max Seat #1 is the button
Seat 1: S.P.S...99 ($1.09 in chips) 
Seat 2: 0ofreeo0 ($3.94 in chips) 
Seat 3: gaturamard ($4.79 in chips) 
Seat 4: kboskov123 ($1.77 in chips) 
Seat 5: SHALOMandKAT ($0.44 in chips) 
Seat 6: Scaaalll ($4.21 in chips) 
0ofreeo0: posts small blind $0.01
gaturamard: posts big blind $0.02
*** HOLE CARDS ***
Dealt to Scaaalll [Kd Ad]
kboskov123: folds 
SHALOMandKAT: raises $0.02 to $0.04
S.P.S...99 is disconnected 
Scaaalll: raises $0.12 to $0.16
S.P.S...99: folds 
0ofreeo0: folds 
gaturamard: folds 
SHALOMandKAT: calls $0.12
*** FLOP *** [2h Qc 6h]
SHALOMandKAT: checks 
Scaaalll: bets $0.28
SHALOMandKAT: calls $0.28 and is all-in
*** TURN *** [2h Qc 6h] [2d]
*** RIVER *** [2h Qc 6h 2d] [3s]
*** SHOW DOWN ***
SHALOMandKAT: shows [9d 9c] (two pair, Nines and Deuces)
Scaaalll: shows [Kd Ad] (a pair of Deuces)
SHALOMandKAT collected $0.88 from pot
*** SUMMARY ***
Total pot $0.91 | Rake $0.03 
Board [2h Qc 6h 2d 3s]
Seat 1: S.P.S...99 (button) folded before Flop (didn't bet)
Seat 2: 0ofreeo0 (small blind) folded before Flop
Seat 3: gaturamard (big blind) folded before Flop
Seat 4: kboskov123 folded before Flop (didn't bet)
Seat 5: SHALOMandKAT showed [9d 9c] and won ($0.88) with two pair, Nines and Deuces
Seat 6: Scaaalll showed [Kd Ad] and lost with a pair of Deuces



PokerStars Zoom Hand #229234104549:  Hold'em No Limit ($0.01/$0.02) - 2021/08/21 23:58:05 CET [2021/08/21 17:58:05 ET]
Table 'Halley' 6-max Seat #1 is the button
Seat 1: Doktor Yes ($2.96 in chips) 
Seat 2: navluc ($3.01 in chips) 
Seat 3: Luben_76 ($2 in chips) 
Seat 4: Scaaalll ($3.77 in chips) 
Seat 5: CYBOPOB66 ($3.36 in chips) 
Seat 6: rotfei02 ($2.46 in chips) 
navluc: posts small blind $0.01
Luben_76: posts big blind $0.02
*** HOLE CARDS ***
Dealt to Scaaalll [6s 3c]
Scaaalll: folds 
CYBOPOB66: raises $0.04 to $0.06
rotfei02: folds 
Doktor Yes: folds 
navluc: folds 
navluc is disconnected 
Luben_76: folds 
Uncalled bet ($0.04) returned to CYBOPOB66
CYBOPOB66 collected $0.05 from pot
CYBOPOB66: doesn't show hand 
*** SUMMARY ***
Total pot $0.05 | Rake $0 
Seat 1: Doktor Yes (button) folded before Flop (didn't bet)
Seat 2: navluc (small blind) folded before Flop
Seat 3: Luben_76 (big blind) folded before Flop
Seat 4: Scaaalll folded before Flop (didn't bet)
Seat 5: CYBOPOB66 collected ($0.05)
Seat 6: rotfei02 folded before Flop (didn't bet)



PokerStars Zoom Hand #229234105741:  Hold'em No Limit ($0.01/$0.02) - 2021/08/21 23:58:09 CET [2021/08/21 17:58:09 ET]
Table 'Halley' 6-max Seat #1 is the button
Seat 1: cheddarspreada ($0.91 in chips) 
Seat 2: PapiMik3 ($11.05 in chips) 
Seat 3: Hope2706 ($5.24 in chips) 
Seat 4: Scaaalll ($3.77 in chips) 
Seat 5: Merlin_Arg ($2.37 in chips) 
Seat 6: SKV_1985 ($2 in chips) 
PapiMik3: posts small blind $0.01
Hope2706: posts big blind $0.02
*** HOLE CARDS ***
Dealt to Scaaalll [4c Th]
Scaaalll: folds 
Merlin_Arg: folds 
SKV_1985: raises $0.04 to $0.06
Hope2706 is disconnected 
cheddarspreada: calls $0.06
PapiMik3: folds 
Hope2706: folds 
*** FLOP *** [5s 2d 7s]
SKV_1985: bets $0.09
cheddarspreada: folds 
Uncalled bet ($0.09) returned to SKV_1985
SKV_1985 collected $0.14 from pot
SKV_1985: doesn't show hand 
cheddarspreada is disconnected 
*** SUMMARY ***
Total pot $0.15 | Rake $0.01 
Board [5s 2d 7s]
Seat 1: cheddarspreada (button) folded on the Flop
Seat 2: PapiMik3 (small blind) folded before Flop
Seat 3: Hope2706 (big blind) folded before Flop
Seat 4: Scaaalll folded before Flop (didn't bet)
Seat 5: Merlin_Arg folded before Flop (didn't bet)
Seat 6: SKV_1985 collected ($0.14)



PokerStars Zoom Hand #229234107184:  Hold'em No Limit ($0.01/$0.02) - 2021/08/21 23:58:14 CET [2021/08/21 17:58:14 ET]
Table 'Halley' 6-max Seat #1 is the button
Seat 1: Luben_76 ($2.01 in chips) 
Seat 2: 365p2eva ($3.40 in chips) 
Seat 3: vovan100157 ($5.66 in chips) 
Seat 4: ctaceo ($2.34 in chips) 
Seat 5: Scaaalll ($3.77 in chips) 
Seat 6: zergmiky ($2.07 in chips) 
365p2eva: posts small blind $0.01
vovan100157: posts big blind $0.02
*** HOLE CARDS ***
Dealt to Scaaalll [Ad Tc]
ctaceo: folds 
Scaaalll: raises $0.04 to $0.06
zergmiky: folds 
Luben_76: folds 
365p2eva: raises $0.18 to $0.24
vovan100157: folds 
Scaaalll: folds 
Uncalled bet ($0.18) returned to 365p2eva
365p2eva collected $0.14 from pot
365p2eva: doesn't show hand 
*** SUMMARY ***
Total pot $0.14 | Rake $0 
Seat 1: Luben_76 (button) folded before Flop (didn't bet)
Seat 2: 365p2eva (small blind) collected ($0.14)
Seat 3: vovan100157 (big blind) folded before Flop
Seat 4: ctaceo folded before Flop (didn't bet)
Seat 5: Scaaalll folded before Flop
Seat 6: zergmiky folded before Flop (didn't bet)



PokerStars Zoom Hand #229234114058:  Hold'em No Limit ($0.01/$0.02) - 2021/08/21 23:58:37 CET [2021/08/21 17:58:37 ET]
Table 'Halley' 6-max Seat #1 is the button
Seat 1: pavlo8855 ($2.31 in chips) 
Seat 2: Carlos_glaza ($2 in chips) 
Seat 3: Scaaalll ($3.71 in chips) 
Seat 4: Jacon2905 ($2.45 in chips) 
Seat 5: jaamonra ($5.42 in chips) 
Seat 6: Doktor Yes ($3.04 in chips) 
Carlos_glaza: posts small blind $0.01
Scaaalll: posts big blind $0.02
*** HOLE CARDS ***
Dealt to Scaaalll [4h Ts]
Jacon2905: folds 
jaamonra: folds 
Doktor Yes: folds 
pavlo8855: raises $0.03 to $0.05
Carlos_glaza: folds 
Scaaalll: folds 
Uncalled bet ($0.03) returned to pavlo8855
pavlo8855 collected $0.05 from pot
pavlo8855: doesn't show hand 
*** SUMMARY ***
Total pot $0.05 | Rake $0 
Seat 1: pavlo8855 (button) collected ($0.05)
Seat 2: Carlos_glaza (small blind) folded before Flop
Seat 3: Scaaalll (big blind) folded before Flop
Seat 4: Jacon2905 folded before Flop (didn't bet)
Seat 5: jaamonra folded before Flop (didn't bet)
Seat 6: Doktor Yes folded before Flop (didn't bet)



PokerStars Zoom Hand #229234121321:  Hold'em No Limit ($0.01/$0.02) - 2021/08/21 23:58:53 CET [2021/08/21 17:58:53 ET]
Table 'Halley' 6-max Seat #1 is the button
Seat 1: tarogame ($3.81 in chips) 
Seat 2: spirosz1000 ($2.23 in chips) 
Seat 3: gilberto98 ($4.02 in chips) 
Seat 4: SchinkenToni ($0.28 in chips) 
Seat 5: pavlo8855 ($2 in chips) 
Seat 6: Scaaalll ($3.69 in chips) 
spirosz1000: posts small blind $0.01
gilberto98: posts big blind $0.02
*** HOLE CARDS ***
Dealt to Scaaalll [8s Ks]
SchinkenToni: folds 
pavlo8855: folds 
Scaaalll: raises $0.04 to $0.06
tarogame: folds 
spirosz1000: folds 
gilberto98: folds 
Uncalled bet ($0.04) returned to Scaaalll
Scaaalll collected $0.05 from pot
Scaaalll: doesn't show hand 
*** SUMMARY ***
Total pot $0.05 | Rake $0 
Seat 1: tarogame (button) folded before Flop (didn't bet)
Seat 2: spirosz1000 (small blind) folded before Flop
Seat 3: gilberto98 (big blind) folded before Flop
Seat 4: SchinkenToni folded before Flop (didn't bet)
Seat 5: pavlo8855 folded before Flop (didn't bet)
Seat 6: Scaaalll collected ($0.05)



PokerStars Zoom Hand #229234126106:  Hold'em No Limit ($0.01/$0.02) - 2021/08/21 23:59:09 CET [2021/08/21 17:59:09 ET]
Table 'Halley' 6-max Seat #1 is the button
Seat 1: Baldisback ($2.74 in chips) 
Seat 2: Scaaalll ($3.72 in chips) 
Seat 3: 1nTeresT ($2.13 in chips) 
Seat 4: NickAlex18 ($2 in chips) 
Seat 5: baddbeat4fun ($4.22 in chips) 
Seat 6: AtZ3899 ($1.13 in chips) 
Scaaalll: posts small blind $0.01
1nTeresT: posts big blind $0.02
*** HOLE CARDS ***
Dealt to Scaaalll [7h 5h]
NickAlex18: folds 
baddbeat4fun: folds 
AtZ3899: folds 
Baldisback: raises $0.02 to $0.04
Scaaalll: folds 
1nTeresT: folds 
Uncalled bet ($0.02) returned to Baldisback
Baldisback collected $0.05 from pot
Baldisback: doesn't show hand 
*** SUMMARY ***
Total pot $0.05 | Rake $0 
Seat 1: Baldisback (button) collected ($0.05)
Seat 2: Scaaalll (small blind) folded before Flop
Seat 3: 1nTeresT (big blind) folded before Flop
Seat 4: NickAlex18 folded before Flop (didn't bet)
Seat 5: baddbeat4fun folded before Flop (didn't bet)
Seat 6: AtZ3899 folded before Flop (didn't bet)



PokerStars Zoom Hand #229234130868:  Hold'em No Limit ($0.01/$0.02) - 2021/08/21 23:59:25 CET [2021/08/21 17:59:25 ET]
Table 'Halley' 6-max Seat #1 is the button
Seat 1: Scaaalll ($3.71 in chips) 
Seat 2: STE1NBERG ($5.43 in chips) 
Seat 3: arex194 ($1.65 in chips) 
Seat 4: nbarreiro021 ($2.36 in chips) 
Seat 5: Gerar NB ($2 in chips) 
Seat 6: rpycmbEM ($5.77 in chips) 
STE1NBERG: posts small blind $0.01
arex194: posts big blind $0.02
*** HOLE CARDS ***
Dealt to Scaaalll [Qd Th]
nbarreiro021: folds 
Gerar NB: raises $0.04 to $0.06
rpycmbEM: calls $0.06
arex194 is disconnected 
Scaaalll: folds 
STE1NBERG: folds 
arex194: folds 
*** FLOP *** [Ah 5c 3d]
Gerar NB: bets $0.07
rpycmbEM: calls $0.07
*** TURN *** [Ah 5c 3d] [Qc]
Gerar NB: checks 
rpycmbEM: checks 
*** RIVER *** [Ah 5c 3d Qc] [5h]
Gerar NB: checks 
rpycmbEM: checks 
*** SHOW DOWN ***
Gerar NB: shows [8d 8c] (two pair, Eights and Fives)
rpycmbEM: shows [Ks Kd] (two pair, Kings and Fives)
rpycmbEM collected $0.28 from pot
*** SUMMARY ***
Total pot $0.29 | Rake $0.01 
Board [Ah 5c 3d Qc 5h]
Seat 1: Scaaalll (button) folded before Flop (didn't bet)
Seat 2: STE1NBERG (small blind) folded before Flop
Seat 3: arex194 (big blind) folded before Flop
Seat 4: nbarreiro021 folded before Flop (didn't bet)
Seat 5: Gerar NB showed [8d 8c] and lost with two pair, Eights and Fives
Seat 6: rpycmbEM showed [Ks Kd] and won ($0.28) with two pair, Kings and Fives



PokerStars Zoom Hand #229234143158:  Hold'em No Limit ($0.01/$0.02) - 2021/08/22 0:00:05 CET [2021/08/21 18:00:05 ET]
Table 'Halley' 6-max Seat #1 is the button
Seat 1: punkosk8 ($7.28 in chips) 
Seat 2: danteesq ($2.24 in chips) 
Seat 3: Scaaalll ($3.71 in chips) 
Seat 4: AXXILLES ($4.60 in chips) 
Seat 5: fabor1303 ($4.35 in chips) 
Seat 6: Dr.stromg ($5.20 in chips) 
danteesq: posts small blind $0.01
Scaaalll: posts big blind $0.02
*** HOLE CARDS ***
Dealt to Scaaalll [4c Jd]
AXXILLES: folds 
fabor1303: folds 
punkosk8 is disconnected 
Dr.stromg: raises $0.03 to $0.05
punkosk8: folds 
danteesq: folds 
Scaaalll: folds 
Uncalled bet ($0.03) returned to Dr.stromg
Dr.stromg collected $0.05 from pot
Dr.stromg: doesn't show hand 
*** SUMMARY ***
Total pot $0.05 | Rake $0 
Seat 1: punkosk8 (button) folded before Flop (didn't bet)
Seat 2: danteesq (small blind) folded before Flop
Seat 3: Scaaalll (big blind) folded before Flop
Seat 4: AXXILLES folded before Flop (didn't bet)
Seat 5: fabor1303 folded before Flop (didn't bet)
Seat 6: Dr.stromg collected ($0.05)



PokerStars Zoom Hand #229234141259:  Hold'em No Limit ($0.01/$0.02) - 2021/08/21 23:59:59 CET [2021/08/21 17:59:59 ET]
Table 'Halley' 6-max Seat #1 is the button
Seat 1: nbarreiro021 ($2 in chips) 
Seat 2: Araj Moon ($2.16 in chips) 
Seat 3: Ck@tih@ ($1.93 in chips) 
Seat 4: Scaaalll ($3.71 in chips) 
Seat 5: Tabitaji ($2.72 in chips) 
Seat 6: Jackb9908 ($0.94 in chips) 
Araj Moon: posts small blind $0.01
Ck@tih@: posts big blind $0.02
*** HOLE CARDS ***
Dealt to Scaaalll [4s 3d]
Scaaalll: folds 
Tabitaji: raises $0.04 to $0.06
Jackb9908: folds 
nbarreiro021: folds 
Araj Moon: folds 
Ck@tih@: folds 
Uncalled bet ($0.04) returned to Tabitaji
Tabitaji collected $0.05 from pot
Tabitaji: doesn't show hand 
*** SUMMARY ***
Total pot $0.05 | Rake $0 
Seat 1: nbarreiro021 (button) folded before Flop (didn't bet)
Seat 2: Araj Moon (small blind) folded before Flop
Seat 3: Ck@tih@ (big blind) folded before Flop
Seat 4: Scaaalll folded before Flop (didn't bet)
Seat 5: Tabitaji collected ($0.05)
Seat 6: Jackb9908 folded before Flop (didn't bet)



PokerStars Zoom Hand #229234137421:  Hold'em No Limit ($0.01/$0.02) - 2021/08/21 23:59:47 CET [2021/08/21 17:59:47 ET]
Table 'Halley' 6-max Seat #1 is the button
Seat 1: zergmiky ($2.14 in chips) 
Seat 2: kboskov123 ($1.66 in chips) 
Seat 3: rancing87 ($3.78 in chips) 
Seat 4: ulisessoria ($2.06 in chips) 
Seat 5: Scaaalll ($3.71 in chips) 
Seat 6: Chrisisxzor ($3.85 in chips) 
kboskov123: posts small blind $0.01
rancing87: posts big blind $0.02
*** HOLE CARDS ***
Dealt to Scaaalll [Td 4c]
ulisessoria: folds 
Scaaalll: folds 
Chrisisxzor: raises $0.04 to $0.06
zergmiky: raises $0.10 to $0.16
kboskov123: folds 
rancing87: raises $0.40 to $0.56
Chrisisxzor: folds 
zergmiky: folds 
Uncalled bet ($0.40) returned to rancing87
rancing87 collected $0.39 from pot
rancing87: doesn't show hand 
*** SUMMARY ***
Total pot $0.39 | Rake $0 
Seat 1: zergmiky (button) folded before Flop
Seat 2: kboskov123 (small blind) folded before Flop
Seat 3: rancing87 (big blind) collected ($0.39)
Seat 4: ulisessoria folded before Flop (didn't bet)
Seat 5: Scaaalll folded before Flop (didn't bet)
Seat 6: Chrisisxzor folded before Flop



PokerStars Zoom Hand #229234148509:  Hold'em No Limit ($0.01/$0.02) - 2021/08/22 0:00:22 CET [2021/08/21 18:00:22 ET]
Table 'Halley' 6-max Seat #1 is the button
Seat 1: Gamer577 ($4.61 in chips) 
Seat 2: Ne0net ($2.04 in chips) 
Seat 3: pipecmolodec ($2.05 in chips) 
Seat 4: elmex886 ($2.09 in chips) 
Seat 5: Xlavariable ($2 in chips) 
Seat 6: Scaaalll ($3.69 in chips) 
Ne0net: posts small blind $0.01
pipecmolodec: posts big blind $0.02
*** HOLE CARDS ***
Dealt to Scaaalll [4c Qh]
elmex886: folds 
Xlavariable: folds 
Scaaalll: folds 
Gamer577: folds 
Ne0net: folds 
Uncalled bet ($0.01) returned to pipecmolodec
pipecmolodec collected $0.02 from pot
pipecmolodec: doesn't show hand 
*** SUMMARY ***
Total pot $0.02 | Rake $0 
Seat 1: Gamer577 (button) folded before Flop (didn't bet)
Seat 2: Ne0net (small blind) folded before Flop
Seat 3: pipecmolodec (big blind) collected ($0.02)
Seat 4: elmex886 folded before Flop (didn't bet)
Seat 5: Xlavariable folded before Flop (didn't bet)
Seat 6: Scaaalll folded before Flop (didn't bet)



PokerStars Zoom Hand #229234151418:  Hold'em No Limit ($0.01/$0.02) - 2021/08/22 0:00:31 CET [2021/08/21 18:00:31 ET]
Table 'Halley' 6-max Seat #1 is the button
Seat 1: slaweksen ($1.93 in chips) 
Seat 2: Scaaalll ($3.69 in chips) 
Seat 3: nagibatorali ($1 in chips) 
Seat 4: tarogame ($2.49 in chips) 
Seat 5: Valansen ($3.04 in chips) 
Seat 6: igara tigara ($2.62 in chips) 
Scaaalll: posts small blind $0.01
nagibatorali: posts big blind $0.02
*** HOLE CARDS ***
Dealt to Scaaalll [5h Jc]
tarogame: folds 
Valansen: folds 
igara tigara: folds 
slaweksen: raises $0.04 to $0.06
Scaaalll: folds 
nagibatorali: calls $0.04
*** FLOP *** [Qd 8c 3c]
nagibatorali: checks 
slaweksen: bets $0.06
nagibatorali: calls $0.06
*** TURN *** [Qd 8c 3c] [4s]
nagibatorali: checks 
slaweksen: checks 
*** RIVER *** [Qd 8c 3c 4s] [7d]
nagibatorali: bets $0.10
slaweksen: calls $0.10
*** SHOW DOWN ***
nagibatorali: shows [6c As] (high card Ace)
slaweksen: shows [Jd Ad] (high card Ace - Queen+Jack kicker)
slaweksen collected $0.43 from pot
*** SUMMARY ***
Total pot $0.45 | Rake $0.02 
Board [Qd 8c 3c 4s 7d]
Seat 1: slaweksen (button) showed [Jd Ad] and won ($0.43) with high card Ace
Seat 2: Scaaalll (small blind) folded before Flop
Seat 3: nagibatorali (big blind) showed [6c As] and lost with high card Ace
Seat 4: tarogame folded before Flop (didn't bet)
Seat 5: Valansen folded before Flop (didn't bet)
Seat 6: igara tigara folded before Flop (didn't bet)



PokerStars Zoom Hand #229234156025:  Hold'em No Limit ($0.01/$0.02) - 2021/08/22 0:00:45 CET [2021/08/21 18:00:45 ET]
Table 'Halley' 6-max Seat #1 is the button
Seat 1: Scaaalll ($3.68 in chips) 
Seat 2: Iv3rson18 ($3.23 in chips) 
Seat 3: kahzura ($2.14 in chips) 
Seat 4: Red Sky 15 ($7.80 in chips) 
Seat 5: menba47 ($0.96 in chips) 
Seat 6: xmaksimus ($3.87 in chips) 
Iv3rson18: posts small blind $0.01
kahzura: posts big blind $0.02
*** HOLE CARDS ***
Dealt to Scaaalll [8h Jd]
Red Sky 15: folds 
Red Sky 15 is disconnected 
menba47: folds 
xmaksimus: folds 
Scaaalll: folds 
Iv3rson18: raises $0.04 to $0.06
kahzura: folds 
Uncalled bet ($0.04) returned to Iv3rson18
Iv3rson18 collected $0.04 from pot
Iv3rson18: doesn't show hand 
*** SUMMARY ***
Total pot $0.04 | Rake $0 
Seat 1: Scaaalll (button) folded before Flop (didn't bet)
Seat 2: Iv3rson18 (small blind) collected ($0.04)
Seat 3: kahzura (big blind) folded before Flop
Seat 4: Red Sky 15 folded before Flop (didn't bet)
Seat 5: menba47 folded before Flop (didn't bet)
Seat 6: xmaksimus folded before Flop (didn't bet)



PokerStars Zoom Hand #229234160871:  Hold'em No Limit ($0.01/$0.02) - 2021/08/22 0:00:59 CET [2021/08/21 18:00:59 ET]
Table 'Halley' 6-max Seat #1 is the button
Seat 1: polymorhp ($2.79 in chips) 
Seat 2: omelski ($0.98 in chips) 
Seat 3: medyza111 ($3.69 in chips) 
Seat 4: jbu2580 ($4.72 in chips) 
Seat 5: KKARMELO ($2.33 in chips) 
Seat 6: Scaaalll ($3.68 in chips) 
omelski: posts small blind $0.01
medyza111: posts big blind $0.02
*** HOLE CARDS ***
Dealt to Scaaalll [6h 3d]
jbu2580: raises $0.04 to $0.06
KKARMELO: folds 
Scaaalll: folds 
polymorhp: folds 
omelski: folds 
medyza111: folds 
Uncalled bet ($0.04) returned to jbu2580
jbu2580 collected $0.05 from pot
jbu2580: doesn't show hand 
*** SUMMARY ***
Total pot $0.05 | Rake $0 
Seat 1: polymorhp (button) folded before Flop (didn't bet)
Seat 2: omelski (small blind) folded before Flop
Seat 3: medyza111 (big blind) folded before Flop
Seat 4: jbu2580 collected ($0.05)
Seat 5: KKARMELO folded before Flop (didn't bet)
Seat 6: Scaaalll folded before Flop (didn't bet)



PokerStars Zoom Hand #229234165895:  Hold'em No Limit ($0.01/$0.02) - 2021/08/22 0:01:13 CET [2021/08/21 18:01:13 ET]
Table 'Halley' 6-max Seat #1 is the button
Seat 1: hexi107 ($4.57 in chips) 
Seat 2: REZAKOV72 ($2.22 in chips) 
Seat 3: gasmar_29 ($4.02 in chips) 
Seat 4: VisjePaktJe ($2.58 in chips) 
Seat 5: Scaaalll ($3.68 in chips) 
Seat 6: viktor2935 ($0.74 in chips) 
REZAKOV72: posts small blind $0.01
gasmar_29: posts big blind $0.02
*** HOLE CARDS ***
Dealt to Scaaalll [7h 7s]
VisjePaktJe: folds 
Scaaalll: raises $0.04 to $0.06
viktor2935: calls $0.06
hexi107: folds 
REZAKOV72: folds 
gasmar_29: folds 
*** FLOP *** [5h 3s Ks]
Scaaalll: bets $0.08
viktor2935: calls $0.08
*** TURN *** [5h 3s Ks] [6c]
Scaaalll: checks 
viktor2935: checks 
*** RIVER *** [5h 3s Ks 6c] [Ah]
Scaaalll: checks 
viktor2935: bets $0.60 and is all-in
Scaaalll: folds 
Uncalled bet ($0.60) returned to viktor2935
viktor2935 collected $0.30 from pot
viktor2935: doesn't show hand 
*** SUMMARY ***
Total pot $0.31 | Rake $0.01 
Board [5h 3s Ks 6c Ah]
Seat 1: hexi107 (button) folded before Flop (didn't bet)
Seat 2: REZAKOV72 (small blind) folded before Flop
Seat 3: gasmar_29 (big blind) folded before Flop
Seat 4: VisjePaktJe folded before Flop (didn't bet)
Seat 5: Scaaalll folded on the River
Seat 6: viktor2935 collected ($0.30)



